"","PAM_Guide1","PAM_Guide2","PAM_Dist","Guide1","Guide2","Gene","ID"
"1",564,93,471,"ACATACCGTATACATTTGA","GTTAAGTCCCATGTATATTC","561307.5.peg.1","   1"
"2",900,93,807,"CAGTATATCTATGTAGCAA","GTTAAGTCCCATGTATATTC","561307.5.peg.1","   1"
"3",641,93,548,"TAAATGTACCTTGTGTTAAC","GTTAAGTCCCATGTATATTC","561307.5.peg.1","   1"
"4",93,564,471,"GTTAAGTCCCATGTATATTC","ACATACCGTATACATTTGA","561307.5.peg.1","   1"
"5",900,564,336,"CAGTATATCTATGTAGCAA","ACATACCGTATACATTTGA","561307.5.peg.1","   1"
"6",93,641,548,"GTTAAGTCCCATGTATATTC","TAAATGTACCTTGTGTTAAC","561307.5.peg.1","   1"
"7",900,641,259,"CAGTATATCTATGTAGCAA","TAAATGTACCTTGTGTTAAC","561307.5.peg.1","   1"
"8",641,900,259,"TAAATGTACCTTGTGTTAAC","CAGTATATCTATGTAGCAA","561307.5.peg.1","   1"
"9",564,900,336,"ACATACCGTATACATTTGA","CAGTATATCTATGTAGCAA","561307.5.peg.1","   1"
"10",93,900,807,"GTTAAGTCCCATGTATATTC","CAGTATATCTATGTAGCAA","561307.5.peg.1","   1"
"11",315,187,128,"CATGAAGCAATATATGCCTT","GCTGTTAATGCTACATTTA","561307.5.peg.10","   2"
"12",497,187,310,"CATGATAATCTTTCGCACCT","GCTGTTAATGCTACATTTA","561307.5.peg.10","   2"
"13",702,187,515,"TTATACGGTCCAATACCAAT","GCTGTTAATGCTACATTTA","561307.5.peg.10","   2"
"14",741,187,554,"ACGAGTTGAACAGCCTCACC","GCTGTTAATGCTACATTTA","561307.5.peg.10","   2"
"15",741,210,531,"ACGAGTTGAACAGCCTCACC","GAAGAATAAACACCACTTGG","561307.5.peg.10","   2"
"16",315,210,105,"CATGAAGCAATATATGCCTT","GAAGAATAAACACCACTTGG","561307.5.peg.10","   2"
"17",497,210,287,"CATGATAATCTTTCGCACCT","GAAGAATAAACACCACTTGG","561307.5.peg.10","   2"
"18",702,210,492,"TTATACGGTCCAATACCAAT","GAAGAATAAACACCACTTGG","561307.5.peg.10","   2"
"19",702,213,489,"TTATACGGTCCAATACCAAT","AACGAAGAATAAACACCACT","561307.5.peg.10","   2"
"20",741,213,528,"ACGAGTTGAACAGCCTCACC","AACGAAGAATAAACACCACT","561307.5.peg.10","   2"
"21",315,213,102,"CATGAAGCAATATATGCCTT","AACGAAGAATAAACACCACT","561307.5.peg.10","   2"
"22",497,213,284,"CATGATAATCTTTCGCACCT","AACGAAGAATAAACACCACT","561307.5.peg.10","   2"
"23",210,315,105,"GAAGAATAAACACCACTTGG","CATGAAGCAATATATGCCTT","561307.5.peg.10","   2"
"24",213,315,102,"AACGAAGAATAAACACCACT","CATGAAGCAATATATGCCTT","561307.5.peg.10","   2"
"25",702,315,387,"TTATACGGTCCAATACCAAT","CATGAAGCAATATATGCCTT","561307.5.peg.10","   2"
"26",497,315,182,"CATGATAATCTTTCGCACCT","CATGAAGCAATATATGCCTT","561307.5.peg.10","   2"
"27",741,315,426,"ACGAGTTGAACAGCCTCACC","CATGAAGCAATATATGCCTT","561307.5.peg.10","   2"
"28",187,315,128,"GCTGTTAATGCTACATTTA","CATGAAGCAATATATGCCTT","561307.5.peg.10","   2"
"29",187,497,310,"GCTGTTAATGCTACATTTA","CATGATAATCTTTCGCACCT","561307.5.peg.10","   2"
"30",210,497,287,"GAAGAATAAACACCACTTGG","CATGATAATCTTTCGCACCT","561307.5.peg.10","   2"
"31",213,497,284,"AACGAAGAATAAACACCACT","CATGATAATCTTTCGCACCT","561307.5.peg.10","   2"
"32",315,497,182,"CATGAAGCAATATATGCCTT","CATGATAATCTTTCGCACCT","561307.5.peg.10","   2"
"33",702,497,205,"TTATACGGTCCAATACCAAT","CATGATAATCTTTCGCACCT","561307.5.peg.10","   2"
"34",741,497,244,"ACGAGTTGAACAGCCTCACC","CATGATAATCTTTCGCACCT","561307.5.peg.10","   2"
"35",315,702,387,"CATGAAGCAATATATGCCTT","TTATACGGTCCAATACCAAT","561307.5.peg.10","   2"
"36",497,702,205,"CATGATAATCTTTCGCACCT","TTATACGGTCCAATACCAAT","561307.5.peg.10","   2"
"37",187,702,515,"GCTGTTAATGCTACATTTA","TTATACGGTCCAATACCAAT","561307.5.peg.10","   2"
"38",213,702,489,"AACGAAGAATAAACACCACT","TTATACGGTCCAATACCAAT","561307.5.peg.10","   2"
"39",210,702,492,"GAAGAATAAACACCACTTGG","TTATACGGTCCAATACCAAT","561307.5.peg.10","   2"
"40",187,741,554,"GCTGTTAATGCTACATTTA","ACGAGTTGAACAGCCTCACC","561307.5.peg.10","   2"
"41",213,741,528,"AACGAAGAATAAACACCACT","ACGAGTTGAACAGCCTCACC","561307.5.peg.10","   2"
"42",497,741,244,"CATGATAATCTTTCGCACCT","ACGAGTTGAACAGCCTCACC","561307.5.peg.10","   2"
"43",210,741,531,"GAAGAATAAACACCACTTGG","ACGAGTTGAACAGCCTCACC","561307.5.peg.10","   2"
"44",315,741,426,"CATGAAGCAATATATGCCTT","ACGAGTTGAACAGCCTCACC","561307.5.peg.10","   2"
"45",522,203,319,"AATTTATCTACAGGTACTCG","CCCCTAATCCTTGATCTACA","561307.5.peg.100","   3"
"46",810,203,607,"GATGTTCCTGTAACCCAACC","CCCCTAATCCTTGATCTACA","561307.5.peg.100","   3"
"47",432,203,229,"CCATAAATGCTTCAAATAA","CCCCTAATCCTTGATCTACA","561307.5.peg.100","   3"
"48",849,203,646,"TTTGTAGCGCCATTTAACCA","CCCCTAATCCTTGATCTACA","561307.5.peg.100","   3"
"49",203,432,229,"CCCCTAATCCTTGATCTACA","CCATAAATGCTTCAAATAA","561307.5.peg.100","   3"
"50",810,432,378,"GATGTTCCTGTAACCCAACC","CCATAAATGCTTCAAATAA","561307.5.peg.100","   3"
"51",849,432,417,"TTTGTAGCGCCATTTAACCA","CCATAAATGCTTCAAATAA","561307.5.peg.100","   3"
"52",203,522,319,"CCCCTAATCCTTGATCTACA","AATTTATCTACAGGTACTCG","561307.5.peg.100","   3"
"53",810,522,288,"GATGTTCCTGTAACCCAACC","AATTTATCTACAGGTACTCG","561307.5.peg.100","   3"
"54",849,522,327,"TTTGTAGCGCCATTTAACCA","AATTTATCTACAGGTACTCG","561307.5.peg.100","   3"
"55",522,810,288,"AATTTATCTACAGGTACTCG","GATGTTCCTGTAACCCAACC","561307.5.peg.100","   3"
"56",203,810,607,"CCCCTAATCCTTGATCTACA","GATGTTCCTGTAACCCAACC","561307.5.peg.100","   3"
"57",432,810,378,"CCATAAATGCTTCAAATAA","GATGTTCCTGTAACCCAACC","561307.5.peg.100","   3"
"58",203,849,646,"CCCCTAATCCTTGATCTACA","TTTGTAGCGCCATTTAACCA","561307.5.peg.100","   3"
"59",432,849,417,"CCATAAATGCTTCAAATAA","TTTGTAGCGCCATTTAACCA","561307.5.peg.100","   3"
"60",522,849,327,"AATTTATCTACAGGTACTCG","TTTGTAGCGCCATTTAACCA","561307.5.peg.100","   3"
"61",342,176,166,"CCATGGAAATGGATGCGACT","CTTTAAATGCGCGATGGTAA","561307.5.peg.1006","  10"
"62",458,176,282,"GAACCGTATCATTAGCATAG","CTTTAAATGCGCGATGGTAA","561307.5.peg.1006","  10"
"63",342,182,160,"CCATGGAAATGGATGCGACT","CACTATCTTTAAATGCGCGA","561307.5.peg.1006","  10"
"64",458,182,276,"GAACCGTATCATTAGCATAG","CACTATCTTTAAATGCGCGA","561307.5.peg.1006","  10"
"65",176,342,166,"CTTTAAATGCGCGATGGTAA","CCATGGAAATGGATGCGACT","561307.5.peg.1006","  10"
"66",458,342,116,"GAACCGTATCATTAGCATAG","CCATGGAAATGGATGCGACT","561307.5.peg.1006","  10"
"67",182,342,160,"CACTATCTTTAAATGCGCGA","CCATGGAAATGGATGCGACT","561307.5.peg.1006","  10"
"68",182,458,276,"CACTATCTTTAAATGCGCGA","GAACCGTATCATTAGCATAG","561307.5.peg.1006","  10"
"69",176,458,282,"CTTTAAATGCGCGATGGTAA","GAACCGTATCATTAGCATAG","561307.5.peg.1006","  10"
"70",342,458,116,"CCATGGAAATGGATGCGACT","GAACCGTATCATTAGCATAG","561307.5.peg.1006","  10"
"71",333,161,172,"TATAGTAATATGTCAACGA","ACTGAGTTACAGCAAATTCT","561307.5.peg.1007","  11"
"72",333,188,145,"TATAGTAATATGTCAACGA","AAATGTATCTATACCTGCA","561307.5.peg.1007","  11"
"73",161,333,172,"ACTGAGTTACAGCAAATTCT","TATAGTAATATGTCAACGA","561307.5.peg.1007","  11"
"74",188,333,145,"AAATGTATCTATACCTGCA","TATAGTAATATGTCAACGA","561307.5.peg.1007","  11"
"75",472,83,389,"TGGATACTTATCAAAGGCAC","CAGGATGTTGATGTAAATGA","561307.5.peg.1008","  12"
"76",288,83,205,"TGATCAGATTGACTGCGATA","CAGGATGTTGATGTAAATGA","561307.5.peg.1008","  12"
"77",574,83,491,"AAAGCGATACTCTGTTGCGC","CAGGATGTTGATGTAAATGA","561307.5.peg.1008","  12"
"78",425,83,342,"CACCAGTTTCTTCTGCAGGT","CAGGATGTTGATGTAAATGA","561307.5.peg.1008","  12"
"79",524,83,441,"CAATGCCTTCATCAGCAAAT","CAGGATGTTGATGTAAATGA","561307.5.peg.1008","  12"
"80",83,288,205,"CAGGATGTTGATGTAAATGA","TGATCAGATTGACTGCGATA","561307.5.peg.1008","  12"
"81",472,288,184,"TGGATACTTATCAAAGGCAC","TGATCAGATTGACTGCGATA","561307.5.peg.1008","  12"
"82",574,288,286,"AAAGCGATACTCTGTTGCGC","TGATCAGATTGACTGCGATA","561307.5.peg.1008","  12"
"83",425,288,137,"CACCAGTTTCTTCTGCAGGT","TGATCAGATTGACTGCGATA","561307.5.peg.1008","  12"
"84",524,288,236,"CAATGCCTTCATCAGCAAAT","TGATCAGATTGACTGCGATA","561307.5.peg.1008","  12"
"85",83,425,342,"CAGGATGTTGATGTAAATGA","CACCAGTTTCTTCTGCAGGT","561307.5.peg.1008","  12"
"86",288,425,137,"TGATCAGATTGACTGCGATA","CACCAGTTTCTTCTGCAGGT","561307.5.peg.1008","  12"
"87",574,425,149,"AAAGCGATACTCTGTTGCGC","CACCAGTTTCTTCTGCAGGT","561307.5.peg.1008","  12"
"88",574,472,102,"AAAGCGATACTCTGTTGCGC","TGGATACTTATCAAAGGCAC","561307.5.peg.1008","  12"
"89",288,472,184,"TGATCAGATTGACTGCGATA","TGGATACTTATCAAAGGCAC","561307.5.peg.1008","  12"
"90",83,472,389,"CAGGATGTTGATGTAAATGA","TGGATACTTATCAAAGGCAC","561307.5.peg.1008","  12"
"91",288,524,236,"TGATCAGATTGACTGCGATA","CAATGCCTTCATCAGCAAAT","561307.5.peg.1008","  12"
"92",83,524,441,"CAGGATGTTGATGTAAATGA","CAATGCCTTCATCAGCAAAT","561307.5.peg.1008","  12"
"93",83,574,491,"CAGGATGTTGATGTAAATGA","AAAGCGATACTCTGTTGCGC","561307.5.peg.1008","  12"
"94",288,574,286,"TGATCAGATTGACTGCGATA","AAAGCGATACTCTGTTGCGC","561307.5.peg.1008","  12"
"95",425,574,149,"CACCAGTTTCTTCTGCAGGT","AAAGCGATACTCTGTTGCGC","561307.5.peg.1008","  12"
"96",472,574,102,"TGGATACTTATCAAAGGCAC","AAAGCGATACTCTGTTGCGC","561307.5.peg.1008","  12"
"97",246,99,147,"GTTGATTTACCTTCACCAGC","GATGCAGCAATATCCTTAAT","561307.5.peg.101","  14"
"98",440,99,341,"TATTTGCAGTTGTAATCGCA","GATGCAGCAATATCCTTAAT","561307.5.peg.101","  14"
"99",336,99,237,"CCAAATGTTGGTCCTAAAGC","GATGCAGCAATATCCTTAAT","561307.5.peg.101","  14"
"100",348,99,249,"CCACCTTTGATACCAAATGT","GATGCAGCAATATCCTTAAT","561307.5.peg.101","  14"
"101",840,99,741,"GGTCCACCATGAACTAATGC","GATGCAGCAATATCCTTAAT","561307.5.peg.101","  14"
"102",615,99,516,"ATATTAAAGCCATCTTCACG","GATGCAGCAATATCCTTAAT","561307.5.peg.101","  14"
"103",600,99,501,"TCACGTGGTACACCATTTGT","GATGCAGCAATATCCTTAAT","561307.5.peg.101","  14"
"104",239,99,140,"TACCTTCACCAGCTGGTGTT","GATGCAGCAATATCCTTAAT","561307.5.peg.101","  14"
"105",402,99,303,"GTAAGTTGATATCTTCCAT","GATGCAGCAATATCCTTAAT","561307.5.peg.101","  14"
"106",497,99,398,"CGATTCCTAATTCGTTACCT","GATGCAGCAATATCCTTAAT","561307.5.peg.101","  14"
"107",497,150,347,"CGATTCCTAATTCGTTACCT","TAGCTTTGTAATGACCATA","561307.5.peg.101","  14"
"108",600,150,450,"TCACGTGGTACACCATTTGT","TAGCTTTGTAATGACCATA","561307.5.peg.101","  14"
"109",336,150,186,"CCAAATGTTGGTCCTAAAGC","TAGCTTTGTAATGACCATA","561307.5.peg.101","  14"
"110",402,150,252,"GTAAGTTGATATCTTCCAT","TAGCTTTGTAATGACCATA","561307.5.peg.101","  14"
"111",840,150,690,"GGTCCACCATGAACTAATGC","TAGCTTTGTAATGACCATA","561307.5.peg.101","  14"
"112",440,150,290,"TATTTGCAGTTGTAATCGCA","TAGCTTTGTAATGACCATA","561307.5.peg.101","  14"
"113",615,150,465,"ATATTAAAGCCATCTTCACG","TAGCTTTGTAATGACCATA","561307.5.peg.101","  14"
"114",348,150,198,"CCACCTTTGATACCAAATGT","TAGCTTTGTAATGACCATA","561307.5.peg.101","  14"
"115",99,239,140,"GATGCAGCAATATCCTTAAT","TACCTTCACCAGCTGGTGTT","561307.5.peg.101","  14"
"116",348,239,109,"CCACCTTTGATACCAAATGT","TACCTTCACCAGCTGGTGTT","561307.5.peg.101","  14"
"117",497,239,258,"CGATTCCTAATTCGTTACCT","TACCTTCACCAGCTGGTGTT","561307.5.peg.101","  14"
"118",840,239,601,"GGTCCACCATGAACTAATGC","TACCTTCACCAGCTGGTGTT","561307.5.peg.101","  14"
"119",402,239,163,"GTAAGTTGATATCTTCCAT","TACCTTCACCAGCTGGTGTT","561307.5.peg.101","  14"
"120",615,239,376,"ATATTAAAGCCATCTTCACG","TACCTTCACCAGCTGGTGTT","561307.5.peg.101","  14"
"121",440,239,201,"TATTTGCAGTTGTAATCGCA","TACCTTCACCAGCTGGTGTT","561307.5.peg.101","  14"
"122",600,239,361,"TCACGTGGTACACCATTTGT","TACCTTCACCAGCTGGTGTT","561307.5.peg.101","  14"
"123",402,246,156,"GTAAGTTGATATCTTCCAT","GTTGATTTACCTTCACCAGC","561307.5.peg.101","  14"
"124",440,246,194,"TATTTGCAGTTGTAATCGCA","GTTGATTTACCTTCACCAGC","561307.5.peg.101","  14"
"125",600,246,354,"TCACGTGGTACACCATTTGT","GTTGATTTACCTTCACCAGC","561307.5.peg.101","  14"
"126",348,246,102,"CCACCTTTGATACCAAATGT","GTTGATTTACCTTCACCAGC","561307.5.peg.101","  14"
"127",99,246,147,"GATGCAGCAATATCCTTAAT","GTTGATTTACCTTCACCAGC","561307.5.peg.101","  14"
"128",615,246,369,"ATATTAAAGCCATCTTCACG","GTTGATTTACCTTCACCAGC","561307.5.peg.101","  14"
"129",497,246,251,"CGATTCCTAATTCGTTACCT","GTTGATTTACCTTCACCAGC","561307.5.peg.101","  14"
"130",840,246,594,"GGTCCACCATGAACTAATGC","GTTGATTTACCTTCACCAGC","561307.5.peg.101","  14"
"131",99,336,237,"GATGCAGCAATATCCTTAAT","CCAAATGTTGGTCCTAAAGC","561307.5.peg.101","  14"
"132",497,336,161,"CGATTCCTAATTCGTTACCT","CCAAATGTTGGTCCTAAAGC","561307.5.peg.101","  14"
"133",840,336,504,"GGTCCACCATGAACTAATGC","CCAAATGTTGGTCCTAAAGC","561307.5.peg.101","  14"
"134",440,336,104,"TATTTGCAGTTGTAATCGCA","CCAAATGTTGGTCCTAAAGC","561307.5.peg.101","  14"
"135",615,336,279,"ATATTAAAGCCATCTTCACG","CCAAATGTTGGTCCTAAAGC","561307.5.peg.101","  14"
"136",600,336,264,"TCACGTGGTACACCATTTGT","CCAAATGTTGGTCCTAAAGC","561307.5.peg.101","  14"
"137",150,336,186,"TAGCTTTGTAATGACCATA","CCAAATGTTGGTCCTAAAGC","561307.5.peg.101","  14"
"138",600,348,252,"TCACGTGGTACACCATTTGT","CCACCTTTGATACCAAATGT","561307.5.peg.101","  14"
"139",239,348,109,"TACCTTCACCAGCTGGTGTT","CCACCTTTGATACCAAATGT","561307.5.peg.101","  14"
"140",615,348,267,"ATATTAAAGCCATCTTCACG","CCACCTTTGATACCAAATGT","561307.5.peg.101","  14"
"141",150,348,198,"TAGCTTTGTAATGACCATA","CCACCTTTGATACCAAATGT","561307.5.peg.101","  14"
"142",99,348,249,"GATGCAGCAATATCCTTAAT","CCACCTTTGATACCAAATGT","561307.5.peg.101","  14"
"143",246,348,102,"GTTGATTTACCTTCACCAGC","CCACCTTTGATACCAAATGT","561307.5.peg.101","  14"
"144",840,348,492,"GGTCCACCATGAACTAATGC","CCACCTTTGATACCAAATGT","561307.5.peg.101","  14"
"145",497,348,149,"CGATTCCTAATTCGTTACCT","CCACCTTTGATACCAAATGT","561307.5.peg.101","  14"
"146",600,402,198,"TCACGTGGTACACCATTTGT","GTAAGTTGATATCTTCCAT","561307.5.peg.101","  14"
"147",246,402,156,"GTTGATTTACCTTCACCAGC","GTAAGTTGATATCTTCCAT","561307.5.peg.101","  14"
"148",150,402,252,"TAGCTTTGTAATGACCATA","GTAAGTTGATATCTTCCAT","561307.5.peg.101","  14"
"149",615,402,213,"ATATTAAAGCCATCTTCACG","GTAAGTTGATATCTTCCAT","561307.5.peg.101","  14"
"150",99,402,303,"GATGCAGCAATATCCTTAAT","GTAAGTTGATATCTTCCAT","561307.5.peg.101","  14"
"151",239,402,163,"TACCTTCACCAGCTGGTGTT","GTAAGTTGATATCTTCCAT","561307.5.peg.101","  14"
"152",840,402,438,"GGTCCACCATGAACTAATGC","GTAAGTTGATATCTTCCAT","561307.5.peg.101","  14"
"153",840,440,400,"GGTCCACCATGAACTAATGC","TATTTGCAGTTGTAATCGCA","561307.5.peg.101","  14"
"154",99,440,341,"GATGCAGCAATATCCTTAAT","TATTTGCAGTTGTAATCGCA","561307.5.peg.101","  14"
"155",246,440,194,"GTTGATTTACCTTCACCAGC","TATTTGCAGTTGTAATCGCA","561307.5.peg.101","  14"
"156",615,440,175,"ATATTAAAGCCATCTTCACG","TATTTGCAGTTGTAATCGCA","561307.5.peg.101","  14"
"157",150,440,290,"TAGCTTTGTAATGACCATA","TATTTGCAGTTGTAATCGCA","561307.5.peg.101","  14"
"158",239,440,201,"TACCTTCACCAGCTGGTGTT","TATTTGCAGTTGTAATCGCA","561307.5.peg.101","  14"
"159",336,440,104,"CCAAATGTTGGTCCTAAAGC","TATTTGCAGTTGTAATCGCA","561307.5.peg.101","  14"
"160",600,440,160,"TCACGTGGTACACCATTTGT","TATTTGCAGTTGTAATCGCA","561307.5.peg.101","  14"
"161",840,497,343,"GGTCCACCATGAACTAATGC","CGATTCCTAATTCGTTACCT","561307.5.peg.101","  14"
"162",99,497,398,"GATGCAGCAATATCCTTAAT","CGATTCCTAATTCGTTACCT","561307.5.peg.101","  14"
"163",336,497,161,"CCAAATGTTGGTCCTAAAGC","CGATTCCTAATTCGTTACCT","561307.5.peg.101","  14"
"164",348,497,149,"CCACCTTTGATACCAAATGT","CGATTCCTAATTCGTTACCT","561307.5.peg.101","  14"
"165",615,497,118,"ATATTAAAGCCATCTTCACG","CGATTCCTAATTCGTTACCT","561307.5.peg.101","  14"
"166",246,497,251,"GTTGATTTACCTTCACCAGC","CGATTCCTAATTCGTTACCT","561307.5.peg.101","  14"
"167",239,497,258,"TACCTTCACCAGCTGGTGTT","CGATTCCTAATTCGTTACCT","561307.5.peg.101","  14"
"168",150,497,347,"TAGCTTTGTAATGACCATA","CGATTCCTAATTCGTTACCT","561307.5.peg.101","  14"
"169",600,497,103,"TCACGTGGTACACCATTTGT","CGATTCCTAATTCGTTACCT","561307.5.peg.101","  14"
"170",440,600,160,"TATTTGCAGTTGTAATCGCA","TCACGTGGTACACCATTTGT","561307.5.peg.101","  14"
"171",246,600,354,"GTTGATTTACCTTCACCAGC","TCACGTGGTACACCATTTGT","561307.5.peg.101","  14"
"172",99,600,501,"GATGCAGCAATATCCTTAAT","TCACGTGGTACACCATTTGT","561307.5.peg.101","  14"
"173",239,600,361,"TACCTTCACCAGCTGGTGTT","TCACGTGGTACACCATTTGT","561307.5.peg.101","  14"
"174",348,600,252,"CCACCTTTGATACCAAATGT","TCACGTGGTACACCATTTGT","561307.5.peg.101","  14"
"175",497,600,103,"CGATTCCTAATTCGTTACCT","TCACGTGGTACACCATTTGT","561307.5.peg.101","  14"
"176",150,600,450,"TAGCTTTGTAATGACCATA","TCACGTGGTACACCATTTGT","561307.5.peg.101","  14"
"177",840,600,240,"GGTCCACCATGAACTAATGC","TCACGTGGTACACCATTTGT","561307.5.peg.101","  14"
"178",402,600,198,"GTAAGTTGATATCTTCCAT","TCACGTGGTACACCATTTGT","561307.5.peg.101","  14"
"179",336,600,264,"CCAAATGTTGGTCCTAAAGC","TCACGTGGTACACCATTTGT","561307.5.peg.101","  14"
"180",99,615,516,"GATGCAGCAATATCCTTAAT","ATATTAAAGCCATCTTCACG","561307.5.peg.101","  14"
"181",348,615,267,"CCACCTTTGATACCAAATGT","ATATTAAAGCCATCTTCACG","561307.5.peg.101","  14"
"182",150,615,465,"TAGCTTTGTAATGACCATA","ATATTAAAGCCATCTTCACG","561307.5.peg.101","  14"
"183",246,615,369,"GTTGATTTACCTTCACCAGC","ATATTAAAGCCATCTTCACG","561307.5.peg.101","  14"
"184",239,615,376,"TACCTTCACCAGCTGGTGTT","ATATTAAAGCCATCTTCACG","561307.5.peg.101","  14"
"185",497,615,118,"CGATTCCTAATTCGTTACCT","ATATTAAAGCCATCTTCACG","561307.5.peg.101","  14"
"186",336,615,279,"CCAAATGTTGGTCCTAAAGC","ATATTAAAGCCATCTTCACG","561307.5.peg.101","  14"
"187",440,615,175,"TATTTGCAGTTGTAATCGCA","ATATTAAAGCCATCTTCACG","561307.5.peg.101","  14"
"188",402,615,213,"GTAAGTTGATATCTTCCAT","ATATTAAAGCCATCTTCACG","561307.5.peg.101","  14"
"189",840,615,225,"GGTCCACCATGAACTAATGC","ATATTAAAGCCATCTTCACG","561307.5.peg.101","  14"
"190",348,840,492,"CCACCTTTGATACCAAATGT","GGTCCACCATGAACTAATGC","561307.5.peg.101","  14"
"191",246,840,594,"GTTGATTTACCTTCACCAGC","GGTCCACCATGAACTAATGC","561307.5.peg.101","  14"
"192",440,840,400,"TATTTGCAGTTGTAATCGCA","GGTCCACCATGAACTAATGC","561307.5.peg.101","  14"
"193",239,840,601,"TACCTTCACCAGCTGGTGTT","GGTCCACCATGAACTAATGC","561307.5.peg.101","  14"
"194",497,840,343,"CGATTCCTAATTCGTTACCT","GGTCCACCATGAACTAATGC","561307.5.peg.101","  14"
"195",615,840,225,"ATATTAAAGCCATCTTCACG","GGTCCACCATGAACTAATGC","561307.5.peg.101","  14"
"196",99,840,741,"GATGCAGCAATATCCTTAAT","GGTCCACCATGAACTAATGC","561307.5.peg.101","  14"
"197",600,840,240,"TCACGTGGTACACCATTTGT","GGTCCACCATGAACTAATGC","561307.5.peg.101","  14"
"198",336,840,504,"CCAAATGTTGGTCCTAAAGC","GGTCCACCATGAACTAATGC","561307.5.peg.101","  14"
"199",150,840,690,"TAGCTTTGTAATGACCATA","GGTCCACCATGAACTAATGC","561307.5.peg.101","  14"
"200",402,840,438,"GTAAGTTGATATCTTCCAT","GGTCCACCATGAACTAATGC","561307.5.peg.101","  14"
"201",273,10,263,"CCAGTTGTTGCCACAACTAA","ACATATGACACATTTAAAGC","561307.5.peg.1010","  15"
"202",10,273,263,"ACATATGACACATTTAAAGC","CCAGTTGTTGCCACAACTAA","561307.5.peg.1010","  15"
"203",314,163,151,"CTTTAGCTTGGATTGAAGCT","TCCATTAACGATGATTGCTT","561307.5.peg.1011","  16"
"204",462,163,299,"ATTGTCATGTTCGTTCTTGA","TCCATTAACGATGATTGCTT","561307.5.peg.1011","  16"
"205",441,163,278,"GGAACATTGTACAGCACGAC","TCCATTAACGATGATTGCTT","561307.5.peg.1011","  16"
"206",326,163,163,"CAGCCCCTAAGGCTTTAGCT","TCCATTAACGATGATTGCTT","561307.5.peg.1011","  16"
"207",337,163,174,"CATAATTGCATCAGCCCCTA","TCCATTAACGATGATTGCTT","561307.5.peg.1011","  16"
"208",389,163,226,"AGTGTTTGACTAAACCACGT","TCCATTAACGATGATTGCTT","561307.5.peg.1011","  16"
"209",270,163,107,"GTGCCAGTTCCTGCTATGAC","TCCATTAACGATGATTGCTT","561307.5.peg.1011","  16"
"210",441,200,241,"GGAACATTGTACAGCACGAC","TTCATCTGTTGTTAAAGTA","561307.5.peg.1011","  16"
"211",314,200,114,"CTTTAGCTTGGATTGAAGCT","TTCATCTGTTGTTAAAGTA","561307.5.peg.1011","  16"
"212",337,200,137,"CATAATTGCATCAGCCCCTA","TTCATCTGTTGTTAAAGTA","561307.5.peg.1011","  16"
"213",326,200,126,"CAGCCCCTAAGGCTTTAGCT","TTCATCTGTTGTTAAAGTA","561307.5.peg.1011","  16"
"214",462,200,262,"ATTGTCATGTTCGTTCTTGA","TTCATCTGTTGTTAAAGTA","561307.5.peg.1011","  16"
"215",389,200,189,"AGTGTTTGACTAAACCACGT","TTCATCTGTTGTTAAAGTA","561307.5.peg.1011","  16"
"216",163,270,107,"TCCATTAACGATGATTGCTT","GTGCCAGTTCCTGCTATGAC","561307.5.peg.1011","  16"
"217",389,270,119,"AGTGTTTGACTAAACCACGT","GTGCCAGTTCCTGCTATGAC","561307.5.peg.1011","  16"
"218",441,270,171,"GGAACATTGTACAGCACGAC","GTGCCAGTTCCTGCTATGAC","561307.5.peg.1011","  16"
"219",462,270,192,"ATTGTCATGTTCGTTCTTGA","GTGCCAGTTCCTGCTATGAC","561307.5.peg.1011","  16"
"220",163,314,151,"TCCATTAACGATGATTGCTT","CTTTAGCTTGGATTGAAGCT","561307.5.peg.1011","  16"
"221",200,314,114,"TTCATCTGTTGTTAAAGTA","CTTTAGCTTGGATTGAAGCT","561307.5.peg.1011","  16"
"222",462,314,148,"ATTGTCATGTTCGTTCTTGA","CTTTAGCTTGGATTGAAGCT","561307.5.peg.1011","  16"
"223",441,314,127,"GGAACATTGTACAGCACGAC","CTTTAGCTTGGATTGAAGCT","561307.5.peg.1011","  16"
"224",163,326,163,"TCCATTAACGATGATTGCTT","CAGCCCCTAAGGCTTTAGCT","561307.5.peg.1011","  16"
"225",441,326,115,"GGAACATTGTACAGCACGAC","CAGCCCCTAAGGCTTTAGCT","561307.5.peg.1011","  16"
"226",462,326,136,"ATTGTCATGTTCGTTCTTGA","CAGCCCCTAAGGCTTTAGCT","561307.5.peg.1011","  16"
"227",200,326,126,"TTCATCTGTTGTTAAAGTA","CAGCCCCTAAGGCTTTAGCT","561307.5.peg.1011","  16"
"228",200,337,137,"TTCATCTGTTGTTAAAGTA","CATAATTGCATCAGCCCCTA","561307.5.peg.1011","  16"
"229",462,337,125,"ATTGTCATGTTCGTTCTTGA","CATAATTGCATCAGCCCCTA","561307.5.peg.1011","  16"
"230",163,337,174,"TCCATTAACGATGATTGCTT","CATAATTGCATCAGCCCCTA","561307.5.peg.1011","  16"
"231",441,337,104,"GGAACATTGTACAGCACGAC","CATAATTGCATCAGCCCCTA","561307.5.peg.1011","  16"
"232",163,389,226,"TCCATTAACGATGATTGCTT","AGTGTTTGACTAAACCACGT","561307.5.peg.1011","  16"
"233",270,389,119,"GTGCCAGTTCCTGCTATGAC","AGTGTTTGACTAAACCACGT","561307.5.peg.1011","  16"
"234",200,389,189,"TTCATCTGTTGTTAAAGTA","AGTGTTTGACTAAACCACGT","561307.5.peg.1011","  16"
"235",200,441,241,"TTCATCTGTTGTTAAAGTA","GGAACATTGTACAGCACGAC","561307.5.peg.1011","  16"
"236",270,441,171,"GTGCCAGTTCCTGCTATGAC","GGAACATTGTACAGCACGAC","561307.5.peg.1011","  16"
"237",314,441,127,"CTTTAGCTTGGATTGAAGCT","GGAACATTGTACAGCACGAC","561307.5.peg.1011","  16"
"238",163,441,278,"TCCATTAACGATGATTGCTT","GGAACATTGTACAGCACGAC","561307.5.peg.1011","  16"
"239",337,441,104,"CATAATTGCATCAGCCCCTA","GGAACATTGTACAGCACGAC","561307.5.peg.1011","  16"
"240",326,441,115,"CAGCCCCTAAGGCTTTAGCT","GGAACATTGTACAGCACGAC","561307.5.peg.1011","  16"
"241",163,462,299,"TCCATTAACGATGATTGCTT","ATTGTCATGTTCGTTCTTGA","561307.5.peg.1011","  16"
"242",270,462,192,"GTGCCAGTTCCTGCTATGAC","ATTGTCATGTTCGTTCTTGA","561307.5.peg.1011","  16"
"243",326,462,136,"CAGCCCCTAAGGCTTTAGCT","ATTGTCATGTTCGTTCTTGA","561307.5.peg.1011","  16"
"244",200,462,262,"TTCATCTGTTGTTAAAGTA","ATTGTCATGTTCGTTCTTGA","561307.5.peg.1011","  16"
"245",314,462,148,"CTTTAGCTTGGATTGAAGCT","ATTGTCATGTTCGTTCTTGA","561307.5.peg.1011","  16"
"246",337,462,125,"CATAATTGCATCAGCCCCTA","ATTGTCATGTTCGTTCTTGA","561307.5.peg.1011","  16"
"247",520,6,514,"ACTAACAGCAAGTGCCACAG","TGCCCTTCCTAACAATTAGG","561307.5.peg.1013","  18"
"248",268,6,262,"AGATACAGTTTGTTGCTCTC","TGCCCTTCCTAACAATTAGG","561307.5.peg.1013","  18"
"249",328,6,322,"TTGATAGCCAGTCATTGCTT","TGCCCTTCCTAACAATTAGG","561307.5.peg.1013","  18"
"250",609,6,603,"ATGTCTAGTCGTTTAGCCTT","TGCCCTTCCTAACAATTAGG","561307.5.peg.1013","  18"
"251",568,6,562,"GGCATACACACCATCAACGT","TGCCCTTCCTAACAATTAGG","561307.5.peg.1013","  18"
"252",568,9,559,"GGCATACACACCATCAACGT","GTGTGCCCTTCCTAACAATT","561307.5.peg.1013","  18"
"253",328,9,319,"TTGATAGCCAGTCATTGCTT","GTGTGCCCTTCCTAACAATT","561307.5.peg.1013","  18"
"254",609,9,600,"ATGTCTAGTCGTTTAGCCTT","GTGTGCCCTTCCTAACAATT","561307.5.peg.1013","  18"
"255",268,9,259,"AGATACAGTTTGTTGCTCTC","GTGTGCCCTTCCTAACAATT","561307.5.peg.1013","  18"
"256",520,9,511,"ACTAACAGCAAGTGCCACAG","GTGTGCCCTTCCTAACAATT","561307.5.peg.1013","  18"
"257",609,25,584,"ATGTCTAGTCGTTTAGCCTT","ATCCTCCTAATTGTTAGGAA","561307.5.peg.1013","  18"
"258",268,25,243,"AGATACAGTTTGTTGCTCTC","ATCCTCCTAATTGTTAGGAA","561307.5.peg.1013","  18"
"259",568,25,543,"GGCATACACACCATCAACGT","ATCCTCCTAATTGTTAGGAA","561307.5.peg.1013","  18"
"260",520,25,495,"ACTAACAGCAAGTGCCACAG","ATCCTCCTAATTGTTAGGAA","561307.5.peg.1013","  18"
"261",328,25,303,"TTGATAGCCAGTCATTGCTT","ATCCTCCTAATTGTTAGGAA","561307.5.peg.1013","  18"
"262",6,268,262,"TGCCCTTCCTAACAATTAGG","AGATACAGTTTGTTGCTCTC","561307.5.peg.1013","  18"
"263",520,268,252,"ACTAACAGCAAGTGCCACAG","AGATACAGTTTGTTGCTCTC","561307.5.peg.1013","  18"
"264",25,268,243,"ATCCTCCTAATTGTTAGGAA","AGATACAGTTTGTTGCTCTC","561307.5.peg.1013","  18"
"265",609,268,341,"ATGTCTAGTCGTTTAGCCTT","AGATACAGTTTGTTGCTCTC","561307.5.peg.1013","  18"
"266",9,268,259,"GTGTGCCCTTCCTAACAATT","AGATACAGTTTGTTGCTCTC","561307.5.peg.1013","  18"
"267",568,268,300,"GGCATACACACCATCAACGT","AGATACAGTTTGTTGCTCTC","561307.5.peg.1013","  18"
"268",6,328,322,"TGCCCTTCCTAACAATTAGG","TTGATAGCCAGTCATTGCTT","561307.5.peg.1013","  18"
"269",609,328,281,"ATGTCTAGTCGTTTAGCCTT","TTGATAGCCAGTCATTGCTT","561307.5.peg.1013","  18"
"270",25,328,303,"ATCCTCCTAATTGTTAGGAA","TTGATAGCCAGTCATTGCTT","561307.5.peg.1013","  18"
"271",520,328,192,"ACTAACAGCAAGTGCCACAG","TTGATAGCCAGTCATTGCTT","561307.5.peg.1013","  18"
"272",568,328,240,"GGCATACACACCATCAACGT","TTGATAGCCAGTCATTGCTT","561307.5.peg.1013","  18"
"273",9,328,319,"GTGTGCCCTTCCTAACAATT","TTGATAGCCAGTCATTGCTT","561307.5.peg.1013","  18"
"274",25,520,495,"ATCCTCCTAATTGTTAGGAA","ACTAACAGCAAGTGCCACAG","561307.5.peg.1013","  18"
"275",9,520,511,"GTGTGCCCTTCCTAACAATT","ACTAACAGCAAGTGCCACAG","561307.5.peg.1013","  18"
"276",268,520,252,"AGATACAGTTTGTTGCTCTC","ACTAACAGCAAGTGCCACAG","561307.5.peg.1013","  18"
"277",328,520,192,"TTGATAGCCAGTCATTGCTT","ACTAACAGCAAGTGCCACAG","561307.5.peg.1013","  18"
"278",6,520,514,"TGCCCTTCCTAACAATTAGG","ACTAACAGCAAGTGCCACAG","561307.5.peg.1013","  18"
"279",268,568,300,"AGATACAGTTTGTTGCTCTC","GGCATACACACCATCAACGT","561307.5.peg.1013","  18"
"280",6,568,562,"TGCCCTTCCTAACAATTAGG","GGCATACACACCATCAACGT","561307.5.peg.1013","  18"
"281",25,568,543,"ATCCTCCTAATTGTTAGGAA","GGCATACACACCATCAACGT","561307.5.peg.1013","  18"
"282",9,568,559,"GTGTGCCCTTCCTAACAATT","GGCATACACACCATCAACGT","561307.5.peg.1013","  18"
"283",328,568,240,"TTGATAGCCAGTCATTGCTT","GGCATACACACCATCAACGT","561307.5.peg.1013","  18"
"284",328,609,281,"TTGATAGCCAGTCATTGCTT","ATGTCTAGTCGTTTAGCCTT","561307.5.peg.1013","  18"
"285",9,609,600,"GTGTGCCCTTCCTAACAATT","ATGTCTAGTCGTTTAGCCTT","561307.5.peg.1013","  18"
"286",25,609,584,"ATCCTCCTAATTGTTAGGAA","ATGTCTAGTCGTTTAGCCTT","561307.5.peg.1013","  18"
"287",268,609,341,"AGATACAGTTTGTTGCTCTC","ATGTCTAGTCGTTTAGCCTT","561307.5.peg.1013","  18"
"288",6,609,603,"TGCCCTTCCTAACAATTAGG","ATGTCTAGTCGTTTAGCCTT","561307.5.peg.1013","  18"
"289",366,266,100,"CCATCTTCATCACTGAAATC","GTTCATCTTCATAAGCATAG","561307.5.peg.1014","  19"
"290",392,266,126,"CACCTTCAAGTTCAGCAGCA","GTTCATCTTCATAAGCATAG","561307.5.peg.1014","  19"
"291",615,266,349,"TCTTCTAACCAACTGATTGC","GTTCATCTTCATAAGCATAG","561307.5.peg.1014","  19"
"292",594,266,328,"GGAATATCGAGACCGTTAGT","GTTCATCTTCATAAGCATAG","561307.5.peg.1014","  19"
"293",570,266,304,"TCATCCAGTAATAGTACGTC","GTTCATCTTCATAAGCATAG","561307.5.peg.1014","  19"
"294",266,366,100,"GTTCATCTTCATAAGCATAG","CCATCTTCATCACTGAAATC","561307.5.peg.1014","  19"
"295",594,366,228,"GGAATATCGAGACCGTTAGT","CCATCTTCATCACTGAAATC","561307.5.peg.1014","  19"
"296",570,366,204,"TCATCCAGTAATAGTACGTC","CCATCTTCATCACTGAAATC","561307.5.peg.1014","  19"
"297",615,366,249,"TCTTCTAACCAACTGATTGC","CCATCTTCATCACTGAAATC","561307.5.peg.1014","  19"
"298",570,392,178,"TCATCCAGTAATAGTACGTC","CACCTTCAAGTTCAGCAGCA","561307.5.peg.1014","  19"
"299",266,392,126,"GTTCATCTTCATAAGCATAG","CACCTTCAAGTTCAGCAGCA","561307.5.peg.1014","  19"
"300",594,392,202,"GGAATATCGAGACCGTTAGT","CACCTTCAAGTTCAGCAGCA","561307.5.peg.1014","  19"
"301",615,392,223,"TCTTCTAACCAACTGATTGC","CACCTTCAAGTTCAGCAGCA","561307.5.peg.1014","  19"
"302",392,570,178,"CACCTTCAAGTTCAGCAGCA","TCATCCAGTAATAGTACGTC","561307.5.peg.1014","  19"
"303",366,570,204,"CCATCTTCATCACTGAAATC","TCATCCAGTAATAGTACGTC","561307.5.peg.1014","  19"
"304",266,570,304,"GTTCATCTTCATAAGCATAG","TCATCCAGTAATAGTACGTC","561307.5.peg.1014","  19"
"305",266,594,328,"GTTCATCTTCATAAGCATAG","GGAATATCGAGACCGTTAGT","561307.5.peg.1014","  19"
"306",392,594,202,"CACCTTCAAGTTCAGCAGCA","GGAATATCGAGACCGTTAGT","561307.5.peg.1014","  19"
"307",366,594,228,"CCATCTTCATCACTGAAATC","GGAATATCGAGACCGTTAGT","561307.5.peg.1014","  19"
"308",366,615,249,"CCATCTTCATCACTGAAATC","TCTTCTAACCAACTGATTGC","561307.5.peg.1014","  19"
"309",266,615,349,"GTTCATCTTCATAAGCATAG","TCTTCTAACCAACTGATTGC","561307.5.peg.1014","  19"
"310",392,615,223,"CACCTTCAAGTTCAGCAGCA","TCTTCTAACCAACTGATTGC","561307.5.peg.1014","  19"
"311",345,161,184,"CATGGTACTAACACTTCACG","CATCATCGTTCATTTCTGAT","561307.5.peg.1015","  20"
"312",347,161,186,"CCCATGGTACTAACACTTCA","CATCATCGTTCATTTCTGAT","561307.5.peg.1015","  20"
"313",405,161,244,"GTAACTAGCAAATAATCACC","CATCATCGTTCATTTCTGAT","561307.5.peg.1015","  20"
"314",440,161,279,"GTCCATACATATGATTCTCA","CATCATCGTTCATTTCTGAT","561307.5.peg.1015","  20"
"315",345,230,115,"CATGGTACTAACACTTCACG","TTGCAAATAATTCACCTGAA","561307.5.peg.1015","  20"
"316",347,230,117,"CCCATGGTACTAACACTTCA","TTGCAAATAATTCACCTGAA","561307.5.peg.1015","  20"
"317",405,230,175,"GTAACTAGCAAATAATCACC","TTGCAAATAATTCACCTGAA","561307.5.peg.1015","  20"
"318",440,230,210,"GTCCATACATATGATTCTCA","TTGCAAATAATTCACCTGAA","561307.5.peg.1015","  20"
"319",161,345,184,"CATCATCGTTCATTTCTGAT","CATGGTACTAACACTTCACG","561307.5.peg.1015","  20"
"320",230,345,115,"TTGCAAATAATTCACCTGAA","CATGGTACTAACACTTCACG","561307.5.peg.1015","  20"
"321",161,347,186,"CATCATCGTTCATTTCTGAT","CCCATGGTACTAACACTTCA","561307.5.peg.1015","  20"
"322",230,347,117,"TTGCAAATAATTCACCTGAA","CCCATGGTACTAACACTTCA","561307.5.peg.1015","  20"
"323",161,405,244,"CATCATCGTTCATTTCTGAT","GTAACTAGCAAATAATCACC","561307.5.peg.1015","  20"
"324",230,405,175,"TTGCAAATAATTCACCTGAA","GTAACTAGCAAATAATCACC","561307.5.peg.1015","  20"
"325",161,440,279,"CATCATCGTTCATTTCTGAT","GTCCATACATATGATTCTCA","561307.5.peg.1015","  20"
"326",230,440,210,"TTGCAAATAATTCACCTGAA","GTCCATACATATGATTCTCA","561307.5.peg.1015","  20"
"327",681,29,652,"GATGAAATTACCCCTCTATA","AAGATGCGAAAGATAATAC","561307.5.peg.1016","  21"
"328",757,29,728,"TACTTCGAACTCTTTACCAG","AAGATGCGAAAGATAATAC","561307.5.peg.1016","  21"
"329",895,29,866,"AGGTCTACTAGCTAATGTGA","AAGATGCGAAAGATAATAC","561307.5.peg.1016","  21"
"330",483,29,454,"ACGCGTTCAGGTTCTGCAGC","AAGATGCGAAAGATAATAC","561307.5.peg.1016","  21"
"331",801,29,772,"TCATCAACTGGAAGCTGCTT","AAGATGCGAAAGATAATAC","561307.5.peg.1016","  21"
"332",624,29,595,"GGTGCTTCTGGGTCACCATC","AAGATGCGAAAGATAATAC","561307.5.peg.1016","  21"
"333",160,29,131,"TCTCTTGTTTCAACTGATT","AAGATGCGAAAGATAATAC","561307.5.peg.1016","  21"
"334",618,29,589,"TCTGGGTCACCATCTGGAGC","AAGATGCGAAAGATAATAC","561307.5.peg.1016","  21"
"335",495,29,466,"ATTTCTTGTTTCACGCGTTC","AAGATGCGAAAGATAATAC","561307.5.peg.1016","  21"
"336",915,29,886,"CCTTGCAATGGTTCTGATGC","AAGATGCGAAAGATAATAC","561307.5.peg.1016","  21"
"337",483,160,323,"ACGCGTTCAGGTTCTGCAGC","TCTCTTGTTTCAACTGATT","561307.5.peg.1016","  21"
"338",915,160,755,"CCTTGCAATGGTTCTGATGC","TCTCTTGTTTCAACTGATT","561307.5.peg.1016","  21"
"339",801,160,641,"TCATCAACTGGAAGCTGCTT","TCTCTTGTTTCAACTGATT","561307.5.peg.1016","  21"
"340",618,160,458,"TCTGGGTCACCATCTGGAGC","TCTCTTGTTTCAACTGATT","561307.5.peg.1016","  21"
"341",495,160,335,"ATTTCTTGTTTCACGCGTTC","TCTCTTGTTTCAACTGATT","561307.5.peg.1016","  21"
"342",681,160,521,"GATGAAATTACCCCTCTATA","TCTCTTGTTTCAACTGATT","561307.5.peg.1016","  21"
"343",757,160,597,"TACTTCGAACTCTTTACCAG","TCTCTTGTTTCAACTGATT","561307.5.peg.1016","  21"
"344",29,160,131,"AAGATGCGAAAGATAATAC","TCTCTTGTTTCAACTGATT","561307.5.peg.1016","  21"
"345",895,160,735,"AGGTCTACTAGCTAATGTGA","TCTCTTGTTTCAACTGATT","561307.5.peg.1016","  21"
"346",624,160,464,"GGTGCTTCTGGGTCACCATC","TCTCTTGTTTCAACTGATT","561307.5.peg.1016","  21"
"347",160,483,323,"TCTCTTGTTTCAACTGATT","ACGCGTTCAGGTTCTGCAGC","561307.5.peg.1016","  21"
"348",29,483,454,"AAGATGCGAAAGATAATAC","ACGCGTTCAGGTTCTGCAGC","561307.5.peg.1016","  21"
"349",757,483,274,"TACTTCGAACTCTTTACCAG","ACGCGTTCAGGTTCTGCAGC","561307.5.peg.1016","  21"
"350",618,483,135,"TCTGGGTCACCATCTGGAGC","ACGCGTTCAGGTTCTGCAGC","561307.5.peg.1016","  21"
"351",681,483,198,"GATGAAATTACCCCTCTATA","ACGCGTTCAGGTTCTGCAGC","561307.5.peg.1016","  21"
"352",624,483,141,"GGTGCTTCTGGGTCACCATC","ACGCGTTCAGGTTCTGCAGC","561307.5.peg.1016","  21"
"353",915,483,432,"CCTTGCAATGGTTCTGATGC","ACGCGTTCAGGTTCTGCAGC","561307.5.peg.1016","  21"
"354",801,483,318,"TCATCAACTGGAAGCTGCTT","ACGCGTTCAGGTTCTGCAGC","561307.5.peg.1016","  21"
"355",895,483,412,"AGGTCTACTAGCTAATGTGA","ACGCGTTCAGGTTCTGCAGC","561307.5.peg.1016","  21"
"356",681,495,186,"GATGAAATTACCCCTCTATA","ATTTCTTGTTTCACGCGTTC","561307.5.peg.1016","  21"
"357",915,495,420,"CCTTGCAATGGTTCTGATGC","ATTTCTTGTTTCACGCGTTC","561307.5.peg.1016","  21"
"358",29,495,466,"AAGATGCGAAAGATAATAC","ATTTCTTGTTTCACGCGTTC","561307.5.peg.1016","  21"
"359",757,495,262,"TACTTCGAACTCTTTACCAG","ATTTCTTGTTTCACGCGTTC","561307.5.peg.1016","  21"
"360",895,495,400,"AGGTCTACTAGCTAATGTGA","ATTTCTTGTTTCACGCGTTC","561307.5.peg.1016","  21"
"361",801,495,306,"TCATCAACTGGAAGCTGCTT","ATTTCTTGTTTCACGCGTTC","561307.5.peg.1016","  21"
"362",160,495,335,"TCTCTTGTTTCAACTGATT","ATTTCTTGTTTCACGCGTTC","561307.5.peg.1016","  21"
"363",624,495,129,"GGTGCTTCTGGGTCACCATC","ATTTCTTGTTTCACGCGTTC","561307.5.peg.1016","  21"
"364",618,495,123,"TCTGGGTCACCATCTGGAGC","ATTTCTTGTTTCACGCGTTC","561307.5.peg.1016","  21"
"365",29,618,589,"AAGATGCGAAAGATAATAC","TCTGGGTCACCATCTGGAGC","561307.5.peg.1016","  21"
"366",495,618,123,"ATTTCTTGTTTCACGCGTTC","TCTGGGTCACCATCTGGAGC","561307.5.peg.1016","  21"
"367",160,618,458,"TCTCTTGTTTCAACTGATT","TCTGGGTCACCATCTGGAGC","561307.5.peg.1016","  21"
"368",801,618,183,"TCATCAACTGGAAGCTGCTT","TCTGGGTCACCATCTGGAGC","561307.5.peg.1016","  21"
"369",915,618,297,"CCTTGCAATGGTTCTGATGC","TCTGGGTCACCATCTGGAGC","561307.5.peg.1016","  21"
"370",483,618,135,"ACGCGTTCAGGTTCTGCAGC","TCTGGGTCACCATCTGGAGC","561307.5.peg.1016","  21"
"371",895,618,277,"AGGTCTACTAGCTAATGTGA","TCTGGGTCACCATCTGGAGC","561307.5.peg.1016","  21"
"372",757,618,139,"TACTTCGAACTCTTTACCAG","TCTGGGTCACCATCTGGAGC","561307.5.peg.1016","  21"
"373",29,624,595,"AAGATGCGAAAGATAATAC","GGTGCTTCTGGGTCACCATC","561307.5.peg.1016","  21"
"374",495,624,129,"ATTTCTTGTTTCACGCGTTC","GGTGCTTCTGGGTCACCATC","561307.5.peg.1016","  21"
"375",160,624,464,"TCTCTTGTTTCAACTGATT","GGTGCTTCTGGGTCACCATC","561307.5.peg.1016","  21"
"376",801,624,177,"TCATCAACTGGAAGCTGCTT","GGTGCTTCTGGGTCACCATC","561307.5.peg.1016","  21"
"377",483,624,141,"ACGCGTTCAGGTTCTGCAGC","GGTGCTTCTGGGTCACCATC","561307.5.peg.1016","  21"
"378",895,624,271,"AGGTCTACTAGCTAATGTGA","GGTGCTTCTGGGTCACCATC","561307.5.peg.1016","  21"
"379",757,624,133,"TACTTCGAACTCTTTACCAG","GGTGCTTCTGGGTCACCATC","561307.5.peg.1016","  21"
"380",915,624,291,"CCTTGCAATGGTTCTGATGC","GGTGCTTCTGGGTCACCATC","561307.5.peg.1016","  21"
"381",495,681,186,"ATTTCTTGTTTCACGCGTTC","GATGAAATTACCCCTCTATA","561307.5.peg.1016","  21"
"382",483,681,198,"ACGCGTTCAGGTTCTGCAGC","GATGAAATTACCCCTCTATA","561307.5.peg.1016","  21"
"383",801,681,120,"TCATCAACTGGAAGCTGCTT","GATGAAATTACCCCTCTATA","561307.5.peg.1016","  21"
"384",29,681,652,"AAGATGCGAAAGATAATAC","GATGAAATTACCCCTCTATA","561307.5.peg.1016","  21"
"385",895,681,214,"AGGTCTACTAGCTAATGTGA","GATGAAATTACCCCTCTATA","561307.5.peg.1016","  21"
"386",160,681,521,"TCTCTTGTTTCAACTGATT","GATGAAATTACCCCTCTATA","561307.5.peg.1016","  21"
"387",915,681,234,"CCTTGCAATGGTTCTGATGC","GATGAAATTACCCCTCTATA","561307.5.peg.1016","  21"
"388",915,757,158,"CCTTGCAATGGTTCTGATGC","TACTTCGAACTCTTTACCAG","561307.5.peg.1016","  21"
"389",483,757,274,"ACGCGTTCAGGTTCTGCAGC","TACTTCGAACTCTTTACCAG","561307.5.peg.1016","  21"
"390",29,757,728,"AAGATGCGAAAGATAATAC","TACTTCGAACTCTTTACCAG","561307.5.peg.1016","  21"
"391",895,757,138,"AGGTCTACTAGCTAATGTGA","TACTTCGAACTCTTTACCAG","561307.5.peg.1016","  21"
"392",160,757,597,"TCTCTTGTTTCAACTGATT","TACTTCGAACTCTTTACCAG","561307.5.peg.1016","  21"
"393",495,757,262,"ATTTCTTGTTTCACGCGTTC","TACTTCGAACTCTTTACCAG","561307.5.peg.1016","  21"
"394",618,757,139,"TCTGGGTCACCATCTGGAGC","TACTTCGAACTCTTTACCAG","561307.5.peg.1016","  21"
"395",624,757,133,"GGTGCTTCTGGGTCACCATC","TACTTCGAACTCTTTACCAG","561307.5.peg.1016","  21"
"396",495,801,306,"ATTTCTTGTTTCACGCGTTC","TCATCAACTGGAAGCTGCTT","561307.5.peg.1016","  21"
"397",618,801,183,"TCTGGGTCACCATCTGGAGC","TCATCAACTGGAAGCTGCTT","561307.5.peg.1016","  21"
"398",29,801,772,"AAGATGCGAAAGATAATAC","TCATCAACTGGAAGCTGCTT","561307.5.peg.1016","  21"
"399",160,801,641,"TCTCTTGTTTCAACTGATT","TCATCAACTGGAAGCTGCTT","561307.5.peg.1016","  21"
"400",483,801,318,"ACGCGTTCAGGTTCTGCAGC","TCATCAACTGGAAGCTGCTT","561307.5.peg.1016","  21"
"401",915,801,114,"CCTTGCAATGGTTCTGATGC","TCATCAACTGGAAGCTGCTT","561307.5.peg.1016","  21"
"402",681,801,120,"GATGAAATTACCCCTCTATA","TCATCAACTGGAAGCTGCTT","561307.5.peg.1016","  21"
"403",624,801,177,"GGTGCTTCTGGGTCACCATC","TCATCAACTGGAAGCTGCTT","561307.5.peg.1016","  21"
"404",681,895,214,"GATGAAATTACCCCTCTATA","AGGTCTACTAGCTAATGTGA","561307.5.peg.1016","  21"
"405",29,895,866,"AAGATGCGAAAGATAATAC","AGGTCTACTAGCTAATGTGA","561307.5.peg.1016","  21"
"406",618,895,277,"TCTGGGTCACCATCTGGAGC","AGGTCTACTAGCTAATGTGA","561307.5.peg.1016","  21"
"407",624,895,271,"GGTGCTTCTGGGTCACCATC","AGGTCTACTAGCTAATGTGA","561307.5.peg.1016","  21"
"408",495,895,400,"ATTTCTTGTTTCACGCGTTC","AGGTCTACTAGCTAATGTGA","561307.5.peg.1016","  21"
"409",483,895,412,"ACGCGTTCAGGTTCTGCAGC","AGGTCTACTAGCTAATGTGA","561307.5.peg.1016","  21"
"410",757,895,138,"TACTTCGAACTCTTTACCAG","AGGTCTACTAGCTAATGTGA","561307.5.peg.1016","  21"
"411",160,895,735,"TCTCTTGTTTCAACTGATT","AGGTCTACTAGCTAATGTGA","561307.5.peg.1016","  21"
"412",160,915,755,"TCTCTTGTTTCAACTGATT","CCTTGCAATGGTTCTGATGC","561307.5.peg.1016","  21"
"413",624,915,291,"GGTGCTTCTGGGTCACCATC","CCTTGCAATGGTTCTGATGC","561307.5.peg.1016","  21"
"414",483,915,432,"ACGCGTTCAGGTTCTGCAGC","CCTTGCAATGGTTCTGATGC","561307.5.peg.1016","  21"
"415",29,915,886,"AAGATGCGAAAGATAATAC","CCTTGCAATGGTTCTGATGC","561307.5.peg.1016","  21"
"416",618,915,297,"TCTGGGTCACCATCTGGAGC","CCTTGCAATGGTTCTGATGC","561307.5.peg.1016","  21"
"417",801,915,114,"TCATCAACTGGAAGCTGCTT","CCTTGCAATGGTTCTGATGC","561307.5.peg.1016","  21"
"418",495,915,420,"ATTTCTTGTTTCACGCGTTC","CCTTGCAATGGTTCTGATGC","561307.5.peg.1016","  21"
"419",681,915,234,"GATGAAATTACCCCTCTATA","CCTTGCAATGGTTCTGATGC","561307.5.peg.1016","  21"
"420",757,915,158,"TACTTCGAACTCTTTACCAG","CCTTGCAATGGTTCTGATGC","561307.5.peg.1016","  21"
"421",792,181,611,"ATTATAGCTCTTACAGCACT","GAATAATGTAAATACCATG","561307.5.peg.1019","  24"
"422",181,792,611,"GAATAATGTAAATACCATG","ATTATAGCTCTTACAGCACT","561307.5.peg.1019","  24"
"423",1020,237,783,"TGTAGTGATTCATCTGCTGG","GTTTGATTTGTATCCTTAGG","561307.5.peg.102","  25"
"424",932,237,695,"AATTTGTTTCATGAGCTGGT","GTTTGATTTGTATCCTTAGG","561307.5.peg.102","  25"
"425",1275,237,1038,"CATATGATACTAATTCGAC","GTTTGATTTGTATCCTTAGG","561307.5.peg.102","  25"
"426",936,237,699,"TAGAATTTGTTTCATGAGC","GTTTGATTTGTATCCTTAGG","561307.5.peg.102","  25"
"427",1023,237,786,"TCTTGTAGTGATTCATCTGC","GTTTGATTTGTATCCTTAGG","561307.5.peg.102","  25"
"428",598,237,361,"TGAAACTGGGAATCGAATAT","GTTTGATTTGTATCCTTAGG","561307.5.peg.102","  25"
"429",611,237,374,"CTTGTGTGCCATCTGAAACT","GTTTGATTTGTATCCTTAGG","561307.5.peg.102","  25"
"430",1328,237,1091,"CTCTCGTACCATTAGATACT","GTTTGATTTGTATCCTTAGG","561307.5.peg.102","  25"
"431",555,237,318,"CTATATGATACAAGTCTCAC","GTTTGATTTGTATCCTTAGG","561307.5.peg.102","  25"
"432",585,237,348,"CGAATATAGGCATGGTCTTC","GTTTGATTTGTATCCTTAGG","561307.5.peg.102","  25"
"433",579,237,342,"TAGGCATGGTCTTCTGGTAC","GTTTGATTTGTATCCTTAGG","561307.5.peg.102","  25"
"434",1315,237,1078,"AGATACTGGGAAACGAATAT","GTTTGATTTGTATCCTTAGG","561307.5.peg.102","  25"
"435",874,237,637,"TTGTGCAGGTTGACTCATAT","GTTTGATTTGTATCCTTAGG","561307.5.peg.102","  25"
"436",861,237,624,"CTCATATTGGTCGTTGCCTG","GTTTGATTTGTATCCTTAGG","561307.5.peg.102","  25"
"437",372,237,135,"TGGAAATTGACTTGTTCTCT","GTTTGATTTGTATCCTTAGG","561307.5.peg.102","  25"
"438",1058,237,821,"GTTCTTTATCGATGATAGCC","GTTTGATTTGTATCCTTAGG","561307.5.peg.102","  25"
"439",450,237,213,"TTAGTGTAATACACATCTGC","GTTTGATTTGTATCCTTAGG","561307.5.peg.102","  25"
"440",598,264,334,"TGAAACTGGGAATCGAATAT","GTGTTTGCTGGTTGCGTAGC","561307.5.peg.102","  25"
"441",1023,264,759,"TCTTGTAGTGATTCATCTGC","GTGTTTGCTGGTTGCGTAGC","561307.5.peg.102","  25"
"442",1020,264,756,"TGTAGTGATTCATCTGCTGG","GTGTTTGCTGGTTGCGTAGC","561307.5.peg.102","  25"
"443",611,264,347,"CTTGTGTGCCATCTGAAACT","GTGTTTGCTGGTTGCGTAGC","561307.5.peg.102","  25"
"444",1315,264,1051,"AGATACTGGGAAACGAATAT","GTGTTTGCTGGTTGCGTAGC","561307.5.peg.102","  25"
"445",1328,264,1064,"CTCTCGTACCATTAGATACT","GTGTTTGCTGGTTGCGTAGC","561307.5.peg.102","  25"
"446",936,264,672,"TAGAATTTGTTTCATGAGC","GTGTTTGCTGGTTGCGTAGC","561307.5.peg.102","  25"
"447",932,264,668,"AATTTGTTTCATGAGCTGGT","GTGTTTGCTGGTTGCGTAGC","561307.5.peg.102","  25"
"448",372,264,108,"TGGAAATTGACTTGTTCTCT","GTGTTTGCTGGTTGCGTAGC","561307.5.peg.102","  25"
"449",874,264,610,"TTGTGCAGGTTGACTCATAT","GTGTTTGCTGGTTGCGTAGC","561307.5.peg.102","  25"
"450",861,264,597,"CTCATATTGGTCGTTGCCTG","GTGTTTGCTGGTTGCGTAGC","561307.5.peg.102","  25"
"451",555,264,291,"CTATATGATACAAGTCTCAC","GTGTTTGCTGGTTGCGTAGC","561307.5.peg.102","  25"
"452",585,264,321,"CGAATATAGGCATGGTCTTC","GTGTTTGCTGGTTGCGTAGC","561307.5.peg.102","  25"
"453",579,264,315,"TAGGCATGGTCTTCTGGTAC","GTGTTTGCTGGTTGCGTAGC","561307.5.peg.102","  25"
"454",1275,264,1011,"CATATGATACTAATTCGAC","GTGTTTGCTGGTTGCGTAGC","561307.5.peg.102","  25"
"455",450,264,186,"TTAGTGTAATACACATCTGC","GTGTTTGCTGGTTGCGTAGC","561307.5.peg.102","  25"
"456",1058,264,794,"GTTCTTTATCGATGATAGCC","GTGTTTGCTGGTTGCGTAGC","561307.5.peg.102","  25"
"457",1315,300,1015,"AGATACTGGGAAACGAATAT","TTAAGTGATTCATCCGCTGC","561307.5.peg.102","  25"
"458",579,300,279,"TAGGCATGGTCTTCTGGTAC","TTAAGTGATTCATCCGCTGC","561307.5.peg.102","  25"
"459",611,300,311,"CTTGTGTGCCATCTGAAACT","TTAAGTGATTCATCCGCTGC","561307.5.peg.102","  25"
"460",1328,300,1028,"CTCTCGTACCATTAGATACT","TTAAGTGATTCATCCGCTGC","561307.5.peg.102","  25"
"461",1058,300,758,"GTTCTTTATCGATGATAGCC","TTAAGTGATTCATCCGCTGC","561307.5.peg.102","  25"
"462",450,300,150,"TTAGTGTAATACACATCTGC","TTAAGTGATTCATCCGCTGC","561307.5.peg.102","  25"
"463",585,300,285,"CGAATATAGGCATGGTCTTC","TTAAGTGATTCATCCGCTGC","561307.5.peg.102","  25"
"464",555,300,255,"CTATATGATACAAGTCTCAC","TTAAGTGATTCATCCGCTGC","561307.5.peg.102","  25"
"465",861,300,561,"CTCATATTGGTCGTTGCCTG","TTAAGTGATTCATCCGCTGC","561307.5.peg.102","  25"
"466",1020,300,720,"TGTAGTGATTCATCTGCTGG","TTAAGTGATTCATCCGCTGC","561307.5.peg.102","  25"
"467",936,300,636,"TAGAATTTGTTTCATGAGC","TTAAGTGATTCATCCGCTGC","561307.5.peg.102","  25"
"468",598,300,298,"TGAAACTGGGAATCGAATAT","TTAAGTGATTCATCCGCTGC","561307.5.peg.102","  25"
"469",932,300,632,"AATTTGTTTCATGAGCTGGT","TTAAGTGATTCATCCGCTGC","561307.5.peg.102","  25"
"470",1275,300,975,"CATATGATACTAATTCGAC","TTAAGTGATTCATCCGCTGC","561307.5.peg.102","  25"
"471",874,300,574,"TTGTGCAGGTTGACTCATAT","TTAAGTGATTCATCCGCTGC","561307.5.peg.102","  25"
"472",1023,300,723,"TCTTGTAGTGATTCATCTGC","TTAAGTGATTCATCCGCTGC","561307.5.peg.102","  25"
"473",237,372,135,"GTTTGATTTGTATCCTTAGG","TGGAAATTGACTTGTTCTCT","561307.5.peg.102","  25"
"474",611,372,239,"CTTGTGTGCCATCTGAAACT","TGGAAATTGACTTGTTCTCT","561307.5.peg.102","  25"
"475",585,372,213,"CGAATATAGGCATGGTCTTC","TGGAAATTGACTTGTTCTCT","561307.5.peg.102","  25"
"476",264,372,108,"GTGTTTGCTGGTTGCGTAGC","TGGAAATTGACTTGTTCTCT","561307.5.peg.102","  25"
"477",861,372,489,"CTCATATTGGTCGTTGCCTG","TGGAAATTGACTTGTTCTCT","561307.5.peg.102","  25"
"478",555,372,183,"CTATATGATACAAGTCTCAC","TGGAAATTGACTTGTTCTCT","561307.5.peg.102","  25"
"479",598,372,226,"TGAAACTGGGAATCGAATAT","TGGAAATTGACTTGTTCTCT","561307.5.peg.102","  25"
"480",936,372,564,"TAGAATTTGTTTCATGAGC","TGGAAATTGACTTGTTCTCT","561307.5.peg.102","  25"
"481",1020,372,648,"TGTAGTGATTCATCTGCTGG","TGGAAATTGACTTGTTCTCT","561307.5.peg.102","  25"
"482",1315,372,943,"AGATACTGGGAAACGAATAT","TGGAAATTGACTTGTTCTCT","561307.5.peg.102","  25"
"483",1023,372,651,"TCTTGTAGTGATTCATCTGC","TGGAAATTGACTTGTTCTCT","561307.5.peg.102","  25"
"484",1058,372,686,"GTTCTTTATCGATGATAGCC","TGGAAATTGACTTGTTCTCT","561307.5.peg.102","  25"
"485",932,372,560,"AATTTGTTTCATGAGCTGGT","TGGAAATTGACTTGTTCTCT","561307.5.peg.102","  25"
"486",1275,372,903,"CATATGATACTAATTCGAC","TGGAAATTGACTTGTTCTCT","561307.5.peg.102","  25"
"487",579,372,207,"TAGGCATGGTCTTCTGGTAC","TGGAAATTGACTTGTTCTCT","561307.5.peg.102","  25"
"488",1328,372,956,"CTCTCGTACCATTAGATACT","TGGAAATTGACTTGTTCTCT","561307.5.peg.102","  25"
"489",874,372,502,"TTGTGCAGGTTGACTCATAT","TGGAAATTGACTTGTTCTCT","561307.5.peg.102","  25"
"490",936,450,486,"TAGAATTTGTTTCATGAGC","TTAGTGTAATACACATCTGC","561307.5.peg.102","  25"
"491",861,450,411,"CTCATATTGGTCGTTGCCTG","TTAGTGTAATACACATCTGC","561307.5.peg.102","  25"
"492",585,450,135,"CGAATATAGGCATGGTCTTC","TTAGTGTAATACACATCTGC","561307.5.peg.102","  25"
"493",1023,450,573,"TCTTGTAGTGATTCATCTGC","TTAGTGTAATACACATCTGC","561307.5.peg.102","  25"
"494",237,450,213,"GTTTGATTTGTATCCTTAGG","TTAGTGTAATACACATCTGC","561307.5.peg.102","  25"
"495",1058,450,608,"GTTCTTTATCGATGATAGCC","TTAGTGTAATACACATCTGC","561307.5.peg.102","  25"
"496",1315,450,865,"AGATACTGGGAAACGAATAT","TTAGTGTAATACACATCTGC","561307.5.peg.102","  25"
"497",598,450,148,"TGAAACTGGGAATCGAATAT","TTAGTGTAATACACATCTGC","561307.5.peg.102","  25"
"498",579,450,129,"TAGGCATGGTCTTCTGGTAC","TTAGTGTAATACACATCTGC","561307.5.peg.102","  25"
"499",555,450,105,"CTATATGATACAAGTCTCAC","TTAGTGTAATACACATCTGC","561307.5.peg.102","  25"
"500",1328,450,878,"CTCTCGTACCATTAGATACT","TTAGTGTAATACACATCTGC","561307.5.peg.102","  25"
"501",1275,450,825,"CATATGATACTAATTCGAC","TTAGTGTAATACACATCTGC","561307.5.peg.102","  25"
"502",874,450,424,"TTGTGCAGGTTGACTCATAT","TTAGTGTAATACACATCTGC","561307.5.peg.102","  25"
"503",264,450,186,"GTGTTTGCTGGTTGCGTAGC","TTAGTGTAATACACATCTGC","561307.5.peg.102","  25"
"504",611,450,161,"CTTGTGTGCCATCTGAAACT","TTAGTGTAATACACATCTGC","561307.5.peg.102","  25"
"505",300,450,150,"TTAAGTGATTCATCCGCTGC","TTAGTGTAATACACATCTGC","561307.5.peg.102","  25"
"506",1020,450,570,"TGTAGTGATTCATCTGCTGG","TTAGTGTAATACACATCTGC","561307.5.peg.102","  25"
"507",932,450,482,"AATTTGTTTCATGAGCTGGT","TTAGTGTAATACACATCTGC","561307.5.peg.102","  25"
"508",1058,555,503,"GTTCTTTATCGATGATAGCC","CTATATGATACAAGTCTCAC","561307.5.peg.102","  25"
"509",237,555,318,"GTTTGATTTGTATCCTTAGG","CTATATGATACAAGTCTCAC","561307.5.peg.102","  25"
"510",861,555,306,"CTCATATTGGTCGTTGCCTG","CTATATGATACAAGTCTCAC","561307.5.peg.102","  25"
"511",1275,555,720,"CATATGATACTAATTCGAC","CTATATGATACAAGTCTCAC","561307.5.peg.102","  25"
"512",1023,555,468,"TCTTGTAGTGATTCATCTGC","CTATATGATACAAGTCTCAC","561307.5.peg.102","  25"
"513",300,555,255,"TTAAGTGATTCATCCGCTGC","CTATATGATACAAGTCTCAC","561307.5.peg.102","  25"
"514",932,555,377,"AATTTGTTTCATGAGCTGGT","CTATATGATACAAGTCTCAC","561307.5.peg.102","  25"
"515",1315,555,760,"AGATACTGGGAAACGAATAT","CTATATGATACAAGTCTCAC","561307.5.peg.102","  25"
"516",1020,555,465,"TGTAGTGATTCATCTGCTGG","CTATATGATACAAGTCTCAC","561307.5.peg.102","  25"
"517",264,555,291,"GTGTTTGCTGGTTGCGTAGC","CTATATGATACAAGTCTCAC","561307.5.peg.102","  25"
"518",450,555,105,"TTAGTGTAATACACATCTGC","CTATATGATACAAGTCTCAC","561307.5.peg.102","  25"
"519",1328,555,773,"CTCTCGTACCATTAGATACT","CTATATGATACAAGTCTCAC","561307.5.peg.102","  25"
"520",874,555,319,"TTGTGCAGGTTGACTCATAT","CTATATGATACAAGTCTCAC","561307.5.peg.102","  25"
"521",936,555,381,"TAGAATTTGTTTCATGAGC","CTATATGATACAAGTCTCAC","561307.5.peg.102","  25"
"522",372,555,183,"TGGAAATTGACTTGTTCTCT","CTATATGATACAAGTCTCAC","561307.5.peg.102","  25"
"523",237,579,342,"GTTTGATTTGTATCCTTAGG","TAGGCATGGTCTTCTGGTAC","561307.5.peg.102","  25"
"524",874,579,295,"TTGTGCAGGTTGACTCATAT","TAGGCATGGTCTTCTGGTAC","561307.5.peg.102","  25"
"525",450,579,129,"TTAGTGTAATACACATCTGC","TAGGCATGGTCTTCTGGTAC","561307.5.peg.102","  25"
"526",300,579,279,"TTAAGTGATTCATCCGCTGC","TAGGCATGGTCTTCTGGTAC","561307.5.peg.102","  25"
"527",932,579,353,"AATTTGTTTCATGAGCTGGT","TAGGCATGGTCTTCTGGTAC","561307.5.peg.102","  25"
"528",1023,579,444,"TCTTGTAGTGATTCATCTGC","TAGGCATGGTCTTCTGGTAC","561307.5.peg.102","  25"
"529",1315,579,736,"AGATACTGGGAAACGAATAT","TAGGCATGGTCTTCTGGTAC","561307.5.peg.102","  25"
"530",372,579,207,"TGGAAATTGACTTGTTCTCT","TAGGCATGGTCTTCTGGTAC","561307.5.peg.102","  25"
"531",936,579,357,"TAGAATTTGTTTCATGAGC","TAGGCATGGTCTTCTGGTAC","561307.5.peg.102","  25"
"532",861,579,282,"CTCATATTGGTCGTTGCCTG","TAGGCATGGTCTTCTGGTAC","561307.5.peg.102","  25"
"533",1058,579,479,"GTTCTTTATCGATGATAGCC","TAGGCATGGTCTTCTGGTAC","561307.5.peg.102","  25"
"534",1275,579,696,"CATATGATACTAATTCGAC","TAGGCATGGTCTTCTGGTAC","561307.5.peg.102","  25"
"535",264,579,315,"GTGTTTGCTGGTTGCGTAGC","TAGGCATGGTCTTCTGGTAC","561307.5.peg.102","  25"
"536",1020,579,441,"TGTAGTGATTCATCTGCTGG","TAGGCATGGTCTTCTGGTAC","561307.5.peg.102","  25"
"537",1328,579,749,"CTCTCGTACCATTAGATACT","TAGGCATGGTCTTCTGGTAC","561307.5.peg.102","  25"
"538",450,585,135,"TTAGTGTAATACACATCTGC","CGAATATAGGCATGGTCTTC","561307.5.peg.102","  25"
"539",264,585,321,"GTGTTTGCTGGTTGCGTAGC","CGAATATAGGCATGGTCTTC","561307.5.peg.102","  25"
"540",1020,585,435,"TGTAGTGATTCATCTGCTGG","CGAATATAGGCATGGTCTTC","561307.5.peg.102","  25"
"541",1275,585,690,"CATATGATACTAATTCGAC","CGAATATAGGCATGGTCTTC","561307.5.peg.102","  25"
"542",1058,585,473,"GTTCTTTATCGATGATAGCC","CGAATATAGGCATGGTCTTC","561307.5.peg.102","  25"
"543",372,585,213,"TGGAAATTGACTTGTTCTCT","CGAATATAGGCATGGTCTTC","561307.5.peg.102","  25"
"544",874,585,289,"TTGTGCAGGTTGACTCATAT","CGAATATAGGCATGGTCTTC","561307.5.peg.102","  25"
"545",1315,585,730,"AGATACTGGGAAACGAATAT","CGAATATAGGCATGGTCTTC","561307.5.peg.102","  25"
"546",861,585,276,"CTCATATTGGTCGTTGCCTG","CGAATATAGGCATGGTCTTC","561307.5.peg.102","  25"
"547",300,585,285,"TTAAGTGATTCATCCGCTGC","CGAATATAGGCATGGTCTTC","561307.5.peg.102","  25"
"548",237,585,348,"GTTTGATTTGTATCCTTAGG","CGAATATAGGCATGGTCTTC","561307.5.peg.102","  25"
"549",1328,585,743,"CTCTCGTACCATTAGATACT","CGAATATAGGCATGGTCTTC","561307.5.peg.102","  25"
"550",1023,585,438,"TCTTGTAGTGATTCATCTGC","CGAATATAGGCATGGTCTTC","561307.5.peg.102","  25"
"551",932,585,347,"AATTTGTTTCATGAGCTGGT","CGAATATAGGCATGGTCTTC","561307.5.peg.102","  25"
"552",936,585,351,"TAGAATTTGTTTCATGAGC","CGAATATAGGCATGGTCTTC","561307.5.peg.102","  25"
"553",936,598,338,"TAGAATTTGTTTCATGAGC","TGAAACTGGGAATCGAATAT","561307.5.peg.102","  25"
"554",300,598,298,"TTAAGTGATTCATCCGCTGC","TGAAACTGGGAATCGAATAT","561307.5.peg.102","  25"
"555",1023,598,425,"TCTTGTAGTGATTCATCTGC","TGAAACTGGGAATCGAATAT","561307.5.peg.102","  25"
"556",874,598,276,"TTGTGCAGGTTGACTCATAT","TGAAACTGGGAATCGAATAT","561307.5.peg.102","  25"
"557",1315,598,717,"AGATACTGGGAAACGAATAT","TGAAACTGGGAATCGAATAT","561307.5.peg.102","  25"
"558",1058,598,460,"GTTCTTTATCGATGATAGCC","TGAAACTGGGAATCGAATAT","561307.5.peg.102","  25"
"559",861,598,263,"CTCATATTGGTCGTTGCCTG","TGAAACTGGGAATCGAATAT","561307.5.peg.102","  25"
"560",237,598,361,"GTTTGATTTGTATCCTTAGG","TGAAACTGGGAATCGAATAT","561307.5.peg.102","  25"
"561",450,598,148,"TTAGTGTAATACACATCTGC","TGAAACTGGGAATCGAATAT","561307.5.peg.102","  25"
"562",1020,598,422,"TGTAGTGATTCATCTGCTGG","TGAAACTGGGAATCGAATAT","561307.5.peg.102","  25"
"563",1328,598,730,"CTCTCGTACCATTAGATACT","TGAAACTGGGAATCGAATAT","561307.5.peg.102","  25"
"564",932,598,334,"AATTTGTTTCATGAGCTGGT","TGAAACTGGGAATCGAATAT","561307.5.peg.102","  25"
"565",372,598,226,"TGGAAATTGACTTGTTCTCT","TGAAACTGGGAATCGAATAT","561307.5.peg.102","  25"
"566",1275,598,677,"CATATGATACTAATTCGAC","TGAAACTGGGAATCGAATAT","561307.5.peg.102","  25"
"567",264,598,334,"GTGTTTGCTGGTTGCGTAGC","TGAAACTGGGAATCGAATAT","561307.5.peg.102","  25"
"568",450,611,161,"TTAGTGTAATACACATCTGC","CTTGTGTGCCATCTGAAACT","561307.5.peg.102","  25"
"569",936,611,325,"TAGAATTTGTTTCATGAGC","CTTGTGTGCCATCTGAAACT","561307.5.peg.102","  25"
"570",372,611,239,"TGGAAATTGACTTGTTCTCT","CTTGTGTGCCATCTGAAACT","561307.5.peg.102","  25"
"571",932,611,321,"AATTTGTTTCATGAGCTGGT","CTTGTGTGCCATCTGAAACT","561307.5.peg.102","  25"
"572",237,611,374,"GTTTGATTTGTATCCTTAGG","CTTGTGTGCCATCTGAAACT","561307.5.peg.102","  25"
"573",874,611,263,"TTGTGCAGGTTGACTCATAT","CTTGTGTGCCATCTGAAACT","561307.5.peg.102","  25"
"574",1315,611,704,"AGATACTGGGAAACGAATAT","CTTGTGTGCCATCTGAAACT","561307.5.peg.102","  25"
"575",300,611,311,"TTAAGTGATTCATCCGCTGC","CTTGTGTGCCATCTGAAACT","561307.5.peg.102","  25"
"576",264,611,347,"GTGTTTGCTGGTTGCGTAGC","CTTGTGTGCCATCTGAAACT","561307.5.peg.102","  25"
"577",861,611,250,"CTCATATTGGTCGTTGCCTG","CTTGTGTGCCATCTGAAACT","561307.5.peg.102","  25"
"578",1058,611,447,"GTTCTTTATCGATGATAGCC","CTTGTGTGCCATCTGAAACT","561307.5.peg.102","  25"
"579",1023,611,412,"TCTTGTAGTGATTCATCTGC","CTTGTGTGCCATCTGAAACT","561307.5.peg.102","  25"
"580",1020,611,409,"TGTAGTGATTCATCTGCTGG","CTTGTGTGCCATCTGAAACT","561307.5.peg.102","  25"
"581",1275,611,664,"CATATGATACTAATTCGAC","CTTGTGTGCCATCTGAAACT","561307.5.peg.102","  25"
"582",1328,611,717,"CTCTCGTACCATTAGATACT","CTTGTGTGCCATCTGAAACT","561307.5.peg.102","  25"
"583",598,861,263,"TGAAACTGGGAATCGAATAT","CTCATATTGGTCGTTGCCTG","561307.5.peg.102","  25"
"584",372,861,489,"TGGAAATTGACTTGTTCTCT","CTCATATTGGTCGTTGCCTG","561307.5.peg.102","  25"
"585",1328,861,467,"CTCTCGTACCATTAGATACT","CTCATATTGGTCGTTGCCTG","561307.5.peg.102","  25"
"586",237,861,624,"GTTTGATTTGTATCCTTAGG","CTCATATTGGTCGTTGCCTG","561307.5.peg.102","  25"
"587",611,861,250,"CTTGTGTGCCATCTGAAACT","CTCATATTGGTCGTTGCCTG","561307.5.peg.102","  25"
"588",300,861,561,"TTAAGTGATTCATCCGCTGC","CTCATATTGGTCGTTGCCTG","561307.5.peg.102","  25"
"589",1315,861,454,"AGATACTGGGAAACGAATAT","CTCATATTGGTCGTTGCCTG","561307.5.peg.102","  25"
"590",264,861,597,"GTGTTTGCTGGTTGCGTAGC","CTCATATTGGTCGTTGCCTG","561307.5.peg.102","  25"
"591",1275,861,414,"CATATGATACTAATTCGAC","CTCATATTGGTCGTTGCCTG","561307.5.peg.102","  25"
"592",555,861,306,"CTATATGATACAAGTCTCAC","CTCATATTGGTCGTTGCCTG","561307.5.peg.102","  25"
"593",579,861,282,"TAGGCATGGTCTTCTGGTAC","CTCATATTGGTCGTTGCCTG","561307.5.peg.102","  25"
"594",1023,861,162,"TCTTGTAGTGATTCATCTGC","CTCATATTGGTCGTTGCCTG","561307.5.peg.102","  25"
"595",1020,861,159,"TGTAGTGATTCATCTGCTGG","CTCATATTGGTCGTTGCCTG","561307.5.peg.102","  25"
"596",450,861,411,"TTAGTGTAATACACATCTGC","CTCATATTGGTCGTTGCCTG","561307.5.peg.102","  25"
"597",1058,861,197,"GTTCTTTATCGATGATAGCC","CTCATATTGGTCGTTGCCTG","561307.5.peg.102","  25"
"598",585,861,276,"CGAATATAGGCATGGTCTTC","CTCATATTGGTCGTTGCCTG","561307.5.peg.102","  25"
"599",1275,874,401,"CATATGATACTAATTCGAC","TTGTGCAGGTTGACTCATAT","561307.5.peg.102","  25"
"600",598,874,276,"TGAAACTGGGAATCGAATAT","TTGTGCAGGTTGACTCATAT","561307.5.peg.102","  25"
"601",300,874,574,"TTAAGTGATTCATCCGCTGC","TTGTGCAGGTTGACTCATAT","561307.5.peg.102","  25"
"602",372,874,502,"TGGAAATTGACTTGTTCTCT","TTGTGCAGGTTGACTCATAT","561307.5.peg.102","  25"
"603",1058,874,184,"GTTCTTTATCGATGATAGCC","TTGTGCAGGTTGACTCATAT","561307.5.peg.102","  25"
"604",237,874,637,"GTTTGATTTGTATCCTTAGG","TTGTGCAGGTTGACTCATAT","561307.5.peg.102","  25"
"605",585,874,289,"CGAATATAGGCATGGTCTTC","TTGTGCAGGTTGACTCATAT","561307.5.peg.102","  25"
"606",450,874,424,"TTAGTGTAATACACATCTGC","TTGTGCAGGTTGACTCATAT","561307.5.peg.102","  25"
"607",611,874,263,"CTTGTGTGCCATCTGAAACT","TTGTGCAGGTTGACTCATAT","561307.5.peg.102","  25"
"608",1020,874,146,"TGTAGTGATTCATCTGCTGG","TTGTGCAGGTTGACTCATAT","561307.5.peg.102","  25"
"609",1315,874,441,"AGATACTGGGAAACGAATAT","TTGTGCAGGTTGACTCATAT","561307.5.peg.102","  25"
"610",1023,874,149,"TCTTGTAGTGATTCATCTGC","TTGTGCAGGTTGACTCATAT","561307.5.peg.102","  25"
"611",555,874,319,"CTATATGATACAAGTCTCAC","TTGTGCAGGTTGACTCATAT","561307.5.peg.102","  25"
"612",264,874,610,"GTGTTTGCTGGTTGCGTAGC","TTGTGCAGGTTGACTCATAT","561307.5.peg.102","  25"
"613",579,874,295,"TAGGCATGGTCTTCTGGTAC","TTGTGCAGGTTGACTCATAT","561307.5.peg.102","  25"
"614",1328,874,454,"CTCTCGTACCATTAGATACT","TTGTGCAGGTTGACTCATAT","561307.5.peg.102","  25"
"615",1315,932,383,"AGATACTGGGAAACGAATAT","AATTTGTTTCATGAGCTGGT","561307.5.peg.102","  25"
"616",555,932,377,"CTATATGATACAAGTCTCAC","AATTTGTTTCATGAGCTGGT","561307.5.peg.102","  25"
"617",585,932,347,"CGAATATAGGCATGGTCTTC","AATTTGTTTCATGAGCTGGT","561307.5.peg.102","  25"
"618",1058,932,126,"GTTCTTTATCGATGATAGCC","AATTTGTTTCATGAGCTGGT","561307.5.peg.102","  25"
"619",450,932,482,"TTAGTGTAATACACATCTGC","AATTTGTTTCATGAGCTGGT","561307.5.peg.102","  25"
"620",598,932,334,"TGAAACTGGGAATCGAATAT","AATTTGTTTCATGAGCTGGT","561307.5.peg.102","  25"
"621",237,932,695,"GTTTGATTTGTATCCTTAGG","AATTTGTTTCATGAGCTGGT","561307.5.peg.102","  25"
"622",264,932,668,"GTGTTTGCTGGTTGCGTAGC","AATTTGTTTCATGAGCTGGT","561307.5.peg.102","  25"
"623",372,932,560,"TGGAAATTGACTTGTTCTCT","AATTTGTTTCATGAGCTGGT","561307.5.peg.102","  25"
"624",1328,932,396,"CTCTCGTACCATTAGATACT","AATTTGTTTCATGAGCTGGT","561307.5.peg.102","  25"
"625",579,932,353,"TAGGCATGGTCTTCTGGTAC","AATTTGTTTCATGAGCTGGT","561307.5.peg.102","  25"
"626",611,932,321,"CTTGTGTGCCATCTGAAACT","AATTTGTTTCATGAGCTGGT","561307.5.peg.102","  25"
"627",300,932,632,"TTAAGTGATTCATCCGCTGC","AATTTGTTTCATGAGCTGGT","561307.5.peg.102","  25"
"628",1275,932,343,"CATATGATACTAATTCGAC","AATTTGTTTCATGAGCTGGT","561307.5.peg.102","  25"
"629",598,936,338,"TGAAACTGGGAATCGAATAT","TAGAATTTGTTTCATGAGC","561307.5.peg.102","  25"
"630",1315,936,379,"AGATACTGGGAAACGAATAT","TAGAATTTGTTTCATGAGC","561307.5.peg.102","  25"
"631",372,936,564,"TGGAAATTGACTTGTTCTCT","TAGAATTTGTTTCATGAGC","561307.5.peg.102","  25"
"632",264,936,672,"GTGTTTGCTGGTTGCGTAGC","TAGAATTTGTTTCATGAGC","561307.5.peg.102","  25"
"633",1275,936,339,"CATATGATACTAATTCGAC","TAGAATTTGTTTCATGAGC","561307.5.peg.102","  25"
"634",450,936,486,"TTAGTGTAATACACATCTGC","TAGAATTTGTTTCATGAGC","561307.5.peg.102","  25"
"635",1328,936,392,"CTCTCGTACCATTAGATACT","TAGAATTTGTTTCATGAGC","561307.5.peg.102","  25"
"636",300,936,636,"TTAAGTGATTCATCCGCTGC","TAGAATTTGTTTCATGAGC","561307.5.peg.102","  25"
"637",579,936,357,"TAGGCATGGTCTTCTGGTAC","TAGAATTTGTTTCATGAGC","561307.5.peg.102","  25"
"638",611,936,325,"CTTGTGTGCCATCTGAAACT","TAGAATTTGTTTCATGAGC","561307.5.peg.102","  25"
"639",555,936,381,"CTATATGATACAAGTCTCAC","TAGAATTTGTTTCATGAGC","561307.5.peg.102","  25"
"640",1058,936,122,"GTTCTTTATCGATGATAGCC","TAGAATTTGTTTCATGAGC","561307.5.peg.102","  25"
"641",585,936,351,"CGAATATAGGCATGGTCTTC","TAGAATTTGTTTCATGAGC","561307.5.peg.102","  25"
"642",237,936,699,"GTTTGATTTGTATCCTTAGG","TAGAATTTGTTTCATGAGC","561307.5.peg.102","  25"
"643",372,1020,648,"TGGAAATTGACTTGTTCTCT","TGTAGTGATTCATCTGCTGG","561307.5.peg.102","  25"
"644",585,1020,435,"CGAATATAGGCATGGTCTTC","TGTAGTGATTCATCTGCTGG","561307.5.peg.102","  25"
"645",874,1020,146,"TTGTGCAGGTTGACTCATAT","TGTAGTGATTCATCTGCTGG","561307.5.peg.102","  25"
"646",1328,1020,308,"CTCTCGTACCATTAGATACT","TGTAGTGATTCATCTGCTGG","561307.5.peg.102","  25"
"647",237,1020,783,"GTTTGATTTGTATCCTTAGG","TGTAGTGATTCATCTGCTGG","561307.5.peg.102","  25"
"648",579,1020,441,"TAGGCATGGTCTTCTGGTAC","TGTAGTGATTCATCTGCTGG","561307.5.peg.102","  25"
"649",861,1020,159,"CTCATATTGGTCGTTGCCTG","TGTAGTGATTCATCTGCTGG","561307.5.peg.102","  25"
"650",264,1020,756,"GTGTTTGCTGGTTGCGTAGC","TGTAGTGATTCATCTGCTGG","561307.5.peg.102","  25"
"651",300,1020,720,"TTAAGTGATTCATCCGCTGC","TGTAGTGATTCATCTGCTGG","561307.5.peg.102","  25"
"652",611,1020,409,"CTTGTGTGCCATCTGAAACT","TGTAGTGATTCATCTGCTGG","561307.5.peg.102","  25"
"653",555,1020,465,"CTATATGATACAAGTCTCAC","TGTAGTGATTCATCTGCTGG","561307.5.peg.102","  25"
"654",450,1020,570,"TTAGTGTAATACACATCTGC","TGTAGTGATTCATCTGCTGG","561307.5.peg.102","  25"
"655",598,1020,422,"TGAAACTGGGAATCGAATAT","TGTAGTGATTCATCTGCTGG","561307.5.peg.102","  25"
"656",1315,1020,295,"AGATACTGGGAAACGAATAT","TGTAGTGATTCATCTGCTGG","561307.5.peg.102","  25"
"657",1275,1020,255,"CATATGATACTAATTCGAC","TGTAGTGATTCATCTGCTGG","561307.5.peg.102","  25"
"658",585,1023,438,"CGAATATAGGCATGGTCTTC","TCTTGTAGTGATTCATCTGC","561307.5.peg.102","  25"
"659",598,1023,425,"TGAAACTGGGAATCGAATAT","TCTTGTAGTGATTCATCTGC","561307.5.peg.102","  25"
"660",1315,1023,292,"AGATACTGGGAAACGAATAT","TCTTGTAGTGATTCATCTGC","561307.5.peg.102","  25"
"661",1275,1023,252,"CATATGATACTAATTCGAC","TCTTGTAGTGATTCATCTGC","561307.5.peg.102","  25"
"662",372,1023,651,"TGGAAATTGACTTGTTCTCT","TCTTGTAGTGATTCATCTGC","561307.5.peg.102","  25"
"663",861,1023,162,"CTCATATTGGTCGTTGCCTG","TCTTGTAGTGATTCATCTGC","561307.5.peg.102","  25"
"664",555,1023,468,"CTATATGATACAAGTCTCAC","TCTTGTAGTGATTCATCTGC","561307.5.peg.102","  25"
"665",611,1023,412,"CTTGTGTGCCATCTGAAACT","TCTTGTAGTGATTCATCTGC","561307.5.peg.102","  25"
"666",264,1023,759,"GTGTTTGCTGGTTGCGTAGC","TCTTGTAGTGATTCATCTGC","561307.5.peg.102","  25"
"667",237,1023,786,"GTTTGATTTGTATCCTTAGG","TCTTGTAGTGATTCATCTGC","561307.5.peg.102","  25"
"668",579,1023,444,"TAGGCATGGTCTTCTGGTAC","TCTTGTAGTGATTCATCTGC","561307.5.peg.102","  25"
"669",1328,1023,305,"CTCTCGTACCATTAGATACT","TCTTGTAGTGATTCATCTGC","561307.5.peg.102","  25"
"670",450,1023,573,"TTAGTGTAATACACATCTGC","TCTTGTAGTGATTCATCTGC","561307.5.peg.102","  25"
"671",300,1023,723,"TTAAGTGATTCATCCGCTGC","TCTTGTAGTGATTCATCTGC","561307.5.peg.102","  25"
"672",874,1023,149,"TTGTGCAGGTTGACTCATAT","TCTTGTAGTGATTCATCTGC","561307.5.peg.102","  25"
"673",300,1058,758,"TTAAGTGATTCATCCGCTGC","GTTCTTTATCGATGATAGCC","561307.5.peg.102","  25"
"674",598,1058,460,"TGAAACTGGGAATCGAATAT","GTTCTTTATCGATGATAGCC","561307.5.peg.102","  25"
"675",936,1058,122,"TAGAATTTGTTTCATGAGC","GTTCTTTATCGATGATAGCC","561307.5.peg.102","  25"
"676",585,1058,473,"CGAATATAGGCATGGTCTTC","GTTCTTTATCGATGATAGCC","561307.5.peg.102","  25"
"677",264,1058,794,"GTGTTTGCTGGTTGCGTAGC","GTTCTTTATCGATGATAGCC","561307.5.peg.102","  25"
"678",1275,1058,217,"CATATGATACTAATTCGAC","GTTCTTTATCGATGATAGCC","561307.5.peg.102","  25"
"679",555,1058,503,"CTATATGATACAAGTCTCAC","GTTCTTTATCGATGATAGCC","561307.5.peg.102","  25"
"680",237,1058,821,"GTTTGATTTGTATCCTTAGG","GTTCTTTATCGATGATAGCC","561307.5.peg.102","  25"
"681",932,1058,126,"AATTTGTTTCATGAGCTGGT","GTTCTTTATCGATGATAGCC","561307.5.peg.102","  25"
"682",372,1058,686,"TGGAAATTGACTTGTTCTCT","GTTCTTTATCGATGATAGCC","561307.5.peg.102","  25"
"683",1328,1058,270,"CTCTCGTACCATTAGATACT","GTTCTTTATCGATGATAGCC","561307.5.peg.102","  25"
"684",1315,1058,257,"AGATACTGGGAAACGAATAT","GTTCTTTATCGATGATAGCC","561307.5.peg.102","  25"
"685",611,1058,447,"CTTGTGTGCCATCTGAAACT","GTTCTTTATCGATGATAGCC","561307.5.peg.102","  25"
"686",450,1058,608,"TTAGTGTAATACACATCTGC","GTTCTTTATCGATGATAGCC","561307.5.peg.102","  25"
"687",874,1058,184,"TTGTGCAGGTTGACTCATAT","GTTCTTTATCGATGATAGCC","561307.5.peg.102","  25"
"688",861,1058,197,"CTCATATTGGTCGTTGCCTG","GTTCTTTATCGATGATAGCC","561307.5.peg.102","  25"
"689",579,1058,479,"TAGGCATGGTCTTCTGGTAC","GTTCTTTATCGATGATAGCC","561307.5.peg.102","  25"
"690",1023,1275,252,"TCTTGTAGTGATTCATCTGC","CATATGATACTAATTCGAC","561307.5.peg.102","  25"
"691",1058,1275,217,"GTTCTTTATCGATGATAGCC","CATATGATACTAATTCGAC","561307.5.peg.102","  25"
"692",372,1275,903,"TGGAAATTGACTTGTTCTCT","CATATGATACTAATTCGAC","561307.5.peg.102","  25"
"693",611,1275,664,"CTTGTGTGCCATCTGAAACT","CATATGATACTAATTCGAC","561307.5.peg.102","  25"
"694",936,1275,339,"TAGAATTTGTTTCATGAGC","CATATGATACTAATTCGAC","561307.5.peg.102","  25"
"695",237,1275,1038,"GTTTGATTTGTATCCTTAGG","CATATGATACTAATTCGAC","561307.5.peg.102","  25"
"696",585,1275,690,"CGAATATAGGCATGGTCTTC","CATATGATACTAATTCGAC","561307.5.peg.102","  25"
"697",1020,1275,255,"TGTAGTGATTCATCTGCTGG","CATATGATACTAATTCGAC","561307.5.peg.102","  25"
"698",300,1275,975,"TTAAGTGATTCATCCGCTGC","CATATGATACTAATTCGAC","561307.5.peg.102","  25"
"699",932,1275,343,"AATTTGTTTCATGAGCTGGT","CATATGATACTAATTCGAC","561307.5.peg.102","  25"
"700",450,1275,825,"TTAGTGTAATACACATCTGC","CATATGATACTAATTCGAC","561307.5.peg.102","  25"
"701",861,1275,414,"CTCATATTGGTCGTTGCCTG","CATATGATACTAATTCGAC","561307.5.peg.102","  25"
"702",579,1275,696,"TAGGCATGGTCTTCTGGTAC","CATATGATACTAATTCGAC","561307.5.peg.102","  25"
"703",874,1275,401,"TTGTGCAGGTTGACTCATAT","CATATGATACTAATTCGAC","561307.5.peg.102","  25"
"704",555,1275,720,"CTATATGATACAAGTCTCAC","CATATGATACTAATTCGAC","561307.5.peg.102","  25"
"705",264,1275,1011,"GTGTTTGCTGGTTGCGTAGC","CATATGATACTAATTCGAC","561307.5.peg.102","  25"
"706",598,1275,677,"TGAAACTGGGAATCGAATAT","CATATGATACTAATTCGAC","561307.5.peg.102","  25"
"707",874,1315,441,"TTGTGCAGGTTGACTCATAT","AGATACTGGGAAACGAATAT","561307.5.peg.102","  25"
"708",264,1315,1051,"GTGTTTGCTGGTTGCGTAGC","AGATACTGGGAAACGAATAT","561307.5.peg.102","  25"
"709",1058,1315,257,"GTTCTTTATCGATGATAGCC","AGATACTGGGAAACGAATAT","561307.5.peg.102","  25"
"710",585,1315,730,"CGAATATAGGCATGGTCTTC","AGATACTGGGAAACGAATAT","561307.5.peg.102","  25"
"711",372,1315,943,"TGGAAATTGACTTGTTCTCT","AGATACTGGGAAACGAATAT","561307.5.peg.102","  25"
"712",579,1315,736,"TAGGCATGGTCTTCTGGTAC","AGATACTGGGAAACGAATAT","561307.5.peg.102","  25"
"713",1023,1315,292,"TCTTGTAGTGATTCATCTGC","AGATACTGGGAAACGAATAT","561307.5.peg.102","  25"
"714",861,1315,454,"CTCATATTGGTCGTTGCCTG","AGATACTGGGAAACGAATAT","561307.5.peg.102","  25"
"715",300,1315,1015,"TTAAGTGATTCATCCGCTGC","AGATACTGGGAAACGAATAT","561307.5.peg.102","  25"
"716",450,1315,865,"TTAGTGTAATACACATCTGC","AGATACTGGGAAACGAATAT","561307.5.peg.102","  25"
"717",932,1315,383,"AATTTGTTTCATGAGCTGGT","AGATACTGGGAAACGAATAT","561307.5.peg.102","  25"
"718",1020,1315,295,"TGTAGTGATTCATCTGCTGG","AGATACTGGGAAACGAATAT","561307.5.peg.102","  25"
"719",237,1315,1078,"GTTTGATTTGTATCCTTAGG","AGATACTGGGAAACGAATAT","561307.5.peg.102","  25"
"720",555,1315,760,"CTATATGATACAAGTCTCAC","AGATACTGGGAAACGAATAT","561307.5.peg.102","  25"
"721",611,1315,704,"CTTGTGTGCCATCTGAAACT","AGATACTGGGAAACGAATAT","561307.5.peg.102","  25"
"722",936,1315,379,"TAGAATTTGTTTCATGAGC","AGATACTGGGAAACGAATAT","561307.5.peg.102","  25"
"723",598,1315,717,"TGAAACTGGGAATCGAATAT","AGATACTGGGAAACGAATAT","561307.5.peg.102","  25"
"724",300,1328,1028,"TTAAGTGATTCATCCGCTGC","CTCTCGTACCATTAGATACT","561307.5.peg.102","  25"
"725",555,1328,773,"CTATATGATACAAGTCTCAC","CTCTCGTACCATTAGATACT","561307.5.peg.102","  25"
"726",579,1328,749,"TAGGCATGGTCTTCTGGTAC","CTCTCGTACCATTAGATACT","561307.5.peg.102","  25"
"727",861,1328,467,"CTCATATTGGTCGTTGCCTG","CTCTCGTACCATTAGATACT","561307.5.peg.102","  25"
"728",1023,1328,305,"TCTTGTAGTGATTCATCTGC","CTCTCGTACCATTAGATACT","561307.5.peg.102","  25"
"729",237,1328,1091,"GTTTGATTTGTATCCTTAGG","CTCTCGTACCATTAGATACT","561307.5.peg.102","  25"
"730",932,1328,396,"AATTTGTTTCATGAGCTGGT","CTCTCGTACCATTAGATACT","561307.5.peg.102","  25"
"731",1058,1328,270,"GTTCTTTATCGATGATAGCC","CTCTCGTACCATTAGATACT","561307.5.peg.102","  25"
"732",372,1328,956,"TGGAAATTGACTTGTTCTCT","CTCTCGTACCATTAGATACT","561307.5.peg.102","  25"
"733",264,1328,1064,"GTGTTTGCTGGTTGCGTAGC","CTCTCGTACCATTAGATACT","561307.5.peg.102","  25"
"734",611,1328,717,"CTTGTGTGCCATCTGAAACT","CTCTCGTACCATTAGATACT","561307.5.peg.102","  25"
"735",598,1328,730,"TGAAACTGGGAATCGAATAT","CTCTCGTACCATTAGATACT","561307.5.peg.102","  25"
"736",450,1328,878,"TTAGTGTAATACACATCTGC","CTCTCGTACCATTAGATACT","561307.5.peg.102","  25"
"737",936,1328,392,"TAGAATTTGTTTCATGAGC","CTCTCGTACCATTAGATACT","561307.5.peg.102","  25"
"738",1020,1328,308,"TGTAGTGATTCATCTGCTGG","CTCTCGTACCATTAGATACT","561307.5.peg.102","  25"
"739",874,1328,454,"TTGTGCAGGTTGACTCATAT","CTCTCGTACCATTAGATACT","561307.5.peg.102","  25"
"740",585,1328,743,"CGAATATAGGCATGGTCTTC","CTCTCGTACCATTAGATACT","561307.5.peg.102","  25"
"741",238,6,232,"GACCTGGACATCTTCTACTT","ACGTGTATAAAGTTGAGGAG","561307.5.peg.1021","  27"
"742",254,6,248,"AATTATCTCCATCTTTGACC","ACGTGTATAAAGTTGAGGAG","561307.5.peg.1021","  27"
"743",238,11,227,"GACCTGGACATCTTCTACTT","TTTATACACGTCTGAGCGAG","561307.5.peg.1021","  27"
"744",254,11,243,"AATTATCTCCATCTTTGACC","TTTATACACGTCTGAGCGAG","561307.5.peg.1021","  27"
"745",6,238,232,"ACGTGTATAAAGTTGAGGAG","GACCTGGACATCTTCTACTT","561307.5.peg.1021","  27"
"746",11,238,227,"TTTATACACGTCTGAGCGAG","GACCTGGACATCTTCTACTT","561307.5.peg.1021","  27"
"747",6,254,248,"ACGTGTATAAAGTTGAGGAG","AATTATCTCCATCTTTGACC","561307.5.peg.1021","  27"
"748",11,254,243,"TTTATACACGTCTGAGCGAG","AATTATCTCCATCTTTGACC","561307.5.peg.1021","  27"
"749",304,86,218,"GAATGCCTTGATCGTGTCAT","TCATATGTGCAGTATGGATA","561307.5.peg.1025","  31"
"750",304,92,212,"GAATGCCTTGATCGTGTCAT","CTACTATCATATGTGCAGTA","561307.5.peg.1025","  31"
"751",86,304,218,"TCATATGTGCAGTATGGATA","GAATGCCTTGATCGTGTCAT","561307.5.peg.1025","  31"
"752",92,304,212,"CTACTATCATATGTGCAGTA","GAATGCCTTGATCGTGTCAT","561307.5.peg.1025","  31"
"753",234,75,159,"GGTATGATACGTTCTTTATG","GGCGACAAGGAATGTGAAAT","561307.5.peg.1027","  33"
"754",234,88,146,"GGTATGATACGTTCTTTATG","TCTATGCATAACGGGCGACA","561307.5.peg.1027","  33"
"755",234,96,138,"GGTATGATACGTTCTTTATG","AAATTTGCTCTATGCATAAC","561307.5.peg.1027","  33"
"756",75,234,159,"GGCGACAAGGAATGTGAAAT","GGTATGATACGTTCTTTATG","561307.5.peg.1027","  33"
"757",88,234,146,"TCTATGCATAACGGGCGACA","GGTATGATACGTTCTTTATG","561307.5.peg.1027","  33"
"758",96,234,138,"AAATTTGCTCTATGCATAAC","GGTATGATACGTTCTTTATG","561307.5.peg.1027","  33"
"759",267,160,107,"TGATCTAATAATTCATCGCC","AATCACAGCGATAGCAACGA","561307.5.peg.103","  36"
"760",160,267,107,"AATCACAGCGATAGCAACGA","TGATCTAATAATTCATCGCC","561307.5.peg.103","  36"
"761",416,207,209,"CTTAAGAAATTCTGATGCT","TAGTCACCATAAAGAATAG","561307.5.peg.1033","  40"
"762",446,207,239,"TCTCTTTATATTGATCCACG","TAGTCACCATAAAGAATAG","561307.5.peg.1033","  40"
"763",416,300,116,"CTTAAGAAATTCTGATGCT","TATTGTTCTCTAGCTGCATA","561307.5.peg.1033","  40"
"764",446,300,146,"TCTCTTTATATTGATCCACG","TATTGTTCTCTAGCTGCATA","561307.5.peg.1033","  40"
"765",207,416,209,"TAGTCACCATAAAGAATAG","CTTAAGAAATTCTGATGCT","561307.5.peg.1033","  40"
"766",300,416,116,"TATTGTTCTCTAGCTGCATA","CTTAAGAAATTCTGATGCT","561307.5.peg.1033","  40"
"767",207,446,239,"TAGTCACCATAAAGAATAG","TCTCTTTATATTGATCCACG","561307.5.peg.1033","  40"
"768",300,446,146,"TATTGTTCTCTAGCTGCATA","TCTCTTTATATTGATCCACG","561307.5.peg.1033","  40"
"769",324,9,315,"GAGATAACAGTACCAAGCCC","TGATATTCAATCCTTATAGG","561307.5.peg.1034","  41"
"770",615,9,606,"CTAATTTCATTGGATGTTC","TGATATTCAATCCTTATAGG","561307.5.peg.1034","  41"
"771",624,9,615,"ATGGGCAAGACTAATTTCAT","TGATATTCAATCCTTATAGG","561307.5.peg.1034","  41"
"772",615,324,291,"CTAATTTCATTGGATGTTC","GAGATAACAGTACCAAGCCC","561307.5.peg.1034","  41"
"773",9,324,315,"TGATATTCAATCCTTATAGG","GAGATAACAGTACCAAGCCC","561307.5.peg.1034","  41"
"774",624,324,300,"ATGGGCAAGACTAATTTCAT","GAGATAACAGTACCAAGCCC","561307.5.peg.1034","  41"
"775",9,615,606,"TGATATTCAATCCTTATAGG","CTAATTTCATTGGATGTTC","561307.5.peg.1034","  41"
"776",324,615,291,"GAGATAACAGTACCAAGCCC","CTAATTTCATTGGATGTTC","561307.5.peg.1034","  41"
"777",324,624,300,"GAGATAACAGTACCAAGCCC","ATGGGCAAGACTAATTTCAT","561307.5.peg.1034","  41"
"778",9,624,615,"TGATATTCAATCCTTATAGG","ATGGGCAAGACTAATTTCAT","561307.5.peg.1034","  41"
"779",205,8,197,"TACTGCAACATTATGTGCTT","ACATCAAATTGTTAAAGGGG","561307.5.peg.1035","  42"
"780",378,8,370,"ATCTGATACAATGCACCATG","ACATCAAATTGTTAAAGGGG","561307.5.peg.1035","  42"
"781",126,8,118,"ACATTCGCACTTGTAATTAA","ACATCAAATTGTTAAAGGGG","561307.5.peg.1035","  42"
"782",246,8,238,"CTGCCAAAGCCTTTCAAATC","ACATCAAATTGTTAAAGGGG","561307.5.peg.1035","  42"
"783",246,100,146,"CTGCCAAAGCCTTTCAAATC","AATTTGATGATCACCACCAA","561307.5.peg.1035","  42"
"784",205,100,105,"TACTGCAACATTATGTGCTT","AATTTGATGATCACCACCAA","561307.5.peg.1035","  42"
"785",378,100,278,"ATCTGATACAATGCACCATG","AATTTGATGATCACCACCAA","561307.5.peg.1035","  42"
"786",8,126,118,"ACATCAAATTGTTAAAGGGG","ACATTCGCACTTGTAATTAA","561307.5.peg.1035","  42"
"787",378,126,252,"ATCTGATACAATGCACCATG","ACATTCGCACTTGTAATTAA","561307.5.peg.1035","  42"
"788",246,126,120,"CTGCCAAAGCCTTTCAAATC","ACATTCGCACTTGTAATTAA","561307.5.peg.1035","  42"
"789",8,205,197,"ACATCAAATTGTTAAAGGGG","TACTGCAACATTATGTGCTT","561307.5.peg.1035","  42"
"790",100,205,105,"AATTTGATGATCACCACCAA","TACTGCAACATTATGTGCTT","561307.5.peg.1035","  42"
"791",378,205,173,"ATCTGATACAATGCACCATG","TACTGCAACATTATGTGCTT","561307.5.peg.1035","  42"
"792",378,246,132,"ATCTGATACAATGCACCATG","CTGCCAAAGCCTTTCAAATC","561307.5.peg.1035","  42"
"793",8,246,238,"ACATCAAATTGTTAAAGGGG","CTGCCAAAGCCTTTCAAATC","561307.5.peg.1035","  42"
"794",100,246,146,"AATTTGATGATCACCACCAA","CTGCCAAAGCCTTTCAAATC","561307.5.peg.1035","  42"
"795",126,246,120,"ACATTCGCACTTGTAATTAA","CTGCCAAAGCCTTTCAAATC","561307.5.peg.1035","  42"
"796",8,378,370,"ACATCAAATTGTTAAAGGGG","ATCTGATACAATGCACCATG","561307.5.peg.1035","  42"
"797",100,378,278,"AATTTGATGATCACCACCAA","ATCTGATACAATGCACCATG","561307.5.peg.1035","  42"
"798",246,378,132,"CTGCCAAAGCCTTTCAAATC","ATCTGATACAATGCACCATG","561307.5.peg.1035","  42"
"799",126,378,252,"ACATTCGCACTTGTAATTAA","ATCTGATACAATGCACCATG","561307.5.peg.1035","  42"
"800",205,378,173,"TACTGCAACATTATGTGCTT","ATCTGATACAATGCACCATG","561307.5.peg.1035","  42"
"801",339,192,147,"TGTTTCCTAACTTTGATTC","TCTTAAATTCATCGTAAGC","561307.5.peg.1037","  44"
"802",494,192,302,"TTTGCGTAGTAATGAAGTGG","TCTTAAATTCATCGTAAGC","561307.5.peg.1037","  44"
"803",414,192,222,"TTATCAACTTGTTGTGAAGC","TCTTAAATTCATCGTAAGC","561307.5.peg.1037","  44"
"804",517,192,325,"GTAATAACTTTCTTGTAGT","TCTTAAATTCATCGTAAGC","561307.5.peg.1037","  44"
"805",497,192,305,"GGGTTTGCGTAGTAATGAAG","TCTTAAATTCATCGTAAGC","561307.5.peg.1037","  44"
"806",192,339,147,"TCTTAAATTCATCGTAAGC","TGTTTCCTAACTTTGATTC","561307.5.peg.1037","  44"
"807",517,339,178,"GTAATAACTTTCTTGTAGT","TGTTTCCTAACTTTGATTC","561307.5.peg.1037","  44"
"808",497,339,158,"GGGTTTGCGTAGTAATGAAG","TGTTTCCTAACTTTGATTC","561307.5.peg.1037","  44"
"809",494,339,155,"TTTGCGTAGTAATGAAGTGG","TGTTTCCTAACTTTGATTC","561307.5.peg.1037","  44"
"810",192,414,222,"TCTTAAATTCATCGTAAGC","TTATCAACTTGTTGTGAAGC","561307.5.peg.1037","  44"
"811",517,414,103,"GTAATAACTTTCTTGTAGT","TTATCAACTTGTTGTGAAGC","561307.5.peg.1037","  44"
"812",339,494,155,"TGTTTCCTAACTTTGATTC","TTTGCGTAGTAATGAAGTGG","561307.5.peg.1037","  44"
"813",192,494,302,"TCTTAAATTCATCGTAAGC","TTTGCGTAGTAATGAAGTGG","561307.5.peg.1037","  44"
"814",339,497,158,"TGTTTCCTAACTTTGATTC","GGGTTTGCGTAGTAATGAAG","561307.5.peg.1037","  44"
"815",192,497,305,"TCTTAAATTCATCGTAAGC","GGGTTTGCGTAGTAATGAAG","561307.5.peg.1037","  44"
"816",192,517,325,"TCTTAAATTCATCGTAAGC","GTAATAACTTTCTTGTAGT","561307.5.peg.1037","  44"
"817",414,517,103,"TTATCAACTTGTTGTGAAGC","GTAATAACTTTCTTGTAGT","561307.5.peg.1037","  44"
"818",339,517,178,"TGTTTCCTAACTTTGATTC","GTAATAACTTTCTTGTAGT","561307.5.peg.1037","  44"
"819",398,166,232,"TATTAACAAGCACTGCACCA","TAAACTATCTGCCGTTGGAT","561307.5.peg.104","  47"
"820",515,166,349,"TACCATGTTCTAAACGACTT","TAAACTATCTGCCGTTGGAT","561307.5.peg.104","  47"
"821",398,171,227,"TATTAACAAGCACTGCACCA","ATATGTAAACTATCTGCCGT","561307.5.peg.104","  47"
"822",515,171,344,"TACCATGTTCTAAACGACTT","ATATGTAAACTATCTGCCGT","561307.5.peg.104","  47"
"823",166,398,232,"TAAACTATCTGCCGTTGGAT","TATTAACAAGCACTGCACCA","561307.5.peg.104","  47"
"824",515,398,117,"TACCATGTTCTAAACGACTT","TATTAACAAGCACTGCACCA","561307.5.peg.104","  47"
"825",171,398,227,"ATATGTAAACTATCTGCCGT","TATTAACAAGCACTGCACCA","561307.5.peg.104","  47"
"826",171,515,344,"ATATGTAAACTATCTGCCGT","TACCATGTTCTAAACGACTT","561307.5.peg.104","  47"
"827",166,515,349,"TAAACTATCTGCCGTTGGAT","TACCATGTTCTAAACGACTT","561307.5.peg.104","  47"
"828",398,515,117,"TATTAACAAGCACTGCACCA","TACCATGTTCTAAACGACTT","561307.5.peg.104","  47"
"829",112,9,103,"TTTATCTTCACTAACGTGTT","TAGCGCTTAATAAATGAAGG","561307.5.peg.1046","  54"
"830",9,112,103,"TAGCGCTTAATAAATGAAGG","TTTATCTTCACTAACGTGTT","561307.5.peg.1046","  54"
"831",316,187,129,"TGAGGGTTTATCATGCCAAA","AAGTAAGCTGTCTGACAACC","561307.5.peg.1049","  57"
"832",333,187,146,"TGAGTTTCTCCATCTGTTGA","AAGTAAGCTGTCTGACAACC","561307.5.peg.1049","  57"
"833",187,316,129,"AAGTAAGCTGTCTGACAACC","TGAGGGTTTATCATGCCAAA","561307.5.peg.1049","  57"
"834",187,333,146,"AAGTAAGCTGTCTGACAACC","TGAGTTTCTCCATCTGTTGA","561307.5.peg.1049","  57"
"835",328,89,239,"AATAACTCCAACAATTGTAG","TGTATCTAGGTGTTTGGCTA","561307.5.peg.105","  58"
"836",405,89,316,"GAACCTACTCCAGCTTCAGA","TGTATCTAGGTGTTTGGCTA","561307.5.peg.105","  58"
"837",328,95,233,"AATAACTCCAACAATTGTAG","GTCTTCTGTATCTAGGTGTT","561307.5.peg.105","  58"
"838",405,95,310,"GAACCTACTCCAGCTTCAGA","GTCTTCTGTATCTAGGTGTT","561307.5.peg.105","  58"
"839",328,102,226,"AATAACTCCAACAATTGTAG","ATTTAGGTCTTCTGTATCT","561307.5.peg.105","  58"
"840",405,102,303,"GAACCTACTCCAGCTTCAGA","ATTTAGGTCTTCTGTATCT","561307.5.peg.105","  58"
"841",89,328,239,"TGTATCTAGGTGTTTGGCTA","AATAACTCCAACAATTGTAG","561307.5.peg.105","  58"
"842",95,328,233,"GTCTTCTGTATCTAGGTGTT","AATAACTCCAACAATTGTAG","561307.5.peg.105","  58"
"843",102,328,226,"ATTTAGGTCTTCTGTATCT","AATAACTCCAACAATTGTAG","561307.5.peg.105","  58"
"844",89,405,316,"TGTATCTAGGTGTTTGGCTA","GAACCTACTCCAGCTTCAGA","561307.5.peg.105","  58"
"845",95,405,310,"GTCTTCTGTATCTAGGTGTT","GAACCTACTCCAGCTTCAGA","561307.5.peg.105","  58"
"846",102,405,303,"ATTTAGGTCTTCTGTATCT","GAACCTACTCCAGCTTCAGA","561307.5.peg.105","  58"
"847",162,12,150,"GGTTCCCTCATTCCGTGATT","AGTATTATCATTGTTCGTGG","561307.5.peg.1053","  62"
"848",183,12,171,"GGAACATGCACAACTCTCCA","AGTATTATCATTGTTCGTGG","561307.5.peg.1053","  62"
"849",204,12,192,"ATATCTCCTAATCTGTCTTT","AGTATTATCATTGTTCGTGG","561307.5.peg.1053","  62"
"850",162,15,147,"GGTTCCCTCATTCCGTGATT","GAAGTATTATCATTGTTCG","561307.5.peg.1053","  62"
"851",183,15,168,"GGAACATGCACAACTCTCCA","GAAGTATTATCATTGTTCG","561307.5.peg.1053","  62"
"852",204,15,189,"ATATCTCCTAATCTGTCTTT","GAAGTATTATCATTGTTCG","561307.5.peg.1053","  62"
"853",12,162,150,"AGTATTATCATTGTTCGTGG","GGTTCCCTCATTCCGTGATT","561307.5.peg.1053","  62"
"854",15,162,147,"GAAGTATTATCATTGTTCG","GGTTCCCTCATTCCGTGATT","561307.5.peg.1053","  62"
"855",12,183,171,"AGTATTATCATTGTTCGTGG","GGAACATGCACAACTCTCCA","561307.5.peg.1053","  62"
"856",15,183,168,"GAAGTATTATCATTGTTCG","GGAACATGCACAACTCTCCA","561307.5.peg.1053","  62"
"857",12,204,192,"AGTATTATCATTGTTCGTGG","ATATCTCCTAATCTGTCTTT","561307.5.peg.1053","  62"
"858",15,204,189,"GAAGTATTATCATTGTTCG","ATATCTCCTAATCTGTCTTT","561307.5.peg.1053","  62"
"859",363,75,288,"TGTATTTCTGCCGGTGATAA","AAGTGATCAACTGAATCTCC","561307.5.peg.1059","  68"
"860",302,75,227,"CAGTTGTCGCTAGTCTAATT","AAGTGATCAACTGAATCTCC","561307.5.peg.1059","  68"
"861",486,75,411,"TGATGATGAGAACTAGCAGC","AAGTGATCAACTGAATCTCC","561307.5.peg.1059","  68"
"862",372,75,297,"ATCTCTTCTTGTATTTCTGC","AAGTGATCAACTGAATCTCC","561307.5.peg.1059","  68"
"863",75,302,227,"AAGTGATCAACTGAATCTCC","CAGTTGTCGCTAGTCTAATT","561307.5.peg.1059","  68"
"864",486,302,184,"TGATGATGAGAACTAGCAGC","CAGTTGTCGCTAGTCTAATT","561307.5.peg.1059","  68"
"865",75,363,288,"AAGTGATCAACTGAATCTCC","TGTATTTCTGCCGGTGATAA","561307.5.peg.1059","  68"
"866",486,363,123,"TGATGATGAGAACTAGCAGC","TGTATTTCTGCCGGTGATAA","561307.5.peg.1059","  68"
"867",75,372,297,"AAGTGATCAACTGAATCTCC","ATCTCTTCTTGTATTTCTGC","561307.5.peg.1059","  68"
"868",486,372,114,"TGATGATGAGAACTAGCAGC","ATCTCTTCTTGTATTTCTGC","561307.5.peg.1059","  68"
"869",75,486,411,"AAGTGATCAACTGAATCTCC","TGATGATGAGAACTAGCAGC","561307.5.peg.1059","  68"
"870",302,486,184,"CAGTTGTCGCTAGTCTAATT","TGATGATGAGAACTAGCAGC","561307.5.peg.1059","  68"
"871",363,486,123,"TGTATTTCTGCCGGTGATAA","TGATGATGAGAACTAGCAGC","561307.5.peg.1059","  68"
"872",372,486,114,"ATCTCTTCTTGTATTTCTGC","TGATGATGAGAACTAGCAGC","561307.5.peg.1059","  68"
"873",348,222,126,"TCATCACGCACAGCACCATT","CCTAGACGTGGTTCTAGTCT","561307.5.peg.1060","  70"
"874",348,234,114,"TCATCACGCACAGCACCATT","CCGTATTGGTTACCTAGACG","561307.5.peg.1060","  70"
"875",222,348,126,"CCTAGACGTGGTTCTAGTCT","TCATCACGCACAGCACCATT","561307.5.peg.1060","  70"
"876",234,348,114,"CCGTATTGGTTACCTAGACG","TCATCACGCACAGCACCATT","561307.5.peg.1060","  70"
"877",195,25,170,"GAAATACAAGTTGTCCAGTT","GTTATCTACCTTTCTGTTTG","561307.5.peg.1064","  74"
"878",25,195,170,"GTTATCTACCTTTCTGTTTG","GAAATACAAGTTGTCCAGTT","561307.5.peg.1064","  74"
"879",194,77,117,"ATCTAATAGCACAATATCA","ATCCTTGTCGCACAATATAA","561307.5.peg.1065","  75"
"880",225,77,148,"ATTTCAATACCATTCATGCC","ATCCTTGTCGCACAATATAA","561307.5.peg.1065","  75"
"881",77,194,117,"ATCCTTGTCGCACAATATAA","ATCTAATAGCACAATATCA","561307.5.peg.1065","  75"
"882",77,225,148,"ATCCTTGTCGCACAATATAA","ATTTCAATACCATTCATGCC","561307.5.peg.1065","  75"
"883",417,237,180,"TGTTCTTGACCCGATTTAAG","TGGTCTGCTGTCAAAGATTG","561307.5.peg.1066","  76"
"884",237,417,180,"TGGTCTGCTGTCAAAGATTG","TGTTCTTGACCCGATTTAAG","561307.5.peg.1066","  76"
"885",315,177,138,"GGGTGAGTCTTAACACCTTT","ACTTTATCCATTAATCGCGC","561307.5.peg.1067","  77"
"886",425,177,248,"TAATAATCCTACTGTTTCC","ACTTTATCCATTAATCGCGC","561307.5.peg.1067","  77"
"887",408,177,231,"TCCTGGTCCAGTCGATGAAT","ACTTTATCCATTAATCGCGC","561307.5.peg.1067","  77"
"888",408,255,153,"TCCTGGTCCAGTCGATGAAT","TTTGTGCATAACGATAACT","561307.5.peg.1067","  77"
"889",425,255,170,"TAATAATCCTACTGTTTCC","TTTGTGCATAACGATAACT","561307.5.peg.1067","  77"
"890",177,315,138,"ACTTTATCCATTAATCGCGC","GGGTGAGTCTTAACACCTTT","561307.5.peg.1067","  77"
"891",425,315,110,"TAATAATCCTACTGTTTCC","GGGTGAGTCTTAACACCTTT","561307.5.peg.1067","  77"
"892",177,408,231,"ACTTTATCCATTAATCGCGC","TCCTGGTCCAGTCGATGAAT","561307.5.peg.1067","  77"
"893",255,408,153,"TTTGTGCATAACGATAACT","TCCTGGTCCAGTCGATGAAT","561307.5.peg.1067","  77"
"894",177,425,248,"ACTTTATCCATTAATCGCGC","TAATAATCCTACTGTTTCC","561307.5.peg.1067","  77"
"895",315,425,110,"GGGTGAGTCTTAACACCTTT","TAATAATCCTACTGTTTCC","561307.5.peg.1067","  77"
"896",255,425,170,"TTTGTGCATAACGATAACT","TAATAATCCTACTGTTTCC","561307.5.peg.1067","  77"
"897",314,168,146,"CTGTTTGCCATACAACTAGT","AACCATAAACTACTTCGAT","561307.5.peg.1068","  78"
"898",428,168,260,"ATTTACATCATCATTTGGG","AACCATAAACTACTTCGAT","561307.5.peg.1068","  78"
"899",476,168,308,"ATGCAACGTGCATAGCAGTT","AACCATAAACTACTTCGAT","561307.5.peg.1068","  78"
"900",624,168,456,"ATCTCTTGTCCTAGTTTGAT","AACCATAAACTACTTCGAT","561307.5.peg.1068","  78"
"901",671,168,503,"CAGATAACATTGTTTCACAA","AACCATAAACTACTTCGAT","561307.5.peg.1068","  78"
"902",428,262,166,"ATTTACATCATCATTTGGG","TTGATCACATGCGTATACAA","561307.5.peg.1068","  78"
"903",476,262,214,"ATGCAACGTGCATAGCAGTT","TTGATCACATGCGTATACAA","561307.5.peg.1068","  78"
"904",624,262,362,"ATCTCTTGTCCTAGTTTGAT","TTGATCACATGCGTATACAA","561307.5.peg.1068","  78"
"905",671,262,409,"CAGATAACATTGTTTCACAA","TTGATCACATGCGTATACAA","561307.5.peg.1068","  78"
"906",168,314,146,"AACCATAAACTACTTCGAT","CTGTTTGCCATACAACTAGT","561307.5.peg.1068","  78"
"907",624,314,310,"ATCTCTTGTCCTAGTTTGAT","CTGTTTGCCATACAACTAGT","561307.5.peg.1068","  78"
"908",671,314,357,"CAGATAACATTGTTTCACAA","CTGTTTGCCATACAACTAGT","561307.5.peg.1068","  78"
"909",428,314,114,"ATTTACATCATCATTTGGG","CTGTTTGCCATACAACTAGT","561307.5.peg.1068","  78"
"910",476,314,162,"ATGCAACGTGCATAGCAGTT","CTGTTTGCCATACAACTAGT","561307.5.peg.1068","  78"
"911",168,428,260,"AACCATAAACTACTTCGAT","ATTTACATCATCATTTGGG","561307.5.peg.1068","  78"
"912",262,428,166,"TTGATCACATGCGTATACAA","ATTTACATCATCATTTGGG","561307.5.peg.1068","  78"
"913",671,428,243,"CAGATAACATTGTTTCACAA","ATTTACATCATCATTTGGG","561307.5.peg.1068","  78"
"914",314,428,114,"CTGTTTGCCATACAACTAGT","ATTTACATCATCATTTGGG","561307.5.peg.1068","  78"
"915",624,428,196,"ATCTCTTGTCCTAGTTTGAT","ATTTACATCATCATTTGGG","561307.5.peg.1068","  78"
"916",671,476,195,"CAGATAACATTGTTTCACAA","ATGCAACGTGCATAGCAGTT","561307.5.peg.1068","  78"
"917",262,476,214,"TTGATCACATGCGTATACAA","ATGCAACGTGCATAGCAGTT","561307.5.peg.1068","  78"
"918",168,476,308,"AACCATAAACTACTTCGAT","ATGCAACGTGCATAGCAGTT","561307.5.peg.1068","  78"
"919",624,476,148,"ATCTCTTGTCCTAGTTTGAT","ATGCAACGTGCATAGCAGTT","561307.5.peg.1068","  78"
"920",314,476,162,"CTGTTTGCCATACAACTAGT","ATGCAACGTGCATAGCAGTT","561307.5.peg.1068","  78"
"921",262,624,362,"TTGATCACATGCGTATACAA","ATCTCTTGTCCTAGTTTGAT","561307.5.peg.1068","  78"
"922",476,624,148,"ATGCAACGTGCATAGCAGTT","ATCTCTTGTCCTAGTTTGAT","561307.5.peg.1068","  78"
"923",428,624,196,"ATTTACATCATCATTTGGG","ATCTCTTGTCCTAGTTTGAT","561307.5.peg.1068","  78"
"924",168,624,456,"AACCATAAACTACTTCGAT","ATCTCTTGTCCTAGTTTGAT","561307.5.peg.1068","  78"
"925",314,624,310,"CTGTTTGCCATACAACTAGT","ATCTCTTGTCCTAGTTTGAT","561307.5.peg.1068","  78"
"926",262,671,409,"TTGATCACATGCGTATACAA","CAGATAACATTGTTTCACAA","561307.5.peg.1068","  78"
"927",168,671,503,"AACCATAAACTACTTCGAT","CAGATAACATTGTTTCACAA","561307.5.peg.1068","  78"
"928",428,671,243,"ATTTACATCATCATTTGGG","CAGATAACATTGTTTCACAA","561307.5.peg.1068","  78"
"929",476,671,195,"ATGCAACGTGCATAGCAGTT","CAGATAACATTGTTTCACAA","561307.5.peg.1068","  78"
"930",314,671,357,"CTGTTTGCCATACAACTAGT","CAGATAACATTGTTTCACAA","561307.5.peg.1068","  78"
"931",570,327,243,"CAATCCATGAATAAAGTAG","ATAAAGGCGCTAATTTCAT","561307.5.peg.107","  80"
"932",669,327,342,"AGTGCATGATGTAATCCTGT","ATAAAGGCGCTAATTTCAT","561307.5.peg.107","  80"
"933",743,327,416,"TTATAGCATCTTTGCCACTT","ATAAAGGCGCTAATTTCAT","561307.5.peg.107","  80"
"934",327,570,243,"ATAAAGGCGCTAATTTCAT","CAATCCATGAATAAAGTAG","561307.5.peg.107","  80"
"935",743,570,173,"TTATAGCATCTTTGCCACTT","CAATCCATGAATAAAGTAG","561307.5.peg.107","  80"
"936",327,669,342,"ATAAAGGCGCTAATTTCAT","AGTGCATGATGTAATCCTGT","561307.5.peg.107","  80"
"937",327,743,416,"ATAAAGGCGCTAATTTCAT","TTATAGCATCTTTGCCACTT","561307.5.peg.107","  80"
"938",570,743,173,"CAATCCATGAATAAAGTAG","TTATAGCATCTTTGCCACTT","561307.5.peg.107","  80"
"939",243,130,113,"GCTATGATTGACCTTGCTGT","CTTCAATTCATCAAAGGGAT","561307.5.peg.1073","  84"
"940",303,130,173,"CGATCACCTCTAACACTCTT","CTTCAATTCATCAAAGGGAT","561307.5.peg.1073","  84"
"941",531,130,401,"TATGTCCATGTTCCTAGTTT","CTTCAATTCATCAAAGGGAT","561307.5.peg.1073","  84"
"942",238,130,108,"GATTGACCTTGCTGTTGGTA","CTTCAATTCATCAAAGGGAT","561307.5.peg.1073","  84"
"943",554,130,424,"TACTGACTAACATTTCACCG","CTTCAATTCATCAAAGGGAT","561307.5.peg.1073","  84"
"944",554,228,326,"TACTGACTAACATTTCACCG","GCTGTTGGTAAGGATAATTT","561307.5.peg.1073","  84"
"945",531,228,303,"TATGTCCATGTTCCTAGTTT","GCTGTTGGTAAGGATAATTT","561307.5.peg.1073","  84"
"946",130,238,108,"CTTCAATTCATCAAAGGGAT","GATTGACCTTGCTGTTGGTA","561307.5.peg.1073","  84"
"947",531,238,293,"TATGTCCATGTTCCTAGTTT","GATTGACCTTGCTGTTGGTA","561307.5.peg.1073","  84"
"948",554,238,316,"TACTGACTAACATTTCACCG","GATTGACCTTGCTGTTGGTA","561307.5.peg.1073","  84"
"949",130,243,113,"CTTCAATTCATCAAAGGGAT","GCTATGATTGACCTTGCTGT","561307.5.peg.1073","  84"
"950",531,243,288,"TATGTCCATGTTCCTAGTTT","GCTATGATTGACCTTGCTGT","561307.5.peg.1073","  84"
"951",554,243,311,"TACTGACTAACATTTCACCG","GCTATGATTGACCTTGCTGT","561307.5.peg.1073","  84"
"952",130,303,173,"CTTCAATTCATCAAAGGGAT","CGATCACCTCTAACACTCTT","561307.5.peg.1073","  84"
"953",531,303,228,"TATGTCCATGTTCCTAGTTT","CGATCACCTCTAACACTCTT","561307.5.peg.1073","  84"
"954",554,303,251,"TACTGACTAACATTTCACCG","CGATCACCTCTAACACTCTT","561307.5.peg.1073","  84"
"955",228,531,303,"GCTGTTGGTAAGGATAATTT","TATGTCCATGTTCCTAGTTT","561307.5.peg.1073","  84"
"956",130,531,401,"CTTCAATTCATCAAAGGGAT","TATGTCCATGTTCCTAGTTT","561307.5.peg.1073","  84"
"957",303,531,228,"CGATCACCTCTAACACTCTT","TATGTCCATGTTCCTAGTTT","561307.5.peg.1073","  84"
"958",238,531,293,"GATTGACCTTGCTGTTGGTA","TATGTCCATGTTCCTAGTTT","561307.5.peg.1073","  84"
"959",243,531,288,"GCTATGATTGACCTTGCTGT","TATGTCCATGTTCCTAGTTT","561307.5.peg.1073","  84"
"960",130,554,424,"CTTCAATTCATCAAAGGGAT","TACTGACTAACATTTCACCG","561307.5.peg.1073","  84"
"961",243,554,311,"GCTATGATTGACCTTGCTGT","TACTGACTAACATTTCACCG","561307.5.peg.1073","  84"
"962",228,554,326,"GCTGTTGGTAAGGATAATTT","TACTGACTAACATTTCACCG","561307.5.peg.1073","  84"
"963",238,554,316,"GATTGACCTTGCTGTTGGTA","TACTGACTAACATTTCACCG","561307.5.peg.1073","  84"
"964",303,554,251,"CGATCACCTCTAACACTCTT","TACTGACTAACATTTCACCG","561307.5.peg.1073","  84"
"965",393,120,273,"TCAACTTGCTTCTTACGTTC","TCTTGTTCAGCATGTGCTGT","561307.5.peg.1075","  86"
"966",376,120,256,"TTCAGGCGTTGAAGTCATTC","TCTTGTTCAGCATGTGCTGT","561307.5.peg.1075","  86"
"967",590,120,470,"CTAATATAACGTCTGGTAAA","TCTTGTTCAGCATGTGCTGT","561307.5.peg.1075","  86"
"968",376,207,169,"TTCAGGCGTTGAAGTCATTC","ACTGTATGCTCAAATTCCAT","561307.5.peg.1075","  86"
"969",590,207,383,"CTAATATAACGTCTGGTAAA","ACTGTATGCTCAAATTCCAT","561307.5.peg.1075","  86"
"970",393,207,186,"TCAACTTGCTTCTTACGTTC","ACTGTATGCTCAAATTCCAT","561307.5.peg.1075","  86"
"971",120,376,256,"TCTTGTTCAGCATGTGCTGT","TTCAGGCGTTGAAGTCATTC","561307.5.peg.1075","  86"
"972",590,376,214,"CTAATATAACGTCTGGTAAA","TTCAGGCGTTGAAGTCATTC","561307.5.peg.1075","  86"
"973",207,376,169,"ACTGTATGCTCAAATTCCAT","TTCAGGCGTTGAAGTCATTC","561307.5.peg.1075","  86"
"974",120,393,273,"TCTTGTTCAGCATGTGCTGT","TCAACTTGCTTCTTACGTTC","561307.5.peg.1075","  86"
"975",590,393,197,"CTAATATAACGTCTGGTAAA","TCAACTTGCTTCTTACGTTC","561307.5.peg.1075","  86"
"976",207,393,186,"ACTGTATGCTCAAATTCCAT","TCAACTTGCTTCTTACGTTC","561307.5.peg.1075","  86"
"977",120,590,470,"TCTTGTTCAGCATGTGCTGT","CTAATATAACGTCTGGTAAA","561307.5.peg.1075","  86"
"978",207,590,383,"ACTGTATGCTCAAATTCCAT","CTAATATAACGTCTGGTAAA","561307.5.peg.1075","  86"
"979",376,590,214,"TTCAGGCGTTGAAGTCATTC","CTAATATAACGTCTGGTAAA","561307.5.peg.1075","  86"
"980",393,590,197,"TCAACTTGCTTCTTACGTTC","CTAATATAACGTCTGGTAAA","561307.5.peg.1075","  86"
"981",207,106,101,"GGATATGCCATCGTTAAGTC","TGAATGCATTGCGTCAGATT","561307.5.peg.1077","  88"
"982",525,106,419,"ACAAATTCACGATTCCCTTC","TGAATGCATTGCGTCAGATT","561307.5.peg.1077","  88"
"983",507,106,401,"TCAGGCATAACTAATTCTTG","TGAATGCATTGCGTCAGATT","561307.5.peg.1077","  88"
"984",357,106,251,"GTAAACGTCTCAGCCATGCG","TGAATGCATTGCGTCAGATT","561307.5.peg.1077","  88"
"985",106,207,101,"TGAATGCATTGCGTCAGATT","GGATATGCCATCGTTAAGTC","561307.5.peg.1077","  88"
"986",507,207,300,"TCAGGCATAACTAATTCTTG","GGATATGCCATCGTTAAGTC","561307.5.peg.1077","  88"
"987",357,207,150,"GTAAACGTCTCAGCCATGCG","GGATATGCCATCGTTAAGTC","561307.5.peg.1077","  88"
"988",525,207,318,"ACAAATTCACGATTCCCTTC","GGATATGCCATCGTTAAGTC","561307.5.peg.1077","  88"
"989",106,357,251,"TGAATGCATTGCGTCAGATT","GTAAACGTCTCAGCCATGCG","561307.5.peg.1077","  88"
"990",507,357,150,"TCAGGCATAACTAATTCTTG","GTAAACGTCTCAGCCATGCG","561307.5.peg.1077","  88"
"991",207,357,150,"GGATATGCCATCGTTAAGTC","GTAAACGTCTCAGCCATGCG","561307.5.peg.1077","  88"
"992",525,357,168,"ACAAATTCACGATTCCCTTC","GTAAACGTCTCAGCCATGCG","561307.5.peg.1077","  88"
"993",106,507,401,"TGAATGCATTGCGTCAGATT","TCAGGCATAACTAATTCTTG","561307.5.peg.1077","  88"
"994",357,507,150,"GTAAACGTCTCAGCCATGCG","TCAGGCATAACTAATTCTTG","561307.5.peg.1077","  88"
"995",207,507,300,"GGATATGCCATCGTTAAGTC","TCAGGCATAACTAATTCTTG","561307.5.peg.1077","  88"
"996",357,525,168,"GTAAACGTCTCAGCCATGCG","ACAAATTCACGATTCCCTTC","561307.5.peg.1077","  88"
"997",106,525,419,"TGAATGCATTGCGTCAGATT","ACAAATTCACGATTCCCTTC","561307.5.peg.1077","  88"
"998",207,525,318,"GGATATGCCATCGTTAAGTC","ACAAATTCACGATTCCCTTC","561307.5.peg.1077","  88"
"999",254,88,166,"CGCCAAGAGACAATTCTGAG","GTCAATGAATTCAGATGTTA","561307.5.peg.1079","  90"
"1000",88,254,166,"GTCAATGAATTCAGATGTTA","CGCCAAGAGACAATTCTGAG","561307.5.peg.1079","  90"
"1001",368,258,110,"CATAAACACGTTGTATCGCT","AATCTCCAATGGAACGGTGA","561307.5.peg.1081","  93"
"1002",368,264,104,"CATAAACACGTTGTATCGCT","TCCAACAATCTCCAATGGAA","561307.5.peg.1081","  93"
"1003",258,368,110,"AATCTCCAATGGAACGGTGA","CATAAACACGTTGTATCGCT","561307.5.peg.1081","  93"
"1004",264,368,104,"TCCAACAATCTCCAATGGAA","CATAAACACGTTGTATCGCT","561307.5.peg.1081","  93"
"1005",187,78,109,"CATGCTGTATCCAGCGATTG","GTTGAAATGTCTCATCAAA","561307.5.peg.1082","  94"
"1006",78,187,109,"GTTGAAATGTCTCATCAAA","CATGCTGTATCCAGCGATTG","561307.5.peg.1082","  94"
"1007",844,290,554,"TGCGATACCCATTGTACCCA","GTAACCATTTAGACTAACT","561307.5.peg.1083","  95"
"1008",290,844,554,"GTAACCATTTAGACTAACT","TGCGATACCCATTGTACCCA","561307.5.peg.1083","  95"
"1009",498,118,380,"CCTATTGTTGGCGCAACAAC","ATCTATCGATAATGCTCCAA","561307.5.peg.1086","  98"
"1010",498,150,348,"CCTATTGTTGGCGCAACAAC","TGTCTAATATCTGGTAATCC","561307.5.peg.1086","  98"
"1011",118,498,380,"ATCTATCGATAATGCTCCAA","CCTATTGTTGGCGCAACAAC","561307.5.peg.1086","  98"
"1012",150,498,348,"TGTCTAATATCTGGTAATCC","CCTATTGTTGGCGCAACAAC","561307.5.peg.1086","  98"
"1013",702,8,694,"GCTGGAATTCTATATGTCCC","ATTGAAGAGGAACAGAATTG","561307.5.peg.1087","  99"
"1014",582,8,574,"TTAACAATTGGTTGCTTGGT","ATTGAAGAGGAACAGAATTG","561307.5.peg.1087","  99"
"1015",586,8,578,"CGGTTTAACAATTGGTTGCT","ATTGAAGAGGAACAGAATTG","561307.5.peg.1087","  99"
"1016",478,8,470,"TTGAATATAAGAAGCTACGC","ATTGAAGAGGAACAGAATTG","561307.5.peg.1087","  99"
"1017",582,62,520,"TTAACAATTGGTTGCTTGGT","GTGCTTGTTGTCCGCACTTC","561307.5.peg.1087","  99"
"1018",478,62,416,"TTGAATATAAGAAGCTACGC","GTGCTTGTTGTCCGCACTTC","561307.5.peg.1087","  99"
"1019",586,62,524,"CGGTTTAACAATTGGTTGCT","GTGCTTGTTGTCCGCACTTC","561307.5.peg.1087","  99"
"1020",702,62,640,"GCTGGAATTCTATATGTCCC","GTGCTTGTTGTCCGCACTTC","561307.5.peg.1087","  99"
"1021",8,478,470,"ATTGAAGAGGAACAGAATTG","TTGAATATAAGAAGCTACGC","561307.5.peg.1087","  99"
"1022",62,478,416,"GTGCTTGTTGTCCGCACTTC","TTGAATATAAGAAGCTACGC","561307.5.peg.1087","  99"
"1023",702,478,224,"GCTGGAATTCTATATGTCCC","TTGAATATAAGAAGCTACGC","561307.5.peg.1087","  99"
"1024",582,478,104,"TTAACAATTGGTTGCTTGGT","TTGAATATAAGAAGCTACGC","561307.5.peg.1087","  99"
"1025",586,478,108,"CGGTTTAACAATTGGTTGCT","TTGAATATAAGAAGCTACGC","561307.5.peg.1087","  99"
"1026",8,582,574,"ATTGAAGAGGAACAGAATTG","TTAACAATTGGTTGCTTGGT","561307.5.peg.1087","  99"
"1027",478,582,104,"TTGAATATAAGAAGCTACGC","TTAACAATTGGTTGCTTGGT","561307.5.peg.1087","  99"
"1028",702,582,120,"GCTGGAATTCTATATGTCCC","TTAACAATTGGTTGCTTGGT","561307.5.peg.1087","  99"
"1029",62,582,520,"GTGCTTGTTGTCCGCACTTC","TTAACAATTGGTTGCTTGGT","561307.5.peg.1087","  99"
"1030",478,586,108,"TTGAATATAAGAAGCTACGC","CGGTTTAACAATTGGTTGCT","561307.5.peg.1087","  99"
"1031",8,586,578,"ATTGAAGAGGAACAGAATTG","CGGTTTAACAATTGGTTGCT","561307.5.peg.1087","  99"
"1032",702,586,116,"GCTGGAATTCTATATGTCCC","CGGTTTAACAATTGGTTGCT","561307.5.peg.1087","  99"
"1033",62,586,524,"GTGCTTGTTGTCCGCACTTC","CGGTTTAACAATTGGTTGCT","561307.5.peg.1087","  99"
"1034",8,702,694,"ATTGAAGAGGAACAGAATTG","GCTGGAATTCTATATGTCCC","561307.5.peg.1087","  99"
"1035",62,702,640,"GTGCTTGTTGTCCGCACTTC","GCTGGAATTCTATATGTCCC","561307.5.peg.1087","  99"
"1036",478,702,224,"TTGAATATAAGAAGCTACGC","GCTGGAATTCTATATGTCCC","561307.5.peg.1087","  99"
"1037",586,702,116,"CGGTTTAACAATTGGTTGCT","GCTGGAATTCTATATGTCCC","561307.5.peg.1087","  99"
"1038",582,702,120,"TTAACAATTGGTTGCTTGGT","GCTGGAATTCTATATGTCCC","561307.5.peg.1087","  99"
"1039",339,180,159,"GCTGAAATCGTATTACCATC","ACGATTAAAGCATGGTATGA","561307.5.peg.109"," 102"
"1040",634,180,454,"TGTAACGAAATCAGAATGTT","ACGATTAAAGCATGGTATGA","561307.5.peg.109"," 102"
"1041",408,180,228,"GTAAGTGATTGGTGTGCTTG","ACGATTAAAGCATGGTATGA","561307.5.peg.109"," 102"
"1042",180,339,159,"ACGATTAAAGCATGGTATGA","GCTGAAATCGTATTACCATC","561307.5.peg.109"," 102"
"1043",634,339,295,"TGTAACGAAATCAGAATGTT","GCTGAAATCGTATTACCATC","561307.5.peg.109"," 102"
"1044",180,408,228,"ACGATTAAAGCATGGTATGA","GTAAGTGATTGGTGTGCTTG","561307.5.peg.109"," 102"
"1045",634,408,226,"TGTAACGAAATCAGAATGTT","GTAAGTGATTGGTGTGCTTG","561307.5.peg.109"," 102"
"1046",408,634,226,"GTAAGTGATTGGTGTGCTTG","TGTAACGAAATCAGAATGTT","561307.5.peg.109"," 102"
"1047",339,634,295,"GCTGAAATCGTATTACCATC","TGTAACGAAATCAGAATGTT","561307.5.peg.109"," 102"
"1048",180,634,454,"ACGATTAAAGCATGGTATGA","TGTAACGAAATCAGAATGTT","561307.5.peg.109"," 102"
"1049",418,190,228,"CAAATAAAGGTTAGTAACA","CATAGACCAAGGGAAAGTAT","561307.5.peg.1090"," 103"
"1050",418,200,218,"CAAATAAAGGTTAGTAACA","ATGTTACAAACATAGACCAA","561307.5.peg.1090"," 103"
"1051",190,418,228,"CATAGACCAAGGGAAAGTAT","CAAATAAAGGTTAGTAACA","561307.5.peg.1090"," 103"
"1052",200,418,218,"ATGTTACAAACATAGACCAA","CAAATAAAGGTTAGTAACA","561307.5.peg.1090"," 103"
"1053",573,433,140,"TGTCCAGTGAAATCTAAGAA","TGCATCTAAACCAAACACCA","561307.5.peg.1091"," 104"
"1054",607,433,174,"AAATATCACGACAGCAATCG","TGCATCTAAACCAAACACCA","561307.5.peg.1091"," 104"
"1055",675,433,242,"TTAAGCAATTCACCATGATC","TGCATCTAAACCAAACACCA","561307.5.peg.1091"," 104"
"1056",607,467,140,"AAATATCACGACAGCAATCG","GTGCTTGTTCAGCGTTACCA","561307.5.peg.1091"," 104"
"1057",573,467,106,"TGTCCAGTGAAATCTAAGAA","GTGCTTGTTCAGCGTTACCA","561307.5.peg.1091"," 104"
"1058",675,467,208,"TTAAGCAATTCACCATGATC","GTGCTTGTTCAGCGTTACCA","561307.5.peg.1091"," 104"
"1059",433,573,140,"TGCATCTAAACCAAACACCA","TGTCCAGTGAAATCTAAGAA","561307.5.peg.1091"," 104"
"1060",467,573,106,"GTGCTTGTTCAGCGTTACCA","TGTCCAGTGAAATCTAAGAA","561307.5.peg.1091"," 104"
"1061",675,573,102,"TTAAGCAATTCACCATGATC","TGTCCAGTGAAATCTAAGAA","561307.5.peg.1091"," 104"
"1062",433,607,174,"TGCATCTAAACCAAACACCA","AAATATCACGACAGCAATCG","561307.5.peg.1091"," 104"
"1063",467,607,140,"GTGCTTGTTCAGCGTTACCA","AAATATCACGACAGCAATCG","561307.5.peg.1091"," 104"
"1064",433,675,242,"TGCATCTAAACCAAACACCA","TTAAGCAATTCACCATGATC","561307.5.peg.1091"," 104"
"1065",573,675,102,"TGTCCAGTGAAATCTAAGAA","TTAAGCAATTCACCATGATC","561307.5.peg.1091"," 104"
"1066",467,675,208,"GTGCTTGTTCAGCGTTACCA","TTAAGCAATTCACCATGATC","561307.5.peg.1091"," 104"
"1067",502,137,365,"AGCCTCTTGTGATGTTTGGA","GATATTCAGTCTTGCTTAGT","561307.5.peg.1092"," 105"
"1068",137,502,365,"GATATTCAGTCTTGCTTAGT","AGCCTCTTGTGATGTTTGGA","561307.5.peg.1092"," 105"
"1069",302,64,238,"TTAACTCATCATGGTTGGGT","TGGATCTTTGACAGATTGAA","561307.5.peg.1093"," 106"
"1070",306,64,242,"GTCATTAACTCATCATGGTT","TGGATCTTTGACAGATTGAA","561307.5.peg.1093"," 106"
"1071",64,302,238,"TGGATCTTTGACAGATTGAA","TTAACTCATCATGGTTGGGT","561307.5.peg.1093"," 106"
"1072",64,306,242,"TGGATCTTTGACAGATTGAA","GTCATTAACTCATCATGGTT","561307.5.peg.1093"," 106"
"1073",217,9,208,"TGCGATACCGGAAGCTTCAA","TGTTTCACACAAATCTGAGG","561307.5.peg.1095"," 108"
"1074",229,9,220,"CATGATTGCAGGTGCGATAC","TGTTTCACACAAATCTGAGG","561307.5.peg.1095"," 108"
"1075",240,9,231,"TGCAGTGCAGCCATGATTGC","TGTTTCACACAAATCTGAGG","561307.5.peg.1095"," 108"
"1076",300,9,291,"TAACCATCCGTCAAAGTGCT","TGTTTCACACAAATCTGAGG","561307.5.peg.1095"," 108"
"1077",217,12,205,"TGCGATACCGGAAGCTTCAA","AATGTTTCACACAAATCTG","561307.5.peg.1095"," 108"
"1078",229,12,217,"CATGATTGCAGGTGCGATAC","AATGTTTCACACAAATCTG","561307.5.peg.1095"," 108"
"1079",240,12,228,"TGCAGTGCAGCCATGATTGC","AATGTTTCACACAAATCTG","561307.5.peg.1095"," 108"
"1080",300,12,288,"TAACCATCCGTCAAAGTGCT","AATGTTTCACACAAATCTG","561307.5.peg.1095"," 108"
"1081",9,217,208,"TGTTTCACACAAATCTGAGG","TGCGATACCGGAAGCTTCAA","561307.5.peg.1095"," 108"
"1082",12,217,205,"AATGTTTCACACAAATCTG","TGCGATACCGGAAGCTTCAA","561307.5.peg.1095"," 108"
"1083",9,229,220,"TGTTTCACACAAATCTGAGG","CATGATTGCAGGTGCGATAC","561307.5.peg.1095"," 108"
"1084",12,229,217,"AATGTTTCACACAAATCTG","CATGATTGCAGGTGCGATAC","561307.5.peg.1095"," 108"
"1085",9,240,231,"TGTTTCACACAAATCTGAGG","TGCAGTGCAGCCATGATTGC","561307.5.peg.1095"," 108"
"1086",12,240,228,"AATGTTTCACACAAATCTG","TGCAGTGCAGCCATGATTGC","561307.5.peg.1095"," 108"
"1087",9,300,291,"TGTTTCACACAAATCTGAGG","TAACCATCCGTCAAAGTGCT","561307.5.peg.1095"," 108"
"1088",12,300,288,"AATGTTTCACACAAATCTG","TAACCATCCGTCAAAGTGCT","561307.5.peg.1095"," 108"
"1089",392,10,382,"CACTACCCGTTACTACTGGT","GGAAACAAAGTGACATTGGT","561307.5.peg.1096"," 109"
"1090",396,10,386,"ACAACACTACCCGTTACTAC","GGAAACAAAGTGACATTGGT","561307.5.peg.1096"," 109"
"1091",114,10,104,"AACTTGTACCAACAATGAT","GGAAACAAAGTGACATTGGT","561307.5.peg.1096"," 109"
"1092",147,10,137,"ACTAAGTAAGCGATTTGTTC","GGAAACAAAGTGACATTGGT","561307.5.peg.1096"," 109"
"1093",214,10,204,"TCCTGTTCCTGTTACTTTAT","GGAAACAAAGTGACATTGGT","561307.5.peg.1096"," 109"
"1094",444,10,434,"GCTAAGTAATTCATTGCTAC","GGAAACAAAGTGACATTGGT","561307.5.peg.1096"," 109"
"1095",147,14,133,"ACTAAGTAAGCGATTTGTTC","AGAAGGAAACAAAGTGACAT","561307.5.peg.1096"," 109"
"1096",396,14,382,"ACAACACTACCCGTTACTAC","AGAAGGAAACAAAGTGACAT","561307.5.peg.1096"," 109"
"1097",392,14,378,"CACTACCCGTTACTACTGGT","AGAAGGAAACAAAGTGACAT","561307.5.peg.1096"," 109"
"1098",214,14,200,"TCCTGTTCCTGTTACTTTAT","AGAAGGAAACAAAGTGACAT","561307.5.peg.1096"," 109"
"1099",114,14,100,"AACTTGTACCAACAATGAT","AGAAGGAAACAAAGTGACAT","561307.5.peg.1096"," 109"
"1100",444,14,430,"GCTAAGTAATTCATTGCTAC","AGAAGGAAACAAAGTGACAT","561307.5.peg.1096"," 109"
"1101",147,31,116,"ACTAAGTAAGCGATTTGTTC","AAGGTTGCTTCACTAGA","561307.5.peg.1096"," 109"
"1102",214,31,183,"TCCTGTTCCTGTTACTTTAT","AAGGTTGCTTCACTAGA","561307.5.peg.1096"," 109"
"1103",392,31,361,"CACTACCCGTTACTACTGGT","AAGGTTGCTTCACTAGA","561307.5.peg.1096"," 109"
"1104",396,31,365,"ACAACACTACCCGTTACTAC","AAGGTTGCTTCACTAGA","561307.5.peg.1096"," 109"
"1105",444,31,413,"GCTAAGTAATTCATTGCTAC","AAGGTTGCTTCACTAGA","561307.5.peg.1096"," 109"
"1106",396,114,282,"ACAACACTACCCGTTACTAC","AACTTGTACCAACAATGAT","561307.5.peg.1096"," 109"
"1107",214,114,100,"TCCTGTTCCTGTTACTTTAT","AACTTGTACCAACAATGAT","561307.5.peg.1096"," 109"
"1108",14,114,100,"AGAAGGAAACAAAGTGACAT","AACTTGTACCAACAATGAT","561307.5.peg.1096"," 109"
"1109",10,114,104,"GGAAACAAAGTGACATTGGT","AACTTGTACCAACAATGAT","561307.5.peg.1096"," 109"
"1110",444,114,330,"GCTAAGTAATTCATTGCTAC","AACTTGTACCAACAATGAT","561307.5.peg.1096"," 109"
"1111",392,114,278,"CACTACCCGTTACTACTGGT","AACTTGTACCAACAATGAT","561307.5.peg.1096"," 109"
"1112",10,147,137,"GGAAACAAAGTGACATTGGT","ACTAAGTAAGCGATTTGTTC","561307.5.peg.1096"," 109"
"1113",392,147,245,"CACTACCCGTTACTACTGGT","ACTAAGTAAGCGATTTGTTC","561307.5.peg.1096"," 109"
"1114",396,147,249,"ACAACACTACCCGTTACTAC","ACTAAGTAAGCGATTTGTTC","561307.5.peg.1096"," 109"
"1115",14,147,133,"AGAAGGAAACAAAGTGACAT","ACTAAGTAAGCGATTTGTTC","561307.5.peg.1096"," 109"
"1116",444,147,297,"GCTAAGTAATTCATTGCTAC","ACTAAGTAAGCGATTTGTTC","561307.5.peg.1096"," 109"
"1117",31,147,116,"AAGGTTGCTTCACTAGA","ACTAAGTAAGCGATTTGTTC","561307.5.peg.1096"," 109"
"1118",10,214,204,"GGAAACAAAGTGACATTGGT","TCCTGTTCCTGTTACTTTAT","561307.5.peg.1096"," 109"
"1119",392,214,178,"CACTACCCGTTACTACTGGT","TCCTGTTCCTGTTACTTTAT","561307.5.peg.1096"," 109"
"1120",14,214,200,"AGAAGGAAACAAAGTGACAT","TCCTGTTCCTGTTACTTTAT","561307.5.peg.1096"," 109"
"1121",31,214,183,"AAGGTTGCTTCACTAGA","TCCTGTTCCTGTTACTTTAT","561307.5.peg.1096"," 109"
"1122",396,214,182,"ACAACACTACCCGTTACTAC","TCCTGTTCCTGTTACTTTAT","561307.5.peg.1096"," 109"
"1123",444,214,230,"GCTAAGTAATTCATTGCTAC","TCCTGTTCCTGTTACTTTAT","561307.5.peg.1096"," 109"
"1124",114,214,100,"AACTTGTACCAACAATGAT","TCCTGTTCCTGTTACTTTAT","561307.5.peg.1096"," 109"
"1125",114,392,278,"AACTTGTACCAACAATGAT","CACTACCCGTTACTACTGGT","561307.5.peg.1096"," 109"
"1126",14,392,378,"AGAAGGAAACAAAGTGACAT","CACTACCCGTTACTACTGGT","561307.5.peg.1096"," 109"
"1127",147,392,245,"ACTAAGTAAGCGATTTGTTC","CACTACCCGTTACTACTGGT","561307.5.peg.1096"," 109"
"1128",214,392,178,"TCCTGTTCCTGTTACTTTAT","CACTACCCGTTACTACTGGT","561307.5.peg.1096"," 109"
"1129",10,392,382,"GGAAACAAAGTGACATTGGT","CACTACCCGTTACTACTGGT","561307.5.peg.1096"," 109"
"1130",31,392,361,"AAGGTTGCTTCACTAGA","CACTACCCGTTACTACTGGT","561307.5.peg.1096"," 109"
"1131",10,396,386,"GGAAACAAAGTGACATTGGT","ACAACACTACCCGTTACTAC","561307.5.peg.1096"," 109"
"1132",114,396,282,"AACTTGTACCAACAATGAT","ACAACACTACCCGTTACTAC","561307.5.peg.1096"," 109"
"1133",147,396,249,"ACTAAGTAAGCGATTTGTTC","ACAACACTACCCGTTACTAC","561307.5.peg.1096"," 109"
"1134",31,396,365,"AAGGTTGCTTCACTAGA","ACAACACTACCCGTTACTAC","561307.5.peg.1096"," 109"
"1135",214,396,182,"TCCTGTTCCTGTTACTTTAT","ACAACACTACCCGTTACTAC","561307.5.peg.1096"," 109"
"1136",14,396,382,"AGAAGGAAACAAAGTGACAT","ACAACACTACCCGTTACTAC","561307.5.peg.1096"," 109"
"1137",10,444,434,"GGAAACAAAGTGACATTGGT","GCTAAGTAATTCATTGCTAC","561307.5.peg.1096"," 109"
"1138",14,444,430,"AGAAGGAAACAAAGTGACAT","GCTAAGTAATTCATTGCTAC","561307.5.peg.1096"," 109"
"1139",114,444,330,"AACTTGTACCAACAATGAT","GCTAAGTAATTCATTGCTAC","561307.5.peg.1096"," 109"
"1140",214,444,230,"TCCTGTTCCTGTTACTTTAT","GCTAAGTAATTCATTGCTAC","561307.5.peg.1096"," 109"
"1141",31,444,413,"AAGGTTGCTTCACTAGA","GCTAAGTAATTCATTGCTAC","561307.5.peg.1096"," 109"
"1142",147,444,297,"ACTAAGTAAGCGATTTGTTC","GCTAAGTAATTCATTGCTAC","561307.5.peg.1096"," 109"
"1143",404,129,275,"CAATTGGTACACCTGAAATA","ACGCTTAAATCAACGTCTTT","561307.5.peg.1097"," 110"
"1144",360,129,231,"GCTTCATAAACGCTTTCTTC","ACGCTTAAATCAACGTCTTT","561307.5.peg.1097"," 110"
"1145",609,129,480,"AGACGTCCGTCTTTAACTAA","ACGCTTAAATCAACGTCTTT","561307.5.peg.1097"," 110"
"1146",360,183,177,"GCTTCATAAACGCTTTCTTC","TCCATACCAGCAGAAATAAC","561307.5.peg.1097"," 110"
"1147",609,183,426,"AGACGTCCGTCTTTAACTAA","TCCATACCAGCAGAAATAAC","561307.5.peg.1097"," 110"
"1148",404,183,221,"CAATTGGTACACCTGAAATA","TCCATACCAGCAGAAATAAC","561307.5.peg.1097"," 110"
"1149",129,360,231,"ACGCTTAAATCAACGTCTTT","GCTTCATAAACGCTTTCTTC","561307.5.peg.1097"," 110"
"1150",609,360,249,"AGACGTCCGTCTTTAACTAA","GCTTCATAAACGCTTTCTTC","561307.5.peg.1097"," 110"
"1151",183,360,177,"TCCATACCAGCAGAAATAAC","GCTTCATAAACGCTTTCTTC","561307.5.peg.1097"," 110"
"1152",129,404,275,"ACGCTTAAATCAACGTCTTT","CAATTGGTACACCTGAAATA","561307.5.peg.1097"," 110"
"1153",609,404,205,"AGACGTCCGTCTTTAACTAA","CAATTGGTACACCTGAAATA","561307.5.peg.1097"," 110"
"1154",183,404,221,"TCCATACCAGCAGAAATAAC","CAATTGGTACACCTGAAATA","561307.5.peg.1097"," 110"
"1155",129,609,480,"ACGCTTAAATCAACGTCTTT","AGACGTCCGTCTTTAACTAA","561307.5.peg.1097"," 110"
"1156",183,609,426,"TCCATACCAGCAGAAATAAC","AGACGTCCGTCTTTAACTAA","561307.5.peg.1097"," 110"
"1157",360,609,249,"GCTTCATAAACGCTTTCTTC","AGACGTCCGTCTTTAACTAA","561307.5.peg.1097"," 110"
"1158",404,609,205,"CAATTGGTACACCTGAAATA","AGACGTCCGTCTTTAACTAA","561307.5.peg.1097"," 110"
"1159",358,80,278,"TTTACCGTATTCACGTTCAT","GGCTACCAAAGTCTAAGACA","561307.5.peg.1098"," 111"
"1160",567,80,487,"TATTCTGTATGACGTACTTC","GGCTACCAAAGTCTAAGACA","561307.5.peg.1098"," 111"
"1161",503,80,423,"TTGCTGCATAGTCTGTGCTT","GGCTACCAAAGTCTAAGACA","561307.5.peg.1098"," 111"
"1162",423,80,343,"ATCCAAACAGTTTGTTCTGC","GGCTACCAAAGTCTAAGACA","561307.5.peg.1098"," 111"
"1163",563,80,483,"CTGTATGACGTACTTCTGGA","GGCTACCAAAGTCTAAGACA","561307.5.peg.1098"," 111"
"1164",617,80,537,"CTCTACAATCACAAACACGA","GGCTACCAAAGTCTAAGACA","561307.5.peg.1098"," 111"
"1165",291,80,211,"CCGTAACAAATACCAAGTAC","GGCTACCAAAGTCTAAGACA","561307.5.peg.1098"," 111"
"1166",423,110,313,"ATCCAAACAGTTTGTTCTGC","GAATTCGGCGTGTAATTAAT","561307.5.peg.1098"," 111"
"1167",358,110,248,"TTTACCGTATTCACGTTCAT","GAATTCGGCGTGTAATTAAT","561307.5.peg.1098"," 111"
"1168",503,110,393,"TTGCTGCATAGTCTGTGCTT","GAATTCGGCGTGTAATTAAT","561307.5.peg.1098"," 111"
"1169",291,110,181,"CCGTAACAAATACCAAGTAC","GAATTCGGCGTGTAATTAAT","561307.5.peg.1098"," 111"
"1170",563,110,453,"CTGTATGACGTACTTCTGGA","GAATTCGGCGTGTAATTAAT","561307.5.peg.1098"," 111"
"1171",567,110,457,"TATTCTGTATGACGTACTTC","GAATTCGGCGTGTAATTAAT","561307.5.peg.1098"," 111"
"1172",617,110,507,"CTCTACAATCACAAACACGA","GAATTCGGCGTGTAATTAAT","561307.5.peg.1098"," 111"
"1173",358,125,233,"TTTACCGTATTCACGTTCAT","AAACGCCCATTTCACGAATT","561307.5.peg.1098"," 111"
"1174",567,125,442,"TATTCTGTATGACGTACTTC","AAACGCCCATTTCACGAATT","561307.5.peg.1098"," 111"
"1175",423,125,298,"ATCCAAACAGTTTGTTCTGC","AAACGCCCATTTCACGAATT","561307.5.peg.1098"," 111"
"1176",563,125,438,"CTGTATGACGTACTTCTGGA","AAACGCCCATTTCACGAATT","561307.5.peg.1098"," 111"
"1177",291,125,166,"CCGTAACAAATACCAAGTAC","AAACGCCCATTTCACGAATT","561307.5.peg.1098"," 111"
"1178",503,125,378,"TTGCTGCATAGTCTGTGCTT","AAACGCCCATTTCACGAATT","561307.5.peg.1098"," 111"
"1179",617,125,492,"CTCTACAATCACAAACACGA","AAACGCCCATTTCACGAATT","561307.5.peg.1098"," 111"
"1180",423,291,132,"ATCCAAACAGTTTGTTCTGC","CCGTAACAAATACCAAGTAC","561307.5.peg.1098"," 111"
"1181",110,291,181,"GAATTCGGCGTGTAATTAAT","CCGTAACAAATACCAAGTAC","561307.5.peg.1098"," 111"
"1182",125,291,166,"AAACGCCCATTTCACGAATT","CCGTAACAAATACCAAGTAC","561307.5.peg.1098"," 111"
"1183",80,291,211,"GGCTACCAAAGTCTAAGACA","CCGTAACAAATACCAAGTAC","561307.5.peg.1098"," 111"
"1184",503,291,212,"TTGCTGCATAGTCTGTGCTT","CCGTAACAAATACCAAGTAC","561307.5.peg.1098"," 111"
"1185",563,291,272,"CTGTATGACGTACTTCTGGA","CCGTAACAAATACCAAGTAC","561307.5.peg.1098"," 111"
"1186",567,291,276,"TATTCTGTATGACGTACTTC","CCGTAACAAATACCAAGTAC","561307.5.peg.1098"," 111"
"1187",617,291,326,"CTCTACAATCACAAACACGA","CCGTAACAAATACCAAGTAC","561307.5.peg.1098"," 111"
"1188",503,358,145,"TTGCTGCATAGTCTGTGCTT","TTTACCGTATTCACGTTCAT","561307.5.peg.1098"," 111"
"1189",563,358,205,"CTGTATGACGTACTTCTGGA","TTTACCGTATTCACGTTCAT","561307.5.peg.1098"," 111"
"1190",110,358,248,"GAATTCGGCGTGTAATTAAT","TTTACCGTATTCACGTTCAT","561307.5.peg.1098"," 111"
"1191",567,358,209,"TATTCTGTATGACGTACTTC","TTTACCGTATTCACGTTCAT","561307.5.peg.1098"," 111"
"1192",80,358,278,"GGCTACCAAAGTCTAAGACA","TTTACCGTATTCACGTTCAT","561307.5.peg.1098"," 111"
"1193",617,358,259,"CTCTACAATCACAAACACGA","TTTACCGTATTCACGTTCAT","561307.5.peg.1098"," 111"
"1194",125,358,233,"AAACGCCCATTTCACGAATT","TTTACCGTATTCACGTTCAT","561307.5.peg.1098"," 111"
"1195",563,423,140,"CTGTATGACGTACTTCTGGA","ATCCAAACAGTTTGTTCTGC","561307.5.peg.1098"," 111"
"1196",291,423,132,"CCGTAACAAATACCAAGTAC","ATCCAAACAGTTTGTTCTGC","561307.5.peg.1098"," 111"
"1197",567,423,144,"TATTCTGTATGACGTACTTC","ATCCAAACAGTTTGTTCTGC","561307.5.peg.1098"," 111"
"1198",617,423,194,"CTCTACAATCACAAACACGA","ATCCAAACAGTTTGTTCTGC","561307.5.peg.1098"," 111"
"1199",80,423,343,"GGCTACCAAAGTCTAAGACA","ATCCAAACAGTTTGTTCTGC","561307.5.peg.1098"," 111"
"1200",110,423,313,"GAATTCGGCGTGTAATTAAT","ATCCAAACAGTTTGTTCTGC","561307.5.peg.1098"," 111"
"1201",125,423,298,"AAACGCCCATTTCACGAATT","ATCCAAACAGTTTGTTCTGC","561307.5.peg.1098"," 111"
"1202",617,503,114,"CTCTACAATCACAAACACGA","TTGCTGCATAGTCTGTGCTT","561307.5.peg.1098"," 111"
"1203",291,503,212,"CCGTAACAAATACCAAGTAC","TTGCTGCATAGTCTGTGCTT","561307.5.peg.1098"," 111"
"1204",358,503,145,"TTTACCGTATTCACGTTCAT","TTGCTGCATAGTCTGTGCTT","561307.5.peg.1098"," 111"
"1205",80,503,423,"GGCTACCAAAGTCTAAGACA","TTGCTGCATAGTCTGTGCTT","561307.5.peg.1098"," 111"
"1206",110,503,393,"GAATTCGGCGTGTAATTAAT","TTGCTGCATAGTCTGTGCTT","561307.5.peg.1098"," 111"
"1207",125,503,378,"AAACGCCCATTTCACGAATT","TTGCTGCATAGTCTGTGCTT","561307.5.peg.1098"," 111"
"1208",80,563,483,"GGCTACCAAAGTCTAAGACA","CTGTATGACGTACTTCTGGA","561307.5.peg.1098"," 111"
"1209",291,563,272,"CCGTAACAAATACCAAGTAC","CTGTATGACGTACTTCTGGA","561307.5.peg.1098"," 111"
"1210",358,563,205,"TTTACCGTATTCACGTTCAT","CTGTATGACGTACTTCTGGA","561307.5.peg.1098"," 111"
"1211",125,563,438,"AAACGCCCATTTCACGAATT","CTGTATGACGTACTTCTGGA","561307.5.peg.1098"," 111"
"1212",110,563,453,"GAATTCGGCGTGTAATTAAT","CTGTATGACGTACTTCTGGA","561307.5.peg.1098"," 111"
"1213",423,563,140,"ATCCAAACAGTTTGTTCTGC","CTGTATGACGTACTTCTGGA","561307.5.peg.1098"," 111"
"1214",110,567,457,"GAATTCGGCGTGTAATTAAT","TATTCTGTATGACGTACTTC","561307.5.peg.1098"," 111"
"1215",291,567,276,"CCGTAACAAATACCAAGTAC","TATTCTGTATGACGTACTTC","561307.5.peg.1098"," 111"
"1216",423,567,144,"ATCCAAACAGTTTGTTCTGC","TATTCTGTATGACGTACTTC","561307.5.peg.1098"," 111"
"1217",80,567,487,"GGCTACCAAAGTCTAAGACA","TATTCTGTATGACGTACTTC","561307.5.peg.1098"," 111"
"1218",125,567,442,"AAACGCCCATTTCACGAATT","TATTCTGTATGACGTACTTC","561307.5.peg.1098"," 111"
"1219",358,567,209,"TTTACCGTATTCACGTTCAT","TATTCTGTATGACGTACTTC","561307.5.peg.1098"," 111"
"1220",503,617,114,"TTGCTGCATAGTCTGTGCTT","CTCTACAATCACAAACACGA","561307.5.peg.1098"," 111"
"1221",110,617,507,"GAATTCGGCGTGTAATTAAT","CTCTACAATCACAAACACGA","561307.5.peg.1098"," 111"
"1222",80,617,537,"GGCTACCAAAGTCTAAGACA","CTCTACAATCACAAACACGA","561307.5.peg.1098"," 111"
"1223",291,617,326,"CCGTAACAAATACCAAGTAC","CTCTACAATCACAAACACGA","561307.5.peg.1098"," 111"
"1224",358,617,259,"TTTACCGTATTCACGTTCAT","CTCTACAATCACAAACACGA","561307.5.peg.1098"," 111"
"1225",125,617,492,"AAACGCCCATTTCACGAATT","CTCTACAATCACAAACACGA","561307.5.peg.1098"," 111"
"1226",423,617,194,"ATCCAAACAGTTTGTTCTGC","CTCTACAATCACAAACACGA","561307.5.peg.1098"," 111"
"1227",498,276,222,"TTGATACCTAATTGCTCTAC","GCTTTCGCAACACCTAACAC","561307.5.peg.11"," 113"
"1228",805,276,529,"AGTATCATACAATGATGCAC","GCTTTCGCAACACCTAACAC","561307.5.peg.11"," 113"
"1229",276,498,222,"GCTTTCGCAACACCTAACAC","TTGATACCTAATTGCTCTAC","561307.5.peg.11"," 113"
"1230",805,498,307,"AGTATCATACAATGATGCAC","TTGATACCTAATTGCTCTAC","561307.5.peg.11"," 113"
"1231",276,805,529,"GCTTTCGCAACACCTAACAC","AGTATCATACAATGATGCAC","561307.5.peg.11"," 113"
"1232",498,805,307,"TTGATACCTAATTGCTCTAC","AGTATCATACAATGATGCAC","561307.5.peg.11"," 113"
"1233",316,66,250,"TGTTTAAATCGGTTACCAA","GGGCCAGGTGTTAATAACAA","561307.5.peg.110"," 114"
"1234",494,66,428,"CATTTCCTAACTCGTGAATA","GGGCCAGGTGTTAATAACAA","561307.5.peg.110"," 114"
"1235",281,66,215,"TGACAACGAAGTGATCTTCA","GGGCCAGGTGTTAATAACAA","561307.5.peg.110"," 114"
"1236",494,81,413,"CATTTCCTAACTCGTGAATA","TCAGGTACAGGGGTTGGGCC","561307.5.peg.110"," 114"
"1237",281,81,200,"TGACAACGAAGTGATCTTCA","TCAGGTACAGGGGTTGGGCC","561307.5.peg.110"," 114"
"1238",316,81,235,"TGTTTAAATCGGTTACCAA","TCAGGTACAGGGGTTGGGCC","561307.5.peg.110"," 114"
"1239",494,86,408,"CATTTCCTAACTCGTGAATA","TGGCATCAGGTACAGGGGTT","561307.5.peg.110"," 114"
"1240",281,86,195,"TGACAACGAAGTGATCTTCA","TGGCATCAGGTACAGGGGTT","561307.5.peg.110"," 114"
"1241",316,86,230,"TGTTTAAATCGGTTACCAA","TGGCATCAGGTACAGGGGTT","561307.5.peg.110"," 114"
"1242",316,93,223,"TGTTTAAATCGGTTACCAA","CTCATAATGGCATCAGGTAC","561307.5.peg.110"," 114"
"1243",281,93,188,"TGACAACGAAGTGATCTTCA","CTCATAATGGCATCAGGTAC","561307.5.peg.110"," 114"
"1244",494,93,401,"CATTTCCTAACTCGTGAATA","CTCATAATGGCATCAGGTAC","561307.5.peg.110"," 114"
"1245",316,106,210,"TGTTTAAATCGGTTACCAA","GCTTGAATTTCTCTCATAA","561307.5.peg.110"," 114"
"1246",494,106,388,"CATTTCCTAACTCGTGAATA","GCTTGAATTTCTCTCATAA","561307.5.peg.110"," 114"
"1247",281,106,175,"TGACAACGAAGTGATCTTCA","GCTTGAATTTCTCTCATAA","561307.5.peg.110"," 114"
"1248",494,129,365,"CATTTCCTAACTCGTGAATA","TTAGAACGATGACCAACCAT","561307.5.peg.110"," 114"
"1249",316,129,187,"TGTTTAAATCGGTTACCAA","TTAGAACGATGACCAACCAT","561307.5.peg.110"," 114"
"1250",281,129,152,"TGACAACGAAGTGATCTTCA","TTAGAACGATGACCAACCAT","561307.5.peg.110"," 114"
"1251",86,281,195,"TGGCATCAGGTACAGGGGTT","TGACAACGAAGTGATCTTCA","561307.5.peg.110"," 114"
"1252",494,281,213,"CATTTCCTAACTCGTGAATA","TGACAACGAAGTGATCTTCA","561307.5.peg.110"," 114"
"1253",129,281,152,"TTAGAACGATGACCAACCAT","TGACAACGAAGTGATCTTCA","561307.5.peg.110"," 114"
"1254",93,281,188,"CTCATAATGGCATCAGGTAC","TGACAACGAAGTGATCTTCA","561307.5.peg.110"," 114"
"1255",66,281,215,"GGGCCAGGTGTTAATAACAA","TGACAACGAAGTGATCTTCA","561307.5.peg.110"," 114"
"1256",106,281,175,"GCTTGAATTTCTCTCATAA","TGACAACGAAGTGATCTTCA","561307.5.peg.110"," 114"
"1257",81,281,200,"TCAGGTACAGGGGTTGGGCC","TGACAACGAAGTGATCTTCA","561307.5.peg.110"," 114"
"1258",81,316,235,"TCAGGTACAGGGGTTGGGCC","TGTTTAAATCGGTTACCAA","561307.5.peg.110"," 114"
"1259",66,316,250,"GGGCCAGGTGTTAATAACAA","TGTTTAAATCGGTTACCAA","561307.5.peg.110"," 114"
"1260",86,316,230,"TGGCATCAGGTACAGGGGTT","TGTTTAAATCGGTTACCAA","561307.5.peg.110"," 114"
"1261",129,316,187,"TTAGAACGATGACCAACCAT","TGTTTAAATCGGTTACCAA","561307.5.peg.110"," 114"
"1262",93,316,223,"CTCATAATGGCATCAGGTAC","TGTTTAAATCGGTTACCAA","561307.5.peg.110"," 114"
"1263",106,316,210,"GCTTGAATTTCTCTCATAA","TGTTTAAATCGGTTACCAA","561307.5.peg.110"," 114"
"1264",494,316,178,"CATTTCCTAACTCGTGAATA","TGTTTAAATCGGTTACCAA","561307.5.peg.110"," 114"
"1265",66,494,428,"GGGCCAGGTGTTAATAACAA","CATTTCCTAACTCGTGAATA","561307.5.peg.110"," 114"
"1266",316,494,178,"TGTTTAAATCGGTTACCAA","CATTTCCTAACTCGTGAATA","561307.5.peg.110"," 114"
"1267",86,494,408,"TGGCATCAGGTACAGGGGTT","CATTTCCTAACTCGTGAATA","561307.5.peg.110"," 114"
"1268",81,494,413,"TCAGGTACAGGGGTTGGGCC","CATTTCCTAACTCGTGAATA","561307.5.peg.110"," 114"
"1269",129,494,365,"TTAGAACGATGACCAACCAT","CATTTCCTAACTCGTGAATA","561307.5.peg.110"," 114"
"1270",93,494,401,"CTCATAATGGCATCAGGTAC","CATTTCCTAACTCGTGAATA","561307.5.peg.110"," 114"
"1271",281,494,213,"TGACAACGAAGTGATCTTCA","CATTTCCTAACTCGTGAATA","561307.5.peg.110"," 114"
"1272",106,494,388,"GCTTGAATTTCTCTCATAA","CATTTCCTAACTCGTGAATA","561307.5.peg.110"," 114"
"1273",267,109,158,"ATGATGGATGGATAATACT","TGATCTATGTGATTTGCAA","561307.5.peg.1104"," 119"
"1274",253,109,144,"ATACTTGGAATAAACACAA","TGATCTATGTGATTTGCAA","561307.5.peg.1104"," 119"
"1275",390,109,281,"AATAAGGACTCATATGGAA","TGATCTATGTGATTTGCAA","561307.5.peg.1104"," 119"
"1276",278,109,169,"GAATACGTTTGAATGATGGA","TGATCTATGTGATTTGCAA","561307.5.peg.1104"," 119"
"1277",109,253,144,"TGATCTATGTGATTTGCAA","ATACTTGGAATAAACACAA","561307.5.peg.1104"," 119"
"1278",390,253,137,"AATAAGGACTCATATGGAA","ATACTTGGAATAAACACAA","561307.5.peg.1104"," 119"
"1279",109,267,158,"TGATCTATGTGATTTGCAA","ATGATGGATGGATAATACT","561307.5.peg.1104"," 119"
"1280",390,267,123,"AATAAGGACTCATATGGAA","ATGATGGATGGATAATACT","561307.5.peg.1104"," 119"
"1281",109,278,169,"TGATCTATGTGATTTGCAA","GAATACGTTTGAATGATGGA","561307.5.peg.1104"," 119"
"1282",390,278,112,"AATAAGGACTCATATGGAA","GAATACGTTTGAATGATGGA","561307.5.peg.1104"," 119"
"1283",109,390,281,"TGATCTATGTGATTTGCAA","AATAAGGACTCATATGGAA","561307.5.peg.1104"," 119"
"1284",253,390,137,"ATACTTGGAATAAACACAA","AATAAGGACTCATATGGAA","561307.5.peg.1104"," 119"
"1285",267,390,123,"ATGATGGATGGATAATACT","AATAAGGACTCATATGGAA","561307.5.peg.1104"," 119"
"1286",278,390,112,"GAATACGTTTGAATGATGGA","AATAAGGACTCATATGGAA","561307.5.peg.1104"," 119"
"1287",384,174,210,"GATTGTTCTTGTTTAGGCGC","AATCGCTCTGCTTTAAGCGT","561307.5.peg.1107"," 122"
"1288",174,384,210,"AATCGCTCTGCTTTAAGCGT","GATTGTTCTTGTTTAGGCGC","561307.5.peg.1107"," 122"
"1289",258,154,104,"GTCGCATTTGCTGTTTGTTG","TTGTGGTGCTTCCACTTTAG","561307.5.peg.1109"," 124"
"1290",285,154,131,"GTTGTCACTTTAGTTGAAGG","TTGTGGTGCTTCCACTTTAG","561307.5.peg.1109"," 124"
"1291",288,154,134,"GGTGTTGTCACTTTAGTTGA","TTGTGGTGCTTCCACTTTAG","561307.5.peg.1109"," 124"
"1292",285,171,114,"GTTGTCACTTTAGTTGAAGG","GTTGAGGGCGGTGTTGATTG","561307.5.peg.1109"," 124"
"1293",288,171,117,"GGTGTTGTCACTTTAGTTGA","GTTGAGGGCGGTGTTGATTG","561307.5.peg.1109"," 124"
"1294",154,258,104,"TTGTGGTGCTTCCACTTTAG","GTCGCATTTGCTGTTTGTTG","561307.5.peg.1109"," 124"
"1295",154,285,131,"TTGTGGTGCTTCCACTTTAG","GTTGTCACTTTAGTTGAAGG","561307.5.peg.1109"," 124"
"1296",171,285,114,"GTTGAGGGCGGTGTTGATTG","GTTGTCACTTTAGTTGAAGG","561307.5.peg.1109"," 124"
"1297",154,288,134,"TTGTGGTGCTTCCACTTTAG","GGTGTTGTCACTTTAGTTGA","561307.5.peg.1109"," 124"
"1298",171,288,117,"GTTGAGGGCGGTGTTGATTG","GGTGTTGTCACTTTAGTTGA","561307.5.peg.1109"," 124"
"1299",186,74,112,"GCTGATACTAACATTTCATC","GACCACCTTGCCAAGAAGTT","561307.5.peg.111"," 125"
"1300",208,74,134,"GATGATATAACATGATGAAG","GACCACCTTGCCAAGAAGTT","561307.5.peg.111"," 125"
"1301",74,186,112,"GACCACCTTGCCAAGAAGTT","GCTGATACTAACATTTCATC","561307.5.peg.111"," 125"
"1302",74,208,134,"GACCACCTTGCCAAGAAGTT","GATGATATAACATGATGAAG","561307.5.peg.111"," 125"
"1303",165,49,116,"TCTCTTTAGTTAACTCATC","TGTGCCGCCACCTACATACA","561307.5.peg.1110"," 126"
"1304",366,49,317,"AAATCTTCAATCGTCTGTTT","TGTGCCGCCACCTACATACA","561307.5.peg.1110"," 126"
"1305",366,72,294,"AAATCTTCAATCGTCTGTTT","TGATTAATAGAAAGGGCCGT","561307.5.peg.1110"," 126"
"1306",366,79,287,"AAATCTTCAATCGTCTGTTT","TCCAACTGATTAATAGAAA","561307.5.peg.1110"," 126"
"1307",49,165,116,"TGTGCCGCCACCTACATACA","TCTCTTTAGTTAACTCATC","561307.5.peg.1110"," 126"
"1308",366,165,201,"AAATCTTCAATCGTCTGTTT","TCTCTTTAGTTAACTCATC","561307.5.peg.1110"," 126"
"1309",72,366,294,"TGATTAATAGAAAGGGCCGT","AAATCTTCAATCGTCTGTTT","561307.5.peg.1110"," 126"
"1310",79,366,287,"TCCAACTGATTAATAGAAA","AAATCTTCAATCGTCTGTTT","561307.5.peg.1110"," 126"
"1311",49,366,317,"TGTGCCGCCACCTACATACA","AAATCTTCAATCGTCTGTTT","561307.5.peg.1110"," 126"
"1312",165,366,201,"TCTCTTTAGTTAACTCATC","AAATCTTCAATCGTCTGTTT","561307.5.peg.1110"," 126"
"1313",306,137,169,"ATCATAGCTGAGATTTCTTG","GTGTTGTACGTGAACCTTCA","561307.5.peg.1113"," 129"
"1314",625,137,488,"ACCGCCAAGTTTGTTGTCAC","GTGTTGTACGTGAACCTTCA","561307.5.peg.1113"," 129"
"1315",399,137,262,"TCAGCATCGTTAAAGTATGC","GTGTTGTACGTGAACCTTCA","561307.5.peg.1113"," 129"
"1316",486,137,349,"TATGCTAATGCTGCAGCTGT","GTGTTGTACGTGAACCTTCA","561307.5.peg.1113"," 129"
"1317",915,137,778,"TCTTTCATTGCTTGGCGTGT","GTGTTGTACGTGAACCTTCA","561307.5.peg.1113"," 129"
"1318",399,230,169,"TCAGCATCGTTAAAGTATGC","AATAGATTGAACAGTGTTT","561307.5.peg.1113"," 129"
"1319",915,230,685,"TCTTTCATTGCTTGGCGTGT","AATAGATTGAACAGTGTTT","561307.5.peg.1113"," 129"
"1320",486,230,256,"TATGCTAATGCTGCAGCTGT","AATAGATTGAACAGTGTTT","561307.5.peg.1113"," 129"
"1321",625,230,395,"ACCGCCAAGTTTGTTGTCAC","AATAGATTGAACAGTGTTT","561307.5.peg.1113"," 129"
"1322",137,306,169,"GTGTTGTACGTGAACCTTCA","ATCATAGCTGAGATTTCTTG","561307.5.peg.1113"," 129"
"1323",625,306,319,"ACCGCCAAGTTTGTTGTCAC","ATCATAGCTGAGATTTCTTG","561307.5.peg.1113"," 129"
"1324",915,306,609,"TCTTTCATTGCTTGGCGTGT","ATCATAGCTGAGATTTCTTG","561307.5.peg.1113"," 129"
"1325",486,306,180,"TATGCTAATGCTGCAGCTGT","ATCATAGCTGAGATTTCTTG","561307.5.peg.1113"," 129"
"1326",137,399,262,"GTGTTGTACGTGAACCTTCA","TCAGCATCGTTAAAGTATGC","561307.5.peg.1113"," 129"
"1327",230,399,169,"AATAGATTGAACAGTGTTT","TCAGCATCGTTAAAGTATGC","561307.5.peg.1113"," 129"
"1328",625,399,226,"ACCGCCAAGTTTGTTGTCAC","TCAGCATCGTTAAAGTATGC","561307.5.peg.1113"," 129"
"1329",915,399,516,"TCTTTCATTGCTTGGCGTGT","TCAGCATCGTTAAAGTATGC","561307.5.peg.1113"," 129"
"1330",230,486,256,"AATAGATTGAACAGTGTTT","TATGCTAATGCTGCAGCTGT","561307.5.peg.1113"," 129"
"1331",137,486,349,"GTGTTGTACGTGAACCTTCA","TATGCTAATGCTGCAGCTGT","561307.5.peg.1113"," 129"
"1332",915,486,429,"TCTTTCATTGCTTGGCGTGT","TATGCTAATGCTGCAGCTGT","561307.5.peg.1113"," 129"
"1333",306,486,180,"ATCATAGCTGAGATTTCTTG","TATGCTAATGCTGCAGCTGT","561307.5.peg.1113"," 129"
"1334",625,486,139,"ACCGCCAAGTTTGTTGTCAC","TATGCTAATGCTGCAGCTGT","561307.5.peg.1113"," 129"
"1335",137,625,488,"GTGTTGTACGTGAACCTTCA","ACCGCCAAGTTTGTTGTCAC","561307.5.peg.1113"," 129"
"1336",486,625,139,"TATGCTAATGCTGCAGCTGT","ACCGCCAAGTTTGTTGTCAC","561307.5.peg.1113"," 129"
"1337",230,625,395,"AATAGATTGAACAGTGTTT","ACCGCCAAGTTTGTTGTCAC","561307.5.peg.1113"," 129"
"1338",306,625,319,"ATCATAGCTGAGATTTCTTG","ACCGCCAAGTTTGTTGTCAC","561307.5.peg.1113"," 129"
"1339",399,625,226,"TCAGCATCGTTAAAGTATGC","ACCGCCAAGTTTGTTGTCAC","561307.5.peg.1113"," 129"
"1340",915,625,290,"TCTTTCATTGCTTGGCGTGT","ACCGCCAAGTTTGTTGTCAC","561307.5.peg.1113"," 129"
"1341",306,915,609,"ATCATAGCTGAGATTTCTTG","TCTTTCATTGCTTGGCGTGT","561307.5.peg.1113"," 129"
"1342",486,915,429,"TATGCTAATGCTGCAGCTGT","TCTTTCATTGCTTGGCGTGT","561307.5.peg.1113"," 129"
"1343",137,915,778,"GTGTTGTACGTGAACCTTCA","TCTTTCATTGCTTGGCGTGT","561307.5.peg.1113"," 129"
"1344",230,915,685,"AATAGATTGAACAGTGTTT","TCTTTCATTGCTTGGCGTGT","561307.5.peg.1113"," 129"
"1345",399,915,516,"TCAGCATCGTTAAAGTATGC","TCTTTCATTGCTTGGCGTGT","561307.5.peg.1113"," 129"
"1346",625,915,290,"ACCGCCAAGTTTGTTGTCAC","TCTTTCATTGCTTGGCGTGT","561307.5.peg.1113"," 129"
"1347",398,170,228,"TCTTCGACGCTCGGAATGGA","CACCGTATTTATCTTCTGGT","561307.5.peg.1115"," 131"
"1348",435,170,265,"TTAGCATATGTTTCCCAACT","CACCGTATTTATCTTCTGGT","561307.5.peg.1115"," 131"
"1349",407,170,237,"TTGTGAACTTCTTCGACGCT","CACCGTATTTATCTTCTGGT","561307.5.peg.1115"," 131"
"1350",402,170,232,"AACTTCTTCGACGCTCGGAA","CACCGTATTTATCTTCTGGT","561307.5.peg.1115"," 131"
"1351",402,174,228,"AACTTCTTCGACGCTCGGAA","TTTCACCGTATTTATCTTC","561307.5.peg.1115"," 131"
"1352",398,174,224,"TCTTCGACGCTCGGAATGGA","TTTCACCGTATTTATCTTC","561307.5.peg.1115"," 131"
"1353",435,174,261,"TTAGCATATGTTTCCCAACT","TTTCACCGTATTTATCTTC","561307.5.peg.1115"," 131"
"1354",407,174,233,"TTGTGAACTTCTTCGACGCT","TTTCACCGTATTTATCTTC","561307.5.peg.1115"," 131"
"1355",407,222,185,"TTGTGAACTTCTTCGACGCT","TTCAATCTTACTCCCTTATC","561307.5.peg.1115"," 131"
"1356",402,222,180,"AACTTCTTCGACGCTCGGAA","TTCAATCTTACTCCCTTATC","561307.5.peg.1115"," 131"
"1357",398,222,176,"TCTTCGACGCTCGGAATGGA","TTCAATCTTACTCCCTTATC","561307.5.peg.1115"," 131"
"1358",435,222,213,"TTAGCATATGTTTCCCAACT","TTCAATCTTACTCCCTTATC","561307.5.peg.1115"," 131"
"1359",170,398,228,"CACCGTATTTATCTTCTGGT","TCTTCGACGCTCGGAATGGA","561307.5.peg.1115"," 131"
"1360",174,398,224,"TTTCACCGTATTTATCTTC","TCTTCGACGCTCGGAATGGA","561307.5.peg.1115"," 131"
"1361",222,398,176,"TTCAATCTTACTCCCTTATC","TCTTCGACGCTCGGAATGGA","561307.5.peg.1115"," 131"
"1362",174,402,228,"TTTCACCGTATTTATCTTC","AACTTCTTCGACGCTCGGAA","561307.5.peg.1115"," 131"
"1363",222,402,180,"TTCAATCTTACTCCCTTATC","AACTTCTTCGACGCTCGGAA","561307.5.peg.1115"," 131"
"1364",170,402,232,"CACCGTATTTATCTTCTGGT","AACTTCTTCGACGCTCGGAA","561307.5.peg.1115"," 131"
"1365",222,407,185,"TTCAATCTTACTCCCTTATC","TTGTGAACTTCTTCGACGCT","561307.5.peg.1115"," 131"
"1366",174,407,233,"TTTCACCGTATTTATCTTC","TTGTGAACTTCTTCGACGCT","561307.5.peg.1115"," 131"
"1367",170,407,237,"CACCGTATTTATCTTCTGGT","TTGTGAACTTCTTCGACGCT","561307.5.peg.1115"," 131"
"1368",222,435,213,"TTCAATCTTACTCCCTTATC","TTAGCATATGTTTCCCAACT","561307.5.peg.1115"," 131"
"1369",170,435,265,"CACCGTATTTATCTTCTGGT","TTAGCATATGTTTCCCAACT","561307.5.peg.1115"," 131"
"1370",174,435,261,"TTTCACCGTATTTATCTTC","TTAGCATATGTTTCCCAACT","561307.5.peg.1115"," 131"
"1371",276,21,255,"CTGCAAATCGTAACATCAAC","AACGGTTGGGTTTGTCTTGT","561307.5.peg.1116"," 132"
"1372",276,31,245,"CTGCAAATCGTAACATCAAC","CACATTATTCACTCACTTTC","561307.5.peg.1116"," 132"
"1373",21,276,255,"AACGGTTGGGTTTGTCTTGT","CTGCAAATCGTAACATCAAC","561307.5.peg.1116"," 132"
"1374",31,276,245,"CACATTATTCACTCACTTTC","CTGCAAATCGTAACATCAAC","561307.5.peg.1116"," 132"
"1375",398,255,143,"TTCCAACACCATTAATTGGT","GTTACACAGATTACAGCATC","561307.5.peg.1117"," 133"
"1376",537,255,282,"CGCATTAAGCCACGAGCCCA","GTTACACAGATTACAGCATC","561307.5.peg.1117"," 133"
"1377",685,255,430,"TCAAGATCACGTAATAATT","GTTACACAGATTACAGCATC","561307.5.peg.1117"," 133"
"1378",386,255,131,"TAATTGGTTGGCGTTCTTTA","GTTACACAGATTACAGCATC","561307.5.peg.1117"," 133"
"1379",255,386,131,"GTTACACAGATTACAGCATC","TAATTGGTTGGCGTTCTTTA","561307.5.peg.1117"," 133"
"1380",537,386,151,"CGCATTAAGCCACGAGCCCA","TAATTGGTTGGCGTTCTTTA","561307.5.peg.1117"," 133"
"1381",685,386,299,"TCAAGATCACGTAATAATT","TAATTGGTTGGCGTTCTTTA","561307.5.peg.1117"," 133"
"1382",255,398,143,"GTTACACAGATTACAGCATC","TTCCAACACCATTAATTGGT","561307.5.peg.1117"," 133"
"1383",685,398,287,"TCAAGATCACGTAATAATT","TTCCAACACCATTAATTGGT","561307.5.peg.1117"," 133"
"1384",537,398,139,"CGCATTAAGCCACGAGCCCA","TTCCAACACCATTAATTGGT","561307.5.peg.1117"," 133"
"1385",255,537,282,"GTTACACAGATTACAGCATC","CGCATTAAGCCACGAGCCCA","561307.5.peg.1117"," 133"
"1386",386,537,151,"TAATTGGTTGGCGTTCTTTA","CGCATTAAGCCACGAGCCCA","561307.5.peg.1117"," 133"
"1387",398,537,139,"TTCCAACACCATTAATTGGT","CGCATTAAGCCACGAGCCCA","561307.5.peg.1117"," 133"
"1388",685,537,148,"TCAAGATCACGTAATAATT","CGCATTAAGCCACGAGCCCA","561307.5.peg.1117"," 133"
"1389",386,685,299,"TAATTGGTTGGCGTTCTTTA","TCAAGATCACGTAATAATT","561307.5.peg.1117"," 133"
"1390",537,685,148,"CGCATTAAGCCACGAGCCCA","TCAAGATCACGTAATAATT","561307.5.peg.1117"," 133"
"1391",255,685,430,"GTTACACAGATTACAGCATC","TCAAGATCACGTAATAATT","561307.5.peg.1117"," 133"
"1392",398,685,287,"TTCCAACACCATTAATTGGT","TCAAGATCACGTAATAATT","561307.5.peg.1117"," 133"
"1393",166,8,158,"AATCCTAAGAATGTCAAAC","GTATAATTAATGTGAGGGCG","561307.5.peg.1119"," 135"
"1394",275,8,267,"ATGCATATTGACATTTCCT","GTATAATTAATGTGAGGGCG","561307.5.peg.1119"," 135"
"1395",8,166,158,"GTATAATTAATGTGAGGGCG","AATCCTAAGAATGTCAAAC","561307.5.peg.1119"," 135"
"1396",275,166,109,"ATGCATATTGACATTTCCT","AATCCTAAGAATGTCAAAC","561307.5.peg.1119"," 135"
"1397",8,275,267,"GTATAATTAATGTGAGGGCG","ATGCATATTGACATTTCCT","561307.5.peg.1119"," 135"
"1398",166,275,109,"AATCCTAAGAATGTCAAAC","ATGCATATTGACATTTCCT","561307.5.peg.1119"," 135"
"1399",386,29,357,"CTAATACGTCACGTCCTGCA","GGAACAAGAGTAGTTGTGA","561307.5.peg.1120"," 137"
"1400",450,29,421,"ATTGCTACACCTGCGATAAA","GGAACAAGAGTAGTTGTGA","561307.5.peg.1120"," 137"
"1401",493,29,464,"TCTAACTGTGATACGAGCTT","GGAACAAGAGTAGTTGTGA","561307.5.peg.1120"," 137"
"1402",450,123,327,"ATTGCTACACCTGCGATAAA","GCTGAAATCCATAAACCAAT","561307.5.peg.1120"," 137"
"1403",386,123,263,"CTAATACGTCACGTCCTGCA","GCTGAAATCCATAAACCAAT","561307.5.peg.1120"," 137"
"1404",493,123,370,"TCTAACTGTGATACGAGCTT","GCTGAAATCCATAAACCAAT","561307.5.peg.1120"," 137"
"1405",29,386,357,"GGAACAAGAGTAGTTGTGA","CTAATACGTCACGTCCTGCA","561307.5.peg.1120"," 137"
"1406",123,386,263,"GCTGAAATCCATAAACCAAT","CTAATACGTCACGTCCTGCA","561307.5.peg.1120"," 137"
"1407",493,386,107,"TCTAACTGTGATACGAGCTT","CTAATACGTCACGTCCTGCA","561307.5.peg.1120"," 137"
"1408",29,450,421,"GGAACAAGAGTAGTTGTGA","ATTGCTACACCTGCGATAAA","561307.5.peg.1120"," 137"
"1409",123,450,327,"GCTGAAATCCATAAACCAAT","ATTGCTACACCTGCGATAAA","561307.5.peg.1120"," 137"
"1410",29,493,464,"GGAACAAGAGTAGTTGTGA","TCTAACTGTGATACGAGCTT","561307.5.peg.1120"," 137"
"1411",386,493,107,"CTAATACGTCACGTCCTGCA","TCTAACTGTGATACGAGCTT","561307.5.peg.1120"," 137"
"1412",123,493,370,"GCTGAAATCCATAAACCAAT","TCTAACTGTGATACGAGCTT","561307.5.peg.1120"," 137"
"1413",288,8,280,"GGAAGTTCATCGAATAAAGG","CACCTGAACATTAAGTCGAG","561307.5.peg.1121"," 138"
"1414",309,8,301,"TTCGATTTAGGCTCTTCCTT","CACCTGAACATTAAGTCGAG","561307.5.peg.1121"," 138"
"1415",321,8,313,"TCTACAACAGGTTTCGATTT","CACCTGAACATTAAGTCGAG","561307.5.peg.1121"," 138"
"1416",333,8,325,"GGTGCCATAGGTTCTACAAC","CACCTGAACATTAAGTCGAG","561307.5.peg.1121"," 138"
"1417",8,288,280,"CACCTGAACATTAAGTCGAG","GGAAGTTCATCGAATAAAGG","561307.5.peg.1121"," 138"
"1418",8,309,301,"CACCTGAACATTAAGTCGAG","TTCGATTTAGGCTCTTCCTT","561307.5.peg.1121"," 138"
"1419",8,321,313,"CACCTGAACATTAAGTCGAG","TCTACAACAGGTTTCGATTT","561307.5.peg.1121"," 138"
"1420",8,333,325,"CACCTGAACATTAAGTCGAG","GGTGCCATAGGTTCTACAAC","561307.5.peg.1121"," 138"
"1421",155,54,101,"CAACTTCTTGTCCTCTTGCA","CGTCTATTTGTATAATTCC","561307.5.peg.1122"," 139"
"1422",54,155,101,"CGTCTATTTGTATAATTCC","CAACTTCTTGTCCTCTTGCA","561307.5.peg.1122"," 139"
"1423",249,26,223,"AGTCACCTAATTTGTGTTT","GTCGCAGAGTTACTACCATT","561307.5.peg.1126"," 143"
"1424",334,26,308,"GCCTCGTCCAATTTCCTCAT","GTCGCAGAGTTACTACCATT","561307.5.peg.1126"," 143"
"1425",249,93,156,"AGTCACCTAATTTGTGTTT","ATGTTGACTTTCCTACATT","561307.5.peg.1126"," 143"
"1426",334,93,241,"GCCTCGTCCAATTTCCTCAT","ATGTTGACTTTCCTACATT","561307.5.peg.1126"," 143"
"1427",26,249,223,"GTCGCAGAGTTACTACCATT","AGTCACCTAATTTGTGTTT","561307.5.peg.1126"," 143"
"1428",93,249,156,"ATGTTGACTTTCCTACATT","AGTCACCTAATTTGTGTTT","561307.5.peg.1126"," 143"
"1429",26,334,308,"GTCGCAGAGTTACTACCATT","GCCTCGTCCAATTTCCTCAT","561307.5.peg.1126"," 143"
"1430",93,334,241,"ATGTTGACTTTCCTACATT","GCCTCGTCCAATTTCCTCAT","561307.5.peg.1126"," 143"
"1431",296,141,155,"CGGCATAACTGCTTACGTAA","TTAGCACGTCTTGCCATAAG","561307.5.peg.1127"," 144"
"1432",141,296,155,"TTAGCACGTCTTGCCATAAG","CGGCATAACTGCTTACGTAA","561307.5.peg.1127"," 144"
"1433",222,107,115,"GCATCGATACCAACGTTAAA","CACCGTAAATATCACTACCA","561307.5.peg.1128"," 145"
"1434",107,222,115,"CACCGTAAATATCACTACCA","GCATCGATACCAACGTTAAA","561307.5.peg.1128"," 145"
"1435",123,21,102,"GAATAATAATATCCAACTCG","GCTATTTGTTCACCAGTAAT","561307.5.peg.1129"," 146"
"1436",216,21,195,"GTATTCTCTCTTAGCACAAC","GCTATTTGTTCACCAGTAAT","561307.5.peg.1129"," 146"
"1437",21,123,102,"GCTATTTGTTCACCAGTAAT","GAATAATAATATCCAACTCG","561307.5.peg.1129"," 146"
"1438",21,216,195,"GCTATTTGTTCACCAGTAAT","GTATTCTCTCTTAGCACAAC","561307.5.peg.1129"," 146"
"1439",341,44,297,"CTTTAAGGTACATACGAACT","CTGTGTTATCAGACATGAAA","561307.5.peg.1132"," 150"
"1440",300,44,256,"GGAGGGGCACTAAGATCACT","CTGTGTTATCAGACATGAAA","561307.5.peg.1132"," 150"
"1441",533,44,489,"TAAGACCCATATTACCTTCT","CTGTGTTATCAGACATGAAA","561307.5.peg.1132"," 150"
"1442",300,93,207,"GGAGGGGCACTAAGATCACT","CATCTTCTAATGTTAATGT","561307.5.peg.1132"," 150"
"1443",533,93,440,"TAAGACCCATATTACCTTCT","CATCTTCTAATGTTAATGT","561307.5.peg.1132"," 150"
"1444",341,93,248,"CTTTAAGGTACATACGAACT","CATCTTCTAATGTTAATGT","561307.5.peg.1132"," 150"
"1445",44,300,256,"CTGTGTTATCAGACATGAAA","GGAGGGGCACTAAGATCACT","561307.5.peg.1132"," 150"
"1446",533,300,233,"TAAGACCCATATTACCTTCT","GGAGGGGCACTAAGATCACT","561307.5.peg.1132"," 150"
"1447",93,300,207,"CATCTTCTAATGTTAATGT","GGAGGGGCACTAAGATCACT","561307.5.peg.1132"," 150"
"1448",44,341,297,"CTGTGTTATCAGACATGAAA","CTTTAAGGTACATACGAACT","561307.5.peg.1132"," 150"
"1449",533,341,192,"TAAGACCCATATTACCTTCT","CTTTAAGGTACATACGAACT","561307.5.peg.1132"," 150"
"1450",93,341,248,"CATCTTCTAATGTTAATGT","CTTTAAGGTACATACGAACT","561307.5.peg.1132"," 150"
"1451",44,533,489,"CTGTGTTATCAGACATGAAA","TAAGACCCATATTACCTTCT","561307.5.peg.1132"," 150"
"1452",93,533,440,"CATCTTCTAATGTTAATGT","TAAGACCCATATTACCTTCT","561307.5.peg.1132"," 150"
"1453",300,533,233,"GGAGGGGCACTAAGATCACT","TAAGACCCATATTACCTTCT","561307.5.peg.1132"," 150"
"1454",341,533,192,"CTTTAAGGTACATACGAACT","TAAGACCCATATTACCTTCT","561307.5.peg.1132"," 150"
"1455",294,68,226,"ATATTATCGATTACGTCCTC","ATCGACTTACCGTCGTTAAT","561307.5.peg.1133"," 151"
"1456",68,294,226,"ATCGACTTACCGTCGTTAAT","ATATTATCGATTACGTCCTC","561307.5.peg.1133"," 151"
"1457",246,11,235,"GTTACGCCTTTAAAGATTAG","CGAAATTGCTGTAATTGAAA","561307.5.peg.1134"," 152"
"1458",465,11,454,"AATGGTCCAACATTATCCTT","CGAAATTGCTGTAATTGAAA","561307.5.peg.1134"," 152"
"1459",246,93,153,"GTTACGCCTTTAAAGATTAG","CAAGATTCAGCAGTACTAAA","561307.5.peg.1134"," 152"
"1460",465,93,372,"AATGGTCCAACATTATCCTT","CAAGATTCAGCAGTACTAAA","561307.5.peg.1134"," 152"
"1461",11,246,235,"CGAAATTGCTGTAATTGAAA","GTTACGCCTTTAAAGATTAG","561307.5.peg.1134"," 152"
"1462",465,246,219,"AATGGTCCAACATTATCCTT","GTTACGCCTTTAAAGATTAG","561307.5.peg.1134"," 152"
"1463",93,246,153,"CAAGATTCAGCAGTACTAAA","GTTACGCCTTTAAAGATTAG","561307.5.peg.1134"," 152"
"1464",93,465,372,"CAAGATTCAGCAGTACTAAA","AATGGTCCAACATTATCCTT","561307.5.peg.1134"," 152"
"1465",11,465,454,"CGAAATTGCTGTAATTGAAA","AATGGTCCAACATTATCCTT","561307.5.peg.1134"," 152"
"1466",246,465,219,"GTTACGCCTTTAAAGATTAG","AATGGTCCAACATTATCCTT","561307.5.peg.1134"," 152"
"1467",267,129,138,"GGTGCAACTACGATTGCTTG","TTCGATTCTGAATTTCAGT","561307.5.peg.1135"," 153"
"1468",288,129,159,"TGTTGTGCAAGTTCTCTTGT","TTCGATTCTGAATTTCAGT","561307.5.peg.1135"," 153"
"1469",657,129,528,"CTGTCGACAGCTACATATTC","TTCGATTCTGAATTTCAGT","561307.5.peg.1135"," 153"
"1470",439,129,310,"AAGTCATTAATTCTAGTAG","TTCGATTCTGAATTTCAGT","561307.5.peg.1135"," 153"
"1471",338,129,209,"CTGAAACACCAGCTTTAAAT","TTCGATTCTGAATTTCAGT","561307.5.peg.1135"," 153"
"1472",657,267,390,"CTGTCGACAGCTACATATTC","GGTGCAACTACGATTGCTTG","561307.5.peg.1135"," 153"
"1473",439,267,172,"AAGTCATTAATTCTAGTAG","GGTGCAACTACGATTGCTTG","561307.5.peg.1135"," 153"
"1474",129,267,138,"TTCGATTCTGAATTTCAGT","GGTGCAACTACGATTGCTTG","561307.5.peg.1135"," 153"
"1475",657,288,369,"CTGTCGACAGCTACATATTC","TGTTGTGCAAGTTCTCTTGT","561307.5.peg.1135"," 153"
"1476",129,288,159,"TTCGATTCTGAATTTCAGT","TGTTGTGCAAGTTCTCTTGT","561307.5.peg.1135"," 153"
"1477",439,288,151,"AAGTCATTAATTCTAGTAG","TGTTGTGCAAGTTCTCTTGT","561307.5.peg.1135"," 153"
"1478",129,338,209,"TTCGATTCTGAATTTCAGT","CTGAAACACCAGCTTTAAAT","561307.5.peg.1135"," 153"
"1479",439,338,101,"AAGTCATTAATTCTAGTAG","CTGAAACACCAGCTTTAAAT","561307.5.peg.1135"," 153"
"1480",657,338,319,"CTGTCGACAGCTACATATTC","CTGAAACACCAGCTTTAAAT","561307.5.peg.1135"," 153"
"1481",338,439,101,"CTGAAACACCAGCTTTAAAT","AAGTCATTAATTCTAGTAG","561307.5.peg.1135"," 153"
"1482",129,439,310,"TTCGATTCTGAATTTCAGT","AAGTCATTAATTCTAGTAG","561307.5.peg.1135"," 153"
"1483",267,439,172,"GGTGCAACTACGATTGCTTG","AAGTCATTAATTCTAGTAG","561307.5.peg.1135"," 153"
"1484",657,439,218,"CTGTCGACAGCTACATATTC","AAGTCATTAATTCTAGTAG","561307.5.peg.1135"," 153"
"1485",288,439,151,"TGTTGTGCAAGTTCTCTTGT","AAGTCATTAATTCTAGTAG","561307.5.peg.1135"," 153"
"1486",129,657,528,"TTCGATTCTGAATTTCAGT","CTGTCGACAGCTACATATTC","561307.5.peg.1135"," 153"
"1487",338,657,319,"CTGAAACACCAGCTTTAAAT","CTGTCGACAGCTACATATTC","561307.5.peg.1135"," 153"
"1488",288,657,369,"TGTTGTGCAAGTTCTCTTGT","CTGTCGACAGCTACATATTC","561307.5.peg.1135"," 153"
"1489",439,657,218,"AAGTCATTAATTCTAGTAG","CTGTCGACAGCTACATATTC","561307.5.peg.1135"," 153"
"1490",267,657,390,"GGTGCAACTACGATTGCTTG","CTGTCGACAGCTACATATTC","561307.5.peg.1135"," 153"
"1491",376,258,118,"TGAAATGAAGATTGCACTCA","ATAAGATTCCAAACCACAT","561307.5.peg.1138"," 156"
"1492",258,376,118,"ATAAGATTCCAAACCACAT","TGAAATGAAGATTGCACTCA","561307.5.peg.1138"," 156"
"1493",240,75,165,"ACAGCAGTTTGGATGTTAGC","TCTAATGCATCAAATGCGTA","561307.5.peg.1140"," 159"
"1494",251,75,176,"CATTATTACGTACAGCAGTT","TCTAATGCATCAAATGCGTA","561307.5.peg.1140"," 159"
"1495",75,240,165,"TCTAATGCATCAAATGCGTA","ACAGCAGTTTGGATGTTAGC","561307.5.peg.1140"," 159"
"1496",75,251,176,"TCTAATGCATCAAATGCGTA","CATTATTACGTACAGCAGTT","561307.5.peg.1140"," 159"
"1497",708,6,702,"TCCATAGACGTGTTAACACC","GAAAGACTTTGAATAGAGGT","561307.5.peg.1141"," 160"
"1498",747,6,741,"CCTCTTAAAGTATCGCCATA","GAAAGACTTTGAATAGAGGT","561307.5.peg.1141"," 160"
"1499",700,6,694,"CGTGTTAACACCTGGTAATT","GAAAGACTTTGAATAGAGGT","561307.5.peg.1141"," 160"
"1500",975,6,969,"AAATCTTGACCGCGAGCGCC","GAAAGACTTTGAATAGAGGT","561307.5.peg.1141"," 160"
"1501",747,10,737,"CCTCTTAAAGTATCGCCATA","AGTGAAAGACTTTGAATAG","561307.5.peg.1141"," 160"
"1502",700,10,690,"CGTGTTAACACCTGGTAATT","AGTGAAAGACTTTGAATAG","561307.5.peg.1141"," 160"
"1503",975,10,965,"AAATCTTGACCGCGAGCGCC","AGTGAAAGACTTTGAATAG","561307.5.peg.1141"," 160"
"1504",708,10,698,"TCCATAGACGTGTTAACACC","AGTGAAAGACTTTGAATAG","561307.5.peg.1141"," 160"
"1505",10,700,690,"AGTGAAAGACTTTGAATAG","CGTGTTAACACCTGGTAATT","561307.5.peg.1141"," 160"
"1506",6,700,694,"GAAAGACTTTGAATAGAGGT","CGTGTTAACACCTGGTAATT","561307.5.peg.1141"," 160"
"1507",975,700,275,"AAATCTTGACCGCGAGCGCC","CGTGTTAACACCTGGTAATT","561307.5.peg.1141"," 160"
"1508",10,708,698,"AGTGAAAGACTTTGAATAG","TCCATAGACGTGTTAACACC","561307.5.peg.1141"," 160"
"1509",6,708,702,"GAAAGACTTTGAATAGAGGT","TCCATAGACGTGTTAACACC","561307.5.peg.1141"," 160"
"1510",975,708,267,"AAATCTTGACCGCGAGCGCC","TCCATAGACGTGTTAACACC","561307.5.peg.1141"," 160"
"1511",6,747,741,"GAAAGACTTTGAATAGAGGT","CCTCTTAAAGTATCGCCATA","561307.5.peg.1141"," 160"
"1512",10,747,737,"AGTGAAAGACTTTGAATAG","CCTCTTAAAGTATCGCCATA","561307.5.peg.1141"," 160"
"1513",975,747,228,"AAATCTTGACCGCGAGCGCC","CCTCTTAAAGTATCGCCATA","561307.5.peg.1141"," 160"
"1514",6,975,969,"GAAAGACTTTGAATAGAGGT","AAATCTTGACCGCGAGCGCC","561307.5.peg.1141"," 160"
"1515",10,975,965,"AGTGAAAGACTTTGAATAG","AAATCTTGACCGCGAGCGCC","561307.5.peg.1141"," 160"
"1516",747,975,228,"CCTCTTAAAGTATCGCCATA","AAATCTTGACCGCGAGCGCC","561307.5.peg.1141"," 160"
"1517",700,975,275,"CGTGTTAACACCTGGTAATT","AAATCTTGACCGCGAGCGCC","561307.5.peg.1141"," 160"
"1518",708,975,267,"TCCATAGACGTGTTAACACC","AAATCTTGACCGCGAGCGCC","561307.5.peg.1141"," 160"
"1519",522,6,516,"ATATTATTGTGTATGTTGC","TATATCAAGCAGCATAGTGG","561307.5.peg.1144"," 163"
"1520",522,9,513,"ATATTATTGTGTATGTTGC","TATATATCAAGCAGCATAG","561307.5.peg.1144"," 163"
"1521",6,522,516,"TATATCAAGCAGCATAGTGG","ATATTATTGTGTATGTTGC","561307.5.peg.1144"," 163"
"1522",9,522,513,"TATATATCAAGCAGCATAG","ATATTATTGTGTATGTTGC","561307.5.peg.1144"," 163"
"1523",266,48,218,"CTGCTTCATGCATATAAACC","GTTAAGCTTGAAATCCTCAT","561307.5.peg.1147"," 166"
"1524",48,266,218,"GTTAAGCTTGAAATCCTCAT","CTGCTTCATGCATATAAACC","561307.5.peg.1147"," 166"
"1525",324,11,313,"CTTTCTTGGCCAAGTGACAA","CCTCCTACGTGATTATATGT","561307.5.peg.1148"," 167"
"1526",338,11,327,"TCTGATAACACAACTTTCT","CCTCCTACGTGATTATATGT","561307.5.peg.1148"," 167"
"1527",459,11,448,"GTACTCTTTCCTGAACCAGT","CCTCCTACGTGATTATATGT","561307.5.peg.1148"," 167"
"1528",419,11,408,"TCCTTGTTTCTTATTCATG","CCTCCTACGTGATTATATGT","561307.5.peg.1148"," 167"
"1529",324,18,306,"CTTTCTTGGCCAAGTGACAA","CCTACATATAATCACGTAGG","561307.5.peg.1148"," 167"
"1530",419,18,401,"TCCTTGTTTCTTATTCATG","CCTACATATAATCACGTAGG","561307.5.peg.1148"," 167"
"1531",338,18,320,"TCTGATAACACAACTTTCT","CCTACATATAATCACGTAGG","561307.5.peg.1148"," 167"
"1532",459,18,441,"GTACTCTTTCCTGAACCAGT","CCTACATATAATCACGTAGG","561307.5.peg.1148"," 167"
"1533",324,21,303,"CTTTCTTGGCCAAGTGACAA","CCTCCTACATATAATCACGT","561307.5.peg.1148"," 167"
"1534",459,21,438,"GTACTCTTTCCTGAACCAGT","CCTCCTACATATAATCACGT","561307.5.peg.1148"," 167"
"1535",419,21,398,"TCCTTGTTTCTTATTCATG","CCTCCTACATATAATCACGT","561307.5.peg.1148"," 167"
"1536",338,21,317,"TCTGATAACACAACTTTCT","CCTCCTACATATAATCACGT","561307.5.peg.1148"," 167"
"1537",11,324,313,"CCTCCTACGTGATTATATGT","CTTTCTTGGCCAAGTGACAA","561307.5.peg.1148"," 167"
"1538",459,324,135,"GTACTCTTTCCTGAACCAGT","CTTTCTTGGCCAAGTGACAA","561307.5.peg.1148"," 167"
"1539",18,324,306,"CCTACATATAATCACGTAGG","CTTTCTTGGCCAAGTGACAA","561307.5.peg.1148"," 167"
"1540",21,324,303,"CCTCCTACATATAATCACGT","CTTTCTTGGCCAAGTGACAA","561307.5.peg.1148"," 167"
"1541",11,338,327,"CCTCCTACGTGATTATATGT","TCTGATAACACAACTTTCT","561307.5.peg.1148"," 167"
"1542",459,338,121,"GTACTCTTTCCTGAACCAGT","TCTGATAACACAACTTTCT","561307.5.peg.1148"," 167"
"1543",18,338,320,"CCTACATATAATCACGTAGG","TCTGATAACACAACTTTCT","561307.5.peg.1148"," 167"
"1544",21,338,317,"CCTCCTACATATAATCACGT","TCTGATAACACAACTTTCT","561307.5.peg.1148"," 167"
"1545",11,419,408,"CCTCCTACGTGATTATATGT","TCCTTGTTTCTTATTCATG","561307.5.peg.1148"," 167"
"1546",21,419,398,"CCTCCTACATATAATCACGT","TCCTTGTTTCTTATTCATG","561307.5.peg.1148"," 167"
"1547",18,419,401,"CCTACATATAATCACGTAGG","TCCTTGTTTCTTATTCATG","561307.5.peg.1148"," 167"
"1548",11,459,448,"CCTCCTACGTGATTATATGT","GTACTCTTTCCTGAACCAGT","561307.5.peg.1148"," 167"
"1549",324,459,135,"CTTTCTTGGCCAAGTGACAA","GTACTCTTTCCTGAACCAGT","561307.5.peg.1148"," 167"
"1550",21,459,438,"CCTCCTACATATAATCACGT","GTACTCTTTCCTGAACCAGT","561307.5.peg.1148"," 167"
"1551",18,459,441,"CCTACATATAATCACGTAGG","GTACTCTTTCCTGAACCAGT","561307.5.peg.1148"," 167"
"1552",338,459,121,"TCTGATAACACAACTTTCT","GTACTCTTTCCTGAACCAGT","561307.5.peg.1148"," 167"
"1553",275,79,196,"GATAGAAACTAGTATTAAG","GAAATTTCACTTAGAATGG","561307.5.peg.1149"," 168"
"1554",323,79,244,"GAAACTGTGGAATTACTGTG","GAAATTTCACTTAGAATGG","561307.5.peg.1149"," 168"
"1555",412,79,333,"ACAATTATAGTAGGTAAGC","GAAATTTCACTTAGAATGG","561307.5.peg.1149"," 168"
"1556",79,275,196,"GAAATTTCACTTAGAATGG","GATAGAAACTAGTATTAAG","561307.5.peg.1149"," 168"
"1557",412,275,137,"ACAATTATAGTAGGTAAGC","GATAGAAACTAGTATTAAG","561307.5.peg.1149"," 168"
"1558",79,323,244,"GAAATTTCACTTAGAATGG","GAAACTGTGGAATTACTGTG","561307.5.peg.1149"," 168"
"1559",79,412,333,"GAAATTTCACTTAGAATGG","ACAATTATAGTAGGTAAGC","561307.5.peg.1149"," 168"
"1560",275,412,137,"GATAGAAACTAGTATTAAG","ACAATTATAGTAGGTAAGC","561307.5.peg.1149"," 168"
"1561",314,197,117,"CTAATAAAGCCTCAGCATTA","CAACTTAGATAATTGTGCA","561307.5.peg.115"," 169"
"1562",644,197,447,"GTTCATTCAAGGCAGCTATA","CAACTTAGATAATTGTGCA","561307.5.peg.115"," 169"
"1563",585,197,388,"ACTTCATATTGCTCTAACCT","CAACTTAGATAATTGTGCA","561307.5.peg.115"," 169"
"1564",869,197,672,"TAGCTTCTTCTAATTCTAAG","CAACTTAGATAATTGTGCA","561307.5.peg.115"," 169"
"1565",858,197,661,"ATTCTAAGCGGCTAATTAA","CAACTTAGATAATTGTGCA","561307.5.peg.115"," 169"
"1566",735,197,538,"TTAAATCTTGGAATTGACC","CAACTTAGATAATTGTGCA","561307.5.peg.115"," 169"
"1567",767,197,570,"ACCCTTCAACTTTAAGATCA","CAACTTAGATAATTGTGCA","561307.5.peg.115"," 169"
"1568",644,314,330,"GTTCATTCAAGGCAGCTATA","CTAATAAAGCCTCAGCATTA","561307.5.peg.115"," 169"
"1569",869,314,555,"TAGCTTCTTCTAATTCTAAG","CTAATAAAGCCTCAGCATTA","561307.5.peg.115"," 169"
"1570",197,314,117,"CAACTTAGATAATTGTGCA","CTAATAAAGCCTCAGCATTA","561307.5.peg.115"," 169"
"1571",767,314,453,"ACCCTTCAACTTTAAGATCA","CTAATAAAGCCTCAGCATTA","561307.5.peg.115"," 169"
"1572",858,314,544,"ATTCTAAGCGGCTAATTAA","CTAATAAAGCCTCAGCATTA","561307.5.peg.115"," 169"
"1573",585,314,271,"ACTTCATATTGCTCTAACCT","CTAATAAAGCCTCAGCATTA","561307.5.peg.115"," 169"
"1574",735,314,421,"TTAAATCTTGGAATTGACC","CTAATAAAGCCTCAGCATTA","561307.5.peg.115"," 169"
"1575",197,585,388,"CAACTTAGATAATTGTGCA","ACTTCATATTGCTCTAACCT","561307.5.peg.115"," 169"
"1576",314,585,271,"CTAATAAAGCCTCAGCATTA","ACTTCATATTGCTCTAACCT","561307.5.peg.115"," 169"
"1577",735,585,150,"TTAAATCTTGGAATTGACC","ACTTCATATTGCTCTAACCT","561307.5.peg.115"," 169"
"1578",767,585,182,"ACCCTTCAACTTTAAGATCA","ACTTCATATTGCTCTAACCT","561307.5.peg.115"," 169"
"1579",869,585,284,"TAGCTTCTTCTAATTCTAAG","ACTTCATATTGCTCTAACCT","561307.5.peg.115"," 169"
"1580",858,585,273,"ATTCTAAGCGGCTAATTAA","ACTTCATATTGCTCTAACCT","561307.5.peg.115"," 169"
"1581",767,644,123,"ACCCTTCAACTTTAAGATCA","GTTCATTCAAGGCAGCTATA","561307.5.peg.115"," 169"
"1582",314,644,330,"CTAATAAAGCCTCAGCATTA","GTTCATTCAAGGCAGCTATA","561307.5.peg.115"," 169"
"1583",858,644,214,"ATTCTAAGCGGCTAATTAA","GTTCATTCAAGGCAGCTATA","561307.5.peg.115"," 169"
"1584",197,644,447,"CAACTTAGATAATTGTGCA","GTTCATTCAAGGCAGCTATA","561307.5.peg.115"," 169"
"1585",869,644,225,"TAGCTTCTTCTAATTCTAAG","GTTCATTCAAGGCAGCTATA","561307.5.peg.115"," 169"
"1586",585,735,150,"ACTTCATATTGCTCTAACCT","TTAAATCTTGGAATTGACC","561307.5.peg.115"," 169"
"1587",869,735,134,"TAGCTTCTTCTAATTCTAAG","TTAAATCTTGGAATTGACC","561307.5.peg.115"," 169"
"1588",197,735,538,"CAACTTAGATAATTGTGCA","TTAAATCTTGGAATTGACC","561307.5.peg.115"," 169"
"1589",314,735,421,"CTAATAAAGCCTCAGCATTA","TTAAATCTTGGAATTGACC","561307.5.peg.115"," 169"
"1590",858,735,123,"ATTCTAAGCGGCTAATTAA","TTAAATCTTGGAATTGACC","561307.5.peg.115"," 169"
"1591",644,767,123,"GTTCATTCAAGGCAGCTATA","ACCCTTCAACTTTAAGATCA","561307.5.peg.115"," 169"
"1592",869,767,102,"TAGCTTCTTCTAATTCTAAG","ACCCTTCAACTTTAAGATCA","561307.5.peg.115"," 169"
"1593",197,767,570,"CAACTTAGATAATTGTGCA","ACCCTTCAACTTTAAGATCA","561307.5.peg.115"," 169"
"1594",314,767,453,"CTAATAAAGCCTCAGCATTA","ACCCTTCAACTTTAAGATCA","561307.5.peg.115"," 169"
"1595",585,767,182,"ACTTCATATTGCTCTAACCT","ACCCTTCAACTTTAAGATCA","561307.5.peg.115"," 169"
"1596",735,858,123,"TTAAATCTTGGAATTGACC","ATTCTAAGCGGCTAATTAA","561307.5.peg.115"," 169"
"1597",197,858,661,"CAACTTAGATAATTGTGCA","ATTCTAAGCGGCTAATTAA","561307.5.peg.115"," 169"
"1598",314,858,544,"CTAATAAAGCCTCAGCATTA","ATTCTAAGCGGCTAATTAA","561307.5.peg.115"," 169"
"1599",585,858,273,"ACTTCATATTGCTCTAACCT","ATTCTAAGCGGCTAATTAA","561307.5.peg.115"," 169"
"1600",644,858,214,"GTTCATTCAAGGCAGCTATA","ATTCTAAGCGGCTAATTAA","561307.5.peg.115"," 169"
"1601",644,869,225,"GTTCATTCAAGGCAGCTATA","TAGCTTCTTCTAATTCTAAG","561307.5.peg.115"," 169"
"1602",197,869,672,"CAACTTAGATAATTGTGCA","TAGCTTCTTCTAATTCTAAG","561307.5.peg.115"," 169"
"1603",314,869,555,"CTAATAAAGCCTCAGCATTA","TAGCTTCTTCTAATTCTAAG","561307.5.peg.115"," 169"
"1604",585,869,284,"ACTTCATATTGCTCTAACCT","TAGCTTCTTCTAATTCTAAG","561307.5.peg.115"," 169"
"1605",767,869,102,"ACCCTTCAACTTTAAGATCA","TAGCTTCTTCTAATTCTAAG","561307.5.peg.115"," 169"
"1606",735,869,134,"TTAAATCTTGGAATTGACC","TAGCTTCTTCTAATTCTAAG","561307.5.peg.115"," 169"
"1607",336,195,141,"GGATGTGATTCACTAAATCC","AAGTCTAGTTCAGCAACTTC","561307.5.peg.1157"," 177"
"1608",579,195,384,"CCTGCAAATGAAGCTGAGGC","AAGTCTAGTTCAGCAACTTC","561307.5.peg.1157"," 177"
"1609",758,195,563,"ATAATAGACCACCAGCATTA","AAGTCTAGTTCAGCAACTTC","561307.5.peg.1157"," 177"
"1610",459,195,264,"TCACCATGTGCGCCAGCAGC","AAGTCTAGTTCAGCAACTTC","561307.5.peg.1157"," 177"
"1611",512,195,317,"GACCTTCACCATTATTCTCA","AAGTCTAGTTCAGCAACTTC","561307.5.peg.1157"," 177"
"1612",746,195,551,"CAGCATTATGGACGATTTCA","AAGTCTAGTTCAGCAACTTC","561307.5.peg.1157"," 177"
"1613",555,195,360,"TTCGTACCATGCGCAGAATC","AAGTCTAGTTCAGCAACTTC","561307.5.peg.1157"," 177"
"1614",583,195,388,"AAATCCTGCAAATGAAGCTG","AAGTCTAGTTCAGCAACTTC","561307.5.peg.1157"," 177"
"1615",579,276,303,"CCTGCAAATGAAGCTGAGGC","TTCATCGTACATGAACCCAA","561307.5.peg.1157"," 177"
"1616",758,276,482,"ATAATAGACCACCAGCATTA","TTCATCGTACATGAACCCAA","561307.5.peg.1157"," 177"
"1617",555,276,279,"TTCGTACCATGCGCAGAATC","TTCATCGTACATGAACCCAA","561307.5.peg.1157"," 177"
"1618",583,276,307,"AAATCCTGCAAATGAAGCTG","TTCATCGTACATGAACCCAA","561307.5.peg.1157"," 177"
"1619",512,276,236,"GACCTTCACCATTATTCTCA","TTCATCGTACATGAACCCAA","561307.5.peg.1157"," 177"
"1620",459,276,183,"TCACCATGTGCGCCAGCAGC","TTCATCGTACATGAACCCAA","561307.5.peg.1157"," 177"
"1621",746,276,470,"CAGCATTATGGACGATTTCA","TTCATCGTACATGAACCCAA","561307.5.peg.1157"," 177"
"1622",583,336,247,"AAATCCTGCAAATGAAGCTG","GGATGTGATTCACTAAATCC","561307.5.peg.1157"," 177"
"1623",579,336,243,"CCTGCAAATGAAGCTGAGGC","GGATGTGATTCACTAAATCC","561307.5.peg.1157"," 177"
"1624",459,336,123,"TCACCATGTGCGCCAGCAGC","GGATGTGATTCACTAAATCC","561307.5.peg.1157"," 177"
"1625",195,336,141,"AAGTCTAGTTCAGCAACTTC","GGATGTGATTCACTAAATCC","561307.5.peg.1157"," 177"
"1626",758,336,422,"ATAATAGACCACCAGCATTA","GGATGTGATTCACTAAATCC","561307.5.peg.1157"," 177"
"1627",746,336,410,"CAGCATTATGGACGATTTCA","GGATGTGATTCACTAAATCC","561307.5.peg.1157"," 177"
"1628",555,336,219,"TTCGTACCATGCGCAGAATC","GGATGTGATTCACTAAATCC","561307.5.peg.1157"," 177"
"1629",512,336,176,"GACCTTCACCATTATTCTCA","GGATGTGATTCACTAAATCC","561307.5.peg.1157"," 177"
"1630",195,459,264,"AAGTCTAGTTCAGCAACTTC","TCACCATGTGCGCCAGCAGC","561307.5.peg.1157"," 177"
"1631",758,459,299,"ATAATAGACCACCAGCATTA","TCACCATGTGCGCCAGCAGC","561307.5.peg.1157"," 177"
"1632",336,459,123,"GGATGTGATTCACTAAATCC","TCACCATGTGCGCCAGCAGC","561307.5.peg.1157"," 177"
"1633",579,459,120,"CCTGCAAATGAAGCTGAGGC","TCACCATGTGCGCCAGCAGC","561307.5.peg.1157"," 177"
"1634",746,459,287,"CAGCATTATGGACGATTTCA","TCACCATGTGCGCCAGCAGC","561307.5.peg.1157"," 177"
"1635",276,459,183,"TTCATCGTACATGAACCCAA","TCACCATGTGCGCCAGCAGC","561307.5.peg.1157"," 177"
"1636",583,459,124,"AAATCCTGCAAATGAAGCTG","TCACCATGTGCGCCAGCAGC","561307.5.peg.1157"," 177"
"1637",195,512,317,"AAGTCTAGTTCAGCAACTTC","GACCTTCACCATTATTCTCA","561307.5.peg.1157"," 177"
"1638",746,512,234,"CAGCATTATGGACGATTTCA","GACCTTCACCATTATTCTCA","561307.5.peg.1157"," 177"
"1639",758,512,246,"ATAATAGACCACCAGCATTA","GACCTTCACCATTATTCTCA","561307.5.peg.1157"," 177"
"1640",336,512,176,"GGATGTGATTCACTAAATCC","GACCTTCACCATTATTCTCA","561307.5.peg.1157"," 177"
"1641",276,512,236,"TTCATCGTACATGAACCCAA","GACCTTCACCATTATTCTCA","561307.5.peg.1157"," 177"
"1642",336,555,219,"GGATGTGATTCACTAAATCC","TTCGTACCATGCGCAGAATC","561307.5.peg.1157"," 177"
"1643",276,555,279,"TTCATCGTACATGAACCCAA","TTCGTACCATGCGCAGAATC","561307.5.peg.1157"," 177"
"1644",746,555,191,"CAGCATTATGGACGATTTCA","TTCGTACCATGCGCAGAATC","561307.5.peg.1157"," 177"
"1645",195,555,360,"AAGTCTAGTTCAGCAACTTC","TTCGTACCATGCGCAGAATC","561307.5.peg.1157"," 177"
"1646",758,555,203,"ATAATAGACCACCAGCATTA","TTCGTACCATGCGCAGAATC","561307.5.peg.1157"," 177"
"1647",195,579,384,"AAGTCTAGTTCAGCAACTTC","CCTGCAAATGAAGCTGAGGC","561307.5.peg.1157"," 177"
"1648",746,579,167,"CAGCATTATGGACGATTTCA","CCTGCAAATGAAGCTGAGGC","561307.5.peg.1157"," 177"
"1649",336,579,243,"GGATGTGATTCACTAAATCC","CCTGCAAATGAAGCTGAGGC","561307.5.peg.1157"," 177"
"1650",758,579,179,"ATAATAGACCACCAGCATTA","CCTGCAAATGAAGCTGAGGC","561307.5.peg.1157"," 177"
"1651",459,579,120,"TCACCATGTGCGCCAGCAGC","CCTGCAAATGAAGCTGAGGC","561307.5.peg.1157"," 177"
"1652",276,579,303,"TTCATCGTACATGAACCCAA","CCTGCAAATGAAGCTGAGGC","561307.5.peg.1157"," 177"
"1653",195,583,388,"AAGTCTAGTTCAGCAACTTC","AAATCCTGCAAATGAAGCTG","561307.5.peg.1157"," 177"
"1654",758,583,175,"ATAATAGACCACCAGCATTA","AAATCCTGCAAATGAAGCTG","561307.5.peg.1157"," 177"
"1655",276,583,307,"TTCATCGTACATGAACCCAA","AAATCCTGCAAATGAAGCTG","561307.5.peg.1157"," 177"
"1656",336,583,247,"GGATGTGATTCACTAAATCC","AAATCCTGCAAATGAAGCTG","561307.5.peg.1157"," 177"
"1657",746,583,163,"CAGCATTATGGACGATTTCA","AAATCCTGCAAATGAAGCTG","561307.5.peg.1157"," 177"
"1658",459,583,124,"TCACCATGTGCGCCAGCAGC","AAATCCTGCAAATGAAGCTG","561307.5.peg.1157"," 177"
"1659",555,746,191,"TTCGTACCATGCGCAGAATC","CAGCATTATGGACGATTTCA","561307.5.peg.1157"," 177"
"1660",276,746,470,"TTCATCGTACATGAACCCAA","CAGCATTATGGACGATTTCA","561307.5.peg.1157"," 177"
"1661",583,746,163,"AAATCCTGCAAATGAAGCTG","CAGCATTATGGACGATTTCA","561307.5.peg.1157"," 177"
"1662",336,746,410,"GGATGTGATTCACTAAATCC","CAGCATTATGGACGATTTCA","561307.5.peg.1157"," 177"
"1663",195,746,551,"AAGTCTAGTTCAGCAACTTC","CAGCATTATGGACGATTTCA","561307.5.peg.1157"," 177"
"1664",512,746,234,"GACCTTCACCATTATTCTCA","CAGCATTATGGACGATTTCA","561307.5.peg.1157"," 177"
"1665",459,746,287,"TCACCATGTGCGCCAGCAGC","CAGCATTATGGACGATTTCA","561307.5.peg.1157"," 177"
"1666",579,746,167,"CCTGCAAATGAAGCTGAGGC","CAGCATTATGGACGATTTCA","561307.5.peg.1157"," 177"
"1667",276,758,482,"TTCATCGTACATGAACCCAA","ATAATAGACCACCAGCATTA","561307.5.peg.1157"," 177"
"1668",336,758,422,"GGATGTGATTCACTAAATCC","ATAATAGACCACCAGCATTA","561307.5.peg.1157"," 177"
"1669",512,758,246,"GACCTTCACCATTATTCTCA","ATAATAGACCACCAGCATTA","561307.5.peg.1157"," 177"
"1670",459,758,299,"TCACCATGTGCGCCAGCAGC","ATAATAGACCACCAGCATTA","561307.5.peg.1157"," 177"
"1671",555,758,203,"TTCGTACCATGCGCAGAATC","ATAATAGACCACCAGCATTA","561307.5.peg.1157"," 177"
"1672",579,758,179,"CCTGCAAATGAAGCTGAGGC","ATAATAGACCACCAGCATTA","561307.5.peg.1157"," 177"
"1673",195,758,563,"AAGTCTAGTTCAGCAACTTC","ATAATAGACCACCAGCATTA","561307.5.peg.1157"," 177"
"1674",583,758,175,"AAATCCTGCAAATGAAGCTG","ATAATAGACCACCAGCATTA","561307.5.peg.1157"," 177"
"1675",287,183,104,"CTTTATCATGTAGCACCCCA","TACCCTATTGATAATGTTGC","561307.5.peg.1159"," 179"
"1676",333,183,150,"GGCATATTCGGATGCGATTC","TACCCTATTGATAATGTTGC","561307.5.peg.1159"," 179"
"1677",345,183,162,"GTAACTGTAGAAGGCATATT","TACCCTATTGATAATGTTGC","561307.5.peg.1159"," 179"
"1678",354,183,171,"TACGCTTCTGTAACTGTAGA","TACCCTATTGATAATGTTGC","561307.5.peg.1159"," 179"
"1679",183,287,104,"TACCCTATTGATAATGTTGC","CTTTATCATGTAGCACCCCA","561307.5.peg.1159"," 179"
"1680",183,333,150,"TACCCTATTGATAATGTTGC","GGCATATTCGGATGCGATTC","561307.5.peg.1159"," 179"
"1681",183,345,162,"TACCCTATTGATAATGTTGC","GTAACTGTAGAAGGCATATT","561307.5.peg.1159"," 179"
"1682",183,354,171,"TACCCTATTGATAATGTTGC","TACGCTTCTGTAACTGTAGA","561307.5.peg.1159"," 179"
"1683",157,8,149,"AGATATGATAAGTGCTCCAC","TGCACAAACGTTTCACTAGG","561307.5.peg.1162"," 183"
"1684",8,157,149,"TGCACAAACGTTTCACTAGG","AGATATGATAAGTGCTCCAC","561307.5.peg.1162"," 183"
"1685",204,8,196,"ATGAATCTTTAGACAAAGT","GTATGGCCAACCGTTATTTA","561307.5.peg.1165"," 186"
"1686",590,8,582,"GAGCTTCTTGTTCTGTCATT","GTATGGCCAACCGTTATTTA","561307.5.peg.1165"," 186"
"1687",237,8,229,"GTTGCAATAGATAAGATGTT","GTATGGCCAACCGTTATTTA","561307.5.peg.1165"," 186"
"1688",680,8,672,"CATAGCTGTCCCCAACAATT","GTATGGCCAACCGTTATTTA","561307.5.peg.1165"," 186"
"1689",507,8,499,"GCAGTAGCTTTAATGATGAC","GTATGGCCAACCGTTATTTA","561307.5.peg.1165"," 186"
"1690",441,8,433,"TTCATTAAACCGTCACTACC","GTATGGCCAACCGTTATTTA","561307.5.peg.1165"," 186"
"1691",432,8,424,"CCGTCACTACCAGGAACAAC","GTATGGCCAACCGTTATTTA","561307.5.peg.1165"," 186"
"1692",341,8,333,"TTGGTCCAATGAACTTCAAT","GTATGGCCAACCGTTATTTA","561307.5.peg.1165"," 186"
"1693",441,25,416,"TTCATTAAACCGTCACTACC","GACGGACAAATGGTAGAGTA","561307.5.peg.1165"," 186"
"1694",341,25,316,"TTGGTCCAATGAACTTCAAT","GACGGACAAATGGTAGAGTA","561307.5.peg.1165"," 186"
"1695",680,25,655,"CATAGCTGTCCCCAACAATT","GACGGACAAATGGTAGAGTA","561307.5.peg.1165"," 186"
"1696",237,25,212,"GTTGCAATAGATAAGATGTT","GACGGACAAATGGTAGAGTA","561307.5.peg.1165"," 186"
"1697",432,25,407,"CCGTCACTACCAGGAACAAC","GACGGACAAATGGTAGAGTA","561307.5.peg.1165"," 186"
"1698",590,25,565,"GAGCTTCTTGTTCTGTCATT","GACGGACAAATGGTAGAGTA","561307.5.peg.1165"," 186"
"1699",204,25,179,"ATGAATCTTTAGACAAAGT","GACGGACAAATGGTAGAGTA","561307.5.peg.1165"," 186"
"1700",507,25,482,"GCAGTAGCTTTAATGATGAC","GACGGACAAATGGTAGAGTA","561307.5.peg.1165"," 186"
"1701",507,27,480,"GCAGTAGCTTTAATGATGAC","TTTCACCTTAAATAACGGT","561307.5.peg.1165"," 186"
"1702",590,27,563,"GAGCTTCTTGTTCTGTCATT","TTTCACCTTAAATAACGGT","561307.5.peg.1165"," 186"
"1703",341,27,314,"TTGGTCCAATGAACTTCAAT","TTTCACCTTAAATAACGGT","561307.5.peg.1165"," 186"
"1704",680,27,653,"CATAGCTGTCCCCAACAATT","TTTCACCTTAAATAACGGT","561307.5.peg.1165"," 186"
"1705",204,27,177,"ATGAATCTTTAGACAAAGT","TTTCACCTTAAATAACGGT","561307.5.peg.1165"," 186"
"1706",432,27,405,"CCGTCACTACCAGGAACAAC","TTTCACCTTAAATAACGGT","561307.5.peg.1165"," 186"
"1707",441,27,414,"TTCATTAAACCGTCACTACC","TTTCACCTTAAATAACGGT","561307.5.peg.1165"," 186"
"1708",237,27,210,"GTTGCAATAGATAAGATGTT","TTTCACCTTAAATAACGGT","561307.5.peg.1165"," 186"
"1709",441,74,367,"TTCATTAAACCGTCACTACC","TCCTAACTGCGATTTCACCG","561307.5.peg.1165"," 186"
"1710",237,74,163,"GTTGCAATAGATAAGATGTT","TCCTAACTGCGATTTCACCG","561307.5.peg.1165"," 186"
"1711",432,74,358,"CCGTCACTACCAGGAACAAC","TCCTAACTGCGATTTCACCG","561307.5.peg.1165"," 186"
"1712",507,74,433,"GCAGTAGCTTTAATGATGAC","TCCTAACTGCGATTTCACCG","561307.5.peg.1165"," 186"
"1713",341,74,267,"TTGGTCCAATGAACTTCAAT","TCCTAACTGCGATTTCACCG","561307.5.peg.1165"," 186"
"1714",680,74,606,"CATAGCTGTCCCCAACAATT","TCCTAACTGCGATTTCACCG","561307.5.peg.1165"," 186"
"1715",590,74,516,"GAGCTTCTTGTTCTGTCATT","TCCTAACTGCGATTTCACCG","561307.5.peg.1165"," 186"
"1716",204,74,130,"ATGAATCTTTAGACAAAGT","TCCTAACTGCGATTTCACCG","561307.5.peg.1165"," 186"
"1717",74,204,130,"TCCTAACTGCGATTTCACCG","ATGAATCTTTAGACAAAGT","561307.5.peg.1165"," 186"
"1718",341,204,137,"TTGGTCCAATGAACTTCAAT","ATGAATCTTTAGACAAAGT","561307.5.peg.1165"," 186"
"1719",507,204,303,"GCAGTAGCTTTAATGATGAC","ATGAATCTTTAGACAAAGT","561307.5.peg.1165"," 186"
"1720",8,204,196,"GTATGGCCAACCGTTATTTA","ATGAATCTTTAGACAAAGT","561307.5.peg.1165"," 186"
"1721",441,204,237,"TTCATTAAACCGTCACTACC","ATGAATCTTTAGACAAAGT","561307.5.peg.1165"," 186"
"1722",25,204,179,"GACGGACAAATGGTAGAGTA","ATGAATCTTTAGACAAAGT","561307.5.peg.1165"," 186"
"1723",680,204,476,"CATAGCTGTCCCCAACAATT","ATGAATCTTTAGACAAAGT","561307.5.peg.1165"," 186"
"1724",27,204,177,"TTTCACCTTAAATAACGGT","ATGAATCTTTAGACAAAGT","561307.5.peg.1165"," 186"
"1725",432,204,228,"CCGTCACTACCAGGAACAAC","ATGAATCTTTAGACAAAGT","561307.5.peg.1165"," 186"
"1726",590,204,386,"GAGCTTCTTGTTCTGTCATT","ATGAATCTTTAGACAAAGT","561307.5.peg.1165"," 186"
"1727",8,237,229,"GTATGGCCAACCGTTATTTA","GTTGCAATAGATAAGATGTT","561307.5.peg.1165"," 186"
"1728",74,237,163,"TCCTAACTGCGATTTCACCG","GTTGCAATAGATAAGATGTT","561307.5.peg.1165"," 186"
"1729",25,237,212,"GACGGACAAATGGTAGAGTA","GTTGCAATAGATAAGATGTT","561307.5.peg.1165"," 186"
"1730",341,237,104,"TTGGTCCAATGAACTTCAAT","GTTGCAATAGATAAGATGTT","561307.5.peg.1165"," 186"
"1731",590,237,353,"GAGCTTCTTGTTCTGTCATT","GTTGCAATAGATAAGATGTT","561307.5.peg.1165"," 186"
"1732",680,237,443,"CATAGCTGTCCCCAACAATT","GTTGCAATAGATAAGATGTT","561307.5.peg.1165"," 186"
"1733",432,237,195,"CCGTCACTACCAGGAACAAC","GTTGCAATAGATAAGATGTT","561307.5.peg.1165"," 186"
"1734",27,237,210,"TTTCACCTTAAATAACGGT","GTTGCAATAGATAAGATGTT","561307.5.peg.1165"," 186"
"1735",507,237,270,"GCAGTAGCTTTAATGATGAC","GTTGCAATAGATAAGATGTT","561307.5.peg.1165"," 186"
"1736",441,237,204,"TTCATTAAACCGTCACTACC","GTTGCAATAGATAAGATGTT","561307.5.peg.1165"," 186"
"1737",25,341,316,"GACGGACAAATGGTAGAGTA","TTGGTCCAATGAACTTCAAT","561307.5.peg.1165"," 186"
"1738",237,341,104,"GTTGCAATAGATAAGATGTT","TTGGTCCAATGAACTTCAAT","561307.5.peg.1165"," 186"
"1739",74,341,267,"TCCTAACTGCGATTTCACCG","TTGGTCCAATGAACTTCAAT","561307.5.peg.1165"," 186"
"1740",8,341,333,"GTATGGCCAACCGTTATTTA","TTGGTCCAATGAACTTCAAT","561307.5.peg.1165"," 186"
"1741",441,341,100,"TTCATTAAACCGTCACTACC","TTGGTCCAATGAACTTCAAT","561307.5.peg.1165"," 186"
"1742",590,341,249,"GAGCTTCTTGTTCTGTCATT","TTGGTCCAATGAACTTCAAT","561307.5.peg.1165"," 186"
"1743",27,341,314,"TTTCACCTTAAATAACGGT","TTGGTCCAATGAACTTCAAT","561307.5.peg.1165"," 186"
"1744",204,341,137,"ATGAATCTTTAGACAAAGT","TTGGTCCAATGAACTTCAAT","561307.5.peg.1165"," 186"
"1745",680,341,339,"CATAGCTGTCCCCAACAATT","TTGGTCCAATGAACTTCAAT","561307.5.peg.1165"," 186"
"1746",507,341,166,"GCAGTAGCTTTAATGATGAC","TTGGTCCAATGAACTTCAAT","561307.5.peg.1165"," 186"
"1747",590,432,158,"GAGCTTCTTGTTCTGTCATT","CCGTCACTACCAGGAACAAC","561307.5.peg.1165"," 186"
"1748",27,432,405,"TTTCACCTTAAATAACGGT","CCGTCACTACCAGGAACAAC","561307.5.peg.1165"," 186"
"1749",8,432,424,"GTATGGCCAACCGTTATTTA","CCGTCACTACCAGGAACAAC","561307.5.peg.1165"," 186"
"1750",74,432,358,"TCCTAACTGCGATTTCACCG","CCGTCACTACCAGGAACAAC","561307.5.peg.1165"," 186"
"1751",204,432,228,"ATGAATCTTTAGACAAAGT","CCGTCACTACCAGGAACAAC","561307.5.peg.1165"," 186"
"1752",680,432,248,"CATAGCTGTCCCCAACAATT","CCGTCACTACCAGGAACAAC","561307.5.peg.1165"," 186"
"1753",25,432,407,"GACGGACAAATGGTAGAGTA","CCGTCACTACCAGGAACAAC","561307.5.peg.1165"," 186"
"1754",237,432,195,"GTTGCAATAGATAAGATGTT","CCGTCACTACCAGGAACAAC","561307.5.peg.1165"," 186"
"1755",25,441,416,"GACGGACAAATGGTAGAGTA","TTCATTAAACCGTCACTACC","561307.5.peg.1165"," 186"
"1756",680,441,239,"CATAGCTGTCCCCAACAATT","TTCATTAAACCGTCACTACC","561307.5.peg.1165"," 186"
"1757",27,441,414,"TTTCACCTTAAATAACGGT","TTCATTAAACCGTCACTACC","561307.5.peg.1165"," 186"
"1758",8,441,433,"GTATGGCCAACCGTTATTTA","TTCATTAAACCGTCACTACC","561307.5.peg.1165"," 186"
"1759",204,441,237,"ATGAATCTTTAGACAAAGT","TTCATTAAACCGTCACTACC","561307.5.peg.1165"," 186"
"1760",74,441,367,"TCCTAACTGCGATTTCACCG","TTCATTAAACCGTCACTACC","561307.5.peg.1165"," 186"
"1761",590,441,149,"GAGCTTCTTGTTCTGTCATT","TTCATTAAACCGTCACTACC","561307.5.peg.1165"," 186"
"1762",237,441,204,"GTTGCAATAGATAAGATGTT","TTCATTAAACCGTCACTACC","561307.5.peg.1165"," 186"
"1763",341,441,100,"TTGGTCCAATGAACTTCAAT","TTCATTAAACCGTCACTACC","561307.5.peg.1165"," 186"
"1764",27,507,480,"TTTCACCTTAAATAACGGT","GCAGTAGCTTTAATGATGAC","561307.5.peg.1165"," 186"
"1765",204,507,303,"ATGAATCTTTAGACAAAGT","GCAGTAGCTTTAATGATGAC","561307.5.peg.1165"," 186"
"1766",680,507,173,"CATAGCTGTCCCCAACAATT","GCAGTAGCTTTAATGATGAC","561307.5.peg.1165"," 186"
"1767",25,507,482,"GACGGACAAATGGTAGAGTA","GCAGTAGCTTTAATGATGAC","561307.5.peg.1165"," 186"
"1768",341,507,166,"TTGGTCCAATGAACTTCAAT","GCAGTAGCTTTAATGATGAC","561307.5.peg.1165"," 186"
"1769",74,507,433,"TCCTAACTGCGATTTCACCG","GCAGTAGCTTTAATGATGAC","561307.5.peg.1165"," 186"
"1770",237,507,270,"GTTGCAATAGATAAGATGTT","GCAGTAGCTTTAATGATGAC","561307.5.peg.1165"," 186"
"1771",8,507,499,"GTATGGCCAACCGTTATTTA","GCAGTAGCTTTAATGATGAC","561307.5.peg.1165"," 186"
"1772",25,590,565,"GACGGACAAATGGTAGAGTA","GAGCTTCTTGTTCTGTCATT","561307.5.peg.1165"," 186"
"1773",8,590,582,"GTATGGCCAACCGTTATTTA","GAGCTTCTTGTTCTGTCATT","561307.5.peg.1165"," 186"
"1774",237,590,353,"GTTGCAATAGATAAGATGTT","GAGCTTCTTGTTCTGTCATT","561307.5.peg.1165"," 186"
"1775",441,590,149,"TTCATTAAACCGTCACTACC","GAGCTTCTTGTTCTGTCATT","561307.5.peg.1165"," 186"
"1776",341,590,249,"TTGGTCCAATGAACTTCAAT","GAGCTTCTTGTTCTGTCATT","561307.5.peg.1165"," 186"
"1777",74,590,516,"TCCTAACTGCGATTTCACCG","GAGCTTCTTGTTCTGTCATT","561307.5.peg.1165"," 186"
"1778",204,590,386,"ATGAATCTTTAGACAAAGT","GAGCTTCTTGTTCTGTCATT","561307.5.peg.1165"," 186"
"1779",27,590,563,"TTTCACCTTAAATAACGGT","GAGCTTCTTGTTCTGTCATT","561307.5.peg.1165"," 186"
"1780",432,590,158,"CCGTCACTACCAGGAACAAC","GAGCTTCTTGTTCTGTCATT","561307.5.peg.1165"," 186"
"1781",25,680,655,"GACGGACAAATGGTAGAGTA","CATAGCTGTCCCCAACAATT","561307.5.peg.1165"," 186"
"1782",341,680,339,"TTGGTCCAATGAACTTCAAT","CATAGCTGTCCCCAACAATT","561307.5.peg.1165"," 186"
"1783",441,680,239,"TTCATTAAACCGTCACTACC","CATAGCTGTCCCCAACAATT","561307.5.peg.1165"," 186"
"1784",27,680,653,"TTTCACCTTAAATAACGGT","CATAGCTGTCCCCAACAATT","561307.5.peg.1165"," 186"
"1785",237,680,443,"GTTGCAATAGATAAGATGTT","CATAGCTGTCCCCAACAATT","561307.5.peg.1165"," 186"
"1786",204,680,476,"ATGAATCTTTAGACAAAGT","CATAGCTGTCCCCAACAATT","561307.5.peg.1165"," 186"
"1787",74,680,606,"TCCTAACTGCGATTTCACCG","CATAGCTGTCCCCAACAATT","561307.5.peg.1165"," 186"
"1788",432,680,248,"CCGTCACTACCAGGAACAAC","CATAGCTGTCCCCAACAATT","561307.5.peg.1165"," 186"
"1789",8,680,672,"GTATGGCCAACCGTTATTTA","CATAGCTGTCCCCAACAATT","561307.5.peg.1165"," 186"
"1790",507,680,173,"GCAGTAGCTTTAATGATGAC","CATAGCTGTCCCCAACAATT","561307.5.peg.1165"," 186"
"1791",261,114,147,"AAGACTTCATCTCCTTCTTT","ATCAATACAGATTGGAGATG","561307.5.peg.1168"," 189"
"1792",493,114,379,"TGAATGGATATCTCGAATTG","ATCAATACAGATTGGAGATG","561307.5.peg.1168"," 189"
"1793",637,114,523,"ACCGCCTCGACCTACAATAA","ATCAATACAGATTGGAGATG","561307.5.peg.1168"," 189"
"1794",220,114,106,"AGCACTACCTTTGAACATCA","ATCAATACAGATTGGAGATG","561307.5.peg.1168"," 189"
"1795",114,220,106,"ATCAATACAGATTGGAGATG","AGCACTACCTTTGAACATCA","561307.5.peg.1168"," 189"
"1796",493,220,273,"TGAATGGATATCTCGAATTG","AGCACTACCTTTGAACATCA","561307.5.peg.1168"," 189"
"1797",637,220,417,"ACCGCCTCGACCTACAATAA","AGCACTACCTTTGAACATCA","561307.5.peg.1168"," 189"
"1798",114,261,147,"ATCAATACAGATTGGAGATG","AAGACTTCATCTCCTTCTTT","561307.5.peg.1168"," 189"
"1799",637,261,376,"ACCGCCTCGACCTACAATAA","AAGACTTCATCTCCTTCTTT","561307.5.peg.1168"," 189"
"1800",493,261,232,"TGAATGGATATCTCGAATTG","AAGACTTCATCTCCTTCTTT","561307.5.peg.1168"," 189"
"1801",114,493,379,"ATCAATACAGATTGGAGATG","TGAATGGATATCTCGAATTG","561307.5.peg.1168"," 189"
"1802",220,493,273,"AGCACTACCTTTGAACATCA","TGAATGGATATCTCGAATTG","561307.5.peg.1168"," 189"
"1803",261,493,232,"AAGACTTCATCTCCTTCTTT","TGAATGGATATCTCGAATTG","561307.5.peg.1168"," 189"
"1804",637,493,144,"ACCGCCTCGACCTACAATAA","TGAATGGATATCTCGAATTG","561307.5.peg.1168"," 189"
"1805",220,637,417,"AGCACTACCTTTGAACATCA","ACCGCCTCGACCTACAATAA","561307.5.peg.1168"," 189"
"1806",493,637,144,"TGAATGGATATCTCGAATTG","ACCGCCTCGACCTACAATAA","561307.5.peg.1168"," 189"
"1807",114,637,523,"ATCAATACAGATTGGAGATG","ACCGCCTCGACCTACAATAA","561307.5.peg.1168"," 189"
"1808",261,637,376,"AAGACTTCATCTCCTTCTTT","ACCGCCTCGACCTACAATAA","561307.5.peg.1168"," 189"
"1809",322,168,154,"CGCTGTATCAAATTTACGAT","CCAGCTTTATGCGGACTATT","561307.5.peg.117"," 191"
"1810",379,168,211,"TATCTTACAACCTCTAATA","CCAGCTTTATGCGGACTATT","561307.5.peg.117"," 191"
"1811",375,168,207,"CTTACAACCTCTAATACGGA","CCAGCTTTATGCGGACTATT","561307.5.peg.117"," 191"
"1812",361,168,193,"TACGGACGGATGCTCTAACA","CCAGCTTTATGCGGACTATT","561307.5.peg.117"," 191"
"1813",549,168,381,"ACTTTAGCCATTTGTGGAAT","CCAGCTTTATGCGGACTATT","561307.5.peg.117"," 191"
"1814",375,177,198,"CTTACAACCTCTAATACGGA","GCCTGCAAACCAGCTTTATG","561307.5.peg.117"," 191"
"1815",322,177,145,"CGCTGTATCAAATTTACGAT","GCCTGCAAACCAGCTTTATG","561307.5.peg.117"," 191"
"1816",379,177,202,"TATCTTACAACCTCTAATA","GCCTGCAAACCAGCTTTATG","561307.5.peg.117"," 191"
"1817",361,177,184,"TACGGACGGATGCTCTAACA","GCCTGCAAACCAGCTTTATG","561307.5.peg.117"," 191"
"1818",549,177,372,"ACTTTAGCCATTTGTGGAAT","GCCTGCAAACCAGCTTTATG","561307.5.peg.117"," 191"
"1819",168,322,154,"CCAGCTTTATGCGGACTATT","CGCTGTATCAAATTTACGAT","561307.5.peg.117"," 191"
"1820",177,322,145,"GCCTGCAAACCAGCTTTATG","CGCTGTATCAAATTTACGAT","561307.5.peg.117"," 191"
"1821",549,322,227,"ACTTTAGCCATTTGTGGAAT","CGCTGTATCAAATTTACGAT","561307.5.peg.117"," 191"
"1822",177,361,184,"GCCTGCAAACCAGCTTTATG","TACGGACGGATGCTCTAACA","561307.5.peg.117"," 191"
"1823",549,361,188,"ACTTTAGCCATTTGTGGAAT","TACGGACGGATGCTCTAACA","561307.5.peg.117"," 191"
"1824",168,361,193,"CCAGCTTTATGCGGACTATT","TACGGACGGATGCTCTAACA","561307.5.peg.117"," 191"
"1825",549,375,174,"ACTTTAGCCATTTGTGGAAT","CTTACAACCTCTAATACGGA","561307.5.peg.117"," 191"
"1826",177,375,198,"GCCTGCAAACCAGCTTTATG","CTTACAACCTCTAATACGGA","561307.5.peg.117"," 191"
"1827",168,375,207,"CCAGCTTTATGCGGACTATT","CTTACAACCTCTAATACGGA","561307.5.peg.117"," 191"
"1828",549,379,170,"ACTTTAGCCATTTGTGGAAT","TATCTTACAACCTCTAATA","561307.5.peg.117"," 191"
"1829",168,379,211,"CCAGCTTTATGCGGACTATT","TATCTTACAACCTCTAATA","561307.5.peg.117"," 191"
"1830",177,379,202,"GCCTGCAAACCAGCTTTATG","TATCTTACAACCTCTAATA","561307.5.peg.117"," 191"
"1831",168,549,381,"CCAGCTTTATGCGGACTATT","ACTTTAGCCATTTGTGGAAT","561307.5.peg.117"," 191"
"1832",177,549,372,"GCCTGCAAACCAGCTTTATG","ACTTTAGCCATTTGTGGAAT","561307.5.peg.117"," 191"
"1833",375,549,174,"CTTACAACCTCTAATACGGA","ACTTTAGCCATTTGTGGAAT","561307.5.peg.117"," 191"
"1834",361,549,188,"TACGGACGGATGCTCTAACA","ACTTTAGCCATTTGTGGAAT","561307.5.peg.117"," 191"
"1835",322,549,227,"CGCTGTATCAAATTTACGAT","ACTTTAGCCATTTGTGGAAT","561307.5.peg.117"," 191"
"1836",379,549,170,"TATCTTACAACCTCTAATA","ACTTTAGCCATTTGTGGAAT","561307.5.peg.117"," 191"
"1837",299,185,114,"CATCATTATCCATCGCTGGT","TGAGTAATAACAGAACTGGT","561307.5.peg.1170"," 192"
"1838",303,185,118,"TAATCATCATTATCCATCGC","TGAGTAATAACAGAACTGGT","561307.5.peg.1170"," 192"
"1839",299,189,110,"CATCATTATCCATCGCTGGT","AAGTGAGTAATAACAGAAC","561307.5.peg.1170"," 192"
"1840",303,189,114,"TAATCATCATTATCCATCGC","AAGTGAGTAATAACAGAAC","561307.5.peg.1170"," 192"
"1841",185,299,114,"TGAGTAATAACAGAACTGGT","CATCATTATCCATCGCTGGT","561307.5.peg.1170"," 192"
"1842",189,299,110,"AAGTGAGTAATAACAGAAC","CATCATTATCCATCGCTGGT","561307.5.peg.1170"," 192"
"1843",185,303,118,"TGAGTAATAACAGAACTGGT","TAATCATCATTATCCATCGC","561307.5.peg.1170"," 192"
"1844",189,303,114,"AAGTGAGTAATAACAGAAC","TAATCATCATTATCCATCGC","561307.5.peg.1170"," 192"
"1845",513,182,331,"GATAAGAATGGCAACTCTGC","AGTAGGAATACAACCTTTA","561307.5.peg.1173"," 195"
"1846",423,182,241,"ACAGAAATTGTGCCACTTTG","AGTAGGAATACAACCTTTA","561307.5.peg.1173"," 195"
"1847",702,182,520,"GAAGCTTGTTTACTTTCAGT","AGTAGGAATACAACCTTTA","561307.5.peg.1173"," 195"
"1848",423,198,225,"ACAGAAATTGTGCCACTTTG","GATTTAAGCAGCGATTTAGT","561307.5.peg.1173"," 195"
"1849",702,198,504,"GAAGCTTGTTTACTTTCAGT","GATTTAAGCAGCGATTTAGT","561307.5.peg.1173"," 195"
"1850",513,198,315,"GATAAGAATGGCAACTCTGC","GATTTAAGCAGCGATTTAGT","561307.5.peg.1173"," 195"
"1851",182,423,241,"AGTAGGAATACAACCTTTA","ACAGAAATTGTGCCACTTTG","561307.5.peg.1173"," 195"
"1852",702,423,279,"GAAGCTTGTTTACTTTCAGT","ACAGAAATTGTGCCACTTTG","561307.5.peg.1173"," 195"
"1853",198,423,225,"GATTTAAGCAGCGATTTAGT","ACAGAAATTGTGCCACTTTG","561307.5.peg.1173"," 195"
"1854",182,513,331,"AGTAGGAATACAACCTTTA","GATAAGAATGGCAACTCTGC","561307.5.peg.1173"," 195"
"1855",702,513,189,"GAAGCTTGTTTACTTTCAGT","GATAAGAATGGCAACTCTGC","561307.5.peg.1173"," 195"
"1856",198,513,315,"GATTTAAGCAGCGATTTAGT","GATAAGAATGGCAACTCTGC","561307.5.peg.1173"," 195"
"1857",182,702,520,"AGTAGGAATACAACCTTTA","GAAGCTTGTTTACTTTCAGT","561307.5.peg.1173"," 195"
"1858",198,702,504,"GATTTAAGCAGCGATTTAGT","GAAGCTTGTTTACTTTCAGT","561307.5.peg.1173"," 195"
"1859",423,702,279,"ACAGAAATTGTGCCACTTTG","GAAGCTTGTTTACTTTCAGT","561307.5.peg.1173"," 195"
"1860",513,702,189,"GATAAGAATGGCAACTCTGC","GAAGCTTGTTTACTTTCAGT","561307.5.peg.1173"," 195"
"1861",429,8,421,"AAAGCAGCACCAACAGCATG","GCTATTCACGTATAAATAGG","561307.5.peg.1174"," 196"
"1862",363,8,355,"GCTCTACTACTAAAGTGTGA","GCTATTCACGTATAAATAGG","561307.5.peg.1174"," 196"
"1863",411,8,403,"TGGGGTATTTGAGTTGCTAC","GCTATTCACGTATAAATAGG","561307.5.peg.1174"," 196"
"1864",515,8,507,"AACCTTCATGGAAGTCACCT","GCTATTCACGTATAAATAGG","561307.5.peg.1174"," 196"
"1865",363,11,352,"GCTCTACTACTAAAGTGTGA","GAGCTATTCACGTATAAAT","561307.5.peg.1174"," 196"
"1866",411,11,400,"TGGGGTATTTGAGTTGCTAC","GAGCTATTCACGTATAAAT","561307.5.peg.1174"," 196"
"1867",515,11,504,"AACCTTCATGGAAGTCACCT","GAGCTATTCACGTATAAAT","561307.5.peg.1174"," 196"
"1868",429,11,418,"AAAGCAGCACCAACAGCATG","GAGCTATTCACGTATAAAT","561307.5.peg.1174"," 196"
"1869",8,363,355,"GCTATTCACGTATAAATAGG","GCTCTACTACTAAAGTGTGA","561307.5.peg.1174"," 196"
"1870",515,363,152,"AACCTTCATGGAAGTCACCT","GCTCTACTACTAAAGTGTGA","561307.5.peg.1174"," 196"
"1871",11,363,352,"GAGCTATTCACGTATAAAT","GCTCTACTACTAAAGTGTGA","561307.5.peg.1174"," 196"
"1872",8,411,403,"GCTATTCACGTATAAATAGG","TGGGGTATTTGAGTTGCTAC","561307.5.peg.1174"," 196"
"1873",11,411,400,"GAGCTATTCACGTATAAAT","TGGGGTATTTGAGTTGCTAC","561307.5.peg.1174"," 196"
"1874",515,411,104,"AACCTTCATGGAAGTCACCT","TGGGGTATTTGAGTTGCTAC","561307.5.peg.1174"," 196"
"1875",8,429,421,"GCTATTCACGTATAAATAGG","AAAGCAGCACCAACAGCATG","561307.5.peg.1174"," 196"
"1876",11,429,418,"GAGCTATTCACGTATAAAT","AAAGCAGCACCAACAGCATG","561307.5.peg.1174"," 196"
"1877",8,515,507,"GCTATTCACGTATAAATAGG","AACCTTCATGGAAGTCACCT","561307.5.peg.1174"," 196"
"1878",11,515,504,"GAGCTATTCACGTATAAAT","AACCTTCATGGAAGTCACCT","561307.5.peg.1174"," 196"
"1879",363,515,152,"GCTCTACTACTAAAGTGTGA","AACCTTCATGGAAGTCACCT","561307.5.peg.1174"," 196"
"1880",411,515,104,"TGGGGTATTTGAGTTGCTAC","AACCTTCATGGAAGTCACCT","561307.5.peg.1174"," 196"
"1881",219,12,207,"CAATATTTGACTCAGCTAA","ATGCATTTGTGTACGAAGAA","561307.5.peg.1175"," 197"
"1882",492,12,480,"TTAGCATCATACGGTGTGGA","ATGCATTTGTGTACGAAGAA","561307.5.peg.1175"," 197"
"1883",383,12,371,"ATGGTGCACGAATCGTTAAT","ATGCATTTGTGTACGAAGAA","561307.5.peg.1175"," 197"
"1884",250,12,238,"ACCTACCATAGCTGCACCAA","ATGCATTTGTGTACGAAGAA","561307.5.peg.1175"," 197"
"1885",496,12,484,"CCCTTTAGCATCATACGGTG","ATGCATTTGTGTACGAAGAA","561307.5.peg.1175"," 197"
"1886",383,83,300,"ATGGTGCACGAATCGTTAAT","GTAATGCTAAGTCTTGTGCC","561307.5.peg.1175"," 197"
"1887",250,83,167,"ACCTACCATAGCTGCACCAA","GTAATGCTAAGTCTTGTGCC","561307.5.peg.1175"," 197"
"1888",219,83,136,"CAATATTTGACTCAGCTAA","GTAATGCTAAGTCTTGTGCC","561307.5.peg.1175"," 197"
"1889",496,83,413,"CCCTTTAGCATCATACGGTG","GTAATGCTAAGTCTTGTGCC","561307.5.peg.1175"," 197"
"1890",492,83,409,"TTAGCATCATACGGTGTGGA","GTAATGCTAAGTCTTGTGCC","561307.5.peg.1175"," 197"
"1891",12,219,207,"ATGCATTTGTGTACGAAGAA","CAATATTTGACTCAGCTAA","561307.5.peg.1175"," 197"
"1892",496,219,277,"CCCTTTAGCATCATACGGTG","CAATATTTGACTCAGCTAA","561307.5.peg.1175"," 197"
"1893",383,219,164,"ATGGTGCACGAATCGTTAAT","CAATATTTGACTCAGCTAA","561307.5.peg.1175"," 197"
"1894",492,219,273,"TTAGCATCATACGGTGTGGA","CAATATTTGACTCAGCTAA","561307.5.peg.1175"," 197"
"1895",83,219,136,"GTAATGCTAAGTCTTGTGCC","CAATATTTGACTCAGCTAA","561307.5.peg.1175"," 197"
"1896",12,250,238,"ATGCATTTGTGTACGAAGAA","ACCTACCATAGCTGCACCAA","561307.5.peg.1175"," 197"
"1897",496,250,246,"CCCTTTAGCATCATACGGTG","ACCTACCATAGCTGCACCAA","561307.5.peg.1175"," 197"
"1898",492,250,242,"TTAGCATCATACGGTGTGGA","ACCTACCATAGCTGCACCAA","561307.5.peg.1175"," 197"
"1899",83,250,167,"GTAATGCTAAGTCTTGTGCC","ACCTACCATAGCTGCACCAA","561307.5.peg.1175"," 197"
"1900",383,250,133,"ATGGTGCACGAATCGTTAAT","ACCTACCATAGCTGCACCAA","561307.5.peg.1175"," 197"
"1901",12,383,371,"ATGCATTTGTGTACGAAGAA","ATGGTGCACGAATCGTTAAT","561307.5.peg.1175"," 197"
"1902",83,383,300,"GTAATGCTAAGTCTTGTGCC","ATGGTGCACGAATCGTTAAT","561307.5.peg.1175"," 197"
"1903",250,383,133,"ACCTACCATAGCTGCACCAA","ATGGTGCACGAATCGTTAAT","561307.5.peg.1175"," 197"
"1904",492,383,109,"TTAGCATCATACGGTGTGGA","ATGGTGCACGAATCGTTAAT","561307.5.peg.1175"," 197"
"1905",219,383,164,"CAATATTTGACTCAGCTAA","ATGGTGCACGAATCGTTAAT","561307.5.peg.1175"," 197"
"1906",496,383,113,"CCCTTTAGCATCATACGGTG","ATGGTGCACGAATCGTTAAT","561307.5.peg.1175"," 197"
"1907",250,492,242,"ACCTACCATAGCTGCACCAA","TTAGCATCATACGGTGTGGA","561307.5.peg.1175"," 197"
"1908",219,492,273,"CAATATTTGACTCAGCTAA","TTAGCATCATACGGTGTGGA","561307.5.peg.1175"," 197"
"1909",383,492,109,"ATGGTGCACGAATCGTTAAT","TTAGCATCATACGGTGTGGA","561307.5.peg.1175"," 197"
"1910",12,492,480,"ATGCATTTGTGTACGAAGAA","TTAGCATCATACGGTGTGGA","561307.5.peg.1175"," 197"
"1911",83,492,409,"GTAATGCTAAGTCTTGTGCC","TTAGCATCATACGGTGTGGA","561307.5.peg.1175"," 197"
"1912",250,496,246,"ACCTACCATAGCTGCACCAA","CCCTTTAGCATCATACGGTG","561307.5.peg.1175"," 197"
"1913",12,496,484,"ATGCATTTGTGTACGAAGAA","CCCTTTAGCATCATACGGTG","561307.5.peg.1175"," 197"
"1914",383,496,113,"ATGGTGCACGAATCGTTAAT","CCCTTTAGCATCATACGGTG","561307.5.peg.1175"," 197"
"1915",83,496,413,"GTAATGCTAAGTCTTGTGCC","CCCTTTAGCATCATACGGTG","561307.5.peg.1175"," 197"
"1916",219,496,277,"CAATATTTGACTCAGCTAA","CCCTTTAGCATCATACGGTG","561307.5.peg.1175"," 197"
"1917",544,7,537,"TTGTTTGTCAGATTGAGCTG","AATTAGCAGAATTCTAGGGA","561307.5.peg.1176"," 198"
"1918",188,7,181,"TTGTTCCTGATATCGTGGAA","AATTAGCAGAATTCTAGGGA","561307.5.peg.1176"," 198"
"1919",193,7,186,"TGTAATTGTTCCTGATATCG","AATTAGCAGAATTCTAGGGA","561307.5.peg.1176"," 198"
"1920",642,7,635,"GCTTTACGCACACCATTTAC","AATTAGCAGAATTCTAGGGA","561307.5.peg.1176"," 198"
"1921",605,7,598,"CACTATTGTCTTCAGATGAT","AATTAGCAGAATTCTAGGGA","561307.5.peg.1176"," 198"
"1922",605,11,594,"CACTATTGTCTTCAGATGAT","CGTGAATTAGCAGAATTCTA","561307.5.peg.1176"," 198"
"1923",193,11,182,"TGTAATTGTTCCTGATATCG","CGTGAATTAGCAGAATTCTA","561307.5.peg.1176"," 198"
"1924",642,11,631,"GCTTTACGCACACCATTTAC","CGTGAATTAGCAGAATTCTA","561307.5.peg.1176"," 198"
"1925",188,11,177,"TTGTTCCTGATATCGTGGAA","CGTGAATTAGCAGAATTCTA","561307.5.peg.1176"," 198"
"1926",544,11,533,"TTGTTTGTCAGATTGAGCTG","CGTGAATTAGCAGAATTCTA","561307.5.peg.1176"," 198"
"1927",642,66,576,"GCTTTACGCACACCATTTAC","TGAACACTCTCACCTAACTT","561307.5.peg.1176"," 198"
"1928",188,66,122,"TTGTTCCTGATATCGTGGAA","TGAACACTCTCACCTAACTT","561307.5.peg.1176"," 198"
"1929",605,66,539,"CACTATTGTCTTCAGATGAT","TGAACACTCTCACCTAACTT","561307.5.peg.1176"," 198"
"1930",544,66,478,"TTGTTTGTCAGATTGAGCTG","TGAACACTCTCACCTAACTT","561307.5.peg.1176"," 198"
"1931",193,66,127,"TGTAATTGTTCCTGATATCG","TGAACACTCTCACCTAACTT","561307.5.peg.1176"," 198"
"1932",7,188,181,"AATTAGCAGAATTCTAGGGA","TTGTTCCTGATATCGTGGAA","561307.5.peg.1176"," 198"
"1933",544,188,356,"TTGTTTGTCAGATTGAGCTG","TTGTTCCTGATATCGTGGAA","561307.5.peg.1176"," 198"
"1934",66,188,122,"TGAACACTCTCACCTAACTT","TTGTTCCTGATATCGTGGAA","561307.5.peg.1176"," 198"
"1935",642,188,454,"GCTTTACGCACACCATTTAC","TTGTTCCTGATATCGTGGAA","561307.5.peg.1176"," 198"
"1936",11,188,177,"CGTGAATTAGCAGAATTCTA","TTGTTCCTGATATCGTGGAA","561307.5.peg.1176"," 198"
"1937",605,188,417,"CACTATTGTCTTCAGATGAT","TTGTTCCTGATATCGTGGAA","561307.5.peg.1176"," 198"
"1938",7,193,186,"AATTAGCAGAATTCTAGGGA","TGTAATTGTTCCTGATATCG","561307.5.peg.1176"," 198"
"1939",642,193,449,"GCTTTACGCACACCATTTAC","TGTAATTGTTCCTGATATCG","561307.5.peg.1176"," 198"
"1940",66,193,127,"TGAACACTCTCACCTAACTT","TGTAATTGTTCCTGATATCG","561307.5.peg.1176"," 198"
"1941",544,193,351,"TTGTTTGTCAGATTGAGCTG","TGTAATTGTTCCTGATATCG","561307.5.peg.1176"," 198"
"1942",605,193,412,"CACTATTGTCTTCAGATGAT","TGTAATTGTTCCTGATATCG","561307.5.peg.1176"," 198"
"1943",11,193,182,"CGTGAATTAGCAGAATTCTA","TGTAATTGTTCCTGATATCG","561307.5.peg.1176"," 198"
"1944",66,544,478,"TGAACACTCTCACCTAACTT","TTGTTTGTCAGATTGAGCTG","561307.5.peg.1176"," 198"
"1945",11,544,533,"CGTGAATTAGCAGAATTCTA","TTGTTTGTCAGATTGAGCTG","561307.5.peg.1176"," 198"
"1946",188,544,356,"TTGTTCCTGATATCGTGGAA","TTGTTTGTCAGATTGAGCTG","561307.5.peg.1176"," 198"
"1947",193,544,351,"TGTAATTGTTCCTGATATCG","TTGTTTGTCAGATTGAGCTG","561307.5.peg.1176"," 198"
"1948",7,544,537,"AATTAGCAGAATTCTAGGGA","TTGTTTGTCAGATTGAGCTG","561307.5.peg.1176"," 198"
"1949",188,605,417,"TTGTTCCTGATATCGTGGAA","CACTATTGTCTTCAGATGAT","561307.5.peg.1176"," 198"
"1950",7,605,598,"AATTAGCAGAATTCTAGGGA","CACTATTGTCTTCAGATGAT","561307.5.peg.1176"," 198"
"1951",66,605,539,"TGAACACTCTCACCTAACTT","CACTATTGTCTTCAGATGAT","561307.5.peg.1176"," 198"
"1952",11,605,594,"CGTGAATTAGCAGAATTCTA","CACTATTGTCTTCAGATGAT","561307.5.peg.1176"," 198"
"1953",193,605,412,"TGTAATTGTTCCTGATATCG","CACTATTGTCTTCAGATGAT","561307.5.peg.1176"," 198"
"1954",193,642,449,"TGTAATTGTTCCTGATATCG","GCTTTACGCACACCATTTAC","561307.5.peg.1176"," 198"
"1955",11,642,631,"CGTGAATTAGCAGAATTCTA","GCTTTACGCACACCATTTAC","561307.5.peg.1176"," 198"
"1956",66,642,576,"TGAACACTCTCACCTAACTT","GCTTTACGCACACCATTTAC","561307.5.peg.1176"," 198"
"1957",188,642,454,"TTGTTCCTGATATCGTGGAA","GCTTTACGCACACCATTTAC","561307.5.peg.1176"," 198"
"1958",7,642,635,"AATTAGCAGAATTCTAGGGA","GCTTTACGCACACCATTTAC","561307.5.peg.1176"," 198"
"1959",492,294,198,"CTAGTTGTTTGTCTAAACT","ACGATAATACCGAGTACAAT","561307.5.peg.1178"," 200"
"1960",294,492,198,"ACGATAATACCGAGTACAAT","CTAGTTGTTTGTCTAAACT","561307.5.peg.1178"," 200"
"1961",549,401,148,"ACTGGTAATCCACCTGAACC","GTAATTCATACGTATCCATT","561307.5.peg.118"," 202"
"1962",621,401,220,"ATCACTTCCATCCCAGCAAC","GTAATTCATACGTATCCATT","561307.5.peg.118"," 202"
"1963",621,486,135,"ATCACTTCCATCCCAGCAAC","TCCACTCGAATTTCATGATC","561307.5.peg.118"," 202"
"1964",401,549,148,"GTAATTCATACGTATCCATT","ACTGGTAATCCACCTGAACC","561307.5.peg.118"," 202"
"1965",401,621,220,"GTAATTCATACGTATCCATT","ATCACTTCCATCCCAGCAAC","561307.5.peg.118"," 202"
"1966",486,621,135,"TCCACTCGAATTTCATGATC","ATCACTTCCATCCCAGCAAC","561307.5.peg.118"," 202"
"1967",440,201,239,"CAAATTGAATTTGTCCATGT","GATTATTGGCACCTAATTT","561307.5.peg.1180"," 203"
"1968",588,201,387,"GCTGAAATTAACATTTGCGT","GATTATTGGCACCTAATTT","561307.5.peg.1180"," 203"
"1969",440,264,176,"CAAATTGAATTTGTCCATGT","GGCTCGTCAAATATAATTT","561307.5.peg.1180"," 203"
"1970",588,264,324,"GCTGAAATTAACATTTGCGT","GGCTCGTCAAATATAATTT","561307.5.peg.1180"," 203"
"1971",588,284,304,"GCTGAAATTAACATTTGCGT","CGGGTACAACAGTATCCATA","561307.5.peg.1180"," 203"
"1972",440,284,156,"CAAATTGAATTTGTCCATGT","CGGGTACAACAGTATCCATA","561307.5.peg.1180"," 203"
"1973",201,440,239,"GATTATTGGCACCTAATTT","CAAATTGAATTTGTCCATGT","561307.5.peg.1180"," 203"
"1974",588,440,148,"GCTGAAATTAACATTTGCGT","CAAATTGAATTTGTCCATGT","561307.5.peg.1180"," 203"
"1975",264,440,176,"GGCTCGTCAAATATAATTT","CAAATTGAATTTGTCCATGT","561307.5.peg.1180"," 203"
"1976",284,440,156,"CGGGTACAACAGTATCCATA","CAAATTGAATTTGTCCATGT","561307.5.peg.1180"," 203"
"1977",264,588,324,"GGCTCGTCAAATATAATTT","GCTGAAATTAACATTTGCGT","561307.5.peg.1180"," 203"
"1978",201,588,387,"GATTATTGGCACCTAATTT","GCTGAAATTAACATTTGCGT","561307.5.peg.1180"," 203"
"1979",440,588,148,"CAAATTGAATTTGTCCATGT","GCTGAAATTAACATTTGCGT","561307.5.peg.1180"," 203"
"1980",284,588,304,"CGGGTACAACAGTATCCATA","GCTGAAATTAACATTTGCGT","561307.5.peg.1180"," 203"
"1981",204,98,106,"ATTCTTCCAATGAATACGT","GTGATTCAATATTCCAAGCT","561307.5.peg.1181"," 204"
"1982",459,98,361,"TGTCCACCCGGCATTAATGA","GTGATTCAATATTCCAAGCT","561307.5.peg.1181"," 204"
"1983",471,98,373,"TAAGCTTCTTCTTGTCCACC","GTGATTCAATATTCCAAGCT","561307.5.peg.1181"," 204"
"1984",459,204,255,"TGTCCACCCGGCATTAATGA","ATTCTTCCAATGAATACGT","561307.5.peg.1181"," 204"
"1985",98,204,106,"GTGATTCAATATTCCAAGCT","ATTCTTCCAATGAATACGT","561307.5.peg.1181"," 204"
"1986",471,204,267,"TAAGCTTCTTCTTGTCCACC","ATTCTTCCAATGAATACGT","561307.5.peg.1181"," 204"
"1987",98,459,361,"GTGATTCAATATTCCAAGCT","TGTCCACCCGGCATTAATGA","561307.5.peg.1181"," 204"
"1988",204,459,255,"ATTCTTCCAATGAATACGT","TGTCCACCCGGCATTAATGA","561307.5.peg.1181"," 204"
"1989",204,471,267,"ATTCTTCCAATGAATACGT","TAAGCTTCTTCTTGTCCACC","561307.5.peg.1181"," 204"
"1990",98,471,373,"GTGATTCAATATTCCAAGCT","TAAGCTTCTTCTTGTCCACC","561307.5.peg.1181"," 204"
"1991",323,8,315,"TTTGTGTACCATAGCCATGC","CCGATGCAGAAATTAACAGG","561307.5.peg.1183"," 206"
"1992",483,8,475,"GGCTTACCAATCACAATAAA","CCGATGCAGAAATTAACAGG","561307.5.peg.1183"," 206"
"1993",189,8,181,"AAAGTTCTAGCAGCGGTATT","CCGATGCAGAAATTAACAGG","561307.5.peg.1183"," 206"
"1994",196,8,188,"TGTAATTAAAGTTCTAGCAG","CCGATGCAGAAATTAACAGG","561307.5.peg.1183"," 206"
"1995",264,8,256,"TAGAATGGATTCAGTCGAAT","CCGATGCAGAAATTAACAGG","561307.5.peg.1183"," 206"
"1996",504,8,496,"TGATGATCTATATCCGATGT","CCGATGCAGAAATTAACAGG","561307.5.peg.1183"," 206"
"1997",189,11,178,"AAAGTTCTAGCAGCGGTATT","TTTCCGATGCAGAAATTAAC","561307.5.peg.1183"," 206"
"1998",504,11,493,"TGATGATCTATATCCGATGT","TTTCCGATGCAGAAATTAAC","561307.5.peg.1183"," 206"
"1999",323,11,312,"TTTGTGTACCATAGCCATGC","TTTCCGATGCAGAAATTAAC","561307.5.peg.1183"," 206"
"2000",264,11,253,"TAGAATGGATTCAGTCGAAT","TTTCCGATGCAGAAATTAAC","561307.5.peg.1183"," 206"
"2001",483,11,472,"GGCTTACCAATCACAATAAA","TTTCCGATGCAGAAATTAAC","561307.5.peg.1183"," 206"
"2002",196,11,185,"TGTAATTAAAGTTCTAGCAG","TTTCCGATGCAGAAATTAAC","561307.5.peg.1183"," 206"
"2003",504,82,422,"TGATGATCTATATCCGATGT","AACTGTCGAAGGAGAAACAC","561307.5.peg.1183"," 206"
"2004",264,82,182,"TAGAATGGATTCAGTCGAAT","AACTGTCGAAGGAGAAACAC","561307.5.peg.1183"," 206"
"2005",483,82,401,"GGCTTACCAATCACAATAAA","AACTGTCGAAGGAGAAACAC","561307.5.peg.1183"," 206"
"2006",189,82,107,"AAAGTTCTAGCAGCGGTATT","AACTGTCGAAGGAGAAACAC","561307.5.peg.1183"," 206"
"2007",196,82,114,"TGTAATTAAAGTTCTAGCAG","AACTGTCGAAGGAGAAACAC","561307.5.peg.1183"," 206"
"2008",323,82,241,"TTTGTGTACCATAGCCATGC","AACTGTCGAAGGAGAAACAC","561307.5.peg.1183"," 206"
"2009",323,93,230,"TTTGTGTACCATAGCCATGC","ATAACTCTTGAAACTGTCGA","561307.5.peg.1183"," 206"
"2010",264,93,171,"TAGAATGGATTCAGTCGAAT","ATAACTCTTGAAACTGTCGA","561307.5.peg.1183"," 206"
"2011",196,93,103,"TGTAATTAAAGTTCTAGCAG","ATAACTCTTGAAACTGTCGA","561307.5.peg.1183"," 206"
"2012",483,93,390,"GGCTTACCAATCACAATAAA","ATAACTCTTGAAACTGTCGA","561307.5.peg.1183"," 206"
"2013",504,93,411,"TGATGATCTATATCCGATGT","ATAACTCTTGAAACTGTCGA","561307.5.peg.1183"," 206"
"2014",82,189,107,"AACTGTCGAAGGAGAAACAC","AAAGTTCTAGCAGCGGTATT","561307.5.peg.1183"," 206"
"2015",11,189,178,"TTTCCGATGCAGAAATTAAC","AAAGTTCTAGCAGCGGTATT","561307.5.peg.1183"," 206"
"2016",8,189,181,"CCGATGCAGAAATTAACAGG","AAAGTTCTAGCAGCGGTATT","561307.5.peg.1183"," 206"
"2017",504,189,315,"TGATGATCTATATCCGATGT","AAAGTTCTAGCAGCGGTATT","561307.5.peg.1183"," 206"
"2018",483,189,294,"GGCTTACCAATCACAATAAA","AAAGTTCTAGCAGCGGTATT","561307.5.peg.1183"," 206"
"2019",323,189,134,"TTTGTGTACCATAGCCATGC","AAAGTTCTAGCAGCGGTATT","561307.5.peg.1183"," 206"
"2020",504,196,308,"TGATGATCTATATCCGATGT","TGTAATTAAAGTTCTAGCAG","561307.5.peg.1183"," 206"
"2021",93,196,103,"ATAACTCTTGAAACTGTCGA","TGTAATTAAAGTTCTAGCAG","561307.5.peg.1183"," 206"
"2022",8,196,188,"CCGATGCAGAAATTAACAGG","TGTAATTAAAGTTCTAGCAG","561307.5.peg.1183"," 206"
"2023",82,196,114,"AACTGTCGAAGGAGAAACAC","TGTAATTAAAGTTCTAGCAG","561307.5.peg.1183"," 206"
"2024",323,196,127,"TTTGTGTACCATAGCCATGC","TGTAATTAAAGTTCTAGCAG","561307.5.peg.1183"," 206"
"2025",11,196,185,"TTTCCGATGCAGAAATTAAC","TGTAATTAAAGTTCTAGCAG","561307.5.peg.1183"," 206"
"2026",483,196,287,"GGCTTACCAATCACAATAAA","TGTAATTAAAGTTCTAGCAG","561307.5.peg.1183"," 206"
"2027",93,264,171,"ATAACTCTTGAAACTGTCGA","TAGAATGGATTCAGTCGAAT","561307.5.peg.1183"," 206"
"2028",483,264,219,"GGCTTACCAATCACAATAAA","TAGAATGGATTCAGTCGAAT","561307.5.peg.1183"," 206"
"2029",504,264,240,"TGATGATCTATATCCGATGT","TAGAATGGATTCAGTCGAAT","561307.5.peg.1183"," 206"
"2030",8,264,256,"CCGATGCAGAAATTAACAGG","TAGAATGGATTCAGTCGAAT","561307.5.peg.1183"," 206"
"2031",82,264,182,"AACTGTCGAAGGAGAAACAC","TAGAATGGATTCAGTCGAAT","561307.5.peg.1183"," 206"
"2032",11,264,253,"TTTCCGATGCAGAAATTAAC","TAGAATGGATTCAGTCGAAT","561307.5.peg.1183"," 206"
"2033",8,323,315,"CCGATGCAGAAATTAACAGG","TTTGTGTACCATAGCCATGC","561307.5.peg.1183"," 206"
"2034",82,323,241,"AACTGTCGAAGGAGAAACAC","TTTGTGTACCATAGCCATGC","561307.5.peg.1183"," 206"
"2035",504,323,181,"TGATGATCTATATCCGATGT","TTTGTGTACCATAGCCATGC","561307.5.peg.1183"," 206"
"2036",11,323,312,"TTTCCGATGCAGAAATTAAC","TTTGTGTACCATAGCCATGC","561307.5.peg.1183"," 206"
"2037",189,323,134,"AAAGTTCTAGCAGCGGTATT","TTTGTGTACCATAGCCATGC","561307.5.peg.1183"," 206"
"2038",93,323,230,"ATAACTCTTGAAACTGTCGA","TTTGTGTACCATAGCCATGC","561307.5.peg.1183"," 206"
"2039",483,323,160,"GGCTTACCAATCACAATAAA","TTTGTGTACCATAGCCATGC","561307.5.peg.1183"," 206"
"2040",196,323,127,"TGTAATTAAAGTTCTAGCAG","TTTGTGTACCATAGCCATGC","561307.5.peg.1183"," 206"
"2041",8,483,475,"CCGATGCAGAAATTAACAGG","GGCTTACCAATCACAATAAA","561307.5.peg.1183"," 206"
"2042",82,483,401,"AACTGTCGAAGGAGAAACAC","GGCTTACCAATCACAATAAA","561307.5.peg.1183"," 206"
"2043",93,483,390,"ATAACTCTTGAAACTGTCGA","GGCTTACCAATCACAATAAA","561307.5.peg.1183"," 206"
"2044",323,483,160,"TTTGTGTACCATAGCCATGC","GGCTTACCAATCACAATAAA","561307.5.peg.1183"," 206"
"2045",11,483,472,"TTTCCGATGCAGAAATTAAC","GGCTTACCAATCACAATAAA","561307.5.peg.1183"," 206"
"2046",196,483,287,"TGTAATTAAAGTTCTAGCAG","GGCTTACCAATCACAATAAA","561307.5.peg.1183"," 206"
"2047",189,483,294,"AAAGTTCTAGCAGCGGTATT","GGCTTACCAATCACAATAAA","561307.5.peg.1183"," 206"
"2048",264,483,219,"TAGAATGGATTCAGTCGAAT","GGCTTACCAATCACAATAAA","561307.5.peg.1183"," 206"
"2049",82,504,422,"AACTGTCGAAGGAGAAACAC","TGATGATCTATATCCGATGT","561307.5.peg.1183"," 206"
"2050",323,504,181,"TTTGTGTACCATAGCCATGC","TGATGATCTATATCCGATGT","561307.5.peg.1183"," 206"
"2051",8,504,496,"CCGATGCAGAAATTAACAGG","TGATGATCTATATCCGATGT","561307.5.peg.1183"," 206"
"2052",93,504,411,"ATAACTCTTGAAACTGTCGA","TGATGATCTATATCCGATGT","561307.5.peg.1183"," 206"
"2053",11,504,493,"TTTCCGATGCAGAAATTAAC","TGATGATCTATATCCGATGT","561307.5.peg.1183"," 206"
"2054",189,504,315,"AAAGTTCTAGCAGCGGTATT","TGATGATCTATATCCGATGT","561307.5.peg.1183"," 206"
"2055",196,504,308,"TGTAATTAAAGTTCTAGCAG","TGATGATCTATATCCGATGT","561307.5.peg.1183"," 206"
"2056",264,504,240,"TAGAATGGATTCAGTCGAAT","TGATGATCTATATCCGATGT","561307.5.peg.1183"," 206"
"2057",555,10,545,"GGATTACCCCAATTCAAATC","AATCAACACAGCGATAGCAA","561307.5.peg.1184"," 207"
"2058",141,10,131,"CCAATTTATCAATCATTCC","AATCAACACAGCGATAGCAA","561307.5.peg.1184"," 207"
"2059",747,10,737,"TGTAACCAAGTTTGTATACC","AATCAACACAGCGATAGCAA","561307.5.peg.1184"," 207"
"2060",576,10,566,"AATACAGCATCTCTAACTTC","AATCAACACAGCGATAGCAA","561307.5.peg.1184"," 207"
"2061",462,10,452,"ATATACTTTCCCAGTTGTT","AATCAACACAGCGATAGCAA","561307.5.peg.1184"," 207"
"2062",836,10,826,"CCCAGTCATCAGCATCATCA","AATCAACACAGCGATAGCAA","561307.5.peg.1184"," 207"
"2063",411,10,401,"CAAATGTACCAATCACGTTT","AATCAACACAGCGATAGCAA","561307.5.peg.1184"," 207"
"2064",441,10,431,"GGTTCAGAGCCATCTGGCTT","AATCAACACAGCGATAGCAA","561307.5.peg.1184"," 207"
"2065",391,10,381,"GGGATTGTCTTTACTAGATT","AATCAACACAGCGATAGCAA","561307.5.peg.1184"," 207"
"2066",10,141,131,"AATCAACACAGCGATAGCAA","CCAATTTATCAATCATTCC","561307.5.peg.1184"," 207"
"2067",462,141,321,"ATATACTTTCCCAGTTGTT","CCAATTTATCAATCATTCC","561307.5.peg.1184"," 207"
"2068",576,141,435,"AATACAGCATCTCTAACTTC","CCAATTTATCAATCATTCC","561307.5.peg.1184"," 207"
"2069",747,141,606,"TGTAACCAAGTTTGTATACC","CCAATTTATCAATCATTCC","561307.5.peg.1184"," 207"
"2070",411,141,270,"CAAATGTACCAATCACGTTT","CCAATTTATCAATCATTCC","561307.5.peg.1184"," 207"
"2071",555,141,414,"GGATTACCCCAATTCAAATC","CCAATTTATCAATCATTCC","561307.5.peg.1184"," 207"
"2072",391,141,250,"GGGATTGTCTTTACTAGATT","CCAATTTATCAATCATTCC","561307.5.peg.1184"," 207"
"2073",441,141,300,"GGTTCAGAGCCATCTGGCTT","CCAATTTATCAATCATTCC","561307.5.peg.1184"," 207"
"2074",836,141,695,"CCCAGTCATCAGCATCATCA","CCAATTTATCAATCATTCC","561307.5.peg.1184"," 207"
"2075",576,391,185,"AATACAGCATCTCTAACTTC","GGGATTGTCTTTACTAGATT","561307.5.peg.1184"," 207"
"2076",747,391,356,"TGTAACCAAGTTTGTATACC","GGGATTGTCTTTACTAGATT","561307.5.peg.1184"," 207"
"2077",555,391,164,"GGATTACCCCAATTCAAATC","GGGATTGTCTTTACTAGATT","561307.5.peg.1184"," 207"
"2078",10,391,381,"AATCAACACAGCGATAGCAA","GGGATTGTCTTTACTAGATT","561307.5.peg.1184"," 207"
"2079",836,391,445,"CCCAGTCATCAGCATCATCA","GGGATTGTCTTTACTAGATT","561307.5.peg.1184"," 207"
"2080",141,391,250,"CCAATTTATCAATCATTCC","GGGATTGTCTTTACTAGATT","561307.5.peg.1184"," 207"
"2081",836,411,425,"CCCAGTCATCAGCATCATCA","CAAATGTACCAATCACGTTT","561307.5.peg.1184"," 207"
"2082",141,411,270,"CCAATTTATCAATCATTCC","CAAATGTACCAATCACGTTT","561307.5.peg.1184"," 207"
"2083",747,411,336,"TGTAACCAAGTTTGTATACC","CAAATGTACCAATCACGTTT","561307.5.peg.1184"," 207"
"2084",10,411,401,"AATCAACACAGCGATAGCAA","CAAATGTACCAATCACGTTT","561307.5.peg.1184"," 207"
"2085",555,411,144,"GGATTACCCCAATTCAAATC","CAAATGTACCAATCACGTTT","561307.5.peg.1184"," 207"
"2086",576,411,165,"AATACAGCATCTCTAACTTC","CAAATGTACCAATCACGTTT","561307.5.peg.1184"," 207"
"2087",141,441,300,"CCAATTTATCAATCATTCC","GGTTCAGAGCCATCTGGCTT","561307.5.peg.1184"," 207"
"2088",555,441,114,"GGATTACCCCAATTCAAATC","GGTTCAGAGCCATCTGGCTT","561307.5.peg.1184"," 207"
"2089",10,441,431,"AATCAACACAGCGATAGCAA","GGTTCAGAGCCATCTGGCTT","561307.5.peg.1184"," 207"
"2090",576,441,135,"AATACAGCATCTCTAACTTC","GGTTCAGAGCCATCTGGCTT","561307.5.peg.1184"," 207"
"2091",836,441,395,"CCCAGTCATCAGCATCATCA","GGTTCAGAGCCATCTGGCTT","561307.5.peg.1184"," 207"
"2092",747,441,306,"TGTAACCAAGTTTGTATACC","GGTTCAGAGCCATCTGGCTT","561307.5.peg.1184"," 207"
"2093",10,462,452,"AATCAACACAGCGATAGCAA","ATATACTTTCCCAGTTGTT","561307.5.peg.1184"," 207"
"2094",576,462,114,"AATACAGCATCTCTAACTTC","ATATACTTTCCCAGTTGTT","561307.5.peg.1184"," 207"
"2095",836,462,374,"CCCAGTCATCAGCATCATCA","ATATACTTTCCCAGTTGTT","561307.5.peg.1184"," 207"
"2096",141,462,321,"CCAATTTATCAATCATTCC","ATATACTTTCCCAGTTGTT","561307.5.peg.1184"," 207"
"2097",747,462,285,"TGTAACCAAGTTTGTATACC","ATATACTTTCCCAGTTGTT","561307.5.peg.1184"," 207"
"2098",836,555,281,"CCCAGTCATCAGCATCATCA","GGATTACCCCAATTCAAATC","561307.5.peg.1184"," 207"
"2099",10,555,545,"AATCAACACAGCGATAGCAA","GGATTACCCCAATTCAAATC","561307.5.peg.1184"," 207"
"2100",441,555,114,"GGTTCAGAGCCATCTGGCTT","GGATTACCCCAATTCAAATC","561307.5.peg.1184"," 207"
"2101",411,555,144,"CAAATGTACCAATCACGTTT","GGATTACCCCAATTCAAATC","561307.5.peg.1184"," 207"
"2102",141,555,414,"CCAATTTATCAATCATTCC","GGATTACCCCAATTCAAATC","561307.5.peg.1184"," 207"
"2103",391,555,164,"GGGATTGTCTTTACTAGATT","GGATTACCCCAATTCAAATC","561307.5.peg.1184"," 207"
"2104",747,555,192,"TGTAACCAAGTTTGTATACC","GGATTACCCCAATTCAAATC","561307.5.peg.1184"," 207"
"2105",411,576,165,"CAAATGTACCAATCACGTTT","AATACAGCATCTCTAACTTC","561307.5.peg.1184"," 207"
"2106",391,576,185,"GGGATTGTCTTTACTAGATT","AATACAGCATCTCTAACTTC","561307.5.peg.1184"," 207"
"2107",462,576,114,"ATATACTTTCCCAGTTGTT","AATACAGCATCTCTAACTTC","561307.5.peg.1184"," 207"
"2108",10,576,566,"AATCAACACAGCGATAGCAA","AATACAGCATCTCTAACTTC","561307.5.peg.1184"," 207"
"2109",441,576,135,"GGTTCAGAGCCATCTGGCTT","AATACAGCATCTCTAACTTC","561307.5.peg.1184"," 207"
"2110",836,576,260,"CCCAGTCATCAGCATCATCA","AATACAGCATCTCTAACTTC","561307.5.peg.1184"," 207"
"2111",747,576,171,"TGTAACCAAGTTTGTATACC","AATACAGCATCTCTAACTTC","561307.5.peg.1184"," 207"
"2112",141,576,435,"CCAATTTATCAATCATTCC","AATACAGCATCTCTAACTTC","561307.5.peg.1184"," 207"
"2113",576,747,171,"AATACAGCATCTCTAACTTC","TGTAACCAAGTTTGTATACC","561307.5.peg.1184"," 207"
"2114",141,747,606,"CCAATTTATCAATCATTCC","TGTAACCAAGTTTGTATACC","561307.5.peg.1184"," 207"
"2115",441,747,306,"GGTTCAGAGCCATCTGGCTT","TGTAACCAAGTTTGTATACC","561307.5.peg.1184"," 207"
"2116",391,747,356,"GGGATTGTCTTTACTAGATT","TGTAACCAAGTTTGTATACC","561307.5.peg.1184"," 207"
"2117",555,747,192,"GGATTACCCCAATTCAAATC","TGTAACCAAGTTTGTATACC","561307.5.peg.1184"," 207"
"2118",10,747,737,"AATCAACACAGCGATAGCAA","TGTAACCAAGTTTGTATACC","561307.5.peg.1184"," 207"
"2119",411,747,336,"CAAATGTACCAATCACGTTT","TGTAACCAAGTTTGTATACC","561307.5.peg.1184"," 207"
"2120",462,747,285,"ATATACTTTCCCAGTTGTT","TGTAACCAAGTTTGTATACC","561307.5.peg.1184"," 207"
"2121",391,836,445,"GGGATTGTCTTTACTAGATT","CCCAGTCATCAGCATCATCA","561307.5.peg.1184"," 207"
"2122",441,836,395,"GGTTCAGAGCCATCTGGCTT","CCCAGTCATCAGCATCATCA","561307.5.peg.1184"," 207"
"2123",462,836,374,"ATATACTTTCCCAGTTGTT","CCCAGTCATCAGCATCATCA","561307.5.peg.1184"," 207"
"2124",576,836,260,"AATACAGCATCTCTAACTTC","CCCAGTCATCAGCATCATCA","561307.5.peg.1184"," 207"
"2125",411,836,425,"CAAATGTACCAATCACGTTT","CCCAGTCATCAGCATCATCA","561307.5.peg.1184"," 207"
"2126",555,836,281,"GGATTACCCCAATTCAAATC","CCCAGTCATCAGCATCATCA","561307.5.peg.1184"," 207"
"2127",141,836,695,"CCAATTTATCAATCATTCC","CCCAGTCATCAGCATCATCA","561307.5.peg.1184"," 207"
"2128",10,836,826,"AATCAACACAGCGATAGCAA","CCCAGTCATCAGCATCATCA","561307.5.peg.1184"," 207"
"2129",420,132,288,"GAAATAACGCCAAAGAATTG","TGGTAGAGATGGAATATTGA","561307.5.peg.1187"," 210"
"2130",420,143,277,"GAAATAACGCCAAAGAATTG","AATTGTCTTGTTGGTAGAGA","561307.5.peg.1187"," 210"
"2131",420,181,239,"GAAATAACGCCAAAGAATTG","ACGACGTCCAATACCGATGA","561307.5.peg.1187"," 210"
"2132",132,420,288,"TGGTAGAGATGGAATATTGA","GAAATAACGCCAAAGAATTG","561307.5.peg.1187"," 210"
"2133",143,420,277,"AATTGTCTTGTTGGTAGAGA","GAAATAACGCCAAAGAATTG","561307.5.peg.1187"," 210"
"2134",181,420,239,"ACGACGTCCAATACCGATGA","GAAATAACGCCAAAGAATTG","561307.5.peg.1187"," 210"
"2135",267,132,135,"GAACGACTAGAAAGTAATCC","AGCCATATGGAATTGGAATA","561307.5.peg.1189"," 212"
"2136",312,132,180,"TTTGGTCCAACCAATGTAAG","AGCCATATGGAATTGGAATA","561307.5.peg.1189"," 212"
"2137",132,267,135,"AGCCATATGGAATTGGAATA","GAACGACTAGAAAGTAATCC","561307.5.peg.1189"," 212"
"2138",132,312,180,"AGCCATATGGAATTGGAATA","TTTGGTCCAACCAATGTAAG","561307.5.peg.1189"," 212"
"2139",342,174,168,"AAGGTTTCAATATTTGTGA","GTACCTAAAGCCACAGATGG","561307.5.peg.119"," 213"
"2140",342,177,165,"AAGGTTTCAATATTTGTGA","TTTGTACCTAAAGCCACAGA","561307.5.peg.119"," 213"
"2141",174,342,168,"GTACCTAAAGCCACAGATGG","AAGGTTTCAATATTTGTGA","561307.5.peg.119"," 213"
"2142",177,342,165,"TTTGTACCTAAAGCCACAGA","AAGGTTTCAATATTTGTGA","561307.5.peg.119"," 213"
"2143",405,259,146,"CCAACTTGCGCATTTGTGTT","AGCATCAAAGTCATGTGGTT","561307.5.peg.1190"," 214"
"2144",259,405,146,"AGCATCAAAGTCATGTGGTT","CCAACTTGCGCATTTGTGTT","561307.5.peg.1190"," 214"
"2145",415,136,279,"TTCGTCTAATGGGTCATCAA","GCACAATCTATAATTTGTT","561307.5.peg.1193"," 217"
"2146",136,415,279,"GCACAATCTATAATTTGTT","TTCGTCTAATGGGTCATCAA","561307.5.peg.1193"," 217"
"2147",255,135,120,"CCAGCTGGAATTTCTAGCAA","CTTGTTGACGTTTCACCGTT","561307.5.peg.1194"," 218"
"2148",270,135,135,"TCATCTTCTAATTTACCAGC","CTTGTTGACGTTTCACCGTT","561307.5.peg.1194"," 218"
"2149",135,255,120,"CTTGTTGACGTTTCACCGTT","CCAGCTGGAATTTCTAGCAA","561307.5.peg.1194"," 218"
"2150",135,270,135,"CTTGTTGACGTTTCACCGTT","TCATCTTCTAATTTACCAGC","561307.5.peg.1194"," 218"
"2151",111,7,104,"CTAACAGTAGCTTCGCGTTG","TTAATTATTAGTAGGGGAG","561307.5.peg.1195"," 219"
"2152",204,7,197,"ACTGTCGCCAAGCCAATTTC","TTAATTATTAGTAGGGGAG","561307.5.peg.1195"," 219"
"2153",7,111,104,"TTAATTATTAGTAGGGGAG","CTAACAGTAGCTTCGCGTTG","561307.5.peg.1195"," 219"
"2154",7,204,197,"TTAATTATTAGTAGGGGAG","ACTGTCGCCAAGCCAATTTC","561307.5.peg.1195"," 219"
"2155",141,9,132,"TGCTCTGTTAATGCTTGCAT","TGCACATATGACGCAATACG","561307.5.peg.1198"," 222"
"2156",221,9,212,"AGAGTTCTGACGCTAATACT","TGCACATATGACGCAATACG","561307.5.peg.1198"," 222"
"2157",270,9,261,"TCCATATCTGATGTTGATTG","TGCACATATGACGCAATACG","561307.5.peg.1198"," 222"
"2158",305,9,296,"GCCCAACTAAATCTTCCCGT","TGCACATATGACGCAATACG","561307.5.peg.1198"," 222"
"2159",9,141,132,"TGCACATATGACGCAATACG","TGCTCTGTTAATGCTTGCAT","561307.5.peg.1198"," 222"
"2160",270,141,129,"TCCATATCTGATGTTGATTG","TGCTCTGTTAATGCTTGCAT","561307.5.peg.1198"," 222"
"2161",305,141,164,"GCCCAACTAAATCTTCCCGT","TGCTCTGTTAATGCTTGCAT","561307.5.peg.1198"," 222"
"2162",9,221,212,"TGCACATATGACGCAATACG","AGAGTTCTGACGCTAATACT","561307.5.peg.1198"," 222"
"2163",9,270,261,"TGCACATATGACGCAATACG","TCCATATCTGATGTTGATTG","561307.5.peg.1198"," 222"
"2164",141,270,129,"TGCTCTGTTAATGCTTGCAT","TCCATATCTGATGTTGATTG","561307.5.peg.1198"," 222"
"2165",9,305,296,"TGCACATATGACGCAATACG","GCCCAACTAAATCTTCCCGT","561307.5.peg.1198"," 222"
"2166",141,305,164,"TGCTCTGTTAATGCTTGCAT","GCCCAACTAAATCTTCCCGT","561307.5.peg.1198"," 222"
"2167",344,23,321,"TAGGATTTAAAGACGCATAT","GACACCCTTTCTACCTTGAG","561307.5.peg.12"," 224"
"2168",407,23,384,"GCTTATCAGTTGCTAAATGA","GACACCCTTTCTACCTTGAG","561307.5.peg.12"," 224"
"2169",23,344,321,"GACACCCTTTCTACCTTGAG","TAGGATTTAAAGACGCATAT","561307.5.peg.12"," 224"
"2170",23,407,384,"GACACCCTTTCTACCTTGAG","GCTTATCAGTTGCTAAATGA","561307.5.peg.12"," 224"
"2171",351,192,159,"TCATAGTCTAAACGACCAAC","TCAACTTCAATCGTATCTGA","561307.5.peg.1200"," 226"
"2172",192,351,159,"TCAACTTCAATCGTATCTGA","TCATAGTCTAAACGACCAAC","561307.5.peg.1200"," 226"
"2173",236,46,190,"CACGCAATTTAGTTGCCACC","AAGTATTTCGTTCGACATAC","561307.5.peg.1201"," 227"
"2174",366,46,320,"ACTCTTAAGACTACTTCTCT","AAGTATTTCGTTCGACATAC","561307.5.peg.1201"," 227"
"2175",155,46,109,"TTGCAAGTTCATAAGCCTCT","AAGTATTTCGTTCGACATAC","561307.5.peg.1201"," 227"
"2176",273,46,227,"TAGCAGTCAACATAATAAT","AAGTATTTCGTTCGACATAC","561307.5.peg.1201"," 227"
"2177",366,155,211,"ACTCTTAAGACTACTTCTCT","TTGCAAGTTCATAAGCCTCT","561307.5.peg.1201"," 227"
"2178",46,155,109,"AAGTATTTCGTTCGACATAC","TTGCAAGTTCATAAGCCTCT","561307.5.peg.1201"," 227"
"2179",273,155,118,"TAGCAGTCAACATAATAAT","TTGCAAGTTCATAAGCCTCT","561307.5.peg.1201"," 227"
"2180",46,236,190,"AAGTATTTCGTTCGACATAC","CACGCAATTTAGTTGCCACC","561307.5.peg.1201"," 227"
"2181",366,236,130,"ACTCTTAAGACTACTTCTCT","CACGCAATTTAGTTGCCACC","561307.5.peg.1201"," 227"
"2182",46,273,227,"AAGTATTTCGTTCGACATAC","TAGCAGTCAACATAATAAT","561307.5.peg.1201"," 227"
"2183",155,273,118,"TTGCAAGTTCATAAGCCTCT","TAGCAGTCAACATAATAAT","561307.5.peg.1201"," 227"
"2184",46,366,320,"AAGTATTTCGTTCGACATAC","ACTCTTAAGACTACTTCTCT","561307.5.peg.1201"," 227"
"2185",155,366,211,"TTGCAAGTTCATAAGCCTCT","ACTCTTAAGACTACTTCTCT","561307.5.peg.1201"," 227"
"2186",236,366,130,"CACGCAATTTAGTTGCCACC","ACTCTTAAGACTACTTCTCT","561307.5.peg.1201"," 227"
"2187",225,2,223,"TTTATAATCATCAACCCACC","TAATTACGACACTATTTAGC","561307.5.peg.1202"," 228"
"2188",617,2,615,"CTTCAGATACACGTGTAGCT","TAATTACGACACTATTTAGC","561307.5.peg.1202"," 228"
"2189",597,2,595,"TGGTCTCTTAAACGTCTTAA","TAATTACGACACTATTTAGC","561307.5.peg.1202"," 228"
"2190",657,2,655,"TCATCTTTCGTTGTGACAGA","TAATTACGACACTATTTAGC","561307.5.peg.1202"," 228"
"2191",800,2,798,"GTCGACTCTCATTAATACCT","TAATTACGACACTATTTAGC","561307.5.peg.1202"," 228"
"2192",225,19,206,"TTTATAATCATCAACCCACC","TAGTGTCGTAATTAAACTG","561307.5.peg.1202"," 228"
"2193",800,19,781,"GTCGACTCTCATTAATACCT","TAGTGTCGTAATTAAACTG","561307.5.peg.1202"," 228"
"2194",597,19,578,"TGGTCTCTTAAACGTCTTAA","TAGTGTCGTAATTAAACTG","561307.5.peg.1202"," 228"
"2195",617,19,598,"CTTCAGATACACGTGTAGCT","TAGTGTCGTAATTAAACTG","561307.5.peg.1202"," 228"
"2196",657,19,638,"TCATCTTTCGTTGTGACAGA","TAGTGTCGTAATTAAACTG","561307.5.peg.1202"," 228"
"2197",2,225,223,"TAATTACGACACTATTTAGC","TTTATAATCATCAACCCACC","561307.5.peg.1202"," 228"
"2198",19,225,206,"TAGTGTCGTAATTAAACTG","TTTATAATCATCAACCCACC","561307.5.peg.1202"," 228"
"2199",617,225,392,"CTTCAGATACACGTGTAGCT","TTTATAATCATCAACCCACC","561307.5.peg.1202"," 228"
"2200",657,225,432,"TCATCTTTCGTTGTGACAGA","TTTATAATCATCAACCCACC","561307.5.peg.1202"," 228"
"2201",800,225,575,"GTCGACTCTCATTAATACCT","TTTATAATCATCAACCCACC","561307.5.peg.1202"," 228"
"2202",597,225,372,"TGGTCTCTTAAACGTCTTAA","TTTATAATCATCAACCCACC","561307.5.peg.1202"," 228"
"2203",2,597,595,"TAATTACGACACTATTTAGC","TGGTCTCTTAAACGTCTTAA","561307.5.peg.1202"," 228"
"2204",19,597,578,"TAGTGTCGTAATTAAACTG","TGGTCTCTTAAACGTCTTAA","561307.5.peg.1202"," 228"
"2205",800,597,203,"GTCGACTCTCATTAATACCT","TGGTCTCTTAAACGTCTTAA","561307.5.peg.1202"," 228"
"2206",225,597,372,"TTTATAATCATCAACCCACC","TGGTCTCTTAAACGTCTTAA","561307.5.peg.1202"," 228"
"2207",19,617,598,"TAGTGTCGTAATTAAACTG","CTTCAGATACACGTGTAGCT","561307.5.peg.1202"," 228"
"2208",2,617,615,"TAATTACGACACTATTTAGC","CTTCAGATACACGTGTAGCT","561307.5.peg.1202"," 228"
"2209",800,617,183,"GTCGACTCTCATTAATACCT","CTTCAGATACACGTGTAGCT","561307.5.peg.1202"," 228"
"2210",225,617,392,"TTTATAATCATCAACCCACC","CTTCAGATACACGTGTAGCT","561307.5.peg.1202"," 228"
"2211",2,657,655,"TAATTACGACACTATTTAGC","TCATCTTTCGTTGTGACAGA","561307.5.peg.1202"," 228"
"2212",19,657,638,"TAGTGTCGTAATTAAACTG","TCATCTTTCGTTGTGACAGA","561307.5.peg.1202"," 228"
"2213",225,657,432,"TTTATAATCATCAACCCACC","TCATCTTTCGTTGTGACAGA","561307.5.peg.1202"," 228"
"2214",800,657,143,"GTCGACTCTCATTAATACCT","TCATCTTTCGTTGTGACAGA","561307.5.peg.1202"," 228"
"2215",657,800,143,"TCATCTTTCGTTGTGACAGA","GTCGACTCTCATTAATACCT","561307.5.peg.1202"," 228"
"2216",225,800,575,"TTTATAATCATCAACCCACC","GTCGACTCTCATTAATACCT","561307.5.peg.1202"," 228"
"2217",2,800,798,"TAATTACGACACTATTTAGC","GTCGACTCTCATTAATACCT","561307.5.peg.1202"," 228"
"2218",19,800,781,"TAGTGTCGTAATTAAACTG","GTCGACTCTCATTAATACCT","561307.5.peg.1202"," 228"
"2219",597,800,203,"TGGTCTCTTAAACGTCTTAA","GTCGACTCTCATTAATACCT","561307.5.peg.1202"," 228"
"2220",617,800,183,"CTTCAGATACACGTGTAGCT","GTCGACTCTCATTAATACCT","561307.5.peg.1202"," 228"
"2221",177,8,169,"CCTAATATACCGACCCCTGA","TAAGCCACATAAATAAGAGG","561307.5.peg.1204"," 230"
"2222",258,8,250,"AATGCTTGTTTAATCGCATC","TAAGCCACATAAATAAGAGG","561307.5.peg.1204"," 230"
"2223",177,10,167,"CCTAATATACCGACCCCTGA","ATAAGCCACATAAATAAGA","561307.5.peg.1204"," 230"
"2224",258,10,248,"AATGCTTGTTTAATCGCATC","ATAAGCCACATAAATAAGA","561307.5.peg.1204"," 230"
"2225",177,25,152,"CCTAATATACCGACCCCTGA","ATTTCCCCCTCTTATTTATG","561307.5.peg.1204"," 230"
"2226",258,25,233,"AATGCTTGTTTAATCGCATC","ATTTCCCCCTCTTATTTATG","561307.5.peg.1204"," 230"
"2227",177,69,108,"CCTAATATACCGACCCCTGA","AACCTTCCAGTCCATAAATT","561307.5.peg.1204"," 230"
"2228",258,69,189,"AATGCTTGTTTAATCGCATC","AACCTTCCAGTCCATAAATT","561307.5.peg.1204"," 230"
"2229",8,177,169,"TAAGCCACATAAATAAGAGG","CCTAATATACCGACCCCTGA","561307.5.peg.1204"," 230"
"2230",10,177,167,"ATAAGCCACATAAATAAGA","CCTAATATACCGACCCCTGA","561307.5.peg.1204"," 230"
"2231",25,177,152,"ATTTCCCCCTCTTATTTATG","CCTAATATACCGACCCCTGA","561307.5.peg.1204"," 230"
"2232",69,177,108,"AACCTTCCAGTCCATAAATT","CCTAATATACCGACCCCTGA","561307.5.peg.1204"," 230"
"2233",8,258,250,"TAAGCCACATAAATAAGAGG","AATGCTTGTTTAATCGCATC","561307.5.peg.1204"," 230"
"2234",10,258,248,"ATAAGCCACATAAATAAGA","AATGCTTGTTTAATCGCATC","561307.5.peg.1204"," 230"
"2235",25,258,233,"ATTTCCCCCTCTTATTTATG","AATGCTTGTTTAATCGCATC","561307.5.peg.1204"," 230"
"2236",69,258,189,"AACCTTCCAGTCCATAAATT","AATGCTTGTTTAATCGCATC","561307.5.peg.1204"," 230"
"2237",290,11,279,"GTCCGAATGTCATTGAAGCA","CCTATTACACACATTCTGAT","561307.5.peg.1206"," 232"
"2238",419,11,408,"TGTTAAATATGCAATACCT","CCTATTACACACATTCTGAT","561307.5.peg.1206"," 232"
"2239",290,18,272,"GTCCGAATGTCATTGAAGCA","CCAATCAGAATGTGTGTAAT","561307.5.peg.1206"," 232"
"2240",419,18,401,"TGTTAAATATGCAATACCT","CCAATCAGAATGTGTGTAAT","561307.5.peg.1206"," 232"
"2241",11,290,279,"CCTATTACACACATTCTGAT","GTCCGAATGTCATTGAAGCA","561307.5.peg.1206"," 232"
"2242",419,290,129,"TGTTAAATATGCAATACCT","GTCCGAATGTCATTGAAGCA","561307.5.peg.1206"," 232"
"2243",18,290,272,"CCAATCAGAATGTGTGTAAT","GTCCGAATGTCATTGAAGCA","561307.5.peg.1206"," 232"
"2244",18,419,401,"CCAATCAGAATGTGTGTAAT","TGTTAAATATGCAATACCT","561307.5.peg.1206"," 232"
"2245",11,419,408,"CCTATTACACACATTCTGAT","TGTTAAATATGCAATACCT","561307.5.peg.1206"," 232"
"2246",290,419,129,"GTCCGAATGTCATTGAAGCA","TGTTAAATATGCAATACCT","561307.5.peg.1206"," 232"
"2247",216,86,130,"AACCCACAAACTGCTTTATG","TCGAGCTATAAGGCAAATCT","561307.5.peg.1208"," 234"
"2248",276,86,190,"ATCGCATGAGTAGGTAGTGT","TCGAGCTATAAGGCAAATCT","561307.5.peg.1208"," 234"
"2249",285,86,199,"TCTCCAAACATCGCATGAGT","TCGAGCTATAAGGCAAATCT","561307.5.peg.1208"," 234"
"2250",216,114,102,"AACCCACAAACTGCTTTATG","TTATCTAAAGCAGAGCGCAT","561307.5.peg.1208"," 234"
"2251",276,114,162,"ATCGCATGAGTAGGTAGTGT","TTATCTAAAGCAGAGCGCAT","561307.5.peg.1208"," 234"
"2252",285,114,171,"TCTCCAAACATCGCATGAGT","TTATCTAAAGCAGAGCGCAT","561307.5.peg.1208"," 234"
"2253",86,216,130,"TCGAGCTATAAGGCAAATCT","AACCCACAAACTGCTTTATG","561307.5.peg.1208"," 234"
"2254",114,216,102,"TTATCTAAAGCAGAGCGCAT","AACCCACAAACTGCTTTATG","561307.5.peg.1208"," 234"
"2255",86,276,190,"TCGAGCTATAAGGCAAATCT","ATCGCATGAGTAGGTAGTGT","561307.5.peg.1208"," 234"
"2256",114,276,162,"TTATCTAAAGCAGAGCGCAT","ATCGCATGAGTAGGTAGTGT","561307.5.peg.1208"," 234"
"2257",86,285,199,"TCGAGCTATAAGGCAAATCT","TCTCCAAACATCGCATGAGT","561307.5.peg.1208"," 234"
"2258",114,285,171,"TTATCTAAAGCAGAGCGCAT","TCTCCAAACATCGCATGAGT","561307.5.peg.1208"," 234"
"2259",294,26,268,"GTATCAATCCAATTGAATC","CTATGATTGCTAAGACCTAT","561307.5.peg.121"," 236"
"2260",178,26,152,"TCTAACAATCCTCTTTCAT","CTATGATTGCTAAGACCTAT","561307.5.peg.121"," 236"
"2261",420,26,394,"TGATGCATAACCGCAATTTC","CTATGATTGCTAAGACCTAT","561307.5.peg.121"," 236"
"2262",385,26,359,"TACAGTAGCACTTAAATGAC","CTATGATTGCTAAGACCTAT","561307.5.peg.121"," 236"
"2263",26,178,152,"CTATGATTGCTAAGACCTAT","TCTAACAATCCTCTTTCAT","561307.5.peg.121"," 236"
"2264",294,178,116,"GTATCAATCCAATTGAATC","TCTAACAATCCTCTTTCAT","561307.5.peg.121"," 236"
"2265",385,178,207,"TACAGTAGCACTTAAATGAC","TCTAACAATCCTCTTTCAT","561307.5.peg.121"," 236"
"2266",420,178,242,"TGATGCATAACCGCAATTTC","TCTAACAATCCTCTTTCAT","561307.5.peg.121"," 236"
"2267",26,294,268,"CTATGATTGCTAAGACCTAT","GTATCAATCCAATTGAATC","561307.5.peg.121"," 236"
"2268",420,294,126,"TGATGCATAACCGCAATTTC","GTATCAATCCAATTGAATC","561307.5.peg.121"," 236"
"2269",178,294,116,"TCTAACAATCCTCTTTCAT","GTATCAATCCAATTGAATC","561307.5.peg.121"," 236"
"2270",26,385,359,"CTATGATTGCTAAGACCTAT","TACAGTAGCACTTAAATGAC","561307.5.peg.121"," 236"
"2271",178,385,207,"TCTAACAATCCTCTTTCAT","TACAGTAGCACTTAAATGAC","561307.5.peg.121"," 236"
"2272",294,420,126,"GTATCAATCCAATTGAATC","TGATGCATAACCGCAATTTC","561307.5.peg.121"," 236"
"2273",26,420,394,"CTATGATTGCTAAGACCTAT","TGATGCATAACCGCAATTTC","561307.5.peg.121"," 236"
"2274",178,420,242,"TCTAACAATCCTCTTTCAT","TGATGCATAACCGCAATTTC","561307.5.peg.121"," 236"
"2275",452,7,445,"TCGTCACATCGATATCACCC","ACAAGTGTTCAAGCTCTGCT","561307.5.peg.1210"," 237"
"2276",500,7,493,"CTTCGTATTCAATCGACCAT","ACAAGTGTTCAAGCTCTGCT","561307.5.peg.1210"," 237"
"2277",452,11,441,"TCGTCACATCGATATCACCC","TTGAACACTTGTGGTTAGAA","561307.5.peg.1210"," 237"
"2278",500,11,489,"CTTCGTATTCAATCGACCAT","TTGAACACTTGTGGTTAGAA","561307.5.peg.1210"," 237"
"2279",452,20,432,"TCGTCACATCGATATCACCC","CAGCAGAGCTTGAACACTTG","561307.5.peg.1210"," 237"
"2280",500,20,480,"CTTCGTATTCAATCGACCAT","CAGCAGAGCTTGAACACTTG","561307.5.peg.1210"," 237"
"2281",7,452,445,"ACAAGTGTTCAAGCTCTGCT","TCGTCACATCGATATCACCC","561307.5.peg.1210"," 237"
"2282",11,452,441,"TTGAACACTTGTGGTTAGAA","TCGTCACATCGATATCACCC","561307.5.peg.1210"," 237"
"2283",20,452,432,"CAGCAGAGCTTGAACACTTG","TCGTCACATCGATATCACCC","561307.5.peg.1210"," 237"
"2284",7,500,493,"ACAAGTGTTCAAGCTCTGCT","CTTCGTATTCAATCGACCAT","561307.5.peg.1210"," 237"
"2285",11,500,489,"TTGAACACTTGTGGTTAGAA","CTTCGTATTCAATCGACCAT","561307.5.peg.1210"," 237"
"2286",20,500,480,"CAGCAGAGCTTGAACACTTG","CTTCGTATTCAATCGACCAT","561307.5.peg.1210"," 237"
"2287",110,10,100,"CCCTAAGCCACAGCCAAATC","ATTGATAGCAAATGTGTGA","561307.5.peg.1211"," 238"
"2288",10,110,100,"ATTGATAGCAAATGTGTGA","CCCTAAGCCACAGCCAAATC","561307.5.peg.1211"," 238"
"2289",139,1,138,"GTTAGATAGGCCAATCATTA","CATTGAGAAGGTTGGTGGCA","561307.5.peg.1212"," 239"
"2290",469,1,468,"TTGTTGATATTTAATTCCC","CATTGAGAAGGTTGGTGGCA","561307.5.peg.1212"," 239"
"2291",139,6,133,"GTTAGATAGGCCAATCATTA","ATATTCATTGAGAAGGTTGG","561307.5.peg.1212"," 239"
"2292",469,6,463,"TTGTTGATATTTAATTCCC","ATATTCATTGAGAAGGTTGG","561307.5.peg.1212"," 239"
"2293",1,139,138,"CATTGAGAAGGTTGGTGGCA","GTTAGATAGGCCAATCATTA","561307.5.peg.1212"," 239"
"2294",469,139,330,"TTGTTGATATTTAATTCCC","GTTAGATAGGCCAATCATTA","561307.5.peg.1212"," 239"
"2295",6,139,133,"ATATTCATTGAGAAGGTTGG","GTTAGATAGGCCAATCATTA","561307.5.peg.1212"," 239"
"2296",6,469,463,"ATATTCATTGAGAAGGTTGG","TTGTTGATATTTAATTCCC","561307.5.peg.1212"," 239"
"2297",1,469,468,"CATTGAGAAGGTTGGTGGCA","TTGTTGATATTTAATTCCC","561307.5.peg.1212"," 239"
"2298",139,469,330,"GTTAGATAGGCCAATCATTA","TTGTTGATATTTAATTCCC","561307.5.peg.1212"," 239"
"2299",327,183,144,"CGAACGCACAACGCTAAATT","ATTATTAGCACACACACAGC","561307.5.peg.1214"," 241"
"2300",183,327,144,"ATTATTAGCACACACACAGC","CGAACGCACAACGCTAAATT","561307.5.peg.1214"," 241"
"2301",445,9,436,"ATGACCGCCTTCCATAGACA","GAGAGGGATATTCAACAAGG","561307.5.peg.1216"," 243"
"2302",162,9,153,"AAGATTAAGCCGCCAATCAC","GAGAGGGATATTCAACAAGG","561307.5.peg.1216"," 243"
"2303",420,9,411,"CCTGCTGTTAATCCTAACAA","GAGAGGGATATTCAACAAGG","561307.5.peg.1216"," 243"
"2304",621,9,612,"AATGTATCGTCACTATGTTG","GAGAGGGATATTCAACAAGG","561307.5.peg.1216"," 243"
"2305",420,95,325,"CCTGCTGTTAATCCTAACAA","AGCCTTACCAAGTAAATAA","561307.5.peg.1216"," 243"
"2306",621,95,526,"AATGTATCGTCACTATGTTG","AGCCTTACCAAGTAAATAA","561307.5.peg.1216"," 243"
"2307",445,95,350,"ATGACCGCCTTCCATAGACA","AGCCTTACCAAGTAAATAA","561307.5.peg.1216"," 243"
"2308",9,162,153,"GAGAGGGATATTCAACAAGG","AAGATTAAGCCGCCAATCAC","561307.5.peg.1216"," 243"
"2309",420,162,258,"CCTGCTGTTAATCCTAACAA","AAGATTAAGCCGCCAATCAC","561307.5.peg.1216"," 243"
"2310",445,162,283,"ATGACCGCCTTCCATAGACA","AAGATTAAGCCGCCAATCAC","561307.5.peg.1216"," 243"
"2311",621,162,459,"AATGTATCGTCACTATGTTG","AAGATTAAGCCGCCAATCAC","561307.5.peg.1216"," 243"
"2312",95,420,325,"AGCCTTACCAAGTAAATAA","CCTGCTGTTAATCCTAACAA","561307.5.peg.1216"," 243"
"2313",621,420,201,"AATGTATCGTCACTATGTTG","CCTGCTGTTAATCCTAACAA","561307.5.peg.1216"," 243"
"2314",162,420,258,"AAGATTAAGCCGCCAATCAC","CCTGCTGTTAATCCTAACAA","561307.5.peg.1216"," 243"
"2315",9,420,411,"GAGAGGGATATTCAACAAGG","CCTGCTGTTAATCCTAACAA","561307.5.peg.1216"," 243"
"2316",621,445,176,"AATGTATCGTCACTATGTTG","ATGACCGCCTTCCATAGACA","561307.5.peg.1216"," 243"
"2317",9,445,436,"GAGAGGGATATTCAACAAGG","ATGACCGCCTTCCATAGACA","561307.5.peg.1216"," 243"
"2318",95,445,350,"AGCCTTACCAAGTAAATAA","ATGACCGCCTTCCATAGACA","561307.5.peg.1216"," 243"
"2319",162,445,283,"AAGATTAAGCCGCCAATCAC","ATGACCGCCTTCCATAGACA","561307.5.peg.1216"," 243"
"2320",9,621,612,"GAGAGGGATATTCAACAAGG","AATGTATCGTCACTATGTTG","561307.5.peg.1216"," 243"
"2321",420,621,201,"CCTGCTGTTAATCCTAACAA","AATGTATCGTCACTATGTTG","561307.5.peg.1216"," 243"
"2322",95,621,526,"AGCCTTACCAAGTAAATAA","AATGTATCGTCACTATGTTG","561307.5.peg.1216"," 243"
"2323",445,621,176,"ATGACCGCCTTCCATAGACA","AATGTATCGTCACTATGTTG","561307.5.peg.1216"," 243"
"2324",162,621,459,"AAGATTAAGCCGCCAATCAC","AATGTATCGTCACTATGTTG","561307.5.peg.1216"," 243"
"2325",198,91,107,"AATGAAACGACGCCATTATA","TCCAGTTACTGAGGTTAGAA","561307.5.peg.1218"," 245"
"2326",318,91,227,"CCATTTCCTTTGTCACCGTT","TCCAGTTACTGAGGTTAGAA","561307.5.peg.1218"," 245"
"2327",313,91,222,"TCCTTTGTCACCGTTTGGAT","TCCAGTTACTGAGGTTAGAA","561307.5.peg.1218"," 245"
"2328",375,91,284,"ACAGAGATGTCTTCATCACC","TCCAGTTACTGAGGTTAGAA","561307.5.peg.1218"," 245"
"2329",313,100,213,"TCCTTTGTCACCGTTTGGAT","AGCATTTATTCCAGTTACTG","561307.5.peg.1218"," 245"
"2330",375,100,275,"ACAGAGATGTCTTCATCACC","AGCATTTATTCCAGTTACTG","561307.5.peg.1218"," 245"
"2331",318,100,218,"CCATTTCCTTTGTCACCGTT","AGCATTTATTCCAGTTACTG","561307.5.peg.1218"," 245"
"2332",91,198,107,"TCCAGTTACTGAGGTTAGAA","AATGAAACGACGCCATTATA","561307.5.peg.1218"," 245"
"2333",313,198,115,"TCCTTTGTCACCGTTTGGAT","AATGAAACGACGCCATTATA","561307.5.peg.1218"," 245"
"2334",375,198,177,"ACAGAGATGTCTTCATCACC","AATGAAACGACGCCATTATA","561307.5.peg.1218"," 245"
"2335",318,198,120,"CCATTTCCTTTGTCACCGTT","AATGAAACGACGCCATTATA","561307.5.peg.1218"," 245"
"2336",100,313,213,"AGCATTTATTCCAGTTACTG","TCCTTTGTCACCGTTTGGAT","561307.5.peg.1218"," 245"
"2337",91,313,222,"TCCAGTTACTGAGGTTAGAA","TCCTTTGTCACCGTTTGGAT","561307.5.peg.1218"," 245"
"2338",198,313,115,"AATGAAACGACGCCATTATA","TCCTTTGTCACCGTTTGGAT","561307.5.peg.1218"," 245"
"2339",100,318,218,"AGCATTTATTCCAGTTACTG","CCATTTCCTTTGTCACCGTT","561307.5.peg.1218"," 245"
"2340",91,318,227,"TCCAGTTACTGAGGTTAGAA","CCATTTCCTTTGTCACCGTT","561307.5.peg.1218"," 245"
"2341",198,318,120,"AATGAAACGACGCCATTATA","CCATTTCCTTTGTCACCGTT","561307.5.peg.1218"," 245"
"2342",91,375,284,"TCCAGTTACTGAGGTTAGAA","ACAGAGATGTCTTCATCACC","561307.5.peg.1218"," 245"
"2343",100,375,275,"AGCATTTATTCCAGTTACTG","ACAGAGATGTCTTCATCACC","561307.5.peg.1218"," 245"
"2344",198,375,177,"AATGAAACGACGCCATTATA","ACAGAGATGTCTTCATCACC","561307.5.peg.1218"," 245"
"2345",408,117,291,"AAGTTAGCTGGGTTGTGAAG","TTGTTACTAATTCCTCTTC","561307.5.peg.122"," 247"
"2346",344,117,227,"CAGTAATAGCTACTGATTCA","TTGTTACTAATTCCTCTTC","561307.5.peg.122"," 247"
"2347",317,117,200,"TTTCACCACCATGTACAACA","TTGTTACTAATTCCTCTTC","561307.5.peg.122"," 247"
"2348",462,117,345,"ATTGCCACATGAGGGATATT","TTGTTACTAATTCCTCTTC","561307.5.peg.122"," 247"
"2349",419,117,302,"GAATACCCATCAAGTTAGCT","TTGTTACTAATTCCTCTTC","561307.5.peg.122"," 247"
"2350",117,317,200,"TTGTTACTAATTCCTCTTC","TTTCACCACCATGTACAACA","561307.5.peg.122"," 247"
"2351",462,317,145,"ATTGCCACATGAGGGATATT","TTTCACCACCATGTACAACA","561307.5.peg.122"," 247"
"2352",419,317,102,"GAATACCCATCAAGTTAGCT","TTTCACCACCATGTACAACA","561307.5.peg.122"," 247"
"2353",117,344,227,"TTGTTACTAATTCCTCTTC","CAGTAATAGCTACTGATTCA","561307.5.peg.122"," 247"
"2354",462,344,118,"ATTGCCACATGAGGGATATT","CAGTAATAGCTACTGATTCA","561307.5.peg.122"," 247"
"2355",117,408,291,"TTGTTACTAATTCCTCTTC","AAGTTAGCTGGGTTGTGAAG","561307.5.peg.122"," 247"
"2356",117,419,302,"TTGTTACTAATTCCTCTTC","GAATACCCATCAAGTTAGCT","561307.5.peg.122"," 247"
"2357",317,419,102,"TTTCACCACCATGTACAACA","GAATACCCATCAAGTTAGCT","561307.5.peg.122"," 247"
"2358",117,462,345,"TTGTTACTAATTCCTCTTC","ATTGCCACATGAGGGATATT","561307.5.peg.122"," 247"
"2359",317,462,145,"TTTCACCACCATGTACAACA","ATTGCCACATGAGGGATATT","561307.5.peg.122"," 247"
"2360",344,462,118,"CAGTAATAGCTACTGATTCA","ATTGCCACATGAGGGATATT","561307.5.peg.122"," 247"
"2361",225,9,216,"ATCTGTGCCACATGTAATTC","TCCAGAACTTTATATGGTTC","561307.5.peg.1225"," 253"
"2362",564,9,555,"TGAACATCACCTGTTTCCTC","TCCAGAACTTTATATGGTTC","561307.5.peg.1225"," 253"
"2363",225,21,204,"ATCTGTGCCACATGTAATTC","ACCTGAACCATATAAAGTTC","561307.5.peg.1225"," 253"
"2364",564,21,543,"TGAACATCACCTGTTTCCTC","ACCTGAACCATATAAAGTTC","561307.5.peg.1225"," 253"
"2365",9,225,216,"TCCAGAACTTTATATGGTTC","ATCTGTGCCACATGTAATTC","561307.5.peg.1225"," 253"
"2366",564,225,339,"TGAACATCACCTGTTTCCTC","ATCTGTGCCACATGTAATTC","561307.5.peg.1225"," 253"
"2367",21,225,204,"ACCTGAACCATATAAAGTTC","ATCTGTGCCACATGTAATTC","561307.5.peg.1225"," 253"
"2368",21,564,543,"ACCTGAACCATATAAAGTTC","TGAACATCACCTGTTTCCTC","561307.5.peg.1225"," 253"
"2369",9,564,555,"TCCAGAACTTTATATGGTTC","TGAACATCACCTGTTTCCTC","561307.5.peg.1225"," 253"
"2370",225,564,339,"ATCTGTGCCACATGTAATTC","TGAACATCACCTGTTTCCTC","561307.5.peg.1225"," 253"
"2371",756,366,390,"TTATCGCTATATGATAACGG","TTTCCAACTTTAAGACGTGT","561307.5.peg.1228"," 256"
"2372",1237,366,871,"ATCTCATCGTTATTTCTCA","TTTCCAACTTTAAGACGTGT","561307.5.peg.1228"," 256"
"2373",713,366,347,"TTCCTTTGAGACAAGATTA","TTTCCAACTTTAAGACGTGT","561307.5.peg.1228"," 256"
"2374",1323,366,957,"GCATAAACATCTGCACTCAT","TTTCCAACTTTAAGACGTGT","561307.5.peg.1228"," 256"
"2375",366,713,347,"TTTCCAACTTTAAGACGTGT","TTCCTTTGAGACAAGATTA","561307.5.peg.1228"," 256"
"2376",1237,713,524,"ATCTCATCGTTATTTCTCA","TTCCTTTGAGACAAGATTA","561307.5.peg.1228"," 256"
"2377",1323,713,610,"GCATAAACATCTGCACTCAT","TTCCTTTGAGACAAGATTA","561307.5.peg.1228"," 256"
"2378",366,756,390,"TTTCCAACTTTAAGACGTGT","TTATCGCTATATGATAACGG","561307.5.peg.1228"," 256"
"2379",1237,756,481,"ATCTCATCGTTATTTCTCA","TTATCGCTATATGATAACGG","561307.5.peg.1228"," 256"
"2380",1323,756,567,"GCATAAACATCTGCACTCAT","TTATCGCTATATGATAACGG","561307.5.peg.1228"," 256"
"2381",756,1237,481,"TTATCGCTATATGATAACGG","ATCTCATCGTTATTTCTCA","561307.5.peg.1228"," 256"
"2382",366,1237,871,"TTTCCAACTTTAAGACGTGT","ATCTCATCGTTATTTCTCA","561307.5.peg.1228"," 256"
"2383",713,1237,524,"TTCCTTTGAGACAAGATTA","ATCTCATCGTTATTTCTCA","561307.5.peg.1228"," 256"
"2384",366,1323,957,"TTTCCAACTTTAAGACGTGT","GCATAAACATCTGCACTCAT","561307.5.peg.1228"," 256"
"2385",713,1323,610,"TTCCTTTGAGACAAGATTA","GCATAAACATCTGCACTCAT","561307.5.peg.1228"," 256"
"2386",756,1323,567,"TTATCGCTATATGATAACGG","GCATAAACATCTGCACTCAT","561307.5.peg.1228"," 256"
"2387",295,12,283,"TAACCTGAATTAATGTTTC","CACACGAAATTAAAGTGAA","561307.5.peg.1230"," 259"
"2388",12,295,283,"CACACGAAATTAAAGTGAA","TAACCTGAATTAATGTTTC","561307.5.peg.1230"," 259"
"2389",353,87,266,"CGTCAGTCCTATATTATAT","TCTTGAATCGGAGATGCTAA","561307.5.peg.1231"," 260"
"2390",476,87,389,"CACCTATAGATGGTGCTGAC","TCTTGAATCGGAGATGCTAA","561307.5.peg.1231"," 260"
"2391",353,99,254,"CGTCAGTCCTATATTATAT","TTTGCTCTAGATTCTTGAAT","561307.5.peg.1231"," 260"
"2392",476,99,377,"CACCTATAGATGGTGCTGAC","TTTGCTCTAGATTCTTGAAT","561307.5.peg.1231"," 260"
"2393",87,353,266,"TCTTGAATCGGAGATGCTAA","CGTCAGTCCTATATTATAT","561307.5.peg.1231"," 260"
"2394",476,353,123,"CACCTATAGATGGTGCTGAC","CGTCAGTCCTATATTATAT","561307.5.peg.1231"," 260"
"2395",99,353,254,"TTTGCTCTAGATTCTTGAAT","CGTCAGTCCTATATTATAT","561307.5.peg.1231"," 260"
"2396",99,476,377,"TTTGCTCTAGATTCTTGAAT","CACCTATAGATGGTGCTGAC","561307.5.peg.1231"," 260"
"2397",87,476,389,"TCTTGAATCGGAGATGCTAA","CACCTATAGATGGTGCTGAC","561307.5.peg.1231"," 260"
"2398",353,476,123,"CGTCAGTCCTATATTATAT","CACCTATAGATGGTGCTGAC","561307.5.peg.1231"," 260"
"2399",211,29,182,"TGTCAGTGTAATCATGTCTC","ATTATCCCTCCTTTATTCA","561307.5.peg.1233"," 262"
"2400",320,29,291,"TTTAATACCGTAAGCTGAA","ATTATCCCTCCTTTATTCA","561307.5.peg.1233"," 262"
"2401",29,211,182,"ATTATCCCTCCTTTATTCA","TGTCAGTGTAATCATGTCTC","561307.5.peg.1233"," 262"
"2402",320,211,109,"TTTAATACCGTAAGCTGAA","TGTCAGTGTAATCATGTCTC","561307.5.peg.1233"," 262"
"2403",29,320,291,"ATTATCCCTCCTTTATTCA","TTTAATACCGTAAGCTGAA","561307.5.peg.1233"," 262"
"2404",211,320,109,"TGTCAGTGTAATCATGTCTC","TTTAATACCGTAAGCTGAA","561307.5.peg.1233"," 262"
"2405",352,11,341,"TGTTAAACCTTGCTGTTGAA","CACGATGATTAACTTACAA","561307.5.peg.1234"," 263"
"2406",352,78,274,"TGTTAAACCTTGCTGTTGAA","AATAAAGCACTAGCTGTTAC","561307.5.peg.1234"," 263"
"2407",11,352,341,"CACGATGATTAACTTACAA","TGTTAAACCTTGCTGTTGAA","561307.5.peg.1234"," 263"
"2408",78,352,274,"AATAAAGCACTAGCTGTTAC","TGTTAAACCTTGCTGTTGAA","561307.5.peg.1234"," 263"
"2409",155,7,148,"TACTCTTACCAGCGCCATTA","TGGTACAATATAAGTCATGG","561307.5.peg.1238"," 267"
"2410",210,7,203,"ATTGATAGAGATCCTTCCAT","TGGTACAATATAAGTCATGG","561307.5.peg.1238"," 267"
"2411",291,7,284,"TCATAAATAACCGGTGATTC","TGGTACAATATAAGTCATGG","561307.5.peg.1238"," 267"
"2412",300,7,293,"GTGAGTTCTTCATAAATAAC","TGGTACAATATAAGTCATGG","561307.5.peg.1238"," 267"
"2413",7,155,148,"TGGTACAATATAAGTCATGG","TACTCTTACCAGCGCCATTA","561307.5.peg.1238"," 267"
"2414",291,155,136,"TCATAAATAACCGGTGATTC","TACTCTTACCAGCGCCATTA","561307.5.peg.1238"," 267"
"2415",300,155,145,"GTGAGTTCTTCATAAATAAC","TACTCTTACCAGCGCCATTA","561307.5.peg.1238"," 267"
"2416",7,210,203,"TGGTACAATATAAGTCATGG","ATTGATAGAGATCCTTCCAT","561307.5.peg.1238"," 267"
"2417",7,291,284,"TGGTACAATATAAGTCATGG","TCATAAATAACCGGTGATTC","561307.5.peg.1238"," 267"
"2418",155,291,136,"TACTCTTACCAGCGCCATTA","TCATAAATAACCGGTGATTC","561307.5.peg.1238"," 267"
"2419",7,300,293,"TGGTACAATATAAGTCATGG","GTGAGTTCTTCATAAATAAC","561307.5.peg.1238"," 267"
"2420",155,300,145,"TACTCTTACCAGCGCCATTA","GTGAGTTCTTCATAAATAAC","561307.5.peg.1238"," 267"
"2421",108,2,106,"ACTAAAGCGTGCACACCACT","AAGATGATTATGGAGGTGGA","561307.5.peg.124"," 269"
"2422",441,2,439,"CTTCCTGCTACCTCACTCAT","AAGATGATTATGGAGGTGGA","561307.5.peg.124"," 269"
"2423",414,2,412,"AACAATGGTAAAGATCGGTC","AAGATGATTATGGAGGTGGA","561307.5.peg.124"," 269"
"2424",429,2,427,"TCACTCATTGGTGATAACAA","AAGATGATTATGGAGGTGGA","561307.5.peg.124"," 269"
"2425",536,2,534,"CTTTACCCTTAGGTACTCCT","AAGATGATTATGGAGGTGGA","561307.5.peg.124"," 269"
"2426",414,6,408,"AACAATGGTAAAGATCGGTC","CGTTAAGATGATTATGGAGG","561307.5.peg.124"," 269"
"2427",536,6,530,"CTTTACCCTTAGGTACTCCT","CGTTAAGATGATTATGGAGG","561307.5.peg.124"," 269"
"2428",441,6,435,"CTTCCTGCTACCTCACTCAT","CGTTAAGATGATTATGGAGG","561307.5.peg.124"," 269"
"2429",429,6,423,"TCACTCATTGGTGATAACAA","CGTTAAGATGATTATGGAGG","561307.5.peg.124"," 269"
"2430",108,6,102,"ACTAAAGCGTGCACACCACT","CGTTAAGATGATTATGGAGG","561307.5.peg.124"," 269"
"2431",536,9,527,"CTTTACCCTTAGGTACTCCT","TCGCGTTAAGATGATTATGG","561307.5.peg.124"," 269"
"2432",441,9,432,"CTTCCTGCTACCTCACTCAT","TCGCGTTAAGATGATTATGG","561307.5.peg.124"," 269"
"2433",414,9,405,"AACAATGGTAAAGATCGGTC","TCGCGTTAAGATGATTATGG","561307.5.peg.124"," 269"
"2434",429,9,420,"TCACTCATTGGTGATAACAA","TCGCGTTAAGATGATTATGG","561307.5.peg.124"," 269"
"2435",536,12,524,"CTTTACCCTTAGGTACTCCT","TGTTCGCGTTAAGATGATTA","561307.5.peg.124"," 269"
"2436",414,12,402,"AACAATGGTAAAGATCGGTC","TGTTCGCGTTAAGATGATTA","561307.5.peg.124"," 269"
"2437",441,12,429,"CTTCCTGCTACCTCACTCAT","TGTTCGCGTTAAGATGATTA","561307.5.peg.124"," 269"
"2438",429,12,417,"TCACTCATTGGTGATAACAA","TGTTCGCGTTAAGATGATTA","561307.5.peg.124"," 269"
"2439",2,108,106,"AAGATGATTATGGAGGTGGA","ACTAAAGCGTGCACACCACT","561307.5.peg.124"," 269"
"2440",6,108,102,"CGTTAAGATGATTATGGAGG","ACTAAAGCGTGCACACCACT","561307.5.peg.124"," 269"
"2441",536,108,428,"CTTTACCCTTAGGTACTCCT","ACTAAAGCGTGCACACCACT","561307.5.peg.124"," 269"
"2442",429,108,321,"TCACTCATTGGTGATAACAA","ACTAAAGCGTGCACACCACT","561307.5.peg.124"," 269"
"2443",414,108,306,"AACAATGGTAAAGATCGGTC","ACTAAAGCGTGCACACCACT","561307.5.peg.124"," 269"
"2444",441,108,333,"CTTCCTGCTACCTCACTCAT","ACTAAAGCGTGCACACCACT","561307.5.peg.124"," 269"
"2445",2,414,412,"AAGATGATTATGGAGGTGGA","AACAATGGTAAAGATCGGTC","561307.5.peg.124"," 269"
"2446",108,414,306,"ACTAAAGCGTGCACACCACT","AACAATGGTAAAGATCGGTC","561307.5.peg.124"," 269"
"2447",9,414,405,"TCGCGTTAAGATGATTATGG","AACAATGGTAAAGATCGGTC","561307.5.peg.124"," 269"
"2448",12,414,402,"TGTTCGCGTTAAGATGATTA","AACAATGGTAAAGATCGGTC","561307.5.peg.124"," 269"
"2449",536,414,122,"CTTTACCCTTAGGTACTCCT","AACAATGGTAAAGATCGGTC","561307.5.peg.124"," 269"
"2450",6,414,408,"CGTTAAGATGATTATGGAGG","AACAATGGTAAAGATCGGTC","561307.5.peg.124"," 269"
"2451",9,429,420,"TCGCGTTAAGATGATTATGG","TCACTCATTGGTGATAACAA","561307.5.peg.124"," 269"
"2452",108,429,321,"ACTAAAGCGTGCACACCACT","TCACTCATTGGTGATAACAA","561307.5.peg.124"," 269"
"2453",2,429,427,"AAGATGATTATGGAGGTGGA","TCACTCATTGGTGATAACAA","561307.5.peg.124"," 269"
"2454",12,429,417,"TGTTCGCGTTAAGATGATTA","TCACTCATTGGTGATAACAA","561307.5.peg.124"," 269"
"2455",6,429,423,"CGTTAAGATGATTATGGAGG","TCACTCATTGGTGATAACAA","561307.5.peg.124"," 269"
"2456",536,429,107,"CTTTACCCTTAGGTACTCCT","TCACTCATTGGTGATAACAA","561307.5.peg.124"," 269"
"2457",6,441,435,"CGTTAAGATGATTATGGAGG","CTTCCTGCTACCTCACTCAT","561307.5.peg.124"," 269"
"2458",2,441,439,"AAGATGATTATGGAGGTGGA","CTTCCTGCTACCTCACTCAT","561307.5.peg.124"," 269"
"2459",12,441,429,"TGTTCGCGTTAAGATGATTA","CTTCCTGCTACCTCACTCAT","561307.5.peg.124"," 269"
"2460",108,441,333,"ACTAAAGCGTGCACACCACT","CTTCCTGCTACCTCACTCAT","561307.5.peg.124"," 269"
"2461",9,441,432,"TCGCGTTAAGATGATTATGG","CTTCCTGCTACCTCACTCAT","561307.5.peg.124"," 269"
"2462",12,536,524,"TGTTCGCGTTAAGATGATTA","CTTTACCCTTAGGTACTCCT","561307.5.peg.124"," 269"
"2463",414,536,122,"AACAATGGTAAAGATCGGTC","CTTTACCCTTAGGTACTCCT","561307.5.peg.124"," 269"
"2464",108,536,428,"ACTAAAGCGTGCACACCACT","CTTTACCCTTAGGTACTCCT","561307.5.peg.124"," 269"
"2465",2,536,534,"AAGATGATTATGGAGGTGGA","CTTTACCCTTAGGTACTCCT","561307.5.peg.124"," 269"
"2466",429,536,107,"TCACTCATTGGTGATAACAA","CTTTACCCTTAGGTACTCCT","561307.5.peg.124"," 269"
"2467",9,536,527,"TCGCGTTAAGATGATTATGG","CTTTACCCTTAGGTACTCCT","561307.5.peg.124"," 269"
"2468",6,536,530,"CGTTAAGATGATTATGGAGG","CTTTACCCTTAGGTACTCCT","561307.5.peg.124"," 269"
"2469",270,113,157,"TATGCATGATCTTCTGTTGA","ATTGGAATAGTTGATGGGTC","561307.5.peg.1240"," 270"
"2470",113,270,157,"ATTGGAATAGTTGATGGGTC","TATGCATGATCTTCTGTTGA","561307.5.peg.1240"," 270"
"2471",288,114,174,"TCGACACCAATTGGCTTTAA","GCTTGTCGCATAAACCAAAC","561307.5.peg.1241"," 271"
"2472",395,114,281,"CATATGGTACATCTCGTTCG","GCTTGTCGCATAAACCAAAC","561307.5.peg.1241"," 271"
"2473",336,114,222,"TGATTGGATTATGAATCAC","GCTTGTCGCATAAACCAAAC","561307.5.peg.1241"," 271"
"2474",297,114,183,"ATTTCTACATCGACACCAAT","GCTTGTCGCATAAACCAAAC","561307.5.peg.1241"," 271"
"2475",397,114,283,"TACATATGGTACATCTCGTT","GCTTGTCGCATAAACCAAAC","561307.5.peg.1241"," 271"
"2476",336,140,196,"TGATTGGATTATGAATCAC","TTCGATATTCTGGTTGCGAA","561307.5.peg.1241"," 271"
"2477",288,140,148,"TCGACACCAATTGGCTTTAA","TTCGATATTCTGGTTGCGAA","561307.5.peg.1241"," 271"
"2478",297,140,157,"ATTTCTACATCGACACCAAT","TTCGATATTCTGGTTGCGAA","561307.5.peg.1241"," 271"
"2479",397,140,257,"TACATATGGTACATCTCGTT","TTCGATATTCTGGTTGCGAA","561307.5.peg.1241"," 271"
"2480",395,140,255,"CATATGGTACATCTCGTTCG","TTCGATATTCTGGTTGCGAA","561307.5.peg.1241"," 271"
"2481",395,204,191,"CATATGGTACATCTCGTTCG","GTTACATAAGCGCACAACTC","561307.5.peg.1241"," 271"
"2482",397,204,193,"TACATATGGTACATCTCGTT","GTTACATAAGCGCACAACTC","561307.5.peg.1241"," 271"
"2483",336,204,132,"TGATTGGATTATGAATCAC","GTTACATAAGCGCACAACTC","561307.5.peg.1241"," 271"
"2484",114,288,174,"GCTTGTCGCATAAACCAAAC","TCGACACCAATTGGCTTTAA","561307.5.peg.1241"," 271"
"2485",140,288,148,"TTCGATATTCTGGTTGCGAA","TCGACACCAATTGGCTTTAA","561307.5.peg.1241"," 271"
"2486",395,288,107,"CATATGGTACATCTCGTTCG","TCGACACCAATTGGCTTTAA","561307.5.peg.1241"," 271"
"2487",397,288,109,"TACATATGGTACATCTCGTT","TCGACACCAATTGGCTTTAA","561307.5.peg.1241"," 271"
"2488",114,297,183,"GCTTGTCGCATAAACCAAAC","ATTTCTACATCGACACCAAT","561307.5.peg.1241"," 271"
"2489",397,297,100,"TACATATGGTACATCTCGTT","ATTTCTACATCGACACCAAT","561307.5.peg.1241"," 271"
"2490",140,297,157,"TTCGATATTCTGGTTGCGAA","ATTTCTACATCGACACCAAT","561307.5.peg.1241"," 271"
"2491",140,336,196,"TTCGATATTCTGGTTGCGAA","TGATTGGATTATGAATCAC","561307.5.peg.1241"," 271"
"2492",204,336,132,"GTTACATAAGCGCACAACTC","TGATTGGATTATGAATCAC","561307.5.peg.1241"," 271"
"2493",114,336,222,"GCTTGTCGCATAAACCAAAC","TGATTGGATTATGAATCAC","561307.5.peg.1241"," 271"
"2494",114,395,281,"GCTTGTCGCATAAACCAAAC","CATATGGTACATCTCGTTCG","561307.5.peg.1241"," 271"
"2495",140,395,255,"TTCGATATTCTGGTTGCGAA","CATATGGTACATCTCGTTCG","561307.5.peg.1241"," 271"
"2496",288,395,107,"TCGACACCAATTGGCTTTAA","CATATGGTACATCTCGTTCG","561307.5.peg.1241"," 271"
"2497",204,395,191,"GTTACATAAGCGCACAACTC","CATATGGTACATCTCGTTCG","561307.5.peg.1241"," 271"
"2498",140,397,257,"TTCGATATTCTGGTTGCGAA","TACATATGGTACATCTCGTT","561307.5.peg.1241"," 271"
"2499",114,397,283,"GCTTGTCGCATAAACCAAAC","TACATATGGTACATCTCGTT","561307.5.peg.1241"," 271"
"2500",297,397,100,"ATTTCTACATCGACACCAAT","TACATATGGTACATCTCGTT","561307.5.peg.1241"," 271"
"2501",288,397,109,"TCGACACCAATTGGCTTTAA","TACATATGGTACATCTCGTT","561307.5.peg.1241"," 271"
"2502",204,397,193,"GTTACATAAGCGCACAACTC","TACATATGGTACATCTCGTT","561307.5.peg.1241"," 271"
"2503",342,142,200,"ATAATTGAACCACCTGGAAT","ACGATTCGATGCTTCAAAGA","561307.5.peg.1243"," 273"
"2504",705,142,563,"ATTGTTTGAATTGTCCTTT","ACGATTCGATGCTTCAAAGA","561307.5.peg.1243"," 273"
"2505",696,142,554,"AATTGTCCTTTCGGTGCGCC","ACGATTCGATGCTTCAAAGA","561307.5.peg.1243"," 273"
"2506",456,142,314,"TCACCATCCTGCATTTGAGT","ACGATTCGATGCTTCAAAGA","561307.5.peg.1243"," 273"
"2507",543,142,401,"CCATAAATACCACCCATTAA","ACGATTCGATGCTTCAAAGA","561307.5.peg.1243"," 273"
"2508",414,142,272,"CCTGCTCTTAATTTACCAAG","ACGATTCGATGCTTCAAAGA","561307.5.peg.1243"," 273"
"2509",696,165,531,"AATTGTCCTTTCGGTGCGCC","TACGATTGAATCTTTCCCCC","561307.5.peg.1243"," 273"
"2510",414,165,249,"CCTGCTCTTAATTTACCAAG","TACGATTGAATCTTTCCCCC","561307.5.peg.1243"," 273"
"2511",342,165,177,"ATAATTGAACCACCTGGAAT","TACGATTGAATCTTTCCCCC","561307.5.peg.1243"," 273"
"2512",456,165,291,"TCACCATCCTGCATTTGAGT","TACGATTGAATCTTTCCCCC","561307.5.peg.1243"," 273"
"2513",543,165,378,"CCATAAATACCACCCATTAA","TACGATTGAATCTTTCCCCC","561307.5.peg.1243"," 273"
"2514",705,165,540,"ATTGTTTGAATTGTCCTTT","TACGATTGAATCTTTCCCCC","561307.5.peg.1243"," 273"
"2515",456,342,114,"TCACCATCCTGCATTTGAGT","ATAATTGAACCACCTGGAAT","561307.5.peg.1243"," 273"
"2516",165,342,177,"TACGATTGAATCTTTCCCCC","ATAATTGAACCACCTGGAAT","561307.5.peg.1243"," 273"
"2517",142,342,200,"ACGATTCGATGCTTCAAAGA","ATAATTGAACCACCTGGAAT","561307.5.peg.1243"," 273"
"2518",696,342,354,"AATTGTCCTTTCGGTGCGCC","ATAATTGAACCACCTGGAAT","561307.5.peg.1243"," 273"
"2519",543,342,201,"CCATAAATACCACCCATTAA","ATAATTGAACCACCTGGAAT","561307.5.peg.1243"," 273"
"2520",705,342,363,"ATTGTTTGAATTGTCCTTT","ATAATTGAACCACCTGGAAT","561307.5.peg.1243"," 273"
"2521",705,414,291,"ATTGTTTGAATTGTCCTTT","CCTGCTCTTAATTTACCAAG","561307.5.peg.1243"," 273"
"2522",165,414,249,"TACGATTGAATCTTTCCCCC","CCTGCTCTTAATTTACCAAG","561307.5.peg.1243"," 273"
"2523",543,414,129,"CCATAAATACCACCCATTAA","CCTGCTCTTAATTTACCAAG","561307.5.peg.1243"," 273"
"2524",142,414,272,"ACGATTCGATGCTTCAAAGA","CCTGCTCTTAATTTACCAAG","561307.5.peg.1243"," 273"
"2525",696,414,282,"AATTGTCCTTTCGGTGCGCC","CCTGCTCTTAATTTACCAAG","561307.5.peg.1243"," 273"
"2526",142,456,314,"ACGATTCGATGCTTCAAAGA","TCACCATCCTGCATTTGAGT","561307.5.peg.1243"," 273"
"2527",342,456,114,"ATAATTGAACCACCTGGAAT","TCACCATCCTGCATTTGAGT","561307.5.peg.1243"," 273"
"2528",165,456,291,"TACGATTGAATCTTTCCCCC","TCACCATCCTGCATTTGAGT","561307.5.peg.1243"," 273"
"2529",696,456,240,"AATTGTCCTTTCGGTGCGCC","TCACCATCCTGCATTTGAGT","561307.5.peg.1243"," 273"
"2530",705,456,249,"ATTGTTTGAATTGTCCTTT","TCACCATCCTGCATTTGAGT","561307.5.peg.1243"," 273"
"2531",142,543,401,"ACGATTCGATGCTTCAAAGA","CCATAAATACCACCCATTAA","561307.5.peg.1243"," 273"
"2532",705,543,162,"ATTGTTTGAATTGTCCTTT","CCATAAATACCACCCATTAA","561307.5.peg.1243"," 273"
"2533",342,543,201,"ATAATTGAACCACCTGGAAT","CCATAAATACCACCCATTAA","561307.5.peg.1243"," 273"
"2534",165,543,378,"TACGATTGAATCTTTCCCCC","CCATAAATACCACCCATTAA","561307.5.peg.1243"," 273"
"2535",414,543,129,"CCTGCTCTTAATTTACCAAG","CCATAAATACCACCCATTAA","561307.5.peg.1243"," 273"
"2536",696,543,153,"AATTGTCCTTTCGGTGCGCC","CCATAAATACCACCCATTAA","561307.5.peg.1243"," 273"
"2537",342,696,354,"ATAATTGAACCACCTGGAAT","AATTGTCCTTTCGGTGCGCC","561307.5.peg.1243"," 273"
"2538",456,696,240,"TCACCATCCTGCATTTGAGT","AATTGTCCTTTCGGTGCGCC","561307.5.peg.1243"," 273"
"2539",165,696,531,"TACGATTGAATCTTTCCCCC","AATTGTCCTTTCGGTGCGCC","561307.5.peg.1243"," 273"
"2540",543,696,153,"CCATAAATACCACCCATTAA","AATTGTCCTTTCGGTGCGCC","561307.5.peg.1243"," 273"
"2541",142,696,554,"ACGATTCGATGCTTCAAAGA","AATTGTCCTTTCGGTGCGCC","561307.5.peg.1243"," 273"
"2542",414,696,282,"CCTGCTCTTAATTTACCAAG","AATTGTCCTTTCGGTGCGCC","561307.5.peg.1243"," 273"
"2543",142,705,563,"ACGATTCGATGCTTCAAAGA","ATTGTTTGAATTGTCCTTT","561307.5.peg.1243"," 273"
"2544",165,705,540,"TACGATTGAATCTTTCCCCC","ATTGTTTGAATTGTCCTTT","561307.5.peg.1243"," 273"
"2545",342,705,363,"ATAATTGAACCACCTGGAAT","ATTGTTTGAATTGTCCTTT","561307.5.peg.1243"," 273"
"2546",543,705,162,"CCATAAATACCACCCATTAA","ATTGTTTGAATTGTCCTTT","561307.5.peg.1243"," 273"
"2547",414,705,291,"CCTGCTCTTAATTTACCAAG","ATTGTTTGAATTGTCCTTT","561307.5.peg.1243"," 273"
"2548",456,705,249,"TCACCATCCTGCATTTGAGT","ATTGTTTGAATTGTCCTTT","561307.5.peg.1243"," 273"
"2549",315,159,156,"CTATCCCATCCATCACCAGC","TTACGAGGACCTGGACCAAC","561307.5.peg.1245"," 275"
"2550",564,159,405,"ATACATGGAAATTCTGCATC","TTACGAGGACCTGGACCAAC","561307.5.peg.1245"," 275"
"2551",705,159,546,"ACTCTTGCTTCTGCATGATC","TTACGAGGACCTGGACCAAC","561307.5.peg.1245"," 275"
"2552",351,159,192,"ATAGCATCTTCTGTTACAAC","TTACGAGGACCTGGACCAAC","561307.5.peg.1245"," 275"
"2553",405,159,246,"GCATAATAAGCAGCAATTGT","TTACGAGGACCTGGACCAAC","561307.5.peg.1245"," 275"
"2554",342,159,183,"TCTGTTACAACCGGCTCGAA","TTACGAGGACCTGGACCAAC","561307.5.peg.1245"," 275"
"2555",351,168,183,"ATAGCATCTTCTGTTACAAC","TCTAATGCCTTACGAGGACC","561307.5.peg.1245"," 275"
"2556",705,168,537,"ACTCTTGCTTCTGCATGATC","TCTAATGCCTTACGAGGACC","561307.5.peg.1245"," 275"
"2557",405,168,237,"GCATAATAAGCAGCAATTGT","TCTAATGCCTTACGAGGACC","561307.5.peg.1245"," 275"
"2558",315,168,147,"CTATCCCATCCATCACCAGC","TCTAATGCCTTACGAGGACC","561307.5.peg.1245"," 275"
"2559",564,168,396,"ATACATGGAAATTCTGCATC","TCTAATGCCTTACGAGGACC","561307.5.peg.1245"," 275"
"2560",342,168,174,"TCTGTTACAACCGGCTCGAA","TCTAATGCCTTACGAGGACC","561307.5.peg.1245"," 275"
"2561",342,174,168,"TCTGTTACAACCGGCTCGAA","ATGTAGTCTAATGCCTTACG","561307.5.peg.1245"," 275"
"2562",705,174,531,"ACTCTTGCTTCTGCATGATC","ATGTAGTCTAATGCCTTACG","561307.5.peg.1245"," 275"
"2563",315,174,141,"CTATCCCATCCATCACCAGC","ATGTAGTCTAATGCCTTACG","561307.5.peg.1245"," 275"
"2564",351,174,177,"ATAGCATCTTCTGTTACAAC","ATGTAGTCTAATGCCTTACG","561307.5.peg.1245"," 275"
"2565",405,174,231,"GCATAATAAGCAGCAATTGT","ATGTAGTCTAATGCCTTACG","561307.5.peg.1245"," 275"
"2566",564,174,390,"ATACATGGAAATTCTGCATC","ATGTAGTCTAATGCCTTACG","561307.5.peg.1245"," 275"
"2567",159,315,156,"TTACGAGGACCTGGACCAAC","CTATCCCATCCATCACCAGC","561307.5.peg.1245"," 275"
"2568",564,315,249,"ATACATGGAAATTCTGCATC","CTATCCCATCCATCACCAGC","561307.5.peg.1245"," 275"
"2569",705,315,390,"ACTCTTGCTTCTGCATGATC","CTATCCCATCCATCACCAGC","561307.5.peg.1245"," 275"
"2570",168,315,147,"TCTAATGCCTTACGAGGACC","CTATCCCATCCATCACCAGC","561307.5.peg.1245"," 275"
"2571",174,315,141,"ATGTAGTCTAATGCCTTACG","CTATCCCATCCATCACCAGC","561307.5.peg.1245"," 275"
"2572",564,342,222,"ATACATGGAAATTCTGCATC","TCTGTTACAACCGGCTCGAA","561307.5.peg.1245"," 275"
"2573",168,342,174,"TCTAATGCCTTACGAGGACC","TCTGTTACAACCGGCTCGAA","561307.5.peg.1245"," 275"
"2574",159,342,183,"TTACGAGGACCTGGACCAAC","TCTGTTACAACCGGCTCGAA","561307.5.peg.1245"," 275"
"2575",174,342,168,"ATGTAGTCTAATGCCTTACG","TCTGTTACAACCGGCTCGAA","561307.5.peg.1245"," 275"
"2576",705,342,363,"ACTCTTGCTTCTGCATGATC","TCTGTTACAACCGGCTCGAA","561307.5.peg.1245"," 275"
"2577",174,351,177,"ATGTAGTCTAATGCCTTACG","ATAGCATCTTCTGTTACAAC","561307.5.peg.1245"," 275"
"2578",159,351,192,"TTACGAGGACCTGGACCAAC","ATAGCATCTTCTGTTACAAC","561307.5.peg.1245"," 275"
"2579",564,351,213,"ATACATGGAAATTCTGCATC","ATAGCATCTTCTGTTACAAC","561307.5.peg.1245"," 275"
"2580",168,351,183,"TCTAATGCCTTACGAGGACC","ATAGCATCTTCTGTTACAAC","561307.5.peg.1245"," 275"
"2581",705,351,354,"ACTCTTGCTTCTGCATGATC","ATAGCATCTTCTGTTACAAC","561307.5.peg.1245"," 275"
"2582",705,405,300,"ACTCTTGCTTCTGCATGATC","GCATAATAAGCAGCAATTGT","561307.5.peg.1245"," 275"
"2583",564,405,159,"ATACATGGAAATTCTGCATC","GCATAATAAGCAGCAATTGT","561307.5.peg.1245"," 275"
"2584",174,405,231,"ATGTAGTCTAATGCCTTACG","GCATAATAAGCAGCAATTGT","561307.5.peg.1245"," 275"
"2585",168,405,237,"TCTAATGCCTTACGAGGACC","GCATAATAAGCAGCAATTGT","561307.5.peg.1245"," 275"
"2586",159,405,246,"TTACGAGGACCTGGACCAAC","GCATAATAAGCAGCAATTGT","561307.5.peg.1245"," 275"
"2587",159,564,405,"TTACGAGGACCTGGACCAAC","ATACATGGAAATTCTGCATC","561307.5.peg.1245"," 275"
"2588",351,564,213,"ATAGCATCTTCTGTTACAAC","ATACATGGAAATTCTGCATC","561307.5.peg.1245"," 275"
"2589",405,564,159,"GCATAATAAGCAGCAATTGT","ATACATGGAAATTCTGCATC","561307.5.peg.1245"," 275"
"2590",174,564,390,"ATGTAGTCTAATGCCTTACG","ATACATGGAAATTCTGCATC","561307.5.peg.1245"," 275"
"2591",315,564,249,"CTATCCCATCCATCACCAGC","ATACATGGAAATTCTGCATC","561307.5.peg.1245"," 275"
"2592",342,564,222,"TCTGTTACAACCGGCTCGAA","ATACATGGAAATTCTGCATC","561307.5.peg.1245"," 275"
"2593",705,564,141,"ACTCTTGCTTCTGCATGATC","ATACATGGAAATTCTGCATC","561307.5.peg.1245"," 275"
"2594",168,564,396,"TCTAATGCCTTACGAGGACC","ATACATGGAAATTCTGCATC","561307.5.peg.1245"," 275"
"2595",159,705,546,"TTACGAGGACCTGGACCAAC","ACTCTTGCTTCTGCATGATC","561307.5.peg.1245"," 275"
"2596",315,705,390,"CTATCCCATCCATCACCAGC","ACTCTTGCTTCTGCATGATC","561307.5.peg.1245"," 275"
"2597",174,705,531,"ATGTAGTCTAATGCCTTACG","ACTCTTGCTTCTGCATGATC","561307.5.peg.1245"," 275"
"2598",351,705,354,"ATAGCATCTTCTGTTACAAC","ACTCTTGCTTCTGCATGATC","561307.5.peg.1245"," 275"
"2599",342,705,363,"TCTGTTACAACCGGCTCGAA","ACTCTTGCTTCTGCATGATC","561307.5.peg.1245"," 275"
"2600",564,705,141,"ATACATGGAAATTCTGCATC","ACTCTTGCTTCTGCATGATC","561307.5.peg.1245"," 275"
"2601",168,705,537,"TCTAATGCCTTACGAGGACC","ACTCTTGCTTCTGCATGATC","561307.5.peg.1245"," 275"
"2602",405,705,300,"GCATAATAAGCAGCAATTGT","ACTCTTGCTTCTGCATGATC","561307.5.peg.1245"," 275"
"2603",359,9,350,"CTGGTTCTACTTCAGGTGTC","ATTTATTCATTATGCGTGG","561307.5.peg.1246"," 276"
"2604",366,9,357,"ACAATTGCTGGTTCTACTTC","ATTTATTCATTATGCGTGG","561307.5.peg.1246"," 276"
"2605",378,9,369,"TTGTATAAGCAACAATTGC","ATTTATTCATTATGCGTGG","561307.5.peg.1246"," 276"
"2606",359,12,347,"CTGGTTCTACTTCAGGTGTC","GCAATTTATTCATTATGCG","561307.5.peg.1246"," 276"
"2607",378,12,366,"TTGTATAAGCAACAATTGC","GCAATTTATTCATTATGCG","561307.5.peg.1246"," 276"
"2608",366,12,354,"ACAATTGCTGGTTCTACTTC","GCAATTTATTCATTATGCG","561307.5.peg.1246"," 276"
"2609",359,87,272,"CTGGTTCTACTTCAGGTGTC","TATGAAACCTTTGCTTCACT","561307.5.peg.1246"," 276"
"2610",378,87,291,"TTGTATAAGCAACAATTGC","TATGAAACCTTTGCTTCACT","561307.5.peg.1246"," 276"
"2611",366,87,279,"ACAATTGCTGGTTCTACTTC","TATGAAACCTTTGCTTCACT","561307.5.peg.1246"," 276"
"2612",9,359,350,"ATTTATTCATTATGCGTGG","CTGGTTCTACTTCAGGTGTC","561307.5.peg.1246"," 276"
"2613",12,359,347,"GCAATTTATTCATTATGCG","CTGGTTCTACTTCAGGTGTC","561307.5.peg.1246"," 276"
"2614",87,359,272,"TATGAAACCTTTGCTTCACT","CTGGTTCTACTTCAGGTGTC","561307.5.peg.1246"," 276"
"2615",9,366,357,"ATTTATTCATTATGCGTGG","ACAATTGCTGGTTCTACTTC","561307.5.peg.1246"," 276"
"2616",87,366,279,"TATGAAACCTTTGCTTCACT","ACAATTGCTGGTTCTACTTC","561307.5.peg.1246"," 276"
"2617",12,366,354,"GCAATTTATTCATTATGCG","ACAATTGCTGGTTCTACTTC","561307.5.peg.1246"," 276"
"2618",9,378,369,"ATTTATTCATTATGCGTGG","TTGTATAAGCAACAATTGC","561307.5.peg.1246"," 276"
"2619",87,378,291,"TATGAAACCTTTGCTTCACT","TTGTATAAGCAACAATTGC","561307.5.peg.1246"," 276"
"2620",12,378,366,"GCAATTTATTCATTATGCG","TTGTATAAGCAACAATTGC","561307.5.peg.1246"," 276"
"2621",378,165,213,"AGCATAATCTCAGGAGTAAT","GCTGATAATGCCGCAATAAA","561307.5.peg.1247"," 277"
"2622",378,201,177,"AGCATAATCTCAGGAGTAAT","CGTTTCGTCCATACTAATTT","561307.5.peg.1247"," 277"
"2623",165,378,213,"GCTGATAATGCCGCAATAAA","AGCATAATCTCAGGAGTAAT","561307.5.peg.1247"," 277"
"2624",201,378,177,"CGTTTCGTCCATACTAATTT","AGCATAATCTCAGGAGTAAT","561307.5.peg.1247"," 277"
"2625",394,132,262,"TCCTGCTTGATCAGTCAAAC","TGCTTTGACCACAACGGCTT","561307.5.peg.1249"," 279"
"2626",394,138,256,"TCCTGCTTGATCAGTCAAAC","TTGTATTGCTTTGACCACAA","561307.5.peg.1249"," 279"
"2627",132,394,262,"TGCTTTGACCACAACGGCTT","TCCTGCTTGATCAGTCAAAC","561307.5.peg.1249"," 279"
"2628",138,394,256,"TTGTATTGCTTTGACCACAA","TCCTGCTTGATCAGTCAAAC","561307.5.peg.1249"," 279"
"2629",540,162,378,"AACTGTGTGAATGGCGTGTG","CAATAAATTCATCTACGTA","561307.5.peg.1251"," 282"
"2630",549,162,387,"TGTTCAGATAACTGTGTGAA","CAATAAATTCATCTACGTA","561307.5.peg.1251"," 282"
"2631",162,540,378,"CAATAAATTCATCTACGTA","AACTGTGTGAATGGCGTGTG","561307.5.peg.1251"," 282"
"2632",162,549,387,"CAATAAATTCATCTACGTA","TGTTCAGATAACTGTGTGAA","561307.5.peg.1251"," 282"
"2633",321,69,252,"ACGTAGCCAACTACAAATTT","GCGACATCTCCTACATATTT","561307.5.peg.1254"," 285"
"2634",69,321,252,"GCGACATCTCCTACATATTT","ACGTAGCCAACTACAAATTT","561307.5.peg.1254"," 285"
"2635",449,293,156,"ATGTACCTGGCTTATTCGTA","TTTGTTTGCGATAGTCTCGA","561307.5.peg.1255"," 286"
"2636",662,293,369,"TTTCTGAAGGTTTACTTACA","TTTGTTTGCGATAGTCTCGA","561307.5.peg.1255"," 286"
"2637",462,293,169,"ATTGCAGAAACATATGTACC","TTTGTTTGCGATAGTCTCGA","561307.5.peg.1255"," 286"
"2638",1522,293,1229,"CATTTCAGACGCGTTTCTAT","TTTGTTTGCGATAGTCTCGA","561307.5.peg.1255"," 286"
"2639",1658,293,1365,"GTTGACACTTAAGTTTGTT","TTTGTTTGCGATAGTCTCGA","561307.5.peg.1255"," 286"
"2640",1878,293,1585,"GGCGTCATGACAACATTAAA","TTTGTTTGCGATAGTCTCGA","561307.5.peg.1255"," 286"
"2641",1381,293,1088,"TCTGAATCAGCAATTAATC","TTTGTTTGCGATAGTCTCGA","561307.5.peg.1255"," 286"
"2642",662,347,315,"TTTCTGAAGGTTTACTTACA","CAGTTGTTTGATTTCTTCTA","561307.5.peg.1255"," 286"
"2643",462,347,115,"ATTGCAGAAACATATGTACC","CAGTTGTTTGATTTCTTCTA","561307.5.peg.1255"," 286"
"2644",1878,347,1531,"GGCGTCATGACAACATTAAA","CAGTTGTTTGATTTCTTCTA","561307.5.peg.1255"," 286"
"2645",1522,347,1175,"CATTTCAGACGCGTTTCTAT","CAGTTGTTTGATTTCTTCTA","561307.5.peg.1255"," 286"
"2646",1658,347,1311,"GTTGACACTTAAGTTTGTT","CAGTTGTTTGATTTCTTCTA","561307.5.peg.1255"," 286"
"2647",1381,347,1034,"TCTGAATCAGCAATTAATC","CAGTTGTTTGATTTCTTCTA","561307.5.peg.1255"," 286"
"2648",449,347,102,"ATGTACCTGGCTTATTCGTA","CAGTTGTTTGATTTCTTCTA","561307.5.peg.1255"," 286"
"2649",293,449,156,"TTTGTTTGCGATAGTCTCGA","ATGTACCTGGCTTATTCGTA","561307.5.peg.1255"," 286"
"2650",347,449,102,"CAGTTGTTTGATTTCTTCTA","ATGTACCTGGCTTATTCGTA","561307.5.peg.1255"," 286"
"2651",1658,449,1209,"GTTGACACTTAAGTTTGTT","ATGTACCTGGCTTATTCGTA","561307.5.peg.1255"," 286"
"2652",1381,449,932,"TCTGAATCAGCAATTAATC","ATGTACCTGGCTTATTCGTA","561307.5.peg.1255"," 286"
"2653",1878,449,1429,"GGCGTCATGACAACATTAAA","ATGTACCTGGCTTATTCGTA","561307.5.peg.1255"," 286"
"2654",662,449,213,"TTTCTGAAGGTTTACTTACA","ATGTACCTGGCTTATTCGTA","561307.5.peg.1255"," 286"
"2655",1522,449,1073,"CATTTCAGACGCGTTTCTAT","ATGTACCTGGCTTATTCGTA","561307.5.peg.1255"," 286"
"2656",1658,462,1196,"GTTGACACTTAAGTTTGTT","ATTGCAGAAACATATGTACC","561307.5.peg.1255"," 286"
"2657",1878,462,1416,"GGCGTCATGACAACATTAAA","ATTGCAGAAACATATGTACC","561307.5.peg.1255"," 286"
"2658",1381,462,919,"TCTGAATCAGCAATTAATC","ATTGCAGAAACATATGTACC","561307.5.peg.1255"," 286"
"2659",293,462,169,"TTTGTTTGCGATAGTCTCGA","ATTGCAGAAACATATGTACC","561307.5.peg.1255"," 286"
"2660",347,462,115,"CAGTTGTTTGATTTCTTCTA","ATTGCAGAAACATATGTACC","561307.5.peg.1255"," 286"
"2661",662,462,200,"TTTCTGAAGGTTTACTTACA","ATTGCAGAAACATATGTACC","561307.5.peg.1255"," 286"
"2662",1522,462,1060,"CATTTCAGACGCGTTTCTAT","ATTGCAGAAACATATGTACC","561307.5.peg.1255"," 286"
"2663",293,662,369,"TTTGTTTGCGATAGTCTCGA","TTTCTGAAGGTTTACTTACA","561307.5.peg.1255"," 286"
"2664",1381,662,719,"TCTGAATCAGCAATTAATC","TTTCTGAAGGTTTACTTACA","561307.5.peg.1255"," 286"
"2665",462,662,200,"ATTGCAGAAACATATGTACC","TTTCTGAAGGTTTACTTACA","561307.5.peg.1255"," 286"
"2666",1658,662,996,"GTTGACACTTAAGTTTGTT","TTTCTGAAGGTTTACTTACA","561307.5.peg.1255"," 286"
"2667",1522,662,860,"CATTTCAGACGCGTTTCTAT","TTTCTGAAGGTTTACTTACA","561307.5.peg.1255"," 286"
"2668",449,662,213,"ATGTACCTGGCTTATTCGTA","TTTCTGAAGGTTTACTTACA","561307.5.peg.1255"," 286"
"2669",347,662,315,"CAGTTGTTTGATTTCTTCTA","TTTCTGAAGGTTTACTTACA","561307.5.peg.1255"," 286"
"2670",1878,662,1216,"GGCGTCATGACAACATTAAA","TTTCTGAAGGTTTACTTACA","561307.5.peg.1255"," 286"
"2671",462,1381,919,"ATTGCAGAAACATATGTACC","TCTGAATCAGCAATTAATC","561307.5.peg.1255"," 286"
"2672",293,1381,1088,"TTTGTTTGCGATAGTCTCGA","TCTGAATCAGCAATTAATC","561307.5.peg.1255"," 286"
"2673",347,1381,1034,"CAGTTGTTTGATTTCTTCTA","TCTGAATCAGCAATTAATC","561307.5.peg.1255"," 286"
"2674",662,1381,719,"TTTCTGAAGGTTTACTTACA","TCTGAATCAGCAATTAATC","561307.5.peg.1255"," 286"
"2675",1522,1381,141,"CATTTCAGACGCGTTTCTAT","TCTGAATCAGCAATTAATC","561307.5.peg.1255"," 286"
"2676",449,1381,932,"ATGTACCTGGCTTATTCGTA","TCTGAATCAGCAATTAATC","561307.5.peg.1255"," 286"
"2677",1878,1381,497,"GGCGTCATGACAACATTAAA","TCTGAATCAGCAATTAATC","561307.5.peg.1255"," 286"
"2678",1658,1381,277,"GTTGACACTTAAGTTTGTT","TCTGAATCAGCAATTAATC","561307.5.peg.1255"," 286"
"2679",293,1522,1229,"TTTGTTTGCGATAGTCTCGA","CATTTCAGACGCGTTTCTAT","561307.5.peg.1255"," 286"
"2680",1381,1522,141,"TCTGAATCAGCAATTAATC","CATTTCAGACGCGTTTCTAT","561307.5.peg.1255"," 286"
"2681",1878,1522,356,"GGCGTCATGACAACATTAAA","CATTTCAGACGCGTTTCTAT","561307.5.peg.1255"," 286"
"2682",347,1522,1175,"CAGTTGTTTGATTTCTTCTA","CATTTCAGACGCGTTTCTAT","561307.5.peg.1255"," 286"
"2683",449,1522,1073,"ATGTACCTGGCTTATTCGTA","CATTTCAGACGCGTTTCTAT","561307.5.peg.1255"," 286"
"2684",462,1522,1060,"ATTGCAGAAACATATGTACC","CATTTCAGACGCGTTTCTAT","561307.5.peg.1255"," 286"
"2685",662,1522,860,"TTTCTGAAGGTTTACTTACA","CATTTCAGACGCGTTTCTAT","561307.5.peg.1255"," 286"
"2686",1658,1522,136,"GTTGACACTTAAGTTTGTT","CATTTCAGACGCGTTTCTAT","561307.5.peg.1255"," 286"
"2687",462,1658,1196,"ATTGCAGAAACATATGTACC","GTTGACACTTAAGTTTGTT","561307.5.peg.1255"," 286"
"2688",1381,1658,277,"TCTGAATCAGCAATTAATC","GTTGACACTTAAGTTTGTT","561307.5.peg.1255"," 286"
"2689",1522,1658,136,"CATTTCAGACGCGTTTCTAT","GTTGACACTTAAGTTTGTT","561307.5.peg.1255"," 286"
"2690",449,1658,1209,"ATGTACCTGGCTTATTCGTA","GTTGACACTTAAGTTTGTT","561307.5.peg.1255"," 286"
"2691",662,1658,996,"TTTCTGAAGGTTTACTTACA","GTTGACACTTAAGTTTGTT","561307.5.peg.1255"," 286"
"2692",1878,1658,220,"GGCGTCATGACAACATTAAA","GTTGACACTTAAGTTTGTT","561307.5.peg.1255"," 286"
"2693",293,1658,1365,"TTTGTTTGCGATAGTCTCGA","GTTGACACTTAAGTTTGTT","561307.5.peg.1255"," 286"
"2694",347,1658,1311,"CAGTTGTTTGATTTCTTCTA","GTTGACACTTAAGTTTGTT","561307.5.peg.1255"," 286"
"2695",1522,1878,356,"CATTTCAGACGCGTTTCTAT","GGCGTCATGACAACATTAAA","561307.5.peg.1255"," 286"
"2696",293,1878,1585,"TTTGTTTGCGATAGTCTCGA","GGCGTCATGACAACATTAAA","561307.5.peg.1255"," 286"
"2697",449,1878,1429,"ATGTACCTGGCTTATTCGTA","GGCGTCATGACAACATTAAA","561307.5.peg.1255"," 286"
"2698",1381,1878,497,"TCTGAATCAGCAATTAATC","GGCGTCATGACAACATTAAA","561307.5.peg.1255"," 286"
"2699",347,1878,1531,"CAGTTGTTTGATTTCTTCTA","GGCGTCATGACAACATTAAA","561307.5.peg.1255"," 286"
"2700",462,1878,1416,"ATTGCAGAAACATATGTACC","GGCGTCATGACAACATTAAA","561307.5.peg.1255"," 286"
"2701",1658,1878,220,"GTTGACACTTAAGTTTGTT","GGCGTCATGACAACATTAAA","561307.5.peg.1255"," 286"
"2702",662,1878,1216,"TTTCTGAAGGTTTACTTACA","GGCGTCATGACAACATTAAA","561307.5.peg.1255"," 286"
"2703",474,269,205,"AAGCGAAATAATCACTTTC","GTGCACGTACTATTTCTTCA","561307.5.peg.1256"," 287"
"2704",537,269,268,"TTGTCATAATTGCGTAATC","GTGCACGTACTATTTCTTCA","561307.5.peg.1256"," 287"
"2705",617,269,348,"AACATTATGTGCCATTTCT","GTGCACGTACTATTTCTTCA","561307.5.peg.1256"," 287"
"2706",269,474,205,"GTGCACGTACTATTTCTTCA","AAGCGAAATAATCACTTTC","561307.5.peg.1256"," 287"
"2707",617,474,143,"AACATTATGTGCCATTTCT","AAGCGAAATAATCACTTTC","561307.5.peg.1256"," 287"
"2708",269,537,268,"GTGCACGTACTATTTCTTCA","TTGTCATAATTGCGTAATC","561307.5.peg.1256"," 287"
"2709",269,617,348,"GTGCACGTACTATTTCTTCA","AACATTATGTGCCATTTCT","561307.5.peg.1256"," 287"
"2710",474,617,143,"AAGCGAAATAATCACTTTC","AACATTATGTGCCATTTCT","561307.5.peg.1256"," 287"
"2711",362,163,199,"ACTCTTCAGGGAATCCATTA","AGTTTGATCGAAACCTTCTA","561307.5.peg.1259"," 290"
"2712",374,163,211,"TTGTTGAATTAACTCTTCA","AGTTTGATCGAAACCTTCTA","561307.5.peg.1259"," 290"
"2713",435,163,272,"ATAATTTGCGTACCCGATGC","AGTTTGATCGAAACCTTCTA","561307.5.peg.1259"," 290"
"2714",518,163,355,"GTGCAGCAATTTGCAATACT","AGTTTGATCGAAACCTTCTA","561307.5.peg.1259"," 290"
"2715",163,362,199,"AGTTTGATCGAAACCTTCTA","ACTCTTCAGGGAATCCATTA","561307.5.peg.1259"," 290"
"2716",518,362,156,"GTGCAGCAATTTGCAATACT","ACTCTTCAGGGAATCCATTA","561307.5.peg.1259"," 290"
"2717",163,374,211,"AGTTTGATCGAAACCTTCTA","TTGTTGAATTAACTCTTCA","561307.5.peg.1259"," 290"
"2718",518,374,144,"GTGCAGCAATTTGCAATACT","TTGTTGAATTAACTCTTCA","561307.5.peg.1259"," 290"
"2719",163,435,272,"AGTTTGATCGAAACCTTCTA","ATAATTTGCGTACCCGATGC","561307.5.peg.1259"," 290"
"2720",163,518,355,"AGTTTGATCGAAACCTTCTA","GTGCAGCAATTTGCAATACT","561307.5.peg.1259"," 290"
"2721",374,518,144,"TTGTTGAATTAACTCTTCA","GTGCAGCAATTTGCAATACT","561307.5.peg.1259"," 290"
"2722",362,518,156,"ACTCTTCAGGGAATCCATTA","GTGCAGCAATTTGCAATACT","561307.5.peg.1259"," 290"
"2723",233,11,222,"AGATATAGCTGATATCAGGA","TTACATCAGTACGAAAGTGA","561307.5.peg.1260"," 292"
"2724",298,11,287,"ACCTACAACGGCTATCGCAA","TTACATCAGTACGAAAGTGA","561307.5.peg.1260"," 292"
"2725",214,11,203,"ATGGAATAATCCGCTGAATA","TTACATCAGTACGAAAGTGA","561307.5.peg.1260"," 292"
"2726",331,11,320,"AATGGAATACAGATAATTG","TTACATCAGTACGAAAGTGA","561307.5.peg.1260"," 292"
"2727",389,11,378,"ATTTGCTAACACCTGAAACT","TTACATCAGTACGAAAGTGA","561307.5.peg.1260"," 292"
"2728",348,11,337,"TTTGCACCTAGAAATGCTAA","TTACATCAGTACGAAAGTGA","561307.5.peg.1260"," 292"
"2729",310,11,299,"GGCGATGAAAGTACCTACAA","TTACATCAGTACGAAAGTGA","561307.5.peg.1260"," 292"
"2730",11,214,203,"TTACATCAGTACGAAAGTGA","ATGGAATAATCCGCTGAATA","561307.5.peg.1260"," 292"
"2731",331,214,117,"AATGGAATACAGATAATTG","ATGGAATAATCCGCTGAATA","561307.5.peg.1260"," 292"
"2732",389,214,175,"ATTTGCTAACACCTGAAACT","ATGGAATAATCCGCTGAATA","561307.5.peg.1260"," 292"
"2733",348,214,134,"TTTGCACCTAGAAATGCTAA","ATGGAATAATCCGCTGAATA","561307.5.peg.1260"," 292"
"2734",348,233,115,"TTTGCACCTAGAAATGCTAA","AGATATAGCTGATATCAGGA","561307.5.peg.1260"," 292"
"2735",11,233,222,"TTACATCAGTACGAAAGTGA","AGATATAGCTGATATCAGGA","561307.5.peg.1260"," 292"
"2736",389,233,156,"ATTTGCTAACACCTGAAACT","AGATATAGCTGATATCAGGA","561307.5.peg.1260"," 292"
"2737",11,298,287,"TTACATCAGTACGAAAGTGA","ACCTACAACGGCTATCGCAA","561307.5.peg.1260"," 292"
"2738",11,310,299,"TTACATCAGTACGAAAGTGA","GGCGATGAAAGTACCTACAA","561307.5.peg.1260"," 292"
"2739",214,331,117,"ATGGAATAATCCGCTGAATA","AATGGAATACAGATAATTG","561307.5.peg.1260"," 292"
"2740",11,331,320,"TTACATCAGTACGAAAGTGA","AATGGAATACAGATAATTG","561307.5.peg.1260"," 292"
"2741",214,348,134,"ATGGAATAATCCGCTGAATA","TTTGCACCTAGAAATGCTAA","561307.5.peg.1260"," 292"
"2742",233,348,115,"AGATATAGCTGATATCAGGA","TTTGCACCTAGAAATGCTAA","561307.5.peg.1260"," 292"
"2743",11,348,337,"TTACATCAGTACGAAAGTGA","TTTGCACCTAGAAATGCTAA","561307.5.peg.1260"," 292"
"2744",214,389,175,"ATGGAATAATCCGCTGAATA","ATTTGCTAACACCTGAAACT","561307.5.peg.1260"," 292"
"2745",11,389,378,"TTACATCAGTACGAAAGTGA","ATTTGCTAACACCTGAAACT","561307.5.peg.1260"," 292"
"2746",233,389,156,"AGATATAGCTGATATCAGGA","ATTTGCTAACACCTGAAACT","561307.5.peg.1260"," 292"
"2747",262,90,172,"TCTAATAATGCTTTACCAT","TTCAAGCCTACATGACCGTT","561307.5.peg.1262"," 294"
"2748",90,262,172,"TTCAAGCCTACATGACCGTT","TCTAATAATGCTTTACCAT","561307.5.peg.1262"," 294"
"2749",369,12,357,"GCTAATGTGTATGCCGTTGG","ACACGATTAAGAATGTGAAG","561307.5.peg.1263"," 295"
"2750",372,12,360,"TGTGCTAATGTGTATGCCGT","ACACGATTAAGAATGTGAAG","561307.5.peg.1263"," 295"
"2751",369,14,355,"GCTAATGTGTATGCCGTTGG","TACACGATTAAGAATGTGA","561307.5.peg.1263"," 295"
"2752",372,14,358,"TGTGCTAATGTGTATGCCGT","TACACGATTAAGAATGTGA","561307.5.peg.1263"," 295"
"2753",12,369,357,"ACACGATTAAGAATGTGAAG","GCTAATGTGTATGCCGTTGG","561307.5.peg.1263"," 295"
"2754",14,369,355,"TACACGATTAAGAATGTGA","GCTAATGTGTATGCCGTTGG","561307.5.peg.1263"," 295"
"2755",12,372,360,"ACACGATTAAGAATGTGAAG","TGTGCTAATGTGTATGCCGT","561307.5.peg.1263"," 295"
"2756",14,372,358,"TACACGATTAAGAATGTGA","TGTGCTAATGTGTATGCCGT","561307.5.peg.1263"," 295"
"2757",709,345,364,"AGTAATTGCTAATGTCGATC","TTGAAAGGAATGTTAGCCTC","561307.5.peg.1264"," 296"
"2758",709,360,349,"AGTAATTGCTAATGTCGATC","GCCTGTTCTGATTCTTTGAA","561307.5.peg.1264"," 296"
"2759",345,709,364,"TTGAAAGGAATGTTAGCCTC","AGTAATTGCTAATGTCGATC","561307.5.peg.1264"," 296"
"2760",360,709,349,"GCCTGTTCTGATTCTTTGAA","AGTAATTGCTAATGTCGATC","561307.5.peg.1264"," 296"
"2761",504,135,369,"TGCTCTGGTTGTTCCCAATG","TTCGCTAGTAACAATCCCAT","561307.5.peg.1265"," 297"
"2762",506,135,371,"TATGCTCTGGTTGTTCCCAA","TTCGCTAGTAACAATCCCAT","561307.5.peg.1265"," 297"
"2763",657,135,522,"TCACCCGTTAATACTTCGGT","TTCGCTAGTAACAATCCCAT","561307.5.peg.1265"," 297"
"2764",579,135,444,"TCTGCATGTCGCTTCATTTC","TTCGCTAGTAACAATCCCAT","561307.5.peg.1265"," 297"
"2765",519,135,384,"GTAAGTGACTGAATATGCTC","TTCGCTAGTAACAATCCCAT","561307.5.peg.1265"," 297"
"2766",792,135,657,"ACAGTTGTACCTCTCGTACC","TTCGCTAGTAACAATCCCAT","561307.5.peg.1265"," 297"
"2767",135,504,369,"TTCGCTAGTAACAATCCCAT","TGCTCTGGTTGTTCCCAATG","561307.5.peg.1265"," 297"
"2768",657,504,153,"TCACCCGTTAATACTTCGGT","TGCTCTGGTTGTTCCCAATG","561307.5.peg.1265"," 297"
"2769",792,504,288,"ACAGTTGTACCTCTCGTACC","TGCTCTGGTTGTTCCCAATG","561307.5.peg.1265"," 297"
"2770",135,506,371,"TTCGCTAGTAACAATCCCAT","TATGCTCTGGTTGTTCCCAA","561307.5.peg.1265"," 297"
"2771",657,506,151,"TCACCCGTTAATACTTCGGT","TATGCTCTGGTTGTTCCCAA","561307.5.peg.1265"," 297"
"2772",792,506,286,"ACAGTTGTACCTCTCGTACC","TATGCTCTGGTTGTTCCCAA","561307.5.peg.1265"," 297"
"2773",135,519,384,"TTCGCTAGTAACAATCCCAT","GTAAGTGACTGAATATGCTC","561307.5.peg.1265"," 297"
"2774",657,519,138,"TCACCCGTTAATACTTCGGT","GTAAGTGACTGAATATGCTC","561307.5.peg.1265"," 297"
"2775",792,519,273,"ACAGTTGTACCTCTCGTACC","GTAAGTGACTGAATATGCTC","561307.5.peg.1265"," 297"
"2776",792,579,213,"ACAGTTGTACCTCTCGTACC","TCTGCATGTCGCTTCATTTC","561307.5.peg.1265"," 297"
"2777",135,579,444,"TTCGCTAGTAACAATCCCAT","TCTGCATGTCGCTTCATTTC","561307.5.peg.1265"," 297"
"2778",519,657,138,"GTAAGTGACTGAATATGCTC","TCACCCGTTAATACTTCGGT","561307.5.peg.1265"," 297"
"2779",792,657,135,"ACAGTTGTACCTCTCGTACC","TCACCCGTTAATACTTCGGT","561307.5.peg.1265"," 297"
"2780",135,657,522,"TTCGCTAGTAACAATCCCAT","TCACCCGTTAATACTTCGGT","561307.5.peg.1265"," 297"
"2781",504,657,153,"TGCTCTGGTTGTTCCCAATG","TCACCCGTTAATACTTCGGT","561307.5.peg.1265"," 297"
"2782",506,657,151,"TATGCTCTGGTTGTTCCCAA","TCACCCGTTAATACTTCGGT","561307.5.peg.1265"," 297"
"2783",506,792,286,"TATGCTCTGGTTGTTCCCAA","ACAGTTGTACCTCTCGTACC","561307.5.peg.1265"," 297"
"2784",135,792,657,"TTCGCTAGTAACAATCCCAT","ACAGTTGTACCTCTCGTACC","561307.5.peg.1265"," 297"
"2785",657,792,135,"TCACCCGTTAATACTTCGGT","ACAGTTGTACCTCTCGTACC","561307.5.peg.1265"," 297"
"2786",504,792,288,"TGCTCTGGTTGTTCCCAATG","ACAGTTGTACCTCTCGTACC","561307.5.peg.1265"," 297"
"2787",519,792,273,"GTAAGTGACTGAATATGCTC","ACAGTTGTACCTCTCGTACC","561307.5.peg.1265"," 297"
"2788",579,792,213,"TCTGCATGTCGCTTCATTTC","ACAGTTGTACCTCTCGTACC","561307.5.peg.1265"," 297"
"2789",191,79,112,"CTGTGATGACAGCTGTTATT","AATTTCAGCGCGTTCATCAT","561307.5.peg.1270"," 303"
"2790",770,79,691,"ATTCACCTGATGTATCATTC","AATTTCAGCGCGTTCATCAT","561307.5.peg.1270"," 303"
"2791",510,79,431,"TCTGCTGGAGATCCCTTCAT","AATTTCAGCGCGTTCATCAT","561307.5.peg.1270"," 303"
"2792",427,79,348,"ACCTGAAACACCTTCATTAA","AATTTCAGCGCGTTCATCAT","561307.5.peg.1270"," 303"
"2793",79,191,112,"AATTTCAGCGCGTTCATCAT","CTGTGATGACAGCTGTTATT","561307.5.peg.1270"," 303"
"2794",427,191,236,"ACCTGAAACACCTTCATTAA","CTGTGATGACAGCTGTTATT","561307.5.peg.1270"," 303"
"2795",510,191,319,"TCTGCTGGAGATCCCTTCAT","CTGTGATGACAGCTGTTATT","561307.5.peg.1270"," 303"
"2796",770,191,579,"ATTCACCTGATGTATCATTC","CTGTGATGACAGCTGTTATT","561307.5.peg.1270"," 303"
"2797",79,427,348,"AATTTCAGCGCGTTCATCAT","ACCTGAAACACCTTCATTAA","561307.5.peg.1270"," 303"
"2798",770,427,343,"ATTCACCTGATGTATCATTC","ACCTGAAACACCTTCATTAA","561307.5.peg.1270"," 303"
"2799",191,427,236,"CTGTGATGACAGCTGTTATT","ACCTGAAACACCTTCATTAA","561307.5.peg.1270"," 303"
"2800",191,510,319,"CTGTGATGACAGCTGTTATT","TCTGCTGGAGATCCCTTCAT","561307.5.peg.1270"," 303"
"2801",79,510,431,"AATTTCAGCGCGTTCATCAT","TCTGCTGGAGATCCCTTCAT","561307.5.peg.1270"," 303"
"2802",770,510,260,"ATTCACCTGATGTATCATTC","TCTGCTGGAGATCCCTTCAT","561307.5.peg.1270"," 303"
"2803",79,770,691,"AATTTCAGCGCGTTCATCAT","ATTCACCTGATGTATCATTC","561307.5.peg.1270"," 303"
"2804",427,770,343,"ACCTGAAACACCTTCATTAA","ATTCACCTGATGTATCATTC","561307.5.peg.1270"," 303"
"2805",191,770,579,"CTGTGATGACAGCTGTTATT","ATTCACCTGATGTATCATTC","561307.5.peg.1270"," 303"
"2806",510,770,260,"TCTGCTGGAGATCCCTTCAT","ATTCACCTGATGTATCATTC","561307.5.peg.1270"," 303"
"2807",350,240,110,"CATCTACCATTTGACTTGCT","GATATAAATTCACCTATGGC","561307.5.peg.1275"," 308"
"2808",350,244,106,"CATCTACCATTTGACTTGCT","GCAGATATAAATTCACCTA","561307.5.peg.1275"," 308"
"2809",240,350,110,"GATATAAATTCACCTATGGC","CATCTACCATTTGACTTGCT","561307.5.peg.1275"," 308"
"2810",244,350,106,"GCAGATATAAATTCACCTA","CATCTACCATTTGACTTGCT","561307.5.peg.1275"," 308"
"2811",114,7,107,"AAATCATTTGGTAGGTGCCA","ATGAAATGATAGAAGAAGG","561307.5.peg.1276"," 309"
"2812",216,7,209,"AGTACAACATTTCGACGATT","ATGAAATGATAGAAGAAGG","561307.5.peg.1276"," 309"
"2813",210,7,203,"ACATTTCGACGATTCGGTAG","ATGAAATGATAGAAGAAGG","561307.5.peg.1276"," 309"
"2814",210,61,149,"ACATTTCGACGATTCGGTAG","CAAGTCATGTGCAACTAGAA","561307.5.peg.1276"," 309"
"2815",216,61,155,"AGTACAACATTTCGACGATT","CAAGTCATGTGCAACTAGAA","561307.5.peg.1276"," 309"
"2816",7,114,107,"ATGAAATGATAGAAGAAGG","AAATCATTTGGTAGGTGCCA","561307.5.peg.1276"," 309"
"2817",216,114,102,"AGTACAACATTTCGACGATT","AAATCATTTGGTAGGTGCCA","561307.5.peg.1276"," 309"
"2818",7,210,203,"ATGAAATGATAGAAGAAGG","ACATTTCGACGATTCGGTAG","561307.5.peg.1276"," 309"
"2819",61,210,149,"CAAGTCATGTGCAACTAGAA","ACATTTCGACGATTCGGTAG","561307.5.peg.1276"," 309"
"2820",7,216,209,"ATGAAATGATAGAAGAAGG","AGTACAACATTTCGACGATT","561307.5.peg.1276"," 309"
"2821",114,216,102,"AAATCATTTGGTAGGTGCCA","AGTACAACATTTCGACGATT","561307.5.peg.1276"," 309"
"2822",61,216,155,"CAAGTCATGTGCAACTAGAA","AGTACAACATTTCGACGATT","561307.5.peg.1276"," 309"
"2823",354,192,162,"TGCCCGAAATCTGTCATATC","CTTTCTTTGTCGTTAATAG","561307.5.peg.1277"," 310"
"2824",192,354,162,"CTTTCTTTGTCGTTAATAG","TGCCCGAAATCTGTCATATC","561307.5.peg.1277"," 310"
"2825",461,11,450,"CTGTTTGCGCTTGAGTCATA","TTCATCAACTAGTATTCGGG","561307.5.peg.1279"," 312"
"2826",444,11,433,"TATGGTCAACATATGTTTG","TTCATCAACTAGTATTCGGG","561307.5.peg.1279"," 312"
"2827",566,11,555,"AGGTAGCTAGCACTTCTTCT","TTCATCAACTAGTATTCGGG","561307.5.peg.1279"," 312"
"2828",444,72,372,"TATGGTCAACATATGTTTG","ATTGTATTTGGACTTGGTGT","561307.5.peg.1279"," 312"
"2829",566,72,494,"AGGTAGCTAGCACTTCTTCT","ATTGTATTTGGACTTGGTGT","561307.5.peg.1279"," 312"
"2830",461,72,389,"CTGTTTGCGCTTGAGTCATA","ATTGTATTTGGACTTGGTGT","561307.5.peg.1279"," 312"
"2831",11,444,433,"TTCATCAACTAGTATTCGGG","TATGGTCAACATATGTTTG","561307.5.peg.1279"," 312"
"2832",566,444,122,"AGGTAGCTAGCACTTCTTCT","TATGGTCAACATATGTTTG","561307.5.peg.1279"," 312"
"2833",72,444,372,"ATTGTATTTGGACTTGGTGT","TATGGTCAACATATGTTTG","561307.5.peg.1279"," 312"
"2834",11,461,450,"TTCATCAACTAGTATTCGGG","CTGTTTGCGCTTGAGTCATA","561307.5.peg.1279"," 312"
"2835",566,461,105,"AGGTAGCTAGCACTTCTTCT","CTGTTTGCGCTTGAGTCATA","561307.5.peg.1279"," 312"
"2836",72,461,389,"ATTGTATTTGGACTTGGTGT","CTGTTTGCGCTTGAGTCATA","561307.5.peg.1279"," 312"
"2837",11,566,555,"TTCATCAACTAGTATTCGGG","AGGTAGCTAGCACTTCTTCT","561307.5.peg.1279"," 312"
"2838",72,566,494,"ATTGTATTTGGACTTGGTGT","AGGTAGCTAGCACTTCTTCT","561307.5.peg.1279"," 312"
"2839",444,566,122,"TATGGTCAACATATGTTTG","AGGTAGCTAGCACTTCTTCT","561307.5.peg.1279"," 312"
"2840",461,566,105,"CTGTTTGCGCTTGAGTCATA","AGGTAGCTAGCACTTCTTCT","561307.5.peg.1279"," 312"
"2841",525,296,229,"CATAACTTGATGATAGAAC","CTTTGTTGCCACCTAACACT","561307.5.peg.128"," 313"
"2842",296,525,229,"CTTTGTTGCCACCTAACACT","CATAACTTGATGATAGAAC","561307.5.peg.128"," 313"
"2843",213,103,110,"ACTATATCTTCGGCTTCTTG","TTTATGTTGATTAGCACCAC","561307.5.peg.1291"," 326"
"2844",223,103,120,"ATCGTTTCGAACTATATCTT","TTTATGTTGATTAGCACCAC","561307.5.peg.1291"," 326"
"2845",103,213,110,"TTTATGTTGATTAGCACCAC","ACTATATCTTCGGCTTCTTG","561307.5.peg.1291"," 326"
"2846",103,223,120,"TTTATGTTGATTAGCACCAC","ATCGTTTCGAACTATATCTT","561307.5.peg.1291"," 326"
"2847",254,125,129,"CTTTAGAACTATTTCCGCCA","GTCCGTATTGCTGGTTCTGT","561307.5.peg.1292"," 327"
"2848",323,125,198,"CTGAATTTACAGTGACTTCA","GTCCGTATTGCTGGTTCTGT","561307.5.peg.1292"," 327"
"2849",369,125,244,"GCGTTTGTTGGTGCAAGAGA","GTCCGTATTGCTGGTTCTGT","561307.5.peg.1292"," 327"
"2850",125,254,129,"GTCCGTATTGCTGGTTCTGT","CTTTAGAACTATTTCCGCCA","561307.5.peg.1292"," 327"
"2851",369,254,115,"GCGTTTGTTGGTGCAAGAGA","CTTTAGAACTATTTCCGCCA","561307.5.peg.1292"," 327"
"2852",125,323,198,"GTCCGTATTGCTGGTTCTGT","CTGAATTTACAGTGACTTCA","561307.5.peg.1292"," 327"
"2853",125,369,244,"GTCCGTATTGCTGGTTCTGT","GCGTTTGTTGGTGCAAGAGA","561307.5.peg.1292"," 327"
"2854",254,369,115,"CTTTAGAACTATTTCCGCCA","GCGTTTGTTGGTGCAAGAGA","561307.5.peg.1292"," 327"
"2855",486,294,192,"ATGTTGGACGGCGACTCTTT","ATCTGATTCGTCATCTCATT","561307.5.peg.1295"," 330"
"2856",613,294,319,"CTCTTTACATCCGATTGCAC","ATCTGATTCGTCATCTCATT","561307.5.peg.1295"," 330"
"2857",678,294,384,"AGACCCGAAATATGATAAAT","ATCTGATTCGTCATCTCATT","561307.5.peg.1295"," 330"
"2858",486,354,132,"ATGTTGGACGGCGACTCTTT","TGAAACCCTCGTAATTCCAG","561307.5.peg.1295"," 330"
"2859",678,354,324,"AGACCCGAAATATGATAAAT","TGAAACCCTCGTAATTCCAG","561307.5.peg.1295"," 330"
"2860",613,354,259,"CTCTTTACATCCGATTGCAC","TGAAACCCTCGTAATTCCAG","561307.5.peg.1295"," 330"
"2861",294,486,192,"ATCTGATTCGTCATCTCATT","ATGTTGGACGGCGACTCTTT","561307.5.peg.1295"," 330"
"2862",354,486,132,"TGAAACCCTCGTAATTCCAG","ATGTTGGACGGCGACTCTTT","561307.5.peg.1295"," 330"
"2863",613,486,127,"CTCTTTACATCCGATTGCAC","ATGTTGGACGGCGACTCTTT","561307.5.peg.1295"," 330"
"2864",678,486,192,"AGACCCGAAATATGATAAAT","ATGTTGGACGGCGACTCTTT","561307.5.peg.1295"," 330"
"2865",294,613,319,"ATCTGATTCGTCATCTCATT","CTCTTTACATCCGATTGCAC","561307.5.peg.1295"," 330"
"2866",354,613,259,"TGAAACCCTCGTAATTCCAG","CTCTTTACATCCGATTGCAC","561307.5.peg.1295"," 330"
"2867",486,613,127,"ATGTTGGACGGCGACTCTTT","CTCTTTACATCCGATTGCAC","561307.5.peg.1295"," 330"
"2868",294,678,384,"ATCTGATTCGTCATCTCATT","AGACCCGAAATATGATAAAT","561307.5.peg.1295"," 330"
"2869",486,678,192,"ATGTTGGACGGCGACTCTTT","AGACCCGAAATATGATAAAT","561307.5.peg.1295"," 330"
"2870",354,678,324,"TGAAACCCTCGTAATTCCAG","AGACCCGAAATATGATAAAT","561307.5.peg.1295"," 330"
"2871",135,11,124,"GCTTCAGATGAAGAATTGAT","ACATTCCAACAATACTCAA","561307.5.peg.1297"," 332"
"2872",232,11,221,"CCATAACGTACTGTTAGAGA","ACATTCCAACAATACTCAA","561307.5.peg.1297"," 332"
"2873",327,11,316,"TTGATATTGCCCCAACTTTC","ACATTCCAACAATACTCAA","561307.5.peg.1297"," 332"
"2874",232,24,208,"CCATAACGTACTGTTAGAGA","TTTCTCCTTTGAGTATTGT","561307.5.peg.1297"," 332"
"2875",135,24,111,"GCTTCAGATGAAGAATTGAT","TTTCTCCTTTGAGTATTGT","561307.5.peg.1297"," 332"
"2876",327,24,303,"TTGATATTGCCCCAACTTTC","TTTCTCCTTTGAGTATTGT","561307.5.peg.1297"," 332"
"2877",11,135,124,"ACATTCCAACAATACTCAA","GCTTCAGATGAAGAATTGAT","561307.5.peg.1297"," 332"
"2878",24,135,111,"TTTCTCCTTTGAGTATTGT","GCTTCAGATGAAGAATTGAT","561307.5.peg.1297"," 332"
"2879",327,135,192,"TTGATATTGCCCCAACTTTC","GCTTCAGATGAAGAATTGAT","561307.5.peg.1297"," 332"
"2880",11,232,221,"ACATTCCAACAATACTCAA","CCATAACGTACTGTTAGAGA","561307.5.peg.1297"," 332"
"2881",24,232,208,"TTTCTCCTTTGAGTATTGT","CCATAACGTACTGTTAGAGA","561307.5.peg.1297"," 332"
"2882",11,327,316,"ACATTCCAACAATACTCAA","TTGATATTGCCCCAACTTTC","561307.5.peg.1297"," 332"
"2883",135,327,192,"GCTTCAGATGAAGAATTGAT","TTGATATTGCCCCAACTTTC","561307.5.peg.1297"," 332"
"2884",24,327,303,"TTTCTCCTTTGAGTATTGT","TTGATATTGCCCCAACTTTC","561307.5.peg.1297"," 332"
"2885",261,11,250,"GTTGCATGAATGCTACCATT","ACTTTGGGTAATTCACGCAA","561307.5.peg.1298"," 333"
"2886",328,11,317,"ATTAATGTTTCCCCAACTCT","ACTTTGGGTAATTCACGCAA","561307.5.peg.1298"," 333"
"2887",11,261,250,"ACTTTGGGTAATTCACGCAA","GTTGCATGAATGCTACCATT","561307.5.peg.1298"," 333"
"2888",11,328,317,"ACTTTGGGTAATTCACGCAA","ATTAATGTTTCCCCAACTCT","561307.5.peg.1298"," 333"
"2889",284,30,254,"TACCCATTTGTGATCCAGTT","TGTATGCGCTTACAATTT","561307.5.peg.1299"," 334"
"2890",420,30,390,"TCAGTTAAACCATTCCACAC","TGTATGCGCTTACAATTT","561307.5.peg.1299"," 334"
"2891",453,30,423,"AAATCAGCAAGAACTTGAGT","TGTATGCGCTTACAATTT","561307.5.peg.1299"," 334"
"2892",420,284,136,"TCAGTTAAACCATTCCACAC","TACCCATTTGTGATCCAGTT","561307.5.peg.1299"," 334"
"2893",30,284,254,"TGTATGCGCTTACAATTT","TACCCATTTGTGATCCAGTT","561307.5.peg.1299"," 334"
"2894",453,284,169,"AAATCAGCAAGAACTTGAGT","TACCCATTTGTGATCCAGTT","561307.5.peg.1299"," 334"
"2895",30,420,390,"TGTATGCGCTTACAATTT","TCAGTTAAACCATTCCACAC","561307.5.peg.1299"," 334"
"2896",284,420,136,"TACCCATTTGTGATCCAGTT","TCAGTTAAACCATTCCACAC","561307.5.peg.1299"," 334"
"2897",284,453,169,"TACCCATTTGTGATCCAGTT","AAATCAGCAAGAACTTGAGT","561307.5.peg.1299"," 334"
"2898",30,453,423,"TGTATGCGCTTACAATTT","AAATCAGCAAGAACTTGAGT","561307.5.peg.1299"," 334"
"2899",368,91,277,"GTTTACCAATTTGCATCGTT","TTCCCCTGCTGTAATATCAA","561307.5.peg.13"," 335"
"2900",556,91,465,"TTTAGGTTCACAAGCTAATG","TTCCCCTGCTGTAATATCAA","561307.5.peg.13"," 335"
"2901",227,91,136,"TAATTCTTCCTGTGTCCCCT","TTCCCCTGCTGTAATATCAA","561307.5.peg.13"," 335"
"2902",91,227,136,"TTCCCCTGCTGTAATATCAA","TAATTCTTCCTGTGTCCCCT","561307.5.peg.13"," 335"
"2903",368,227,141,"GTTTACCAATTTGCATCGTT","TAATTCTTCCTGTGTCCCCT","561307.5.peg.13"," 335"
"2904",556,227,329,"TTTAGGTTCACAAGCTAATG","TAATTCTTCCTGTGTCCCCT","561307.5.peg.13"," 335"
"2905",91,368,277,"TTCCCCTGCTGTAATATCAA","GTTTACCAATTTGCATCGTT","561307.5.peg.13"," 335"
"2906",556,368,188,"TTTAGGTTCACAAGCTAATG","GTTTACCAATTTGCATCGTT","561307.5.peg.13"," 335"
"2907",227,368,141,"TAATTCTTCCTGTGTCCCCT","GTTTACCAATTTGCATCGTT","561307.5.peg.13"," 335"
"2908",91,556,465,"TTCCCCTGCTGTAATATCAA","TTTAGGTTCACAAGCTAATG","561307.5.peg.13"," 335"
"2909",227,556,329,"TAATTCTTCCTGTGTCCCCT","TTTAGGTTCACAAGCTAATG","561307.5.peg.13"," 335"
"2910",368,556,188,"GTTTACCAATTTGCATCGTT","TTTAGGTTCACAAGCTAATG","561307.5.peg.13"," 335"
"2911",966,41,925,"CCAGCTGAAGAACCACGACC","AATATGCCACCATGATTGAA","561307.5.peg.130"," 336"
"2912",1067,41,1026,"CAGGCATTGTTACACGTTCT","AATATGCCACCATGATTGAA","561307.5.peg.130"," 336"
"2913",1349,41,1308,"TGAACCAGCGTTCATGTCGA","AATATGCCACCATGATTGAA","561307.5.peg.130"," 336"
"2914",1118,41,1077,"CGTACTGAATGACCCTTTCT","AATATGCCACCATGATTGAA","561307.5.peg.130"," 336"
"2915",1462,41,1421,"TGTATCCCCTTTCGTTAAAG","AATATGCCACCATGATTGAA","561307.5.peg.130"," 336"
"2916",1442,41,1401,"GGGCATATTCATATAATGGA","AATATGCCACCATGATTGAA","561307.5.peg.130"," 336"
"2917",556,41,515,"TGCTAATGCAGAAATCGTAT","AATATGCCACCATGATTGAA","561307.5.peg.130"," 336"
"2918",753,41,712,"TCATTAGGTGTCTCATATTG","AATATGCCACCATGATTGAA","561307.5.peg.130"," 336"
"2919",1398,41,1357,"GCATGTGTAGATGTATGTCT","AATATGCCACCATGATTGAA","561307.5.peg.130"," 336"
"2920",460,41,419,"GTCCATATATGTGTCATTAT","AATATGCCACCATGATTGAA","561307.5.peg.130"," 336"
"2921",157,41,116,"CAATACATTGGTGTCAGTTA","AATATGCCACCATGATTGAA","561307.5.peg.130"," 336"
"2922",482,41,441,"CTTGAATCGAAATACTAAGG","AATATGCCACCATGATTGAA","561307.5.peg.130"," 336"
"2923",485,41,444,"ACCTTGAATCGAAATACTA","AATATGCCACCATGATTGAA","561307.5.peg.130"," 336"
"2924",539,41,498,"TATCGGCATCTTGACGTGTT","AATATGCCACCATGATTGAA","561307.5.peg.130"," 336"
"2925",753,118,635,"TCATTAGGTGTCTCATATTG","TTCAGACACAGCAAGTCTTA","561307.5.peg.130"," 336"
"2926",1118,118,1000,"CGTACTGAATGACCCTTTCT","TTCAGACACAGCAAGTCTTA","561307.5.peg.130"," 336"
"2927",1349,118,1231,"TGAACCAGCGTTCATGTCGA","TTCAGACACAGCAAGTCTTA","561307.5.peg.130"," 336"
"2928",1067,118,949,"CAGGCATTGTTACACGTTCT","TTCAGACACAGCAAGTCTTA","561307.5.peg.130"," 336"
"2929",485,118,367,"ACCTTGAATCGAAATACTA","TTCAGACACAGCAAGTCTTA","561307.5.peg.130"," 336"
"2930",1442,118,1324,"GGGCATATTCATATAATGGA","TTCAGACACAGCAAGTCTTA","561307.5.peg.130"," 336"
"2931",556,118,438,"TGCTAATGCAGAAATCGTAT","TTCAGACACAGCAAGTCTTA","561307.5.peg.130"," 336"
"2932",1398,118,1280,"GCATGTGTAGATGTATGTCT","TTCAGACACAGCAAGTCTTA","561307.5.peg.130"," 336"
"2933",539,118,421,"TATCGGCATCTTGACGTGTT","TTCAGACACAGCAAGTCTTA","561307.5.peg.130"," 336"
"2934",966,118,848,"CCAGCTGAAGAACCACGACC","TTCAGACACAGCAAGTCTTA","561307.5.peg.130"," 336"
"2935",482,118,364,"CTTGAATCGAAATACTAAGG","TTCAGACACAGCAAGTCTTA","561307.5.peg.130"," 336"
"2936",460,118,342,"GTCCATATATGTGTCATTAT","TTCAGACACAGCAAGTCTTA","561307.5.peg.130"," 336"
"2937",1462,118,1344,"TGTATCCCCTTTCGTTAAAG","TTCAGACACAGCAAGTCTTA","561307.5.peg.130"," 336"
"2938",1067,157,910,"CAGGCATTGTTACACGTTCT","CAATACATTGGTGTCAGTTA","561307.5.peg.130"," 336"
"2939",1118,157,961,"CGTACTGAATGACCCTTTCT","CAATACATTGGTGTCAGTTA","561307.5.peg.130"," 336"
"2940",460,157,303,"GTCCATATATGTGTCATTAT","CAATACATTGGTGTCAGTTA","561307.5.peg.130"," 336"
"2941",1398,157,1241,"GCATGTGTAGATGTATGTCT","CAATACATTGGTGTCAGTTA","561307.5.peg.130"," 336"
"2942",556,157,399,"TGCTAATGCAGAAATCGTAT","CAATACATTGGTGTCAGTTA","561307.5.peg.130"," 336"
"2943",1442,157,1285,"GGGCATATTCATATAATGGA","CAATACATTGGTGTCAGTTA","561307.5.peg.130"," 336"
"2944",539,157,382,"TATCGGCATCTTGACGTGTT","CAATACATTGGTGTCAGTTA","561307.5.peg.130"," 336"
"2945",485,157,328,"ACCTTGAATCGAAATACTA","CAATACATTGGTGTCAGTTA","561307.5.peg.130"," 336"
"2946",41,157,116,"AATATGCCACCATGATTGAA","CAATACATTGGTGTCAGTTA","561307.5.peg.130"," 336"
"2947",1462,157,1305,"TGTATCCCCTTTCGTTAAAG","CAATACATTGGTGTCAGTTA","561307.5.peg.130"," 336"
"2948",753,157,596,"TCATTAGGTGTCTCATATTG","CAATACATTGGTGTCAGTTA","561307.5.peg.130"," 336"
"2949",1349,157,1192,"TGAACCAGCGTTCATGTCGA","CAATACATTGGTGTCAGTTA","561307.5.peg.130"," 336"
"2950",482,157,325,"CTTGAATCGAAATACTAAGG","CAATACATTGGTGTCAGTTA","561307.5.peg.130"," 336"
"2951",966,157,809,"CCAGCTGAAGAACCACGACC","CAATACATTGGTGTCAGTTA","561307.5.peg.130"," 336"
"2952",1442,460,982,"GGGCATATTCATATAATGGA","GTCCATATATGTGTCATTAT","561307.5.peg.130"," 336"
"2953",1118,460,658,"CGTACTGAATGACCCTTTCT","GTCCATATATGTGTCATTAT","561307.5.peg.130"," 336"
"2954",1398,460,938,"GCATGTGTAGATGTATGTCT","GTCCATATATGTGTCATTAT","561307.5.peg.130"," 336"
"2955",41,460,419,"AATATGCCACCATGATTGAA","GTCCATATATGTGTCATTAT","561307.5.peg.130"," 336"
"2956",966,460,506,"CCAGCTGAAGAACCACGACC","GTCCATATATGTGTCATTAT","561307.5.peg.130"," 336"
"2957",157,460,303,"CAATACATTGGTGTCAGTTA","GTCCATATATGTGTCATTAT","561307.5.peg.130"," 336"
"2958",1349,460,889,"TGAACCAGCGTTCATGTCGA","GTCCATATATGTGTCATTAT","561307.5.peg.130"," 336"
"2959",1462,460,1002,"TGTATCCCCTTTCGTTAAAG","GTCCATATATGTGTCATTAT","561307.5.peg.130"," 336"
"2960",118,460,342,"TTCAGACACAGCAAGTCTTA","GTCCATATATGTGTCATTAT","561307.5.peg.130"," 336"
"2961",753,460,293,"TCATTAGGTGTCTCATATTG","GTCCATATATGTGTCATTAT","561307.5.peg.130"," 336"
"2962",1067,460,607,"CAGGCATTGTTACACGTTCT","GTCCATATATGTGTCATTAT","561307.5.peg.130"," 336"
"2963",753,482,271,"TCATTAGGTGTCTCATATTG","CTTGAATCGAAATACTAAGG","561307.5.peg.130"," 336"
"2964",157,482,325,"CAATACATTGGTGTCAGTTA","CTTGAATCGAAATACTAAGG","561307.5.peg.130"," 336"
"2965",118,482,364,"TTCAGACACAGCAAGTCTTA","CTTGAATCGAAATACTAAGG","561307.5.peg.130"," 336"
"2966",1349,482,867,"TGAACCAGCGTTCATGTCGA","CTTGAATCGAAATACTAAGG","561307.5.peg.130"," 336"
"2967",1462,482,980,"TGTATCCCCTTTCGTTAAAG","CTTGAATCGAAATACTAAGG","561307.5.peg.130"," 336"
"2968",1067,482,585,"CAGGCATTGTTACACGTTCT","CTTGAATCGAAATACTAAGG","561307.5.peg.130"," 336"
"2969",1398,482,916,"GCATGTGTAGATGTATGTCT","CTTGAATCGAAATACTAAGG","561307.5.peg.130"," 336"
"2970",966,482,484,"CCAGCTGAAGAACCACGACC","CTTGAATCGAAATACTAAGG","561307.5.peg.130"," 336"
"2971",1442,482,960,"GGGCATATTCATATAATGGA","CTTGAATCGAAATACTAAGG","561307.5.peg.130"," 336"
"2972",1118,482,636,"CGTACTGAATGACCCTTTCT","CTTGAATCGAAATACTAAGG","561307.5.peg.130"," 336"
"2973",41,482,441,"AATATGCCACCATGATTGAA","CTTGAATCGAAATACTAAGG","561307.5.peg.130"," 336"
"2974",966,485,481,"CCAGCTGAAGAACCACGACC","ACCTTGAATCGAAATACTA","561307.5.peg.130"," 336"
"2975",41,485,444,"AATATGCCACCATGATTGAA","ACCTTGAATCGAAATACTA","561307.5.peg.130"," 336"
"2976",1349,485,864,"TGAACCAGCGTTCATGTCGA","ACCTTGAATCGAAATACTA","561307.5.peg.130"," 336"
"2977",1118,485,633,"CGTACTGAATGACCCTTTCT","ACCTTGAATCGAAATACTA","561307.5.peg.130"," 336"
"2978",1462,485,977,"TGTATCCCCTTTCGTTAAAG","ACCTTGAATCGAAATACTA","561307.5.peg.130"," 336"
"2979",1398,485,913,"GCATGTGTAGATGTATGTCT","ACCTTGAATCGAAATACTA","561307.5.peg.130"," 336"
"2980",1442,485,957,"GGGCATATTCATATAATGGA","ACCTTGAATCGAAATACTA","561307.5.peg.130"," 336"
"2981",753,485,268,"TCATTAGGTGTCTCATATTG","ACCTTGAATCGAAATACTA","561307.5.peg.130"," 336"
"2982",118,485,367,"TTCAGACACAGCAAGTCTTA","ACCTTGAATCGAAATACTA","561307.5.peg.130"," 336"
"2983",1067,485,582,"CAGGCATTGTTACACGTTCT","ACCTTGAATCGAAATACTA","561307.5.peg.130"," 336"
"2984",157,485,328,"CAATACATTGGTGTCAGTTA","ACCTTGAATCGAAATACTA","561307.5.peg.130"," 336"
"2985",1398,539,859,"GCATGTGTAGATGTATGTCT","TATCGGCATCTTGACGTGTT","561307.5.peg.130"," 336"
"2986",1067,539,528,"CAGGCATTGTTACACGTTCT","TATCGGCATCTTGACGTGTT","561307.5.peg.130"," 336"
"2987",966,539,427,"CCAGCTGAAGAACCACGACC","TATCGGCATCTTGACGTGTT","561307.5.peg.130"," 336"
"2988",1349,539,810,"TGAACCAGCGTTCATGTCGA","TATCGGCATCTTGACGTGTT","561307.5.peg.130"," 336"
"2989",1442,539,903,"GGGCATATTCATATAATGGA","TATCGGCATCTTGACGTGTT","561307.5.peg.130"," 336"
"2990",118,539,421,"TTCAGACACAGCAAGTCTTA","TATCGGCATCTTGACGTGTT","561307.5.peg.130"," 336"
"2991",1462,539,923,"TGTATCCCCTTTCGTTAAAG","TATCGGCATCTTGACGTGTT","561307.5.peg.130"," 336"
"2992",1118,539,579,"CGTACTGAATGACCCTTTCT","TATCGGCATCTTGACGTGTT","561307.5.peg.130"," 336"
"2993",753,539,214,"TCATTAGGTGTCTCATATTG","TATCGGCATCTTGACGTGTT","561307.5.peg.130"," 336"
"2994",41,539,498,"AATATGCCACCATGATTGAA","TATCGGCATCTTGACGTGTT","561307.5.peg.130"," 336"
"2995",157,539,382,"CAATACATTGGTGTCAGTTA","TATCGGCATCTTGACGTGTT","561307.5.peg.130"," 336"
"2996",157,556,399,"CAATACATTGGTGTCAGTTA","TGCTAATGCAGAAATCGTAT","561307.5.peg.130"," 336"
"2997",966,556,410,"CCAGCTGAAGAACCACGACC","TGCTAATGCAGAAATCGTAT","561307.5.peg.130"," 336"
"2998",1118,556,562,"CGTACTGAATGACCCTTTCT","TGCTAATGCAGAAATCGTAT","561307.5.peg.130"," 336"
"2999",1442,556,886,"GGGCATATTCATATAATGGA","TGCTAATGCAGAAATCGTAT","561307.5.peg.130"," 336"
"3000",1462,556,906,"TGTATCCCCTTTCGTTAAAG","TGCTAATGCAGAAATCGTAT","561307.5.peg.130"," 336"
"3001",1067,556,511,"CAGGCATTGTTACACGTTCT","TGCTAATGCAGAAATCGTAT","561307.5.peg.130"," 336"
"3002",118,556,438,"TTCAGACACAGCAAGTCTTA","TGCTAATGCAGAAATCGTAT","561307.5.peg.130"," 336"
"3003",41,556,515,"AATATGCCACCATGATTGAA","TGCTAATGCAGAAATCGTAT","561307.5.peg.130"," 336"
"3004",1398,556,842,"GCATGTGTAGATGTATGTCT","TGCTAATGCAGAAATCGTAT","561307.5.peg.130"," 336"
"3005",1349,556,793,"TGAACCAGCGTTCATGTCGA","TGCTAATGCAGAAATCGTAT","561307.5.peg.130"," 336"
"3006",753,556,197,"TCATTAGGTGTCTCATATTG","TGCTAATGCAGAAATCGTAT","561307.5.peg.130"," 336"
"3007",556,753,197,"TGCTAATGCAGAAATCGTAT","TCATTAGGTGTCTCATATTG","561307.5.peg.130"," 336"
"3008",1398,753,645,"GCATGTGTAGATGTATGTCT","TCATTAGGTGTCTCATATTG","561307.5.peg.130"," 336"
"3009",1067,753,314,"CAGGCATTGTTACACGTTCT","TCATTAGGTGTCTCATATTG","561307.5.peg.130"," 336"
"3010",157,753,596,"CAATACATTGGTGTCAGTTA","TCATTAGGTGTCTCATATTG","561307.5.peg.130"," 336"
"3011",482,753,271,"CTTGAATCGAAATACTAAGG","TCATTAGGTGTCTCATATTG","561307.5.peg.130"," 336"
"3012",1442,753,689,"GGGCATATTCATATAATGGA","TCATTAGGTGTCTCATATTG","561307.5.peg.130"," 336"
"3013",1118,753,365,"CGTACTGAATGACCCTTTCT","TCATTAGGTGTCTCATATTG","561307.5.peg.130"," 336"
"3014",460,753,293,"GTCCATATATGTGTCATTAT","TCATTAGGTGTCTCATATTG","561307.5.peg.130"," 336"
"3015",966,753,213,"CCAGCTGAAGAACCACGACC","TCATTAGGTGTCTCATATTG","561307.5.peg.130"," 336"
"3016",485,753,268,"ACCTTGAATCGAAATACTA","TCATTAGGTGTCTCATATTG","561307.5.peg.130"," 336"
"3017",1349,753,596,"TGAACCAGCGTTCATGTCGA","TCATTAGGTGTCTCATATTG","561307.5.peg.130"," 336"
"3018",118,753,635,"TTCAGACACAGCAAGTCTTA","TCATTAGGTGTCTCATATTG","561307.5.peg.130"," 336"
"3019",41,753,712,"AATATGCCACCATGATTGAA","TCATTAGGTGTCTCATATTG","561307.5.peg.130"," 336"
"3020",1462,753,709,"TGTATCCCCTTTCGTTAAAG","TCATTAGGTGTCTCATATTG","561307.5.peg.130"," 336"
"3021",539,753,214,"TATCGGCATCTTGACGTGTT","TCATTAGGTGTCTCATATTG","561307.5.peg.130"," 336"
"3022",482,966,484,"CTTGAATCGAAATACTAAGG","CCAGCTGAAGAACCACGACC","561307.5.peg.130"," 336"
"3023",1067,966,101,"CAGGCATTGTTACACGTTCT","CCAGCTGAAGAACCACGACC","561307.5.peg.130"," 336"
"3024",118,966,848,"TTCAGACACAGCAAGTCTTA","CCAGCTGAAGAACCACGACC","561307.5.peg.130"," 336"
"3025",41,966,925,"AATATGCCACCATGATTGAA","CCAGCTGAAGAACCACGACC","561307.5.peg.130"," 336"
"3026",1349,966,383,"TGAACCAGCGTTCATGTCGA","CCAGCTGAAGAACCACGACC","561307.5.peg.130"," 336"
"3027",753,966,213,"TCATTAGGTGTCTCATATTG","CCAGCTGAAGAACCACGACC","561307.5.peg.130"," 336"
"3028",556,966,410,"TGCTAATGCAGAAATCGTAT","CCAGCTGAAGAACCACGACC","561307.5.peg.130"," 336"
"3029",485,966,481,"ACCTTGAATCGAAATACTA","CCAGCTGAAGAACCACGACC","561307.5.peg.130"," 336"
"3030",1398,966,432,"GCATGTGTAGATGTATGTCT","CCAGCTGAAGAACCACGACC","561307.5.peg.130"," 336"
"3031",539,966,427,"TATCGGCATCTTGACGTGTT","CCAGCTGAAGAACCACGACC","561307.5.peg.130"," 336"
"3032",1442,966,476,"GGGCATATTCATATAATGGA","CCAGCTGAAGAACCACGACC","561307.5.peg.130"," 336"
"3033",157,966,809,"CAATACATTGGTGTCAGTTA","CCAGCTGAAGAACCACGACC","561307.5.peg.130"," 336"
"3034",1462,966,496,"TGTATCCCCTTTCGTTAAAG","CCAGCTGAAGAACCACGACC","561307.5.peg.130"," 336"
"3035",460,966,506,"GTCCATATATGTGTCATTAT","CCAGCTGAAGAACCACGACC","561307.5.peg.130"," 336"
"3036",1118,966,152,"CGTACTGAATGACCCTTTCT","CCAGCTGAAGAACCACGACC","561307.5.peg.130"," 336"
"3037",485,1067,582,"ACCTTGAATCGAAATACTA","CAGGCATTGTTACACGTTCT","561307.5.peg.130"," 336"
"3038",539,1067,528,"TATCGGCATCTTGACGTGTT","CAGGCATTGTTACACGTTCT","561307.5.peg.130"," 336"
"3039",1398,1067,331,"GCATGTGTAGATGTATGTCT","CAGGCATTGTTACACGTTCT","561307.5.peg.130"," 336"
"3040",1442,1067,375,"GGGCATATTCATATAATGGA","CAGGCATTGTTACACGTTCT","561307.5.peg.130"," 336"
"3041",157,1067,910,"CAATACATTGGTGTCAGTTA","CAGGCATTGTTACACGTTCT","561307.5.peg.130"," 336"
"3042",482,1067,585,"CTTGAATCGAAATACTAAGG","CAGGCATTGTTACACGTTCT","561307.5.peg.130"," 336"
"3043",1462,1067,395,"TGTATCCCCTTTCGTTAAAG","CAGGCATTGTTACACGTTCT","561307.5.peg.130"," 336"
"3044",460,1067,607,"GTCCATATATGTGTCATTAT","CAGGCATTGTTACACGTTCT","561307.5.peg.130"," 336"
"3045",556,1067,511,"TGCTAATGCAGAAATCGTAT","CAGGCATTGTTACACGTTCT","561307.5.peg.130"," 336"
"3046",41,1067,1026,"AATATGCCACCATGATTGAA","CAGGCATTGTTACACGTTCT","561307.5.peg.130"," 336"
"3047",753,1067,314,"TCATTAGGTGTCTCATATTG","CAGGCATTGTTACACGTTCT","561307.5.peg.130"," 336"
"3048",118,1067,949,"TTCAGACACAGCAAGTCTTA","CAGGCATTGTTACACGTTCT","561307.5.peg.130"," 336"
"3049",1349,1067,282,"TGAACCAGCGTTCATGTCGA","CAGGCATTGTTACACGTTCT","561307.5.peg.130"," 336"
"3050",966,1067,101,"CCAGCTGAAGAACCACGACC","CAGGCATTGTTACACGTTCT","561307.5.peg.130"," 336"
"3051",482,1118,636,"CTTGAATCGAAATACTAAGG","CGTACTGAATGACCCTTTCT","561307.5.peg.130"," 336"
"3052",1349,1118,231,"TGAACCAGCGTTCATGTCGA","CGTACTGAATGACCCTTTCT","561307.5.peg.130"," 336"
"3053",118,1118,1000,"TTCAGACACAGCAAGTCTTA","CGTACTGAATGACCCTTTCT","561307.5.peg.130"," 336"
"3054",41,1118,1077,"AATATGCCACCATGATTGAA","CGTACTGAATGACCCTTTCT","561307.5.peg.130"," 336"
"3055",753,1118,365,"TCATTAGGTGTCTCATATTG","CGTACTGAATGACCCTTTCT","561307.5.peg.130"," 336"
"3056",556,1118,562,"TGCTAATGCAGAAATCGTAT","CGTACTGAATGACCCTTTCT","561307.5.peg.130"," 336"
"3057",1398,1118,280,"GCATGTGTAGATGTATGTCT","CGTACTGAATGACCCTTTCT","561307.5.peg.130"," 336"
"3058",485,1118,633,"ACCTTGAATCGAAATACTA","CGTACTGAATGACCCTTTCT","561307.5.peg.130"," 336"
"3059",539,1118,579,"TATCGGCATCTTGACGTGTT","CGTACTGAATGACCCTTTCT","561307.5.peg.130"," 336"
"3060",460,1118,658,"GTCCATATATGTGTCATTAT","CGTACTGAATGACCCTTTCT","561307.5.peg.130"," 336"
"3061",966,1118,152,"CCAGCTGAAGAACCACGACC","CGTACTGAATGACCCTTTCT","561307.5.peg.130"," 336"
"3062",157,1118,961,"CAATACATTGGTGTCAGTTA","CGTACTGAATGACCCTTTCT","561307.5.peg.130"," 336"
"3063",1462,1118,344,"TGTATCCCCTTTCGTTAAAG","CGTACTGAATGACCCTTTCT","561307.5.peg.130"," 336"
"3064",1442,1118,324,"GGGCATATTCATATAATGGA","CGTACTGAATGACCCTTTCT","561307.5.peg.130"," 336"
"3065",482,1349,867,"CTTGAATCGAAATACTAAGG","TGAACCAGCGTTCATGTCGA","561307.5.peg.130"," 336"
"3066",41,1349,1308,"AATATGCCACCATGATTGAA","TGAACCAGCGTTCATGTCGA","561307.5.peg.130"," 336"
"3067",1067,1349,282,"CAGGCATTGTTACACGTTCT","TGAACCAGCGTTCATGTCGA","561307.5.peg.130"," 336"
"3068",460,1349,889,"GTCCATATATGTGTCATTAT","TGAACCAGCGTTCATGTCGA","561307.5.peg.130"," 336"
"3069",118,1349,1231,"TTCAGACACAGCAAGTCTTA","TGAACCAGCGTTCATGTCGA","561307.5.peg.130"," 336"
"3070",753,1349,596,"TCATTAGGTGTCTCATATTG","TGAACCAGCGTTCATGTCGA","561307.5.peg.130"," 336"
"3071",1462,1349,113,"TGTATCCCCTTTCGTTAAAG","TGAACCAGCGTTCATGTCGA","561307.5.peg.130"," 336"
"3072",1118,1349,231,"CGTACTGAATGACCCTTTCT","TGAACCAGCGTTCATGTCGA","561307.5.peg.130"," 336"
"3073",556,1349,793,"TGCTAATGCAGAAATCGTAT","TGAACCAGCGTTCATGTCGA","561307.5.peg.130"," 336"
"3074",485,1349,864,"ACCTTGAATCGAAATACTA","TGAACCAGCGTTCATGTCGA","561307.5.peg.130"," 336"
"3075",966,1349,383,"CCAGCTGAAGAACCACGACC","TGAACCAGCGTTCATGTCGA","561307.5.peg.130"," 336"
"3076",157,1349,1192,"CAATACATTGGTGTCAGTTA","TGAACCAGCGTTCATGTCGA","561307.5.peg.130"," 336"
"3077",539,1349,810,"TATCGGCATCTTGACGTGTT","TGAACCAGCGTTCATGTCGA","561307.5.peg.130"," 336"
"3078",41,1398,1357,"AATATGCCACCATGATTGAA","GCATGTGTAGATGTATGTCT","561307.5.peg.130"," 336"
"3079",539,1398,859,"TATCGGCATCTTGACGTGTT","GCATGTGTAGATGTATGTCT","561307.5.peg.130"," 336"
"3080",460,1398,938,"GTCCATATATGTGTCATTAT","GCATGTGTAGATGTATGTCT","561307.5.peg.130"," 336"
"3081",482,1398,916,"CTTGAATCGAAATACTAAGG","GCATGTGTAGATGTATGTCT","561307.5.peg.130"," 336"
"3082",118,1398,1280,"TTCAGACACAGCAAGTCTTA","GCATGTGTAGATGTATGTCT","561307.5.peg.130"," 336"
"3083",1067,1398,331,"CAGGCATTGTTACACGTTCT","GCATGTGTAGATGTATGTCT","561307.5.peg.130"," 336"
"3084",157,1398,1241,"CAATACATTGGTGTCAGTTA","GCATGTGTAGATGTATGTCT","561307.5.peg.130"," 336"
"3085",966,1398,432,"CCAGCTGAAGAACCACGACC","GCATGTGTAGATGTATGTCT","561307.5.peg.130"," 336"
"3086",1118,1398,280,"CGTACTGAATGACCCTTTCT","GCATGTGTAGATGTATGTCT","561307.5.peg.130"," 336"
"3087",753,1398,645,"TCATTAGGTGTCTCATATTG","GCATGTGTAGATGTATGTCT","561307.5.peg.130"," 336"
"3088",485,1398,913,"ACCTTGAATCGAAATACTA","GCATGTGTAGATGTATGTCT","561307.5.peg.130"," 336"
"3089",556,1398,842,"TGCTAATGCAGAAATCGTAT","GCATGTGTAGATGTATGTCT","561307.5.peg.130"," 336"
"3090",157,1442,1285,"CAATACATTGGTGTCAGTTA","GGGCATATTCATATAATGGA","561307.5.peg.130"," 336"
"3091",1118,1442,324,"CGTACTGAATGACCCTTTCT","GGGCATATTCATATAATGGA","561307.5.peg.130"," 336"
"3092",966,1442,476,"CCAGCTGAAGAACCACGACC","GGGCATATTCATATAATGGA","561307.5.peg.130"," 336"
"3093",41,1442,1401,"AATATGCCACCATGATTGAA","GGGCATATTCATATAATGGA","561307.5.peg.130"," 336"
"3094",482,1442,960,"CTTGAATCGAAATACTAAGG","GGGCATATTCATATAATGGA","561307.5.peg.130"," 336"
"3095",485,1442,957,"ACCTTGAATCGAAATACTA","GGGCATATTCATATAATGGA","561307.5.peg.130"," 336"
"3096",118,1442,1324,"TTCAGACACAGCAAGTCTTA","GGGCATATTCATATAATGGA","561307.5.peg.130"," 336"
"3097",1067,1442,375,"CAGGCATTGTTACACGTTCT","GGGCATATTCATATAATGGA","561307.5.peg.130"," 336"
"3098",556,1442,886,"TGCTAATGCAGAAATCGTAT","GGGCATATTCATATAATGGA","561307.5.peg.130"," 336"
"3099",460,1442,982,"GTCCATATATGTGTCATTAT","GGGCATATTCATATAATGGA","561307.5.peg.130"," 336"
"3100",753,1442,689,"TCATTAGGTGTCTCATATTG","GGGCATATTCATATAATGGA","561307.5.peg.130"," 336"
"3101",539,1442,903,"TATCGGCATCTTGACGTGTT","GGGCATATTCATATAATGGA","561307.5.peg.130"," 336"
"3102",539,1462,923,"TATCGGCATCTTGACGTGTT","TGTATCCCCTTTCGTTAAAG","561307.5.peg.130"," 336"
"3103",966,1462,496,"CCAGCTGAAGAACCACGACC","TGTATCCCCTTTCGTTAAAG","561307.5.peg.130"," 336"
"3104",118,1462,1344,"TTCAGACACAGCAAGTCTTA","TGTATCCCCTTTCGTTAAAG","561307.5.peg.130"," 336"
"3105",460,1462,1002,"GTCCATATATGTGTCATTAT","TGTATCCCCTTTCGTTAAAG","561307.5.peg.130"," 336"
"3106",1118,1462,344,"CGTACTGAATGACCCTTTCT","TGTATCCCCTTTCGTTAAAG","561307.5.peg.130"," 336"
"3107",41,1462,1421,"AATATGCCACCATGATTGAA","TGTATCCCCTTTCGTTAAAG","561307.5.peg.130"," 336"
"3108",556,1462,906,"TGCTAATGCAGAAATCGTAT","TGTATCCCCTTTCGTTAAAG","561307.5.peg.130"," 336"
"3109",482,1462,980,"CTTGAATCGAAATACTAAGG","TGTATCCCCTTTCGTTAAAG","561307.5.peg.130"," 336"
"3110",157,1462,1305,"CAATACATTGGTGTCAGTTA","TGTATCCCCTTTCGTTAAAG","561307.5.peg.130"," 336"
"3111",1067,1462,395,"CAGGCATTGTTACACGTTCT","TGTATCCCCTTTCGTTAAAG","561307.5.peg.130"," 336"
"3112",485,1462,977,"ACCTTGAATCGAAATACTA","TGTATCCCCTTTCGTTAAAG","561307.5.peg.130"," 336"
"3113",753,1462,709,"TCATTAGGTGTCTCATATTG","TGTATCCCCTTTCGTTAAAG","561307.5.peg.130"," 336"
"3114",1349,1462,113,"TGAACCAGCGTTCATGTCGA","TGTATCCCCTTTCGTTAAAG","561307.5.peg.130"," 336"
"3115",198,30,168,"AAATTAATGCTTCCAACCTG","AGTCATGGTTGCTACATT","561307.5.peg.1300"," 337"
"3116",264,30,234,"ATTGCGCCACATTCAGCAAA","AGTCATGGTTGCTACATT","561307.5.peg.1300"," 337"
"3117",255,30,225,"CATTCAGCAAATGGAAATGC","AGTCATGGTTGCTACATT","561307.5.peg.1300"," 337"
"3118",405,30,375,"TTTGAAGGATTGTTAAATGC","AGTCATGGTTGCTACATT","561307.5.peg.1300"," 337"
"3119",255,102,153,"CATTCAGCAAATGGAAATGC","ACAAGCTCGAGTTGTTCTTG","561307.5.peg.1300"," 337"
"3120",405,102,303,"TTTGAAGGATTGTTAAATGC","ACAAGCTCGAGTTGTTCTTG","561307.5.peg.1300"," 337"
"3121",264,102,162,"ATTGCGCCACATTCAGCAAA","ACAAGCTCGAGTTGTTCTTG","561307.5.peg.1300"," 337"
"3122",405,198,207,"TTTGAAGGATTGTTAAATGC","AAATTAATGCTTCCAACCTG","561307.5.peg.1300"," 337"
"3123",30,198,168,"AGTCATGGTTGCTACATT","AAATTAATGCTTCCAACCTG","561307.5.peg.1300"," 337"
"3124",102,255,153,"ACAAGCTCGAGTTGTTCTTG","CATTCAGCAAATGGAAATGC","561307.5.peg.1300"," 337"
"3125",30,255,225,"AGTCATGGTTGCTACATT","CATTCAGCAAATGGAAATGC","561307.5.peg.1300"," 337"
"3126",405,255,150,"TTTGAAGGATTGTTAAATGC","CATTCAGCAAATGGAAATGC","561307.5.peg.1300"," 337"
"3127",30,264,234,"AGTCATGGTTGCTACATT","ATTGCGCCACATTCAGCAAA","561307.5.peg.1300"," 337"
"3128",102,264,162,"ACAAGCTCGAGTTGTTCTTG","ATTGCGCCACATTCAGCAAA","561307.5.peg.1300"," 337"
"3129",405,264,141,"TTTGAAGGATTGTTAAATGC","ATTGCGCCACATTCAGCAAA","561307.5.peg.1300"," 337"
"3130",30,405,375,"AGTCATGGTTGCTACATT","TTTGAAGGATTGTTAAATGC","561307.5.peg.1300"," 337"
"3131",102,405,303,"ACAAGCTCGAGTTGTTCTTG","TTTGAAGGATTGTTAAATGC","561307.5.peg.1300"," 337"
"3132",255,405,150,"CATTCAGCAAATGGAAATGC","TTTGAAGGATTGTTAAATGC","561307.5.peg.1300"," 337"
"3133",198,405,207,"AAATTAATGCTTCCAACCTG","TTTGAAGGATTGTTAAATGC","561307.5.peg.1300"," 337"
"3134",264,405,141,"ATTGCGCCACATTCAGCAAA","TTTGAAGGATTGTTAAATGC","561307.5.peg.1300"," 337"
"3135",201,11,190,"ATCTTTAGTTCTTGGGATGA","AATGCTAGGTTAAATGTCGA","561307.5.peg.1301"," 338"
"3136",692,11,681,"TACTACCGACAGAGCTGGCA","AATGCTAGGTTAAATGTCGA","561307.5.peg.1301"," 338"
"3137",333,11,322,"TAAGTATTCGGAATTGATAC","AATGCTAGGTTAAATGTCGA","561307.5.peg.1301"," 338"
"3138",384,11,373,"TGCTACTTGTTATTTGTTC","AATGCTAGGTTAAATGTCGA","561307.5.peg.1301"," 338"
"3139",375,11,364,"GTTATTTGTTCTGGTCCAGC","AATGCTAGGTTAAATGTCGA","561307.5.peg.1301"," 338"
"3140",168,11,157,"AGTTTAGAATATGCACCAGC","AATGCTAGGTTAAATGTCGA","561307.5.peg.1301"," 338"
"3141",731,11,720,"AGGCAATTACAACCGAGAAC","AATGCTAGGTTAAATGTCGA","561307.5.peg.1301"," 338"
"3142",697,11,686,"AAATGTACTACCGACAGAGC","AATGCTAGGTTAAATGTCGA","561307.5.peg.1301"," 338"
"3143",255,11,244,"TCTAGTTCCTGTTGCGTACC","AATGCTAGGTTAAATGTCGA","561307.5.peg.1301"," 338"
"3144",751,11,740,"AGTTGTACCAGCGGCATTAG","AATGCTAGGTTAAATGTCGA","561307.5.peg.1301"," 338"
"3145",685,11,674,"GACAGAGCTGGCAAGGAATA","AATGCTAGGTTAAATGTCGA","561307.5.peg.1301"," 338"
"3146",685,168,517,"GACAGAGCTGGCAAGGAATA","AGTTTAGAATATGCACCAGC","561307.5.peg.1301"," 338"
"3147",333,168,165,"TAAGTATTCGGAATTGATAC","AGTTTAGAATATGCACCAGC","561307.5.peg.1301"," 338"
"3148",731,168,563,"AGGCAATTACAACCGAGAAC","AGTTTAGAATATGCACCAGC","561307.5.peg.1301"," 338"
"3149",11,168,157,"AATGCTAGGTTAAATGTCGA","AGTTTAGAATATGCACCAGC","561307.5.peg.1301"," 338"
"3150",692,168,524,"TACTACCGACAGAGCTGGCA","AGTTTAGAATATGCACCAGC","561307.5.peg.1301"," 338"
"3151",751,168,583,"AGTTGTACCAGCGGCATTAG","AGTTTAGAATATGCACCAGC","561307.5.peg.1301"," 338"
"3152",384,168,216,"TGCTACTTGTTATTTGTTC","AGTTTAGAATATGCACCAGC","561307.5.peg.1301"," 338"
"3153",375,168,207,"GTTATTTGTTCTGGTCCAGC","AGTTTAGAATATGCACCAGC","561307.5.peg.1301"," 338"
"3154",697,168,529,"AAATGTACTACCGACAGAGC","AGTTTAGAATATGCACCAGC","561307.5.peg.1301"," 338"
"3155",11,201,190,"AATGCTAGGTTAAATGTCGA","ATCTTTAGTTCTTGGGATGA","561307.5.peg.1301"," 338"
"3156",333,201,132,"TAAGTATTCGGAATTGATAC","ATCTTTAGTTCTTGGGATGA","561307.5.peg.1301"," 338"
"3157",384,201,183,"TGCTACTTGTTATTTGTTC","ATCTTTAGTTCTTGGGATGA","561307.5.peg.1301"," 338"
"3158",375,201,174,"GTTATTTGTTCTGGTCCAGC","ATCTTTAGTTCTTGGGATGA","561307.5.peg.1301"," 338"
"3159",697,201,496,"AAATGTACTACCGACAGAGC","ATCTTTAGTTCTTGGGATGA","561307.5.peg.1301"," 338"
"3160",685,201,484,"GACAGAGCTGGCAAGGAATA","ATCTTTAGTTCTTGGGATGA","561307.5.peg.1301"," 338"
"3161",731,201,530,"AGGCAATTACAACCGAGAAC","ATCTTTAGTTCTTGGGATGA","561307.5.peg.1301"," 338"
"3162",692,201,491,"TACTACCGACAGAGCTGGCA","ATCTTTAGTTCTTGGGATGA","561307.5.peg.1301"," 338"
"3163",751,201,550,"AGTTGTACCAGCGGCATTAG","ATCTTTAGTTCTTGGGATGA","561307.5.peg.1301"," 338"
"3164",685,255,430,"GACAGAGCTGGCAAGGAATA","TCTAGTTCCTGTTGCGTACC","561307.5.peg.1301"," 338"
"3165",11,255,244,"AATGCTAGGTTAAATGTCGA","TCTAGTTCCTGTTGCGTACC","561307.5.peg.1301"," 338"
"3166",692,255,437,"TACTACCGACAGAGCTGGCA","TCTAGTTCCTGTTGCGTACC","561307.5.peg.1301"," 338"
"3167",375,255,120,"GTTATTTGTTCTGGTCCAGC","TCTAGTTCCTGTTGCGTACC","561307.5.peg.1301"," 338"
"3168",751,255,496,"AGTTGTACCAGCGGCATTAG","TCTAGTTCCTGTTGCGTACC","561307.5.peg.1301"," 338"
"3169",697,255,442,"AAATGTACTACCGACAGAGC","TCTAGTTCCTGTTGCGTACC","561307.5.peg.1301"," 338"
"3170",731,255,476,"AGGCAATTACAACCGAGAAC","TCTAGTTCCTGTTGCGTACC","561307.5.peg.1301"," 338"
"3171",384,255,129,"TGCTACTTGTTATTTGTTC","TCTAGTTCCTGTTGCGTACC","561307.5.peg.1301"," 338"
"3172",11,333,322,"AATGCTAGGTTAAATGTCGA","TAAGTATTCGGAATTGATAC","561307.5.peg.1301"," 338"
"3173",697,333,364,"AAATGTACTACCGACAGAGC","TAAGTATTCGGAATTGATAC","561307.5.peg.1301"," 338"
"3174",168,333,165,"AGTTTAGAATATGCACCAGC","TAAGTATTCGGAATTGATAC","561307.5.peg.1301"," 338"
"3175",751,333,418,"AGTTGTACCAGCGGCATTAG","TAAGTATTCGGAATTGATAC","561307.5.peg.1301"," 338"
"3176",692,333,359,"TACTACCGACAGAGCTGGCA","TAAGTATTCGGAATTGATAC","561307.5.peg.1301"," 338"
"3177",685,333,352,"GACAGAGCTGGCAAGGAATA","TAAGTATTCGGAATTGATAC","561307.5.peg.1301"," 338"
"3178",201,333,132,"ATCTTTAGTTCTTGGGATGA","TAAGTATTCGGAATTGATAC","561307.5.peg.1301"," 338"
"3179",731,333,398,"AGGCAATTACAACCGAGAAC","TAAGTATTCGGAATTGATAC","561307.5.peg.1301"," 338"
"3180",692,375,317,"TACTACCGACAGAGCTGGCA","GTTATTTGTTCTGGTCCAGC","561307.5.peg.1301"," 338"
"3181",11,375,364,"AATGCTAGGTTAAATGTCGA","GTTATTTGTTCTGGTCCAGC","561307.5.peg.1301"," 338"
"3182",751,375,376,"AGTTGTACCAGCGGCATTAG","GTTATTTGTTCTGGTCCAGC","561307.5.peg.1301"," 338"
"3183",168,375,207,"AGTTTAGAATATGCACCAGC","GTTATTTGTTCTGGTCCAGC","561307.5.peg.1301"," 338"
"3184",685,375,310,"GACAGAGCTGGCAAGGAATA","GTTATTTGTTCTGGTCCAGC","561307.5.peg.1301"," 338"
"3185",201,375,174,"ATCTTTAGTTCTTGGGATGA","GTTATTTGTTCTGGTCCAGC","561307.5.peg.1301"," 338"
"3186",731,375,356,"AGGCAATTACAACCGAGAAC","GTTATTTGTTCTGGTCCAGC","561307.5.peg.1301"," 338"
"3187",255,375,120,"TCTAGTTCCTGTTGCGTACC","GTTATTTGTTCTGGTCCAGC","561307.5.peg.1301"," 338"
"3188",697,375,322,"AAATGTACTACCGACAGAGC","GTTATTTGTTCTGGTCCAGC","561307.5.peg.1301"," 338"
"3189",731,384,347,"AGGCAATTACAACCGAGAAC","TGCTACTTGTTATTTGTTC","561307.5.peg.1301"," 338"
"3190",692,384,308,"TACTACCGACAGAGCTGGCA","TGCTACTTGTTATTTGTTC","561307.5.peg.1301"," 338"
"3191",697,384,313,"AAATGTACTACCGACAGAGC","TGCTACTTGTTATTTGTTC","561307.5.peg.1301"," 338"
"3192",751,384,367,"AGTTGTACCAGCGGCATTAG","TGCTACTTGTTATTTGTTC","561307.5.peg.1301"," 338"
"3193",201,384,183,"ATCTTTAGTTCTTGGGATGA","TGCTACTTGTTATTTGTTC","561307.5.peg.1301"," 338"
"3194",11,384,373,"AATGCTAGGTTAAATGTCGA","TGCTACTTGTTATTTGTTC","561307.5.peg.1301"," 338"
"3195",255,384,129,"TCTAGTTCCTGTTGCGTACC","TGCTACTTGTTATTTGTTC","561307.5.peg.1301"," 338"
"3196",685,384,301,"GACAGAGCTGGCAAGGAATA","TGCTACTTGTTATTTGTTC","561307.5.peg.1301"," 338"
"3197",168,384,216,"AGTTTAGAATATGCACCAGC","TGCTACTTGTTATTTGTTC","561307.5.peg.1301"," 338"
"3198",11,685,674,"AATGCTAGGTTAAATGTCGA","GACAGAGCTGGCAAGGAATA","561307.5.peg.1301"," 338"
"3199",201,685,484,"ATCTTTAGTTCTTGGGATGA","GACAGAGCTGGCAAGGAATA","561307.5.peg.1301"," 338"
"3200",375,685,310,"GTTATTTGTTCTGGTCCAGC","GACAGAGCTGGCAAGGAATA","561307.5.peg.1301"," 338"
"3201",384,685,301,"TGCTACTTGTTATTTGTTC","GACAGAGCTGGCAAGGAATA","561307.5.peg.1301"," 338"
"3202",255,685,430,"TCTAGTTCCTGTTGCGTACC","GACAGAGCTGGCAAGGAATA","561307.5.peg.1301"," 338"
"3203",168,685,517,"AGTTTAGAATATGCACCAGC","GACAGAGCTGGCAAGGAATA","561307.5.peg.1301"," 338"
"3204",333,685,352,"TAAGTATTCGGAATTGATAC","GACAGAGCTGGCAAGGAATA","561307.5.peg.1301"," 338"
"3205",384,692,308,"TGCTACTTGTTATTTGTTC","TACTACCGACAGAGCTGGCA","561307.5.peg.1301"," 338"
"3206",333,692,359,"TAAGTATTCGGAATTGATAC","TACTACCGACAGAGCTGGCA","561307.5.peg.1301"," 338"
"3207",11,692,681,"AATGCTAGGTTAAATGTCGA","TACTACCGACAGAGCTGGCA","561307.5.peg.1301"," 338"
"3208",375,692,317,"GTTATTTGTTCTGGTCCAGC","TACTACCGACAGAGCTGGCA","561307.5.peg.1301"," 338"
"3209",255,692,437,"TCTAGTTCCTGTTGCGTACC","TACTACCGACAGAGCTGGCA","561307.5.peg.1301"," 338"
"3210",168,692,524,"AGTTTAGAATATGCACCAGC","TACTACCGACAGAGCTGGCA","561307.5.peg.1301"," 338"
"3211",201,692,491,"ATCTTTAGTTCTTGGGATGA","TACTACCGACAGAGCTGGCA","561307.5.peg.1301"," 338"
"3212",333,697,364,"TAAGTATTCGGAATTGATAC","AAATGTACTACCGACAGAGC","561307.5.peg.1301"," 338"
"3213",11,697,686,"AATGCTAGGTTAAATGTCGA","AAATGTACTACCGACAGAGC","561307.5.peg.1301"," 338"
"3214",255,697,442,"TCTAGTTCCTGTTGCGTACC","AAATGTACTACCGACAGAGC","561307.5.peg.1301"," 338"
"3215",201,697,496,"ATCTTTAGTTCTTGGGATGA","AAATGTACTACCGACAGAGC","561307.5.peg.1301"," 338"
"3216",168,697,529,"AGTTTAGAATATGCACCAGC","AAATGTACTACCGACAGAGC","561307.5.peg.1301"," 338"
"3217",384,697,313,"TGCTACTTGTTATTTGTTC","AAATGTACTACCGACAGAGC","561307.5.peg.1301"," 338"
"3218",375,697,322,"GTTATTTGTTCTGGTCCAGC","AAATGTACTACCGACAGAGC","561307.5.peg.1301"," 338"
"3219",201,731,530,"ATCTTTAGTTCTTGGGATGA","AGGCAATTACAACCGAGAAC","561307.5.peg.1301"," 338"
"3220",375,731,356,"GTTATTTGTTCTGGTCCAGC","AGGCAATTACAACCGAGAAC","561307.5.peg.1301"," 338"
"3221",168,731,563,"AGTTTAGAATATGCACCAGC","AGGCAATTACAACCGAGAAC","561307.5.peg.1301"," 338"
"3222",11,731,720,"AATGCTAGGTTAAATGTCGA","AGGCAATTACAACCGAGAAC","561307.5.peg.1301"," 338"
"3223",255,731,476,"TCTAGTTCCTGTTGCGTACC","AGGCAATTACAACCGAGAAC","561307.5.peg.1301"," 338"
"3224",333,731,398,"TAAGTATTCGGAATTGATAC","AGGCAATTACAACCGAGAAC","561307.5.peg.1301"," 338"
"3225",384,731,347,"TGCTACTTGTTATTTGTTC","AGGCAATTACAACCGAGAAC","561307.5.peg.1301"," 338"
"3226",255,751,496,"TCTAGTTCCTGTTGCGTACC","AGTTGTACCAGCGGCATTAG","561307.5.peg.1301"," 338"
"3227",11,751,740,"AATGCTAGGTTAAATGTCGA","AGTTGTACCAGCGGCATTAG","561307.5.peg.1301"," 338"
"3228",201,751,550,"ATCTTTAGTTCTTGGGATGA","AGTTGTACCAGCGGCATTAG","561307.5.peg.1301"," 338"
"3229",384,751,367,"TGCTACTTGTTATTTGTTC","AGTTGTACCAGCGGCATTAG","561307.5.peg.1301"," 338"
"3230",375,751,376,"GTTATTTGTTCTGGTCCAGC","AGTTGTACCAGCGGCATTAG","561307.5.peg.1301"," 338"
"3231",333,751,418,"TAAGTATTCGGAATTGATAC","AGTTGTACCAGCGGCATTAG","561307.5.peg.1301"," 338"
"3232",168,751,583,"AGTTTAGAATATGCACCAGC","AGTTGTACCAGCGGCATTAG","561307.5.peg.1301"," 338"
"3233",240,69,171,"GTGAACACTGATGAAACTAG","ACTAGTCCTGACGTTACTAG","561307.5.peg.1303"," 340"
"3234",69,240,171,"ACTAGTCCTGACGTTACTAG","GTGAACACTGATGAAACTAG","561307.5.peg.1303"," 340"
"3235",147,8,139,"GGCGCTTTAATTGTCACATG","AGCAATAGGTTAAACAAAGG","561307.5.peg.1305"," 342"
"3236",237,8,229,"GTAGCATGAACTTCTACTGC","AGCAATAGGTTAAACAAAGG","561307.5.peg.1305"," 342"
"3237",279,8,271,"AGTAAATCACATTGTTCGT","AGCAATAGGTTAAACAAAGG","561307.5.peg.1305"," 342"
"3238",8,147,139,"AGCAATAGGTTAAACAAAGG","GGCGCTTTAATTGTCACATG","561307.5.peg.1305"," 342"
"3239",279,147,132,"AGTAAATCACATTGTTCGT","GGCGCTTTAATTGTCACATG","561307.5.peg.1305"," 342"
"3240",8,237,229,"AGCAATAGGTTAAACAAAGG","GTAGCATGAACTTCTACTGC","561307.5.peg.1305"," 342"
"3241",8,279,271,"AGCAATAGGTTAAACAAAGG","AGTAAATCACATTGTTCGT","561307.5.peg.1305"," 342"
"3242",147,279,132,"GGCGCTTTAATTGTCACATG","AGTAAATCACATTGTTCGT","561307.5.peg.1305"," 342"
"3243",281,10,271,"GCTTATCAACGTCTTCATAA","ATAACAATACAACTACTAG","561307.5.peg.1306"," 343"
"3244",321,10,311,"AAATGAGAACGACTTCCTTG","ATAACAATACAACTACTAG","561307.5.peg.1306"," 343"
"3245",10,281,271,"ATAACAATACAACTACTAG","GCTTATCAACGTCTTCATAA","561307.5.peg.1306"," 343"
"3246",10,321,311,"ATAACAATACAACTACTAG","AAATGAGAACGACTTCCTTG","561307.5.peg.1306"," 343"
"3247",422,244,178,"TATAATACGCTGGTCCACCA","AACCCTGCCTGCTAAAGACA","561307.5.peg.1307"," 344"
"3248",585,244,341,"ATACCACCCATTAACCATTG","AACCCTGCCTGCTAAAGACA","561307.5.peg.1307"," 344"
"3249",658,244,414,"TACAACGGCTGTTGCAACAT","AACCCTGCCTGCTAAAGACA","561307.5.peg.1307"," 344"
"3250",673,244,429,"AATTGCCATAAATGGTACAA","AACCCTGCCTGCTAAAGACA","561307.5.peg.1307"," 344"
"3251",244,422,178,"AACCCTGCCTGCTAAAGACA","TATAATACGCTGGTCCACCA","561307.5.peg.1307"," 344"
"3252",585,422,163,"ATACCACCCATTAACCATTG","TATAATACGCTGGTCCACCA","561307.5.peg.1307"," 344"
"3253",658,422,236,"TACAACGGCTGTTGCAACAT","TATAATACGCTGGTCCACCA","561307.5.peg.1307"," 344"
"3254",673,422,251,"AATTGCCATAAATGGTACAA","TATAATACGCTGGTCCACCA","561307.5.peg.1307"," 344"
"3255",244,585,341,"AACCCTGCCTGCTAAAGACA","ATACCACCCATTAACCATTG","561307.5.peg.1307"," 344"
"3256",422,585,163,"TATAATACGCTGGTCCACCA","ATACCACCCATTAACCATTG","561307.5.peg.1307"," 344"
"3257",244,658,414,"AACCCTGCCTGCTAAAGACA","TACAACGGCTGTTGCAACAT","561307.5.peg.1307"," 344"
"3258",422,658,236,"TATAATACGCTGGTCCACCA","TACAACGGCTGTTGCAACAT","561307.5.peg.1307"," 344"
"3259",244,673,429,"AACCCTGCCTGCTAAAGACA","AATTGCCATAAATGGTACAA","561307.5.peg.1307"," 344"
"3260",422,673,251,"TATAATACGCTGGTCCACCA","AATTGCCATAAATGGTACAA","561307.5.peg.1307"," 344"
"3261",249,71,178,"GTTGTTATACTAGCCCATCT","TAATCAGAGCGATGCCAGTT","561307.5.peg.1308"," 345"
"3262",429,71,358,"TTCTACTTGTTACATCTTC","TAATCAGAGCGATGCCAGTT","561307.5.peg.1308"," 345"
"3263",71,249,178,"TAATCAGAGCGATGCCAGTT","GTTGTTATACTAGCCCATCT","561307.5.peg.1308"," 345"
"3264",429,249,180,"TTCTACTTGTTACATCTTC","GTTGTTATACTAGCCCATCT","561307.5.peg.1308"," 345"
"3265",71,429,358,"TAATCAGAGCGATGCCAGTT","TTCTACTTGTTACATCTTC","561307.5.peg.1308"," 345"
"3266",249,429,180,"GTTGTTATACTAGCCCATCT","TTCTACTTGTTACATCTTC","561307.5.peg.1308"," 345"
"3267",363,162,201,"CAGTTGTATTTAACGCAAT","TTACACGGTTCAGCAACGCC","561307.5.peg.131"," 347"
"3268",510,162,348,"TGTTGATCGTCATGGAATAC","TTACACGGTTCAGCAACGCC","561307.5.peg.131"," 347"
"3269",518,162,356,"CTGTACCATGTTGATCGTCA","TTACACGGTTCAGCAACGCC","561307.5.peg.131"," 347"
"3270",510,363,147,"TGTTGATCGTCATGGAATAC","CAGTTGTATTTAACGCAAT","561307.5.peg.131"," 347"
"3271",162,363,201,"TTACACGGTTCAGCAACGCC","CAGTTGTATTTAACGCAAT","561307.5.peg.131"," 347"
"3272",518,363,155,"CTGTACCATGTTGATCGTCA","CAGTTGTATTTAACGCAAT","561307.5.peg.131"," 347"
"3273",162,510,348,"TTACACGGTTCAGCAACGCC","TGTTGATCGTCATGGAATAC","561307.5.peg.131"," 347"
"3274",363,510,147,"CAGTTGTATTTAACGCAAT","TGTTGATCGTCATGGAATAC","561307.5.peg.131"," 347"
"3275",363,518,155,"CAGTTGTATTTAACGCAAT","CTGTACCATGTTGATCGTCA","561307.5.peg.131"," 347"
"3276",162,518,356,"TTACACGGTTCAGCAACGCC","CTGTACCATGTTGATCGTCA","561307.5.peg.131"," 347"
"3277",339,5,334,"AACGCTAGATTAAGATGCCC","TGGCTTACTTAATTTAAGG","561307.5.peg.1311"," 349"
"3278",472,5,467,"AGTTGGAACAACTACGCCTA","TGGCTTACTTAATTTAAGG","561307.5.peg.1311"," 349"
"3279",331,5,326,"ATTAAGATGCCCTGGAATTG","TGGCTTACTTAATTTAAGG","561307.5.peg.1311"," 349"
"3280",775,5,770,"TGCGCCAACTCCCTCTGCTA","TGGCTTACTTAATTTAAGG","561307.5.peg.1311"," 349"
"3281",539,5,534,"CCGCAAGTACTGCTACTAAT","TGGCTTACTTAATTTAAGG","561307.5.peg.1311"," 349"
"3282",331,24,307,"ATTAAGATGCCCTGGAATTG","GGTTTAGCTACATCATTTA","561307.5.peg.1311"," 349"
"3283",539,24,515,"CCGCAAGTACTGCTACTAAT","GGTTTAGCTACATCATTTA","561307.5.peg.1311"," 349"
"3284",472,24,448,"AGTTGGAACAACTACGCCTA","GGTTTAGCTACATCATTTA","561307.5.peg.1311"," 349"
"3285",339,24,315,"AACGCTAGATTAAGATGCCC","GGTTTAGCTACATCATTTA","561307.5.peg.1311"," 349"
"3286",775,24,751,"TGCGCCAACTCCCTCTGCTA","GGTTTAGCTACATCATTTA","561307.5.peg.1311"," 349"
"3287",24,331,307,"GGTTTAGCTACATCATTTA","ATTAAGATGCCCTGGAATTG","561307.5.peg.1311"," 349"
"3288",5,331,326,"TGGCTTACTTAATTTAAGG","ATTAAGATGCCCTGGAATTG","561307.5.peg.1311"," 349"
"3289",472,331,141,"AGTTGGAACAACTACGCCTA","ATTAAGATGCCCTGGAATTG","561307.5.peg.1311"," 349"
"3290",539,331,208,"CCGCAAGTACTGCTACTAAT","ATTAAGATGCCCTGGAATTG","561307.5.peg.1311"," 349"
"3291",775,331,444,"TGCGCCAACTCCCTCTGCTA","ATTAAGATGCCCTGGAATTG","561307.5.peg.1311"," 349"
"3292",24,339,315,"GGTTTAGCTACATCATTTA","AACGCTAGATTAAGATGCCC","561307.5.peg.1311"," 349"
"3293",775,339,436,"TGCGCCAACTCCCTCTGCTA","AACGCTAGATTAAGATGCCC","561307.5.peg.1311"," 349"
"3294",5,339,334,"TGGCTTACTTAATTTAAGG","AACGCTAGATTAAGATGCCC","561307.5.peg.1311"," 349"
"3295",472,339,133,"AGTTGGAACAACTACGCCTA","AACGCTAGATTAAGATGCCC","561307.5.peg.1311"," 349"
"3296",539,339,200,"CCGCAAGTACTGCTACTAAT","AACGCTAGATTAAGATGCCC","561307.5.peg.1311"," 349"
"3297",331,472,141,"ATTAAGATGCCCTGGAATTG","AGTTGGAACAACTACGCCTA","561307.5.peg.1311"," 349"
"3298",24,472,448,"GGTTTAGCTACATCATTTA","AGTTGGAACAACTACGCCTA","561307.5.peg.1311"," 349"
"3299",5,472,467,"TGGCTTACTTAATTTAAGG","AGTTGGAACAACTACGCCTA","561307.5.peg.1311"," 349"
"3300",339,472,133,"AACGCTAGATTAAGATGCCC","AGTTGGAACAACTACGCCTA","561307.5.peg.1311"," 349"
"3301",775,472,303,"TGCGCCAACTCCCTCTGCTA","AGTTGGAACAACTACGCCTA","561307.5.peg.1311"," 349"
"3302",5,539,534,"TGGCTTACTTAATTTAAGG","CCGCAAGTACTGCTACTAAT","561307.5.peg.1311"," 349"
"3303",24,539,515,"GGTTTAGCTACATCATTTA","CCGCAAGTACTGCTACTAAT","561307.5.peg.1311"," 349"
"3304",775,539,236,"TGCGCCAACTCCCTCTGCTA","CCGCAAGTACTGCTACTAAT","561307.5.peg.1311"," 349"
"3305",339,539,200,"AACGCTAGATTAAGATGCCC","CCGCAAGTACTGCTACTAAT","561307.5.peg.1311"," 349"
"3306",331,539,208,"ATTAAGATGCCCTGGAATTG","CCGCAAGTACTGCTACTAAT","561307.5.peg.1311"," 349"
"3307",472,775,303,"AGTTGGAACAACTACGCCTA","TGCGCCAACTCCCTCTGCTA","561307.5.peg.1311"," 349"
"3308",5,775,770,"TGGCTTACTTAATTTAAGG","TGCGCCAACTCCCTCTGCTA","561307.5.peg.1311"," 349"
"3309",339,775,436,"AACGCTAGATTAAGATGCCC","TGCGCCAACTCCCTCTGCTA","561307.5.peg.1311"," 349"
"3310",331,775,444,"ATTAAGATGCCCTGGAATTG","TGCGCCAACTCCCTCTGCTA","561307.5.peg.1311"," 349"
"3311",24,775,751,"GGTTTAGCTACATCATTTA","TGCGCCAACTCCCTCTGCTA","561307.5.peg.1311"," 349"
"3312",539,775,236,"CCGCAAGTACTGCTACTAAT","TGCGCCAACTCCCTCTGCTA","561307.5.peg.1311"," 349"
"3313",330,126,204,"GTTCTTGGTAATCTATAAC","ACATATATTGTTTCTGCGTC","561307.5.peg.1312"," 350"
"3314",344,126,218,"TGATACCAAGCAAATGTTCT","ACATATATTGTTTCTGCGTC","561307.5.peg.1312"," 350"
"3315",430,126,304,"CGAATCGATATCTGATACCC","ACATATATTGTTTCTGCGTC","561307.5.peg.1312"," 350"
"3316",126,330,204,"ACATATATTGTTTCTGCGTC","GTTCTTGGTAATCTATAAC","561307.5.peg.1312"," 350"
"3317",430,330,100,"CGAATCGATATCTGATACCC","GTTCTTGGTAATCTATAAC","561307.5.peg.1312"," 350"
"3318",126,344,218,"ACATATATTGTTTCTGCGTC","TGATACCAAGCAAATGTTCT","561307.5.peg.1312"," 350"
"3319",126,430,304,"ACATATATTGTTTCTGCGTC","CGAATCGATATCTGATACCC","561307.5.peg.1312"," 350"
"3320",330,430,100,"GTTCTTGGTAATCTATAAC","CGAATCGATATCTGATACCC","561307.5.peg.1312"," 350"
"3321",645,79,566,"TCATACTGAGATACTAATTG","TCCCCCAATAGCGGTTACGA","561307.5.peg.1313"," 351"
"3322",405,79,326,"AAACCAGCTGTCACAATCGC","TCCCCCAATAGCGGTTACGA","561307.5.peg.1313"," 351"
"3323",687,79,608,"AAGCCAAATAAGTTCCACGT","TCCCCCAATAGCGGTTACGA","561307.5.peg.1313"," 351"
"3324",354,79,275,"ATTTGATCAAACGTTGTAC","TCCCCCAATAGCGGTTACGA","561307.5.peg.1313"," 351"
"3325",252,79,173,"TACACTTCATCGACTGTTCC","TCCCCCAATAGCGGTTACGA","561307.5.peg.1313"," 351"
"3326",606,79,527,"CCTAAGACTATGCCTAGAAT","TCCCCCAATAGCGGTTACGA","561307.5.peg.1313"," 351"
"3327",731,79,652,"AAACTGGCAACACTTGACCT","TCCCCCAATAGCGGTTACGA","561307.5.peg.1313"," 351"
"3328",354,252,102,"ATTTGATCAAACGTTGTAC","TACACTTCATCGACTGTTCC","561307.5.peg.1313"," 351"
"3329",645,252,393,"TCATACTGAGATACTAATTG","TACACTTCATCGACTGTTCC","561307.5.peg.1313"," 351"
"3330",606,252,354,"CCTAAGACTATGCCTAGAAT","TACACTTCATCGACTGTTCC","561307.5.peg.1313"," 351"
"3331",731,252,479,"AAACTGGCAACACTTGACCT","TACACTTCATCGACTGTTCC","561307.5.peg.1313"," 351"
"3332",687,252,435,"AAGCCAAATAAGTTCCACGT","TACACTTCATCGACTGTTCC","561307.5.peg.1313"," 351"
"3333",405,252,153,"AAACCAGCTGTCACAATCGC","TACACTTCATCGACTGTTCC","561307.5.peg.1313"," 351"
"3334",79,252,173,"TCCCCCAATAGCGGTTACGA","TACACTTCATCGACTGTTCC","561307.5.peg.1313"," 351"
"3335",252,354,102,"TACACTTCATCGACTGTTCC","ATTTGATCAAACGTTGTAC","561307.5.peg.1313"," 351"
"3336",645,354,291,"TCATACTGAGATACTAATTG","ATTTGATCAAACGTTGTAC","561307.5.peg.1313"," 351"
"3337",687,354,333,"AAGCCAAATAAGTTCCACGT","ATTTGATCAAACGTTGTAC","561307.5.peg.1313"," 351"
"3338",79,354,275,"TCCCCCAATAGCGGTTACGA","ATTTGATCAAACGTTGTAC","561307.5.peg.1313"," 351"
"3339",606,354,252,"CCTAAGACTATGCCTAGAAT","ATTTGATCAAACGTTGTAC","561307.5.peg.1313"," 351"
"3340",731,354,377,"AAACTGGCAACACTTGACCT","ATTTGATCAAACGTTGTAC","561307.5.peg.1313"," 351"
"3341",252,405,153,"TACACTTCATCGACTGTTCC","AAACCAGCTGTCACAATCGC","561307.5.peg.1313"," 351"
"3342",79,405,326,"TCCCCCAATAGCGGTTACGA","AAACCAGCTGTCACAATCGC","561307.5.peg.1313"," 351"
"3343",731,405,326,"AAACTGGCAACACTTGACCT","AAACCAGCTGTCACAATCGC","561307.5.peg.1313"," 351"
"3344",687,405,282,"AAGCCAAATAAGTTCCACGT","AAACCAGCTGTCACAATCGC","561307.5.peg.1313"," 351"
"3345",645,405,240,"TCATACTGAGATACTAATTG","AAACCAGCTGTCACAATCGC","561307.5.peg.1313"," 351"
"3346",606,405,201,"CCTAAGACTATGCCTAGAAT","AAACCAGCTGTCACAATCGC","561307.5.peg.1313"," 351"
"3347",731,606,125,"AAACTGGCAACACTTGACCT","CCTAAGACTATGCCTAGAAT","561307.5.peg.1313"," 351"
"3348",354,606,252,"ATTTGATCAAACGTTGTAC","CCTAAGACTATGCCTAGAAT","561307.5.peg.1313"," 351"
"3349",252,606,354,"TACACTTCATCGACTGTTCC","CCTAAGACTATGCCTAGAAT","561307.5.peg.1313"," 351"
"3350",79,606,527,"TCCCCCAATAGCGGTTACGA","CCTAAGACTATGCCTAGAAT","561307.5.peg.1313"," 351"
"3351",405,606,201,"AAACCAGCTGTCACAATCGC","CCTAAGACTATGCCTAGAAT","561307.5.peg.1313"," 351"
"3352",79,645,566,"TCCCCCAATAGCGGTTACGA","TCATACTGAGATACTAATTG","561307.5.peg.1313"," 351"
"3353",354,645,291,"ATTTGATCAAACGTTGTAC","TCATACTGAGATACTAATTG","561307.5.peg.1313"," 351"
"3354",252,645,393,"TACACTTCATCGACTGTTCC","TCATACTGAGATACTAATTG","561307.5.peg.1313"," 351"
"3355",405,645,240,"AAACCAGCTGTCACAATCGC","TCATACTGAGATACTAATTG","561307.5.peg.1313"," 351"
"3356",354,687,333,"ATTTGATCAAACGTTGTAC","AAGCCAAATAAGTTCCACGT","561307.5.peg.1313"," 351"
"3357",405,687,282,"AAACCAGCTGTCACAATCGC","AAGCCAAATAAGTTCCACGT","561307.5.peg.1313"," 351"
"3358",79,687,608,"TCCCCCAATAGCGGTTACGA","AAGCCAAATAAGTTCCACGT","561307.5.peg.1313"," 351"
"3359",252,687,435,"TACACTTCATCGACTGTTCC","AAGCCAAATAAGTTCCACGT","561307.5.peg.1313"," 351"
"3360",79,731,652,"TCCCCCAATAGCGGTTACGA","AAACTGGCAACACTTGACCT","561307.5.peg.1313"," 351"
"3361",354,731,377,"ATTTGATCAAACGTTGTAC","AAACTGGCAACACTTGACCT","561307.5.peg.1313"," 351"
"3362",405,731,326,"AAACCAGCTGTCACAATCGC","AAACTGGCAACACTTGACCT","561307.5.peg.1313"," 351"
"3363",606,731,125,"CCTAAGACTATGCCTAGAAT","AAACTGGCAACACTTGACCT","561307.5.peg.1313"," 351"
"3364",252,731,479,"TACACTTCATCGACTGTTCC","AAACTGGCAACACTTGACCT","561307.5.peg.1313"," 351"
"3365",720,8,712,"TGCAGAAACTCATGCACTCT","CCTTTATTACGTTATAAGG","561307.5.peg.1314"," 352"
"3366",207,8,199,"TTCATCGGTGATTCATACAC","CCTTTATTACGTTATAAGG","561307.5.peg.1314"," 352"
"3367",394,8,386,"AGGGTTATCTTTAGATTTAC","CCTTTATTACGTTATAAGG","561307.5.peg.1314"," 352"
"3368",837,8,829,"CTATTCAATTCTTGGCGTTC","CCTTTATTACGTTATAAGG","561307.5.peg.1314"," 352"
"3369",456,8,448,"TTAGAATGCCAATTTGTTGG","CCTTTATTACGTTATAAGG","561307.5.peg.1314"," 352"
"3370",573,8,565,"TATAACGATTGACGTACTTC","CCTTTATTACGTTATAAGG","561307.5.peg.1314"," 352"
"3371",837,11,826,"CTATTCAATTCTTGGCGTTC","CGTCCTTTATTACGTTATA","561307.5.peg.1314"," 352"
"3372",573,11,562,"TATAACGATTGACGTACTTC","CGTCCTTTATTACGTTATA","561307.5.peg.1314"," 352"
"3373",456,11,445,"TTAGAATGCCAATTTGTTGG","CGTCCTTTATTACGTTATA","561307.5.peg.1314"," 352"
"3374",207,11,196,"TTCATCGGTGATTCATACAC","CGTCCTTTATTACGTTATA","561307.5.peg.1314"," 352"
"3375",394,11,383,"AGGGTTATCTTTAGATTTAC","CGTCCTTTATTACGTTATA","561307.5.peg.1314"," 352"
"3376",720,11,709,"TGCAGAAACTCATGCACTCT","CGTCCTTTATTACGTTATA","561307.5.peg.1314"," 352"
"3377",394,22,372,"AGGGTTATCTTTAGATTTAC","CCACCTTATAACGTAATAA","561307.5.peg.1314"," 352"
"3378",207,22,185,"TTCATCGGTGATTCATACAC","CCACCTTATAACGTAATAA","561307.5.peg.1314"," 352"
"3379",837,22,815,"CTATTCAATTCTTGGCGTTC","CCACCTTATAACGTAATAA","561307.5.peg.1314"," 352"
"3380",720,22,698,"TGCAGAAACTCATGCACTCT","CCACCTTATAACGTAATAA","561307.5.peg.1314"," 352"
"3381",456,22,434,"TTAGAATGCCAATTTGTTGG","CCACCTTATAACGTAATAA","561307.5.peg.1314"," 352"
"3382",573,22,551,"TATAACGATTGACGTACTTC","CCACCTTATAACGTAATAA","561307.5.peg.1314"," 352"
"3383",394,207,187,"AGGGTTATCTTTAGATTTAC","TTCATCGGTGATTCATACAC","561307.5.peg.1314"," 352"
"3384",11,207,196,"CGTCCTTTATTACGTTATA","TTCATCGGTGATTCATACAC","561307.5.peg.1314"," 352"
"3385",8,207,199,"CCTTTATTACGTTATAAGG","TTCATCGGTGATTCATACAC","561307.5.peg.1314"," 352"
"3386",456,207,249,"TTAGAATGCCAATTTGTTGG","TTCATCGGTGATTCATACAC","561307.5.peg.1314"," 352"
"3387",720,207,513,"TGCAGAAACTCATGCACTCT","TTCATCGGTGATTCATACAC","561307.5.peg.1314"," 352"
"3388",837,207,630,"CTATTCAATTCTTGGCGTTC","TTCATCGGTGATTCATACAC","561307.5.peg.1314"," 352"
"3389",573,207,366,"TATAACGATTGACGTACTTC","TTCATCGGTGATTCATACAC","561307.5.peg.1314"," 352"
"3390",22,207,185,"CCACCTTATAACGTAATAA","TTCATCGGTGATTCATACAC","561307.5.peg.1314"," 352"
"3391",837,394,443,"CTATTCAATTCTTGGCGTTC","AGGGTTATCTTTAGATTTAC","561307.5.peg.1314"," 352"
"3392",8,394,386,"CCTTTATTACGTTATAAGG","AGGGTTATCTTTAGATTTAC","561307.5.peg.1314"," 352"
"3393",573,394,179,"TATAACGATTGACGTACTTC","AGGGTTATCTTTAGATTTAC","561307.5.peg.1314"," 352"
"3394",11,394,383,"CGTCCTTTATTACGTTATA","AGGGTTATCTTTAGATTTAC","561307.5.peg.1314"," 352"
"3395",22,394,372,"CCACCTTATAACGTAATAA","AGGGTTATCTTTAGATTTAC","561307.5.peg.1314"," 352"
"3396",720,394,326,"TGCAGAAACTCATGCACTCT","AGGGTTATCTTTAGATTTAC","561307.5.peg.1314"," 352"
"3397",207,394,187,"TTCATCGGTGATTCATACAC","AGGGTTATCTTTAGATTTAC","561307.5.peg.1314"," 352"
"3398",11,456,445,"CGTCCTTTATTACGTTATA","TTAGAATGCCAATTTGTTGG","561307.5.peg.1314"," 352"
"3399",8,456,448,"CCTTTATTACGTTATAAGG","TTAGAATGCCAATTTGTTGG","561307.5.peg.1314"," 352"
"3400",720,456,264,"TGCAGAAACTCATGCACTCT","TTAGAATGCCAATTTGTTGG","561307.5.peg.1314"," 352"
"3401",22,456,434,"CCACCTTATAACGTAATAA","TTAGAATGCCAATTTGTTGG","561307.5.peg.1314"," 352"
"3402",837,456,381,"CTATTCAATTCTTGGCGTTC","TTAGAATGCCAATTTGTTGG","561307.5.peg.1314"," 352"
"3403",207,456,249,"TTCATCGGTGATTCATACAC","TTAGAATGCCAATTTGTTGG","561307.5.peg.1314"," 352"
"3404",573,456,117,"TATAACGATTGACGTACTTC","TTAGAATGCCAATTTGTTGG","561307.5.peg.1314"," 352"
"3405",8,573,565,"CCTTTATTACGTTATAAGG","TATAACGATTGACGTACTTC","561307.5.peg.1314"," 352"
"3406",394,573,179,"AGGGTTATCTTTAGATTTAC","TATAACGATTGACGTACTTC","561307.5.peg.1314"," 352"
"3407",11,573,562,"CGTCCTTTATTACGTTATA","TATAACGATTGACGTACTTC","561307.5.peg.1314"," 352"
"3408",456,573,117,"TTAGAATGCCAATTTGTTGG","TATAACGATTGACGTACTTC","561307.5.peg.1314"," 352"
"3409",22,573,551,"CCACCTTATAACGTAATAA","TATAACGATTGACGTACTTC","561307.5.peg.1314"," 352"
"3410",207,573,366,"TTCATCGGTGATTCATACAC","TATAACGATTGACGTACTTC","561307.5.peg.1314"," 352"
"3411",837,573,264,"CTATTCAATTCTTGGCGTTC","TATAACGATTGACGTACTTC","561307.5.peg.1314"," 352"
"3412",720,573,147,"TGCAGAAACTCATGCACTCT","TATAACGATTGACGTACTTC","561307.5.peg.1314"," 352"
"3413",8,720,712,"CCTTTATTACGTTATAAGG","TGCAGAAACTCATGCACTCT","561307.5.peg.1314"," 352"
"3414",22,720,698,"CCACCTTATAACGTAATAA","TGCAGAAACTCATGCACTCT","561307.5.peg.1314"," 352"
"3415",573,720,147,"TATAACGATTGACGTACTTC","TGCAGAAACTCATGCACTCT","561307.5.peg.1314"," 352"
"3416",11,720,709,"CGTCCTTTATTACGTTATA","TGCAGAAACTCATGCACTCT","561307.5.peg.1314"," 352"
"3417",207,720,513,"TTCATCGGTGATTCATACAC","TGCAGAAACTCATGCACTCT","561307.5.peg.1314"," 352"
"3418",837,720,117,"CTATTCAATTCTTGGCGTTC","TGCAGAAACTCATGCACTCT","561307.5.peg.1314"," 352"
"3419",394,720,326,"AGGGTTATCTTTAGATTTAC","TGCAGAAACTCATGCACTCT","561307.5.peg.1314"," 352"
"3420",456,720,264,"TTAGAATGCCAATTTGTTGG","TGCAGAAACTCATGCACTCT","561307.5.peg.1314"," 352"
"3421",456,837,381,"TTAGAATGCCAATTTGTTGG","CTATTCAATTCTTGGCGTTC","561307.5.peg.1314"," 352"
"3422",8,837,829,"CCTTTATTACGTTATAAGG","CTATTCAATTCTTGGCGTTC","561307.5.peg.1314"," 352"
"3423",573,837,264,"TATAACGATTGACGTACTTC","CTATTCAATTCTTGGCGTTC","561307.5.peg.1314"," 352"
"3424",207,837,630,"TTCATCGGTGATTCATACAC","CTATTCAATTCTTGGCGTTC","561307.5.peg.1314"," 352"
"3425",394,837,443,"AGGGTTATCTTTAGATTTAC","CTATTCAATTCTTGGCGTTC","561307.5.peg.1314"," 352"
"3426",22,837,815,"CCACCTTATAACGTAATAA","CTATTCAATTCTTGGCGTTC","561307.5.peg.1314"," 352"
"3427",11,837,826,"CGTCCTTTATTACGTTATA","CTATTCAATTCTTGGCGTTC","561307.5.peg.1314"," 352"
"3428",720,837,117,"TGCAGAAACTCATGCACTCT","CTATTCAATTCTTGGCGTTC","561307.5.peg.1314"," 352"
"3429",132,5,127,"CGTGCTTGCCAACTCGTTTC","TGACAATCAAATGCCTACGG","561307.5.peg.1316"," 354"
"3430",132,8,124,"CGTGCTTGCCAACTCGTTTC","TATTGACAATCAAATGCCTA","561307.5.peg.1316"," 354"
"3431",5,132,127,"TGACAATCAAATGCCTACGG","CGTGCTTGCCAACTCGTTTC","561307.5.peg.1316"," 354"
"3432",8,132,124,"TATTGACAATCAAATGCCTA","CGTGCTTGCCAACTCGTTTC","561307.5.peg.1316"," 354"
"3433",536,8,528,"CCCTAGAAATGATTGTTGGA","TGAGAGGTAATTGTTTATGG","561307.5.peg.1317"," 355"
"3434",214,8,206,"GATTGCTTTAGCAAACACTT","TGAGAGGTAATTGTTTATGG","561307.5.peg.1317"," 355"
"3435",655,8,647,"CGCTTTAGCGATAAATGCCA","TGAGAGGTAATTGTTTATGG","561307.5.peg.1317"," 355"
"3436",214,64,150,"GATTGCTTTAGCAAACACTT","GGGTCTGTACATACGATATA","561307.5.peg.1317"," 355"
"3437",536,64,472,"CCCTAGAAATGATTGTTGGA","GGGTCTGTACATACGATATA","561307.5.peg.1317"," 355"
"3438",655,64,591,"CGCTTTAGCGATAAATGCCA","GGGTCTGTACATACGATATA","561307.5.peg.1317"," 355"
"3439",536,84,452,"CCCTAGAAATGATTGTTGGA","ACGACATCCTCGAAACTTTG","561307.5.peg.1317"," 355"
"3440",655,84,571,"CGCTTTAGCGATAAATGCCA","ACGACATCCTCGAAACTTTG","561307.5.peg.1317"," 355"
"3441",214,84,130,"GATTGCTTTAGCAAACACTT","ACGACATCCTCGAAACTTTG","561307.5.peg.1317"," 355"
"3442",655,86,569,"CGCTTTAGCGATAAATGCCA","CGACGACATCCTCGAAACTT","561307.5.peg.1317"," 355"
"3443",536,86,450,"CCCTAGAAATGATTGTTGGA","CGACGACATCCTCGAAACTT","561307.5.peg.1317"," 355"
"3444",214,86,128,"GATTGCTTTAGCAAACACTT","CGACGACATCCTCGAAACTT","561307.5.peg.1317"," 355"
"3445",84,214,130,"ACGACATCCTCGAAACTTTG","GATTGCTTTAGCAAACACTT","561307.5.peg.1317"," 355"
"3446",8,214,206,"TGAGAGGTAATTGTTTATGG","GATTGCTTTAGCAAACACTT","561307.5.peg.1317"," 355"
"3447",64,214,150,"GGGTCTGTACATACGATATA","GATTGCTTTAGCAAACACTT","561307.5.peg.1317"," 355"
"3448",86,214,128,"CGACGACATCCTCGAAACTT","GATTGCTTTAGCAAACACTT","561307.5.peg.1317"," 355"
"3449",655,214,441,"CGCTTTAGCGATAAATGCCA","GATTGCTTTAGCAAACACTT","561307.5.peg.1317"," 355"
"3450",536,214,322,"CCCTAGAAATGATTGTTGGA","GATTGCTTTAGCAAACACTT","561307.5.peg.1317"," 355"
"3451",8,536,528,"TGAGAGGTAATTGTTTATGG","CCCTAGAAATGATTGTTGGA","561307.5.peg.1317"," 355"
"3452",214,536,322,"GATTGCTTTAGCAAACACTT","CCCTAGAAATGATTGTTGGA","561307.5.peg.1317"," 355"
"3453",64,536,472,"GGGTCTGTACATACGATATA","CCCTAGAAATGATTGTTGGA","561307.5.peg.1317"," 355"
"3454",84,536,452,"ACGACATCCTCGAAACTTTG","CCCTAGAAATGATTGTTGGA","561307.5.peg.1317"," 355"
"3455",86,536,450,"CGACGACATCCTCGAAACTT","CCCTAGAAATGATTGTTGGA","561307.5.peg.1317"," 355"
"3456",655,536,119,"CGCTTTAGCGATAAATGCCA","CCCTAGAAATGATTGTTGGA","561307.5.peg.1317"," 355"
"3457",8,655,647,"TGAGAGGTAATTGTTTATGG","CGCTTTAGCGATAAATGCCA","561307.5.peg.1317"," 355"
"3458",86,655,569,"CGACGACATCCTCGAAACTT","CGCTTTAGCGATAAATGCCA","561307.5.peg.1317"," 355"
"3459",214,655,441,"GATTGCTTTAGCAAACACTT","CGCTTTAGCGATAAATGCCA","561307.5.peg.1317"," 355"
"3460",64,655,591,"GGGTCTGTACATACGATATA","CGCTTTAGCGATAAATGCCA","561307.5.peg.1317"," 355"
"3461",84,655,571,"ACGACATCCTCGAAACTTTG","CGCTTTAGCGATAAATGCCA","561307.5.peg.1317"," 355"
"3462",536,655,119,"CCCTAGAAATGATTGTTGGA","CGCTTTAGCGATAAATGCCA","561307.5.peg.1317"," 355"
"3463",114,14,100,"GCCAGACGTTGGGCTGTCTT","ACTCAAGGCTTAAACATCCC","561307.5.peg.1319"," 357"
"3464",14,114,100,"ACTCAAGGCTTAAACATCCC","GCCAGACGTTGGGCTGTCTT","561307.5.peg.1319"," 357"
"3465",126,8,118,"CACTTAGTCATAATACCTGC","TTAGAACAGAGGTTATTTGG","561307.5.peg.132"," 358"
"3466",126,19,107,"CACTTAGTCATAATACCTGC","GCTCTAAATGGTTAGAACAG","561307.5.peg.132"," 358"
"3467",8,126,118,"TTAGAACAGAGGTTATTTGG","CACTTAGTCATAATACCTGC","561307.5.peg.132"," 358"
"3468",19,126,107,"GCTCTAAATGGTTAGAACAG","CACTTAGTCATAATACCTGC","561307.5.peg.132"," 358"
"3469",357,87,270,"CTTGTAACAATAGTATCCCC","AATGCCCTTGGAGATAAACC","561307.5.peg.1320"," 359"
"3470",231,87,144,"AATGTCGGTGATCCTGTTTC","AATGCCCTTGGAGATAAACC","561307.5.peg.1320"," 359"
"3471",525,87,438,"ATGTACCTGTAGGATTATT","AATGCCCTTGGAGATAAACC","561307.5.peg.1320"," 359"
"3472",525,174,351,"ATGTACCTGTAGGATTATT","GCTTCTTTAACTTTAGGCGA","561307.5.peg.1320"," 359"
"3473",357,174,183,"CTTGTAACAATAGTATCCCC","GCTTCTTTAACTTTAGGCGA","561307.5.peg.1320"," 359"
"3474",87,231,144,"AATGCCCTTGGAGATAAACC","AATGTCGGTGATCCTGTTTC","561307.5.peg.1320"," 359"
"3475",525,231,294,"ATGTACCTGTAGGATTATT","AATGTCGGTGATCCTGTTTC","561307.5.peg.1320"," 359"
"3476",357,231,126,"CTTGTAACAATAGTATCCCC","AATGTCGGTGATCCTGTTTC","561307.5.peg.1320"," 359"
"3477",231,357,126,"AATGTCGGTGATCCTGTTTC","CTTGTAACAATAGTATCCCC","561307.5.peg.1320"," 359"
"3478",87,357,270,"AATGCCCTTGGAGATAAACC","CTTGTAACAATAGTATCCCC","561307.5.peg.1320"," 359"
"3479",174,357,183,"GCTTCTTTAACTTTAGGCGA","CTTGTAACAATAGTATCCCC","561307.5.peg.1320"," 359"
"3480",525,357,168,"ATGTACCTGTAGGATTATT","CTTGTAACAATAGTATCCCC","561307.5.peg.1320"," 359"
"3481",174,525,351,"GCTTCTTTAACTTTAGGCGA","ATGTACCTGTAGGATTATT","561307.5.peg.1320"," 359"
"3482",87,525,438,"AATGCCCTTGGAGATAAACC","ATGTACCTGTAGGATTATT","561307.5.peg.1320"," 359"
"3483",357,525,168,"CTTGTAACAATAGTATCCCC","ATGTACCTGTAGGATTATT","561307.5.peg.1320"," 359"
"3484",231,525,294,"AATGTCGGTGATCCTGTTTC","ATGTACCTGTAGGATTATT","561307.5.peg.1320"," 359"
"3485",456,238,218,"CTTACACCAGCCATTATAAC","TAATAATGCCAACGATGGTA","561307.5.peg.1321"," 360"
"3486",606,238,368,"ATAATTGCCAATAAGGCTGC","TAATAATGCCAACGATGGTA","561307.5.peg.1321"," 360"
"3487",781,238,543,"ATTTGTAATAATCGATGGCT","TAATAATGCCAACGATGGTA","561307.5.peg.1321"," 360"
"3488",569,238,331,"ATATCAACGATGCATTGTTA","TAATAATGCCAACGATGGTA","561307.5.peg.1321"," 360"
"3489",444,238,206,"ATTATAACAGGCATTGCTAT","TAATAATGCCAACGATGGTA","561307.5.peg.1321"," 360"
"3490",375,238,137,"TTAGCCGCTTCAATGAGTGA","TAATAATGCCAACGATGGTA","561307.5.peg.1321"," 360"
"3491",375,243,132,"TTAGCCGCTTCAATGAGTGA","AAACCTAATAATGCCAACGA","561307.5.peg.1321"," 360"
"3492",456,243,213,"CTTACACCAGCCATTATAAC","AAACCTAATAATGCCAACGA","561307.5.peg.1321"," 360"
"3493",569,243,326,"ATATCAACGATGCATTGTTA","AAACCTAATAATGCCAACGA","561307.5.peg.1321"," 360"
"3494",781,243,538,"ATTTGTAATAATCGATGGCT","AAACCTAATAATGCCAACGA","561307.5.peg.1321"," 360"
"3495",606,243,363,"ATAATTGCCAATAAGGCTGC","AAACCTAATAATGCCAACGA","561307.5.peg.1321"," 360"
"3496",444,243,201,"ATTATAACAGGCATTGCTAT","AAACCTAATAATGCCAACGA","561307.5.peg.1321"," 360"
"3497",375,273,102,"TTAGCCGCTTCAATGAGTGA","ACACGACCGATACCAAATAA","561307.5.peg.1321"," 360"
"3498",569,273,296,"ATATCAACGATGCATTGTTA","ACACGACCGATACCAAATAA","561307.5.peg.1321"," 360"
"3499",456,273,183,"CTTACACCAGCCATTATAAC","ACACGACCGATACCAAATAA","561307.5.peg.1321"," 360"
"3500",444,273,171,"ATTATAACAGGCATTGCTAT","ACACGACCGATACCAAATAA","561307.5.peg.1321"," 360"
"3501",781,273,508,"ATTTGTAATAATCGATGGCT","ACACGACCGATACCAAATAA","561307.5.peg.1321"," 360"
"3502",606,273,333,"ATAATTGCCAATAAGGCTGC","ACACGACCGATACCAAATAA","561307.5.peg.1321"," 360"
"3503",238,375,137,"TAATAATGCCAACGATGGTA","TTAGCCGCTTCAATGAGTGA","561307.5.peg.1321"," 360"
"3504",273,375,102,"ACACGACCGATACCAAATAA","TTAGCCGCTTCAATGAGTGA","561307.5.peg.1321"," 360"
"3505",243,375,132,"AAACCTAATAATGCCAACGA","TTAGCCGCTTCAATGAGTGA","561307.5.peg.1321"," 360"
"3506",606,375,231,"ATAATTGCCAATAAGGCTGC","TTAGCCGCTTCAATGAGTGA","561307.5.peg.1321"," 360"
"3507",569,375,194,"ATATCAACGATGCATTGTTA","TTAGCCGCTTCAATGAGTGA","561307.5.peg.1321"," 360"
"3508",781,375,406,"ATTTGTAATAATCGATGGCT","TTAGCCGCTTCAATGAGTGA","561307.5.peg.1321"," 360"
"3509",569,444,125,"ATATCAACGATGCATTGTTA","ATTATAACAGGCATTGCTAT","561307.5.peg.1321"," 360"
"3510",238,444,206,"TAATAATGCCAACGATGGTA","ATTATAACAGGCATTGCTAT","561307.5.peg.1321"," 360"
"3511",781,444,337,"ATTTGTAATAATCGATGGCT","ATTATAACAGGCATTGCTAT","561307.5.peg.1321"," 360"
"3512",606,444,162,"ATAATTGCCAATAAGGCTGC","ATTATAACAGGCATTGCTAT","561307.5.peg.1321"," 360"
"3513",243,444,201,"AAACCTAATAATGCCAACGA","ATTATAACAGGCATTGCTAT","561307.5.peg.1321"," 360"
"3514",273,444,171,"ACACGACCGATACCAAATAA","ATTATAACAGGCATTGCTAT","561307.5.peg.1321"," 360"
"3515",569,456,113,"ATATCAACGATGCATTGTTA","CTTACACCAGCCATTATAAC","561307.5.peg.1321"," 360"
"3516",238,456,218,"TAATAATGCCAACGATGGTA","CTTACACCAGCCATTATAAC","561307.5.peg.1321"," 360"
"3517",243,456,213,"AAACCTAATAATGCCAACGA","CTTACACCAGCCATTATAAC","561307.5.peg.1321"," 360"
"3518",273,456,183,"ACACGACCGATACCAAATAA","CTTACACCAGCCATTATAAC","561307.5.peg.1321"," 360"
"3519",781,456,325,"ATTTGTAATAATCGATGGCT","CTTACACCAGCCATTATAAC","561307.5.peg.1321"," 360"
"3520",606,456,150,"ATAATTGCCAATAAGGCTGC","CTTACACCAGCCATTATAAC","561307.5.peg.1321"," 360"
"3521",273,569,296,"ACACGACCGATACCAAATAA","ATATCAACGATGCATTGTTA","561307.5.peg.1321"," 360"
"3522",781,569,212,"ATTTGTAATAATCGATGGCT","ATATCAACGATGCATTGTTA","561307.5.peg.1321"," 360"
"3523",444,569,125,"ATTATAACAGGCATTGCTAT","ATATCAACGATGCATTGTTA","561307.5.peg.1321"," 360"
"3524",375,569,194,"TTAGCCGCTTCAATGAGTGA","ATATCAACGATGCATTGTTA","561307.5.peg.1321"," 360"
"3525",243,569,326,"AAACCTAATAATGCCAACGA","ATATCAACGATGCATTGTTA","561307.5.peg.1321"," 360"
"3526",238,569,331,"TAATAATGCCAACGATGGTA","ATATCAACGATGCATTGTTA","561307.5.peg.1321"," 360"
"3527",456,569,113,"CTTACACCAGCCATTATAAC","ATATCAACGATGCATTGTTA","561307.5.peg.1321"," 360"
"3528",243,606,363,"AAACCTAATAATGCCAACGA","ATAATTGCCAATAAGGCTGC","561307.5.peg.1321"," 360"
"3529",273,606,333,"ACACGACCGATACCAAATAA","ATAATTGCCAATAAGGCTGC","561307.5.peg.1321"," 360"
"3530",781,606,175,"ATTTGTAATAATCGATGGCT","ATAATTGCCAATAAGGCTGC","561307.5.peg.1321"," 360"
"3531",238,606,368,"TAATAATGCCAACGATGGTA","ATAATTGCCAATAAGGCTGC","561307.5.peg.1321"," 360"
"3532",375,606,231,"TTAGCCGCTTCAATGAGTGA","ATAATTGCCAATAAGGCTGC","561307.5.peg.1321"," 360"
"3533",444,606,162,"ATTATAACAGGCATTGCTAT","ATAATTGCCAATAAGGCTGC","561307.5.peg.1321"," 360"
"3534",456,606,150,"CTTACACCAGCCATTATAAC","ATAATTGCCAATAAGGCTGC","561307.5.peg.1321"," 360"
"3535",273,781,508,"ACACGACCGATACCAAATAA","ATTTGTAATAATCGATGGCT","561307.5.peg.1321"," 360"
"3536",243,781,538,"AAACCTAATAATGCCAACGA","ATTTGTAATAATCGATGGCT","561307.5.peg.1321"," 360"
"3537",444,781,337,"ATTATAACAGGCATTGCTAT","ATTTGTAATAATCGATGGCT","561307.5.peg.1321"," 360"
"3538",456,781,325,"CTTACACCAGCCATTATAAC","ATTTGTAATAATCGATGGCT","561307.5.peg.1321"," 360"
"3539",238,781,543,"TAATAATGCCAACGATGGTA","ATTTGTAATAATCGATGGCT","561307.5.peg.1321"," 360"
"3540",606,781,175,"ATAATTGCCAATAAGGCTGC","ATTTGTAATAATCGATGGCT","561307.5.peg.1321"," 360"
"3541",375,781,406,"TTAGCCGCTTCAATGAGTGA","ATTTGTAATAATCGATGGCT","561307.5.peg.1321"," 360"
"3542",569,781,212,"ATATCAACGATGCATTGTTA","ATTTGTAATAATCGATGGCT","561307.5.peg.1321"," 360"
"3543",447,255,192,"TGCCCCCCTGACAATTCATC","TCCCAACGCATTTCGTATAC","561307.5.peg.1322"," 361"
"3544",447,311,136,"TGCCCCCCTGACAATTCATC","TTCTTTGATTGTCATATGT","561307.5.peg.1322"," 361"
"3545",255,447,192,"TCCCAACGCATTTCGTATAC","TGCCCCCCTGACAATTCATC","561307.5.peg.1322"," 361"
"3546",311,447,136,"TTCTTTGATTGTCATATGT","TGCCCCCCTGACAATTCATC","561307.5.peg.1322"," 361"
"3547",571,134,437,"ATCTTGCTGTACTTCAACCG","AGACACCAAGCACATTACGA","561307.5.peg.1323"," 362"
"3548",571,159,412,"ATCTTGCTGTACTTCAACCG","ATAGACTTACCTCCACCAGT","561307.5.peg.1323"," 362"
"3549",571,195,376,"ATCTTGCTGTACTTCAACCG","GTACCACCTAACAATAAACC","561307.5.peg.1323"," 362"
"3550",134,571,437,"AGACACCAAGCACATTACGA","ATCTTGCTGTACTTCAACCG","561307.5.peg.1323"," 362"
"3551",159,571,412,"ATAGACTTACCTCCACCAGT","ATCTTGCTGTACTTCAACCG","561307.5.peg.1323"," 362"
"3552",195,571,376,"GTACCACCTAACAATAAACC","ATCTTGCTGTACTTCAACCG","561307.5.peg.1323"," 362"
"3553",223,2,221,"TGATTTGGATGCATAACAT","TTCAACAGAAGAAGGAAGAT","561307.5.peg.1324"," 363"
"3554",600,2,598,"TCGAAGTCTAAATGGTTCGT","TTCAACAGAAGAAGGAAGAT","561307.5.peg.1324"," 363"
"3555",223,10,213,"TGATTTGGATGCATAACAT","GTAGAGATTTCAACAGAAGA","561307.5.peg.1324"," 363"
"3556",600,10,590,"TCGAAGTCTAAATGGTTCGT","GTAGAGATTTCAACAGAAGA","561307.5.peg.1324"," 363"
"3557",2,223,221,"TTCAACAGAAGAAGGAAGAT","TGATTTGGATGCATAACAT","561307.5.peg.1324"," 363"
"3558",600,223,377,"TCGAAGTCTAAATGGTTCGT","TGATTTGGATGCATAACAT","561307.5.peg.1324"," 363"
"3559",10,223,213,"GTAGAGATTTCAACAGAAGA","TGATTTGGATGCATAACAT","561307.5.peg.1324"," 363"
"3560",10,600,590,"GTAGAGATTTCAACAGAAGA","TCGAAGTCTAAATGGTTCGT","561307.5.peg.1324"," 363"
"3561",2,600,598,"TTCAACAGAAGAAGGAAGAT","TCGAAGTCTAAATGGTTCGT","561307.5.peg.1324"," 363"
"3562",223,600,377,"TGATTTGGATGCATAACAT","TCGAAGTCTAAATGGTTCGT","561307.5.peg.1324"," 363"
"3563",207,30,177,"GCAATTTGCACACGATCCCA","TTATTTAGTCACCTCTTGA","561307.5.peg.133"," 369"
"3564",246,30,216,"GGAATATAATCTAGGGTCGT","TTATTTAGTCACCTCTTGA","561307.5.peg.133"," 369"
"3565",30,207,177,"TTATTTAGTCACCTCTTGA","GCAATTTGCACACGATCCCA","561307.5.peg.133"," 369"
"3566",30,246,216,"TTATTTAGTCACCTCTTGA","GGAATATAATCTAGGGTCGT","561307.5.peg.133"," 369"
"3567",423,3,420,"TCCGTATGTTTCAATAACGT","CAACAATGACCTAAGAGGTG","561307.5.peg.1334"," 374"
"3568",423,8,415,"TCCGTATGTTTCAATAACGT","ATAACAACAATGACCTAAG","561307.5.peg.1334"," 374"
"3569",423,35,388,"TCCGTATGTTTCAATAACGT","TATTCATATCCACACCTCTT","561307.5.peg.1334"," 374"
"3570",3,423,420,"CAACAATGACCTAAGAGGTG","TCCGTATGTTTCAATAACGT","561307.5.peg.1334"," 374"
"3571",8,423,415,"ATAACAACAATGACCTAAG","TCCGTATGTTTCAATAACGT","561307.5.peg.1334"," 374"
"3572",35,423,388,"TATTCATATCCACACCTCTT","TCCGTATGTTTCAATAACGT","561307.5.peg.1334"," 374"
"3573",488,78,410,"GACTACCTCCACTTTGTGCA","AATCCTGGGAATCTCAACTC","561307.5.peg.1337"," 377"
"3574",556,78,478,"CTGTTCTTCAAATATAGTTG","AATCCTGGGAATCTCAACTC","561307.5.peg.1337"," 377"
"3575",78,488,410,"AATCCTGGGAATCTCAACTC","GACTACCTCCACTTTGTGCA","561307.5.peg.1337"," 377"
"3576",78,556,478,"AATCCTGGGAATCTCAACTC","CTGTTCTTCAAATATAGTTG","561307.5.peg.1337"," 377"
"3577",317,191,126,"ATGAACCGGAACCACATGTT","TCGCCGCAAAGCGCCCGATT","561307.5.peg.1338"," 378"
"3578",533,191,342,"TCCATTTCGCACTGTATGGT","TCGCCGCAAAGCGCCCGATT","561307.5.peg.1338"," 378"
"3579",533,246,287,"TCCATTTCGCACTGTATGGT","GTATCTTAGATACTTGTTG","561307.5.peg.1338"," 378"
"3580",191,317,126,"TCGCCGCAAAGCGCCCGATT","ATGAACCGGAACCACATGTT","561307.5.peg.1338"," 378"
"3581",533,317,216,"TCCATTTCGCACTGTATGGT","ATGAACCGGAACCACATGTT","561307.5.peg.1338"," 378"
"3582",191,533,342,"TCGCCGCAAAGCGCCCGATT","TCCATTTCGCACTGTATGGT","561307.5.peg.1338"," 378"
"3583",246,533,287,"GTATCTTAGATACTTGTTG","TCCATTTCGCACTGTATGGT","561307.5.peg.1338"," 378"
"3584",317,533,216,"ATGAACCGGAACCACATGTT","TCCATTTCGCACTGTATGGT","561307.5.peg.1338"," 378"
"3585",391,282,109,"ATCAGGAGGATAGTAACCAG","TTAGCGTTTGTTTATATTC","561307.5.peg.1339"," 379"
"3586",282,391,109,"TTAGCGTTTGTTTATATTC","ATCAGGAGGATAGTAACCAG","561307.5.peg.1339"," 379"
"3587",270,90,180,"ACTTCTTGCTCCTTAAACTC","CTTACGGCAGCATTCATTCC","561307.5.peg.134"," 380"
"3588",338,90,248,"CGTCACCACCAATAACTACA","CTTACGGCAGCATTCATTCC","561307.5.peg.134"," 380"
"3589",423,90,333,"ATATCATTGTCAATCGTACC","CTTACGGCAGCATTCATTCC","561307.5.peg.134"," 380"
"3590",338,106,232,"CGTCACCACCAATAACTACA","TGTACGAACAACTGCTCTTA","561307.5.peg.134"," 380"
"3591",270,106,164,"ACTTCTTGCTCCTTAAACTC","TGTACGAACAACTGCTCTTA","561307.5.peg.134"," 380"
"3592",423,106,317,"ATATCATTGTCAATCGTACC","TGTACGAACAACTGCTCTTA","561307.5.peg.134"," 380"
"3593",90,270,180,"CTTACGGCAGCATTCATTCC","ACTTCTTGCTCCTTAAACTC","561307.5.peg.134"," 380"
"3594",106,270,164,"TGTACGAACAACTGCTCTTA","ACTTCTTGCTCCTTAAACTC","561307.5.peg.134"," 380"
"3595",423,270,153,"ATATCATTGTCAATCGTACC","ACTTCTTGCTCCTTAAACTC","561307.5.peg.134"," 380"
"3596",90,338,248,"CTTACGGCAGCATTCATTCC","CGTCACCACCAATAACTACA","561307.5.peg.134"," 380"
"3597",106,338,232,"TGTACGAACAACTGCTCTTA","CGTCACCACCAATAACTACA","561307.5.peg.134"," 380"
"3598",90,423,333,"CTTACGGCAGCATTCATTCC","ATATCATTGTCAATCGTACC","561307.5.peg.134"," 380"
"3599",270,423,153,"ACTTCTTGCTCCTTAAACTC","ATATCATTGTCAATCGTACC","561307.5.peg.134"," 380"
"3600",106,423,317,"TGTACGAACAACTGCTCTTA","ATATCATTGTCAATCGTACC","561307.5.peg.134"," 380"
"3601",249,9,240,"CCAGCTGTTACACTTCCACC","GAGTAACAGTTATTACAAGG","561307.5.peg.1340"," 381"
"3602",249,86,163,"CCAGCTGTTACACTTCCACC","TATCATATGCACGTTCACCG","561307.5.peg.1340"," 381"
"3603",9,249,240,"GAGTAACAGTTATTACAAGG","CCAGCTGTTACACTTCCACC","561307.5.peg.1340"," 381"
"3604",86,249,163,"TATCATATGCACGTTCACCG","CCAGCTGTTACACTTCCACC","561307.5.peg.1340"," 381"
"3605",204,29,175,"TTTCTGATGTCTCCTGGTGC","AATGTTTATGTGCATCATA","561307.5.peg.1342"," 383"
"3606",417,29,388,"TGCACACTTGTATTTGTAGA","AATGTTTATGTGCATCATA","561307.5.peg.1342"," 383"
"3607",210,29,181,"ATCACATTTCTGATGTCTCC","AATGTTTATGTGCATCATA","561307.5.peg.1342"," 383"
"3608",29,204,175,"AATGTTTATGTGCATCATA","TTTCTGATGTCTCCTGGTGC","561307.5.peg.1342"," 383"
"3609",417,204,213,"TGCACACTTGTATTTGTAGA","TTTCTGATGTCTCCTGGTGC","561307.5.peg.1342"," 383"
"3610",29,210,181,"AATGTTTATGTGCATCATA","ATCACATTTCTGATGTCTCC","561307.5.peg.1342"," 383"
"3611",417,210,207,"TGCACACTTGTATTTGTAGA","ATCACATTTCTGATGTCTCC","561307.5.peg.1342"," 383"
"3612",210,417,207,"ATCACATTTCTGATGTCTCC","TGCACACTTGTATTTGTAGA","561307.5.peg.1342"," 383"
"3613",204,417,213,"TTTCTGATGTCTCCTGGTGC","TGCACACTTGTATTTGTAGA","561307.5.peg.1342"," 383"
"3614",29,417,388,"AATGTTTATGTGCATCATA","TGCACACTTGTATTTGTAGA","561307.5.peg.1342"," 383"
"3615",366,189,177,"ATTAACATCATCCCCTCGAT","CTTGAAGTTTGACCTTGACC","561307.5.peg.1344"," 385"
"3616",189,366,177,"CTTGAAGTTTGACCTTGACC","ATTAACATCATCCCCTCGAT","561307.5.peg.1344"," 385"
"3617",125,8,117,"CTTTATTGGCGCCCAAACGT","TTGTAAACACAAGGGTTTGG","561307.5.peg.1345"," 386"
"3618",139,8,131,"ATTTCCGGCAACGACTTTAT","TTGTAAACACAAGGGTTTGG","561307.5.peg.1345"," 386"
"3619",154,8,146,"TAACTCTGGAATTGTATTTC","TTGTAAACACAAGGGTTTGG","561307.5.peg.1345"," 386"
"3620",125,11,114,"CTTTATTGGCGCCCAAACGT","TATTGTAAACACAAGGGTT","561307.5.peg.1345"," 386"
"3621",139,11,128,"ATTTCCGGCAACGACTTTAT","TATTGTAAACACAAGGGTT","561307.5.peg.1345"," 386"
"3622",154,11,143,"TAACTCTGGAATTGTATTTC","TATTGTAAACACAAGGGTT","561307.5.peg.1345"," 386"
"3623",8,125,117,"TTGTAAACACAAGGGTTTGG","CTTTATTGGCGCCCAAACGT","561307.5.peg.1345"," 386"
"3624",11,125,114,"TATTGTAAACACAAGGGTT","CTTTATTGGCGCCCAAACGT","561307.5.peg.1345"," 386"
"3625",8,139,131,"TTGTAAACACAAGGGTTTGG","ATTTCCGGCAACGACTTTAT","561307.5.peg.1345"," 386"
"3626",11,139,128,"TATTGTAAACACAAGGGTT","ATTTCCGGCAACGACTTTAT","561307.5.peg.1345"," 386"
"3627",8,154,146,"TTGTAAACACAAGGGTTTGG","TAACTCTGGAATTGTATTTC","561307.5.peg.1345"," 386"
"3628",11,154,143,"TATTGTAAACACAAGGGTT","TAACTCTGGAATTGTATTTC","561307.5.peg.1345"," 386"
"3629",432,225,207,"CCTTTATCTTGTGCTACTAA","TGTGCAATATCTTTAGACAC","561307.5.peg.1347"," 388"
"3630",417,225,192,"CTAATGGAAATAAATGACC","TGTGCAATATCTTTAGACAC","561307.5.peg.1347"," 388"
"3631",387,225,162,"AATCTTTAGCTTCACTACT","TGTGCAATATCTTTAGACAC","561307.5.peg.1347"," 388"
"3632",519,225,294,"ATCTCACAAATGACACCAGC","TGTGCAATATCTTTAGACAC","561307.5.peg.1347"," 388"
"3633",514,225,289,"ACAAATGACACCAGCGGGCT","TGTGCAATATCTTTAGACAC","561307.5.peg.1347"," 388"
"3634",225,387,162,"TGTGCAATATCTTTAGACAC","AATCTTTAGCTTCACTACT","561307.5.peg.1347"," 388"
"3635",519,387,132,"ATCTCACAAATGACACCAGC","AATCTTTAGCTTCACTACT","561307.5.peg.1347"," 388"
"3636",514,387,127,"ACAAATGACACCAGCGGGCT","AATCTTTAGCTTCACTACT","561307.5.peg.1347"," 388"
"3637",225,417,192,"TGTGCAATATCTTTAGACAC","CTAATGGAAATAAATGACC","561307.5.peg.1347"," 388"
"3638",519,417,102,"ATCTCACAAATGACACCAGC","CTAATGGAAATAAATGACC","561307.5.peg.1347"," 388"
"3639",225,432,207,"TGTGCAATATCTTTAGACAC","CCTTTATCTTGTGCTACTAA","561307.5.peg.1347"," 388"
"3640",225,514,289,"TGTGCAATATCTTTAGACAC","ACAAATGACACCAGCGGGCT","561307.5.peg.1347"," 388"
"3641",387,514,127,"AATCTTTAGCTTCACTACT","ACAAATGACACCAGCGGGCT","561307.5.peg.1347"," 388"
"3642",225,519,294,"TGTGCAATATCTTTAGACAC","ATCTCACAAATGACACCAGC","561307.5.peg.1347"," 388"
"3643",387,519,132,"AATCTTTAGCTTCACTACT","ATCTCACAAATGACACCAGC","561307.5.peg.1347"," 388"
"3644",417,519,102,"CTAATGGAAATAAATGACC","ATCTCACAAATGACACCAGC","561307.5.peg.1347"," 388"
"3645",307,169,138,"AAACCTACCGTTACCACTCA","ACATGCACCATTAACACTGA","561307.5.peg.1348"," 389"
"3646",169,307,138,"ACATGCACCATTAACACTGA","AAACCTACCGTTACCACTCA","561307.5.peg.1348"," 389"
"3647",531,84,447,"GGTAAACTTACTCTTACGCC","ATTTCTTCTGATTCTGAAGC","561307.5.peg.135"," 391"
"3648",864,84,780,"TTTGTGTAGCTGTAATAAC","ATTTCTTCTGATTCTGAAGC","561307.5.peg.135"," 391"
"3649",258,84,174,"TATTATGCGTACGAATTTC","ATTTCTTCTGATTCTGAAGC","561307.5.peg.135"," 391"
"3650",84,258,174,"ATTTCTTCTGATTCTGAAGC","TATTATGCGTACGAATTTC","561307.5.peg.135"," 391"
"3651",531,258,273,"GGTAAACTTACTCTTACGCC","TATTATGCGTACGAATTTC","561307.5.peg.135"," 391"
"3652",864,258,606,"TTTGTGTAGCTGTAATAAC","TATTATGCGTACGAATTTC","561307.5.peg.135"," 391"
"3653",84,531,447,"ATTTCTTCTGATTCTGAAGC","GGTAAACTTACTCTTACGCC","561307.5.peg.135"," 391"
"3654",864,531,333,"TTTGTGTAGCTGTAATAAC","GGTAAACTTACTCTTACGCC","561307.5.peg.135"," 391"
"3655",258,531,273,"TATTATGCGTACGAATTTC","GGTAAACTTACTCTTACGCC","561307.5.peg.135"," 391"
"3656",84,864,780,"ATTTCTTCTGATTCTGAAGC","TTTGTGTAGCTGTAATAAC","561307.5.peg.135"," 391"
"3657",258,864,606,"TATTATGCGTACGAATTTC","TTTGTGTAGCTGTAATAAC","561307.5.peg.135"," 391"
"3658",531,864,333,"GGTAAACTTACTCTTACGCC","TTTGTGTAGCTGTAATAAC","561307.5.peg.135"," 391"
"3659",652,306,346,"ATAACGGACAACATCTAAAC","ACAAATCTCGGTAAATATGC","561307.5.peg.1350"," 392"
"3660",732,306,426,"ATCATTGTACCTCTTACACT","ACAAATCTCGGTAAATATGC","561307.5.peg.1350"," 392"
"3661",585,306,279,"CGTCTAACGTATTATATGT","ACAAATCTCGGTAAATATGC","561307.5.peg.1350"," 392"
"3662",668,306,362,"GATGATGAGCAGCAACATAA","ACAAATCTCGGTAAATATGC","561307.5.peg.1350"," 392"
"3663",529,306,223,"AAGTTATATGGATCATGGT","ACAAATCTCGGTAAATATGC","561307.5.peg.1350"," 392"
"3664",647,306,341,"GGACAACATCTAAACTGGCA","ACAAATCTCGGTAAATATGC","561307.5.peg.1350"," 392"
"3665",699,306,393,"GAACGACTCGTCATAGTAAT","ACAAATCTCGGTAAATATGC","561307.5.peg.1350"," 392"
"3666",529,318,211,"AAGTTATATGGATCATGGT","TAATGTCCGAATACAAATCT","561307.5.peg.1350"," 392"
"3667",647,318,329,"GGACAACATCTAAACTGGCA","TAATGTCCGAATACAAATCT","561307.5.peg.1350"," 392"
"3668",652,318,334,"ATAACGGACAACATCTAAAC","TAATGTCCGAATACAAATCT","561307.5.peg.1350"," 392"
"3669",668,318,350,"GATGATGAGCAGCAACATAA","TAATGTCCGAATACAAATCT","561307.5.peg.1350"," 392"
"3670",732,318,414,"ATCATTGTACCTCTTACACT","TAATGTCCGAATACAAATCT","561307.5.peg.1350"," 392"
"3671",699,318,381,"GAACGACTCGTCATAGTAAT","TAATGTCCGAATACAAATCT","561307.5.peg.1350"," 392"
"3672",585,318,267,"CGTCTAACGTATTATATGT","TAATGTCCGAATACAAATCT","561307.5.peg.1350"," 392"
"3673",318,529,211,"TAATGTCCGAATACAAATCT","AAGTTATATGGATCATGGT","561307.5.peg.1350"," 392"
"3674",306,529,223,"ACAAATCTCGGTAAATATGC","AAGTTATATGGATCATGGT","561307.5.peg.1350"," 392"
"3675",668,529,139,"GATGATGAGCAGCAACATAA","AAGTTATATGGATCATGGT","561307.5.peg.1350"," 392"
"3676",647,529,118,"GGACAACATCTAAACTGGCA","AAGTTATATGGATCATGGT","561307.5.peg.1350"," 392"
"3677",732,529,203,"ATCATTGTACCTCTTACACT","AAGTTATATGGATCATGGT","561307.5.peg.1350"," 392"
"3678",652,529,123,"ATAACGGACAACATCTAAAC","AAGTTATATGGATCATGGT","561307.5.peg.1350"," 392"
"3679",699,529,170,"GAACGACTCGTCATAGTAAT","AAGTTATATGGATCATGGT","561307.5.peg.1350"," 392"
"3680",732,585,147,"ATCATTGTACCTCTTACACT","CGTCTAACGTATTATATGT","561307.5.peg.1350"," 392"
"3681",306,585,279,"ACAAATCTCGGTAAATATGC","CGTCTAACGTATTATATGT","561307.5.peg.1350"," 392"
"3682",318,585,267,"TAATGTCCGAATACAAATCT","CGTCTAACGTATTATATGT","561307.5.peg.1350"," 392"
"3683",699,585,114,"GAACGACTCGTCATAGTAAT","CGTCTAACGTATTATATGT","561307.5.peg.1350"," 392"
"3684",529,647,118,"AAGTTATATGGATCATGGT","GGACAACATCTAAACTGGCA","561307.5.peg.1350"," 392"
"3685",318,647,329,"TAATGTCCGAATACAAATCT","GGACAACATCTAAACTGGCA","561307.5.peg.1350"," 392"
"3686",306,647,341,"ACAAATCTCGGTAAATATGC","GGACAACATCTAAACTGGCA","561307.5.peg.1350"," 392"
"3687",529,652,123,"AAGTTATATGGATCATGGT","ATAACGGACAACATCTAAAC","561307.5.peg.1350"," 392"
"3688",318,652,334,"TAATGTCCGAATACAAATCT","ATAACGGACAACATCTAAAC","561307.5.peg.1350"," 392"
"3689",306,652,346,"ACAAATCTCGGTAAATATGC","ATAACGGACAACATCTAAAC","561307.5.peg.1350"," 392"
"3690",318,668,350,"TAATGTCCGAATACAAATCT","GATGATGAGCAGCAACATAA","561307.5.peg.1350"," 392"
"3691",306,668,362,"ACAAATCTCGGTAAATATGC","GATGATGAGCAGCAACATAA","561307.5.peg.1350"," 392"
"3692",529,668,139,"AAGTTATATGGATCATGGT","GATGATGAGCAGCAACATAA","561307.5.peg.1350"," 392"
"3693",306,699,393,"ACAAATCTCGGTAAATATGC","GAACGACTCGTCATAGTAAT","561307.5.peg.1350"," 392"
"3694",585,699,114,"CGTCTAACGTATTATATGT","GAACGACTCGTCATAGTAAT","561307.5.peg.1350"," 392"
"3695",529,699,170,"AAGTTATATGGATCATGGT","GAACGACTCGTCATAGTAAT","561307.5.peg.1350"," 392"
"3696",318,699,381,"TAATGTCCGAATACAAATCT","GAACGACTCGTCATAGTAAT","561307.5.peg.1350"," 392"
"3697",306,732,426,"ACAAATCTCGGTAAATATGC","ATCATTGTACCTCTTACACT","561307.5.peg.1350"," 392"
"3698",318,732,414,"TAATGTCCGAATACAAATCT","ATCATTGTACCTCTTACACT","561307.5.peg.1350"," 392"
"3699",585,732,147,"CGTCTAACGTATTATATGT","ATCATTGTACCTCTTACACT","561307.5.peg.1350"," 392"
"3700",529,732,203,"AAGTTATATGGATCATGGT","ATCATTGTACCTCTTACACT","561307.5.peg.1350"," 392"
"3701",119,2,117,"GTGCGGTAATGCCAATATCT","ACAAATACATCGTTGGTTAG","561307.5.peg.1351"," 393"
"3702",513,2,511,"ACTAGATTGCTCACGATTAA","ACAAATACATCGTTGGTTAG","561307.5.peg.1351"," 393"
"3703",136,2,134,"AATAAAGGCACCAGTTAGTG","ACAAATACATCGTTGGTTAG","561307.5.peg.1351"," 393"
"3704",111,2,109,"ATGCCAATATCTAGGCCTTT","ACAAATACATCGTTGGTTAG","561307.5.peg.1351"," 393"
"3705",414,2,412,"TAACCATCGCTAATACAAT","ACAAATACATCGTTGGTTAG","561307.5.peg.1351"," 393"
"3706",111,9,102,"ATGCCAATATCTAGGCCTTT","GGTTATGACAAATACATCGT","561307.5.peg.1351"," 393"
"3707",414,9,405,"TAACCATCGCTAATACAAT","GGTTATGACAAATACATCGT","561307.5.peg.1351"," 393"
"3708",119,9,110,"GTGCGGTAATGCCAATATCT","GGTTATGACAAATACATCGT","561307.5.peg.1351"," 393"
"3709",136,9,127,"AATAAAGGCACCAGTTAGTG","GGTTATGACAAATACATCGT","561307.5.peg.1351"," 393"
"3710",513,9,504,"ACTAGATTGCTCACGATTAA","GGTTATGACAAATACATCGT","561307.5.peg.1351"," 393"
"3711",111,10,101,"ATGCCAATATCTAGGCCTTT","TTTGTCATAACCTTAAGAC","561307.5.peg.1351"," 393"
"3712",414,10,404,"TAACCATCGCTAATACAAT","TTTGTCATAACCTTAAGAC","561307.5.peg.1351"," 393"
"3713",119,10,109,"GTGCGGTAATGCCAATATCT","TTTGTCATAACCTTAAGAC","561307.5.peg.1351"," 393"
"3714",136,10,126,"AATAAAGGCACCAGTTAGTG","TTTGTCATAACCTTAAGAC","561307.5.peg.1351"," 393"
"3715",513,10,503,"ACTAGATTGCTCACGATTAA","TTTGTCATAACCTTAAGAC","561307.5.peg.1351"," 393"
"3716",513,30,483,"ACTAGATTGCTCACGATTAA","ATTAGCATTCACCAGTCTTA","561307.5.peg.1351"," 393"
"3717",136,30,106,"AATAAAGGCACCAGTTAGTG","ATTAGCATTCACCAGTCTTA","561307.5.peg.1351"," 393"
"3718",414,30,384,"TAACCATCGCTAATACAAT","ATTAGCATTCACCAGTCTTA","561307.5.peg.1351"," 393"
"3719",2,111,109,"ACAAATACATCGTTGGTTAG","ATGCCAATATCTAGGCCTTT","561307.5.peg.1351"," 393"
"3720",10,111,101,"TTTGTCATAACCTTAAGAC","ATGCCAATATCTAGGCCTTT","561307.5.peg.1351"," 393"
"3721",513,111,402,"ACTAGATTGCTCACGATTAA","ATGCCAATATCTAGGCCTTT","561307.5.peg.1351"," 393"
"3722",9,111,102,"GGTTATGACAAATACATCGT","ATGCCAATATCTAGGCCTTT","561307.5.peg.1351"," 393"
"3723",414,111,303,"TAACCATCGCTAATACAAT","ATGCCAATATCTAGGCCTTT","561307.5.peg.1351"," 393"
"3724",9,119,110,"GGTTATGACAAATACATCGT","GTGCGGTAATGCCAATATCT","561307.5.peg.1351"," 393"
"3725",513,119,394,"ACTAGATTGCTCACGATTAA","GTGCGGTAATGCCAATATCT","561307.5.peg.1351"," 393"
"3726",10,119,109,"TTTGTCATAACCTTAAGAC","GTGCGGTAATGCCAATATCT","561307.5.peg.1351"," 393"
"3727",2,119,117,"ACAAATACATCGTTGGTTAG","GTGCGGTAATGCCAATATCT","561307.5.peg.1351"," 393"
"3728",414,119,295,"TAACCATCGCTAATACAAT","GTGCGGTAATGCCAATATCT","561307.5.peg.1351"," 393"
"3729",30,136,106,"ATTAGCATTCACCAGTCTTA","AATAAAGGCACCAGTTAGTG","561307.5.peg.1351"," 393"
"3730",2,136,134,"ACAAATACATCGTTGGTTAG","AATAAAGGCACCAGTTAGTG","561307.5.peg.1351"," 393"
"3731",513,136,377,"ACTAGATTGCTCACGATTAA","AATAAAGGCACCAGTTAGTG","561307.5.peg.1351"," 393"
"3732",10,136,126,"TTTGTCATAACCTTAAGAC","AATAAAGGCACCAGTTAGTG","561307.5.peg.1351"," 393"
"3733",9,136,127,"GGTTATGACAAATACATCGT","AATAAAGGCACCAGTTAGTG","561307.5.peg.1351"," 393"
"3734",414,136,278,"TAACCATCGCTAATACAAT","AATAAAGGCACCAGTTAGTG","561307.5.peg.1351"," 393"
"3735",10,414,404,"TTTGTCATAACCTTAAGAC","TAACCATCGCTAATACAAT","561307.5.peg.1351"," 393"
"3736",30,414,384,"ATTAGCATTCACCAGTCTTA","TAACCATCGCTAATACAAT","561307.5.peg.1351"," 393"
"3737",2,414,412,"ACAAATACATCGTTGGTTAG","TAACCATCGCTAATACAAT","561307.5.peg.1351"," 393"
"3738",111,414,303,"ATGCCAATATCTAGGCCTTT","TAACCATCGCTAATACAAT","561307.5.peg.1351"," 393"
"3739",136,414,278,"AATAAAGGCACCAGTTAGTG","TAACCATCGCTAATACAAT","561307.5.peg.1351"," 393"
"3740",9,414,405,"GGTTATGACAAATACATCGT","TAACCATCGCTAATACAAT","561307.5.peg.1351"," 393"
"3741",119,414,295,"GTGCGGTAATGCCAATATCT","TAACCATCGCTAATACAAT","561307.5.peg.1351"," 393"
"3742",2,513,511,"ACAAATACATCGTTGGTTAG","ACTAGATTGCTCACGATTAA","561307.5.peg.1351"," 393"
"3743",30,513,483,"ATTAGCATTCACCAGTCTTA","ACTAGATTGCTCACGATTAA","561307.5.peg.1351"," 393"
"3744",9,513,504,"GGTTATGACAAATACATCGT","ACTAGATTGCTCACGATTAA","561307.5.peg.1351"," 393"
"3745",119,513,394,"GTGCGGTAATGCCAATATCT","ACTAGATTGCTCACGATTAA","561307.5.peg.1351"," 393"
"3746",136,513,377,"AATAAAGGCACCAGTTAGTG","ACTAGATTGCTCACGATTAA","561307.5.peg.1351"," 393"
"3747",111,513,402,"ATGCCAATATCTAGGCCTTT","ACTAGATTGCTCACGATTAA","561307.5.peg.1351"," 393"
"3748",10,513,503,"TTTGTCATAACCTTAAGAC","ACTAGATTGCTCACGATTAA","561307.5.peg.1351"," 393"
"3749",972,333,639,"CCGCAAGTTGCTCCATACTC","GAAGCTAAATCAACTACGGC","561307.5.peg.1353"," 395"
"3750",434,333,101,"AGCTATCCACTTGAACTGAG","GAAGCTAAATCAACTACGGC","561307.5.peg.1353"," 395"
"3751",936,333,603,"ATTGTAGCACGGTCTGCTAG","GAAGCTAAATCAACTACGGC","561307.5.peg.1353"," 395"
"3752",1001,333,668,"TAAGAGATTCATCATCAACT","GAAGCTAAATCAACTACGGC","561307.5.peg.1353"," 395"
"3753",947,333,614,"CCATGTTTGCAATTGTAGCA","GAAGCTAAATCAACTACGGC","561307.5.peg.1353"," 395"
"3754",1251,333,918,"CCGTGTCCTTGGTTGCCTGC","GAAGCTAAATCAACTACGGC","561307.5.peg.1353"," 395"
"3755",771,333,438,"TCTGGAATTGGGAAATAAGA","GAAGCTAAATCAACTACGGC","561307.5.peg.1353"," 395"
"3756",573,333,240,"TGGTGAACTATTCCAGTTGC","GAAGCTAAATCAACTACGGC","561307.5.peg.1353"," 395"
"3757",918,333,585,"AGTGGTAAATGTTGTACACC","GAAGCTAAATCAACTACGGC","561307.5.peg.1353"," 395"
"3758",570,333,237,"TGAACTATTCCAGTTGCAGG","GAAGCTAAATCAACTACGGC","561307.5.peg.1353"," 395"
"3759",789,333,456,"AGTCGTACACCAATAACCTC","GAAGCTAAATCAACTACGGC","561307.5.peg.1353"," 395"
"3760",825,333,492,"TCAGTTGCTGTTGCGCCTTG","GAAGCTAAATCAACTACGGC","561307.5.peg.1353"," 395"
"3761",663,333,330,"TCAGTACCAACTAATGTATC","GAAGCTAAATCAACTACGGC","561307.5.peg.1353"," 395"
"3762",782,333,449,"CACCAATAACCTCTGGAATT","GAAGCTAAATCAACTACGGC","561307.5.peg.1353"," 395"
"3763",789,337,452,"AGTCGTACACCAATAACCTC","AAAGAAGCTAAATCAACTA","561307.5.peg.1353"," 395"
"3764",782,337,445,"CACCAATAACCTCTGGAATT","AAAGAAGCTAAATCAACTA","561307.5.peg.1353"," 395"
"3765",573,337,236,"TGGTGAACTATTCCAGTTGC","AAAGAAGCTAAATCAACTA","561307.5.peg.1353"," 395"
"3766",1001,337,664,"TAAGAGATTCATCATCAACT","AAAGAAGCTAAATCAACTA","561307.5.peg.1353"," 395"
"3767",825,337,488,"TCAGTTGCTGTTGCGCCTTG","AAAGAAGCTAAATCAACTA","561307.5.peg.1353"," 395"
"3768",663,337,326,"TCAGTACCAACTAATGTATC","AAAGAAGCTAAATCAACTA","561307.5.peg.1353"," 395"
"3769",1251,337,914,"CCGTGTCCTTGGTTGCCTGC","AAAGAAGCTAAATCAACTA","561307.5.peg.1353"," 395"
"3770",947,337,610,"CCATGTTTGCAATTGTAGCA","AAAGAAGCTAAATCAACTA","561307.5.peg.1353"," 395"
"3771",918,337,581,"AGTGGTAAATGTTGTACACC","AAAGAAGCTAAATCAACTA","561307.5.peg.1353"," 395"
"3772",972,337,635,"CCGCAAGTTGCTCCATACTC","AAAGAAGCTAAATCAACTA","561307.5.peg.1353"," 395"
"3773",771,337,434,"TCTGGAATTGGGAAATAAGA","AAAGAAGCTAAATCAACTA","561307.5.peg.1353"," 395"
"3774",570,337,233,"TGAACTATTCCAGTTGCAGG","AAAGAAGCTAAATCAACTA","561307.5.peg.1353"," 395"
"3775",936,337,599,"ATTGTAGCACGGTCTGCTAG","AAAGAAGCTAAATCAACTA","561307.5.peg.1353"," 395"
"3776",771,405,366,"TCTGGAATTGGGAAATAAGA","ACTAAATCCACCGGTACTTC","561307.5.peg.1353"," 395"
"3777",918,405,513,"AGTGGTAAATGTTGTACACC","ACTAAATCCACCGGTACTTC","561307.5.peg.1353"," 395"
"3778",972,405,567,"CCGCAAGTTGCTCCATACTC","ACTAAATCCACCGGTACTTC","561307.5.peg.1353"," 395"
"3779",570,405,165,"TGAACTATTCCAGTTGCAGG","ACTAAATCCACCGGTACTTC","561307.5.peg.1353"," 395"
"3780",936,405,531,"ATTGTAGCACGGTCTGCTAG","ACTAAATCCACCGGTACTTC","561307.5.peg.1353"," 395"
"3781",825,405,420,"TCAGTTGCTGTTGCGCCTTG","ACTAAATCCACCGGTACTTC","561307.5.peg.1353"," 395"
"3782",1001,405,596,"TAAGAGATTCATCATCAACT","ACTAAATCCACCGGTACTTC","561307.5.peg.1353"," 395"
"3783",947,405,542,"CCATGTTTGCAATTGTAGCA","ACTAAATCCACCGGTACTTC","561307.5.peg.1353"," 395"
"3784",789,405,384,"AGTCGTACACCAATAACCTC","ACTAAATCCACCGGTACTTC","561307.5.peg.1353"," 395"
"3785",573,405,168,"TGGTGAACTATTCCAGTTGC","ACTAAATCCACCGGTACTTC","561307.5.peg.1353"," 395"
"3786",663,405,258,"TCAGTACCAACTAATGTATC","ACTAAATCCACCGGTACTTC","561307.5.peg.1353"," 395"
"3787",1251,405,846,"CCGTGTCCTTGGTTGCCTGC","ACTAAATCCACCGGTACTTC","561307.5.peg.1353"," 395"
"3788",782,405,377,"CACCAATAACCTCTGGAATT","ACTAAATCCACCGGTACTTC","561307.5.peg.1353"," 395"
"3789",936,434,502,"ATTGTAGCACGGTCTGCTAG","AGCTATCCACTTGAACTGAG","561307.5.peg.1353"," 395"
"3790",1251,434,817,"CCGTGTCCTTGGTTGCCTGC","AGCTATCCACTTGAACTGAG","561307.5.peg.1353"," 395"
"3791",782,434,348,"CACCAATAACCTCTGGAATT","AGCTATCCACTTGAACTGAG","561307.5.peg.1353"," 395"
"3792",570,434,136,"TGAACTATTCCAGTTGCAGG","AGCTATCCACTTGAACTGAG","561307.5.peg.1353"," 395"
"3793",333,434,101,"GAAGCTAAATCAACTACGGC","AGCTATCCACTTGAACTGAG","561307.5.peg.1353"," 395"
"3794",972,434,538,"CCGCAAGTTGCTCCATACTC","AGCTATCCACTTGAACTGAG","561307.5.peg.1353"," 395"
"3795",947,434,513,"CCATGTTTGCAATTGTAGCA","AGCTATCCACTTGAACTGAG","561307.5.peg.1353"," 395"
"3796",918,434,484,"AGTGGTAAATGTTGTACACC","AGCTATCCACTTGAACTGAG","561307.5.peg.1353"," 395"
"3797",1001,434,567,"TAAGAGATTCATCATCAACT","AGCTATCCACTTGAACTGAG","561307.5.peg.1353"," 395"
"3798",573,434,139,"TGGTGAACTATTCCAGTTGC","AGCTATCCACTTGAACTGAG","561307.5.peg.1353"," 395"
"3799",663,434,229,"TCAGTACCAACTAATGTATC","AGCTATCCACTTGAACTGAG","561307.5.peg.1353"," 395"
"3800",789,434,355,"AGTCGTACACCAATAACCTC","AGCTATCCACTTGAACTGAG","561307.5.peg.1353"," 395"
"3801",825,434,391,"TCAGTTGCTGTTGCGCCTTG","AGCTATCCACTTGAACTGAG","561307.5.peg.1353"," 395"
"3802",771,434,337,"TCTGGAATTGGGAAATAAGA","AGCTATCCACTTGAACTGAG","561307.5.peg.1353"," 395"
"3803",936,570,366,"ATTGTAGCACGGTCTGCTAG","TGAACTATTCCAGTTGCAGG","561307.5.peg.1353"," 395"
"3804",947,570,377,"CCATGTTTGCAATTGTAGCA","TGAACTATTCCAGTTGCAGG","561307.5.peg.1353"," 395"
"3805",789,570,219,"AGTCGTACACCAATAACCTC","TGAACTATTCCAGTTGCAGG","561307.5.peg.1353"," 395"
"3806",337,570,233,"AAAGAAGCTAAATCAACTA","TGAACTATTCCAGTTGCAGG","561307.5.peg.1353"," 395"
"3807",972,570,402,"CCGCAAGTTGCTCCATACTC","TGAACTATTCCAGTTGCAGG","561307.5.peg.1353"," 395"
"3808",1001,570,431,"TAAGAGATTCATCATCAACT","TGAACTATTCCAGTTGCAGG","561307.5.peg.1353"," 395"
"3809",333,570,237,"GAAGCTAAATCAACTACGGC","TGAACTATTCCAGTTGCAGG","561307.5.peg.1353"," 395"
"3810",918,570,348,"AGTGGTAAATGTTGTACACC","TGAACTATTCCAGTTGCAGG","561307.5.peg.1353"," 395"
"3811",825,570,255,"TCAGTTGCTGTTGCGCCTTG","TGAACTATTCCAGTTGCAGG","561307.5.peg.1353"," 395"
"3812",434,570,136,"AGCTATCCACTTGAACTGAG","TGAACTATTCCAGTTGCAGG","561307.5.peg.1353"," 395"
"3813",405,570,165,"ACTAAATCCACCGGTACTTC","TGAACTATTCCAGTTGCAGG","561307.5.peg.1353"," 395"
"3814",782,570,212,"CACCAATAACCTCTGGAATT","TGAACTATTCCAGTTGCAGG","561307.5.peg.1353"," 395"
"3815",771,570,201,"TCTGGAATTGGGAAATAAGA","TGAACTATTCCAGTTGCAGG","561307.5.peg.1353"," 395"
"3816",1251,570,681,"CCGTGTCCTTGGTTGCCTGC","TGAACTATTCCAGTTGCAGG","561307.5.peg.1353"," 395"
"3817",405,573,168,"ACTAAATCCACCGGTACTTC","TGGTGAACTATTCCAGTTGC","561307.5.peg.1353"," 395"
"3818",1251,573,678,"CCGTGTCCTTGGTTGCCTGC","TGGTGAACTATTCCAGTTGC","561307.5.peg.1353"," 395"
"3819",434,573,139,"AGCTATCCACTTGAACTGAG","TGGTGAACTATTCCAGTTGC","561307.5.peg.1353"," 395"
"3820",337,573,236,"AAAGAAGCTAAATCAACTA","TGGTGAACTATTCCAGTTGC","561307.5.peg.1353"," 395"
"3821",947,573,374,"CCATGTTTGCAATTGTAGCA","TGGTGAACTATTCCAGTTGC","561307.5.peg.1353"," 395"
"3822",333,573,240,"GAAGCTAAATCAACTACGGC","TGGTGAACTATTCCAGTTGC","561307.5.peg.1353"," 395"
"3823",789,573,216,"AGTCGTACACCAATAACCTC","TGGTGAACTATTCCAGTTGC","561307.5.peg.1353"," 395"
"3824",918,573,345,"AGTGGTAAATGTTGTACACC","TGGTGAACTATTCCAGTTGC","561307.5.peg.1353"," 395"
"3825",1001,573,428,"TAAGAGATTCATCATCAACT","TGGTGAACTATTCCAGTTGC","561307.5.peg.1353"," 395"
"3826",771,573,198,"TCTGGAATTGGGAAATAAGA","TGGTGAACTATTCCAGTTGC","561307.5.peg.1353"," 395"
"3827",825,573,252,"TCAGTTGCTGTTGCGCCTTG","TGGTGAACTATTCCAGTTGC","561307.5.peg.1353"," 395"
"3828",972,573,399,"CCGCAAGTTGCTCCATACTC","TGGTGAACTATTCCAGTTGC","561307.5.peg.1353"," 395"
"3829",936,573,363,"ATTGTAGCACGGTCTGCTAG","TGGTGAACTATTCCAGTTGC","561307.5.peg.1353"," 395"
"3830",782,573,209,"CACCAATAACCTCTGGAATT","TGGTGAACTATTCCAGTTGC","561307.5.peg.1353"," 395"
"3831",337,663,326,"AAAGAAGCTAAATCAACTA","TCAGTACCAACTAATGTATC","561307.5.peg.1353"," 395"
"3832",434,663,229,"AGCTATCCACTTGAACTGAG","TCAGTACCAACTAATGTATC","561307.5.peg.1353"," 395"
"3833",825,663,162,"TCAGTTGCTGTTGCGCCTTG","TCAGTACCAACTAATGTATC","561307.5.peg.1353"," 395"
"3834",947,663,284,"CCATGTTTGCAATTGTAGCA","TCAGTACCAACTAATGTATC","561307.5.peg.1353"," 395"
"3835",782,663,119,"CACCAATAACCTCTGGAATT","TCAGTACCAACTAATGTATC","561307.5.peg.1353"," 395"
"3836",405,663,258,"ACTAAATCCACCGGTACTTC","TCAGTACCAACTAATGTATC","561307.5.peg.1353"," 395"
"3837",918,663,255,"AGTGGTAAATGTTGTACACC","TCAGTACCAACTAATGTATC","561307.5.peg.1353"," 395"
"3838",972,663,309,"CCGCAAGTTGCTCCATACTC","TCAGTACCAACTAATGTATC","561307.5.peg.1353"," 395"
"3839",1251,663,588,"CCGTGTCCTTGGTTGCCTGC","TCAGTACCAACTAATGTATC","561307.5.peg.1353"," 395"
"3840",789,663,126,"AGTCGTACACCAATAACCTC","TCAGTACCAACTAATGTATC","561307.5.peg.1353"," 395"
"3841",936,663,273,"ATTGTAGCACGGTCTGCTAG","TCAGTACCAACTAATGTATC","561307.5.peg.1353"," 395"
"3842",333,663,330,"GAAGCTAAATCAACTACGGC","TCAGTACCAACTAATGTATC","561307.5.peg.1353"," 395"
"3843",771,663,108,"TCTGGAATTGGGAAATAAGA","TCAGTACCAACTAATGTATC","561307.5.peg.1353"," 395"
"3844",1001,663,338,"TAAGAGATTCATCATCAACT","TCAGTACCAACTAATGTATC","561307.5.peg.1353"," 395"
"3845",918,771,147,"AGTGGTAAATGTTGTACACC","TCTGGAATTGGGAAATAAGA","561307.5.peg.1353"," 395"
"3846",434,771,337,"AGCTATCCACTTGAACTGAG","TCTGGAATTGGGAAATAAGA","561307.5.peg.1353"," 395"
"3847",570,771,201,"TGAACTATTCCAGTTGCAGG","TCTGGAATTGGGAAATAAGA","561307.5.peg.1353"," 395"
"3848",337,771,434,"AAAGAAGCTAAATCAACTA","TCTGGAATTGGGAAATAAGA","561307.5.peg.1353"," 395"
"3849",1251,771,480,"CCGTGTCCTTGGTTGCCTGC","TCTGGAATTGGGAAATAAGA","561307.5.peg.1353"," 395"
"3850",1001,771,230,"TAAGAGATTCATCATCAACT","TCTGGAATTGGGAAATAAGA","561307.5.peg.1353"," 395"
"3851",936,771,165,"ATTGTAGCACGGTCTGCTAG","TCTGGAATTGGGAAATAAGA","561307.5.peg.1353"," 395"
"3852",663,771,108,"TCAGTACCAACTAATGTATC","TCTGGAATTGGGAAATAAGA","561307.5.peg.1353"," 395"
"3853",405,771,366,"ACTAAATCCACCGGTACTTC","TCTGGAATTGGGAAATAAGA","561307.5.peg.1353"," 395"
"3854",947,771,176,"CCATGTTTGCAATTGTAGCA","TCTGGAATTGGGAAATAAGA","561307.5.peg.1353"," 395"
"3855",333,771,438,"GAAGCTAAATCAACTACGGC","TCTGGAATTGGGAAATAAGA","561307.5.peg.1353"," 395"
"3856",972,771,201,"CCGCAAGTTGCTCCATACTC","TCTGGAATTGGGAAATAAGA","561307.5.peg.1353"," 395"
"3857",573,771,198,"TGGTGAACTATTCCAGTTGC","TCTGGAATTGGGAAATAAGA","561307.5.peg.1353"," 395"
"3858",936,782,154,"ATTGTAGCACGGTCTGCTAG","CACCAATAACCTCTGGAATT","561307.5.peg.1353"," 395"
"3859",972,782,190,"CCGCAAGTTGCTCCATACTC","CACCAATAACCTCTGGAATT","561307.5.peg.1353"," 395"
"3860",570,782,212,"TGAACTATTCCAGTTGCAGG","CACCAATAACCTCTGGAATT","561307.5.peg.1353"," 395"
"3861",405,782,377,"ACTAAATCCACCGGTACTTC","CACCAATAACCTCTGGAATT","561307.5.peg.1353"," 395"
"3862",918,782,136,"AGTGGTAAATGTTGTACACC","CACCAATAACCTCTGGAATT","561307.5.peg.1353"," 395"
"3863",333,782,449,"GAAGCTAAATCAACTACGGC","CACCAATAACCTCTGGAATT","561307.5.peg.1353"," 395"
"3864",434,782,348,"AGCTATCCACTTGAACTGAG","CACCAATAACCTCTGGAATT","561307.5.peg.1353"," 395"
"3865",1251,782,469,"CCGTGTCCTTGGTTGCCTGC","CACCAATAACCTCTGGAATT","561307.5.peg.1353"," 395"
"3866",573,782,209,"TGGTGAACTATTCCAGTTGC","CACCAATAACCTCTGGAATT","561307.5.peg.1353"," 395"
"3867",337,782,445,"AAAGAAGCTAAATCAACTA","CACCAATAACCTCTGGAATT","561307.5.peg.1353"," 395"
"3868",1001,782,219,"TAAGAGATTCATCATCAACT","CACCAATAACCTCTGGAATT","561307.5.peg.1353"," 395"
"3869",947,782,165,"CCATGTTTGCAATTGTAGCA","CACCAATAACCTCTGGAATT","561307.5.peg.1353"," 395"
"3870",663,782,119,"TCAGTACCAACTAATGTATC","CACCAATAACCTCTGGAATT","561307.5.peg.1353"," 395"
"3871",1251,789,462,"CCGTGTCCTTGGTTGCCTGC","AGTCGTACACCAATAACCTC","561307.5.peg.1353"," 395"
"3872",663,789,126,"TCAGTACCAACTAATGTATC","AGTCGTACACCAATAACCTC","561307.5.peg.1353"," 395"
"3873",333,789,456,"GAAGCTAAATCAACTACGGC","AGTCGTACACCAATAACCTC","561307.5.peg.1353"," 395"
"3874",570,789,219,"TGAACTATTCCAGTTGCAGG","AGTCGTACACCAATAACCTC","561307.5.peg.1353"," 395"
"3875",936,789,147,"ATTGTAGCACGGTCTGCTAG","AGTCGTACACCAATAACCTC","561307.5.peg.1353"," 395"
"3876",1001,789,212,"TAAGAGATTCATCATCAACT","AGTCGTACACCAATAACCTC","561307.5.peg.1353"," 395"
"3877",918,789,129,"AGTGGTAAATGTTGTACACC","AGTCGTACACCAATAACCTC","561307.5.peg.1353"," 395"
"3878",573,789,216,"TGGTGAACTATTCCAGTTGC","AGTCGTACACCAATAACCTC","561307.5.peg.1353"," 395"
"3879",434,789,355,"AGCTATCCACTTGAACTGAG","AGTCGTACACCAATAACCTC","561307.5.peg.1353"," 395"
"3880",337,789,452,"AAAGAAGCTAAATCAACTA","AGTCGTACACCAATAACCTC","561307.5.peg.1353"," 395"
"3881",947,789,158,"CCATGTTTGCAATTGTAGCA","AGTCGTACACCAATAACCTC","561307.5.peg.1353"," 395"
"3882",972,789,183,"CCGCAAGTTGCTCCATACTC","AGTCGTACACCAATAACCTC","561307.5.peg.1353"," 395"
"3883",405,789,384,"ACTAAATCCACCGGTACTTC","AGTCGTACACCAATAACCTC","561307.5.peg.1353"," 395"
"3884",333,825,492,"GAAGCTAAATCAACTACGGC","TCAGTTGCTGTTGCGCCTTG","561307.5.peg.1353"," 395"
"3885",663,825,162,"TCAGTACCAACTAATGTATC","TCAGTTGCTGTTGCGCCTTG","561307.5.peg.1353"," 395"
"3886",434,825,391,"AGCTATCCACTTGAACTGAG","TCAGTTGCTGTTGCGCCTTG","561307.5.peg.1353"," 395"
"3887",972,825,147,"CCGCAAGTTGCTCCATACTC","TCAGTTGCTGTTGCGCCTTG","561307.5.peg.1353"," 395"
"3888",1251,825,426,"CCGTGTCCTTGGTTGCCTGC","TCAGTTGCTGTTGCGCCTTG","561307.5.peg.1353"," 395"
"3889",936,825,111,"ATTGTAGCACGGTCTGCTAG","TCAGTTGCTGTTGCGCCTTG","561307.5.peg.1353"," 395"
"3890",405,825,420,"ACTAAATCCACCGGTACTTC","TCAGTTGCTGTTGCGCCTTG","561307.5.peg.1353"," 395"
"3891",947,825,122,"CCATGTTTGCAATTGTAGCA","TCAGTTGCTGTTGCGCCTTG","561307.5.peg.1353"," 395"
"3892",573,825,252,"TGGTGAACTATTCCAGTTGC","TCAGTTGCTGTTGCGCCTTG","561307.5.peg.1353"," 395"
"3893",1001,825,176,"TAAGAGATTCATCATCAACT","TCAGTTGCTGTTGCGCCTTG","561307.5.peg.1353"," 395"
"3894",570,825,255,"TGAACTATTCCAGTTGCAGG","TCAGTTGCTGTTGCGCCTTG","561307.5.peg.1353"," 395"
"3895",337,825,488,"AAAGAAGCTAAATCAACTA","TCAGTTGCTGTTGCGCCTTG","561307.5.peg.1353"," 395"
"3896",771,918,147,"TCTGGAATTGGGAAATAAGA","AGTGGTAAATGTTGTACACC","561307.5.peg.1353"," 395"
"3897",789,918,129,"AGTCGTACACCAATAACCTC","AGTGGTAAATGTTGTACACC","561307.5.peg.1353"," 395"
"3898",333,918,585,"GAAGCTAAATCAACTACGGC","AGTGGTAAATGTTGTACACC","561307.5.peg.1353"," 395"
"3899",573,918,345,"TGGTGAACTATTCCAGTTGC","AGTGGTAAATGTTGTACACC","561307.5.peg.1353"," 395"
"3900",570,918,348,"TGAACTATTCCAGTTGCAGG","AGTGGTAAATGTTGTACACC","561307.5.peg.1353"," 395"
"3901",1251,918,333,"CCGTGTCCTTGGTTGCCTGC","AGTGGTAAATGTTGTACACC","561307.5.peg.1353"," 395"
"3902",434,918,484,"AGCTATCCACTTGAACTGAG","AGTGGTAAATGTTGTACACC","561307.5.peg.1353"," 395"
"3903",663,918,255,"TCAGTACCAACTAATGTATC","AGTGGTAAATGTTGTACACC","561307.5.peg.1353"," 395"
"3904",782,918,136,"CACCAATAACCTCTGGAATT","AGTGGTAAATGTTGTACACC","561307.5.peg.1353"," 395"
"3905",337,918,581,"AAAGAAGCTAAATCAACTA","AGTGGTAAATGTTGTACACC","561307.5.peg.1353"," 395"
"3906",405,918,513,"ACTAAATCCACCGGTACTTC","AGTGGTAAATGTTGTACACC","561307.5.peg.1353"," 395"
"3907",434,936,502,"AGCTATCCACTTGAACTGAG","ATTGTAGCACGGTCTGCTAG","561307.5.peg.1353"," 395"
"3908",333,936,603,"GAAGCTAAATCAACTACGGC","ATTGTAGCACGGTCTGCTAG","561307.5.peg.1353"," 395"
"3909",573,936,363,"TGGTGAACTATTCCAGTTGC","ATTGTAGCACGGTCTGCTAG","561307.5.peg.1353"," 395"
"3910",405,936,531,"ACTAAATCCACCGGTACTTC","ATTGTAGCACGGTCTGCTAG","561307.5.peg.1353"," 395"
"3911",789,936,147,"AGTCGTACACCAATAACCTC","ATTGTAGCACGGTCTGCTAG","561307.5.peg.1353"," 395"
"3912",570,936,366,"TGAACTATTCCAGTTGCAGG","ATTGTAGCACGGTCTGCTAG","561307.5.peg.1353"," 395"
"3913",663,936,273,"TCAGTACCAACTAATGTATC","ATTGTAGCACGGTCTGCTAG","561307.5.peg.1353"," 395"
"3914",337,936,599,"AAAGAAGCTAAATCAACTA","ATTGTAGCACGGTCTGCTAG","561307.5.peg.1353"," 395"
"3915",771,936,165,"TCTGGAATTGGGAAATAAGA","ATTGTAGCACGGTCTGCTAG","561307.5.peg.1353"," 395"
"3916",825,936,111,"TCAGTTGCTGTTGCGCCTTG","ATTGTAGCACGGTCTGCTAG","561307.5.peg.1353"," 395"
"3917",782,936,154,"CACCAATAACCTCTGGAATT","ATTGTAGCACGGTCTGCTAG","561307.5.peg.1353"," 395"
"3918",1251,936,315,"CCGTGTCCTTGGTTGCCTGC","ATTGTAGCACGGTCTGCTAG","561307.5.peg.1353"," 395"
"3919",434,947,513,"AGCTATCCACTTGAACTGAG","CCATGTTTGCAATTGTAGCA","561307.5.peg.1353"," 395"
"3920",782,947,165,"CACCAATAACCTCTGGAATT","CCATGTTTGCAATTGTAGCA","561307.5.peg.1353"," 395"
"3921",1251,947,304,"CCGTGTCCTTGGTTGCCTGC","CCATGTTTGCAATTGTAGCA","561307.5.peg.1353"," 395"
"3922",570,947,377,"TGAACTATTCCAGTTGCAGG","CCATGTTTGCAATTGTAGCA","561307.5.peg.1353"," 395"
"3923",825,947,122,"TCAGTTGCTGTTGCGCCTTG","CCATGTTTGCAATTGTAGCA","561307.5.peg.1353"," 395"
"3924",337,947,610,"AAAGAAGCTAAATCAACTA","CCATGTTTGCAATTGTAGCA","561307.5.peg.1353"," 395"
"3925",771,947,176,"TCTGGAATTGGGAAATAAGA","CCATGTTTGCAATTGTAGCA","561307.5.peg.1353"," 395"
"3926",663,947,284,"TCAGTACCAACTAATGTATC","CCATGTTTGCAATTGTAGCA","561307.5.peg.1353"," 395"
"3927",405,947,542,"ACTAAATCCACCGGTACTTC","CCATGTTTGCAATTGTAGCA","561307.5.peg.1353"," 395"
"3928",789,947,158,"AGTCGTACACCAATAACCTC","CCATGTTTGCAATTGTAGCA","561307.5.peg.1353"," 395"
"3929",573,947,374,"TGGTGAACTATTCCAGTTGC","CCATGTTTGCAATTGTAGCA","561307.5.peg.1353"," 395"
"3930",333,947,614,"GAAGCTAAATCAACTACGGC","CCATGTTTGCAATTGTAGCA","561307.5.peg.1353"," 395"
"3931",663,972,309,"TCAGTACCAACTAATGTATC","CCGCAAGTTGCTCCATACTC","561307.5.peg.1353"," 395"
"3932",434,972,538,"AGCTATCCACTTGAACTGAG","CCGCAAGTTGCTCCATACTC","561307.5.peg.1353"," 395"
"3933",782,972,190,"CACCAATAACCTCTGGAATT","CCGCAAGTTGCTCCATACTC","561307.5.peg.1353"," 395"
"3934",771,972,201,"TCTGGAATTGGGAAATAAGA","CCGCAAGTTGCTCCATACTC","561307.5.peg.1353"," 395"
"3935",1251,972,279,"CCGTGTCCTTGGTTGCCTGC","CCGCAAGTTGCTCCATACTC","561307.5.peg.1353"," 395"
"3936",789,972,183,"AGTCGTACACCAATAACCTC","CCGCAAGTTGCTCCATACTC","561307.5.peg.1353"," 395"
"3937",405,972,567,"ACTAAATCCACCGGTACTTC","CCGCAAGTTGCTCCATACTC","561307.5.peg.1353"," 395"
"3938",570,972,402,"TGAACTATTCCAGTTGCAGG","CCGCAAGTTGCTCCATACTC","561307.5.peg.1353"," 395"
"3939",825,972,147,"TCAGTTGCTGTTGCGCCTTG","CCGCAAGTTGCTCCATACTC","561307.5.peg.1353"," 395"
"3940",573,972,399,"TGGTGAACTATTCCAGTTGC","CCGCAAGTTGCTCCATACTC","561307.5.peg.1353"," 395"
"3941",337,972,635,"AAAGAAGCTAAATCAACTA","CCGCAAGTTGCTCCATACTC","561307.5.peg.1353"," 395"
"3942",333,972,639,"GAAGCTAAATCAACTACGGC","CCGCAAGTTGCTCCATACTC","561307.5.peg.1353"," 395"
"3943",405,1001,596,"ACTAAATCCACCGGTACTTC","TAAGAGATTCATCATCAACT","561307.5.peg.1353"," 395"
"3944",573,1001,428,"TGGTGAACTATTCCAGTTGC","TAAGAGATTCATCATCAACT","561307.5.peg.1353"," 395"
"3945",1251,1001,250,"CCGTGTCCTTGGTTGCCTGC","TAAGAGATTCATCATCAACT","561307.5.peg.1353"," 395"
"3946",333,1001,668,"GAAGCTAAATCAACTACGGC","TAAGAGATTCATCATCAACT","561307.5.peg.1353"," 395"
"3947",782,1001,219,"CACCAATAACCTCTGGAATT","TAAGAGATTCATCATCAACT","561307.5.peg.1353"," 395"
"3948",825,1001,176,"TCAGTTGCTGTTGCGCCTTG","TAAGAGATTCATCATCAACT","561307.5.peg.1353"," 395"
"3949",771,1001,230,"TCTGGAATTGGGAAATAAGA","TAAGAGATTCATCATCAACT","561307.5.peg.1353"," 395"
"3950",570,1001,431,"TGAACTATTCCAGTTGCAGG","TAAGAGATTCATCATCAACT","561307.5.peg.1353"," 395"
"3951",434,1001,567,"AGCTATCCACTTGAACTGAG","TAAGAGATTCATCATCAACT","561307.5.peg.1353"," 395"
"3952",663,1001,338,"TCAGTACCAACTAATGTATC","TAAGAGATTCATCATCAACT","561307.5.peg.1353"," 395"
"3953",789,1001,212,"AGTCGTACACCAATAACCTC","TAAGAGATTCATCATCAACT","561307.5.peg.1353"," 395"
"3954",337,1001,664,"AAAGAAGCTAAATCAACTA","TAAGAGATTCATCATCAACT","561307.5.peg.1353"," 395"
"3955",947,1251,304,"CCATGTTTGCAATTGTAGCA","CCGTGTCCTTGGTTGCCTGC","561307.5.peg.1353"," 395"
"3956",570,1251,681,"TGAACTATTCCAGTTGCAGG","CCGTGTCCTTGGTTGCCTGC","561307.5.peg.1353"," 395"
"3957",825,1251,426,"TCAGTTGCTGTTGCGCCTTG","CCGTGTCCTTGGTTGCCTGC","561307.5.peg.1353"," 395"
"3958",789,1251,462,"AGTCGTACACCAATAACCTC","CCGTGTCCTTGGTTGCCTGC","561307.5.peg.1353"," 395"
"3959",918,1251,333,"AGTGGTAAATGTTGTACACC","CCGTGTCCTTGGTTGCCTGC","561307.5.peg.1353"," 395"
"3960",663,1251,588,"TCAGTACCAACTAATGTATC","CCGTGTCCTTGGTTGCCTGC","561307.5.peg.1353"," 395"
"3961",333,1251,918,"GAAGCTAAATCAACTACGGC","CCGTGTCCTTGGTTGCCTGC","561307.5.peg.1353"," 395"
"3962",434,1251,817,"AGCTATCCACTTGAACTGAG","CCGTGTCCTTGGTTGCCTGC","561307.5.peg.1353"," 395"
"3963",573,1251,678,"TGGTGAACTATTCCAGTTGC","CCGTGTCCTTGGTTGCCTGC","561307.5.peg.1353"," 395"
"3964",1001,1251,250,"TAAGAGATTCATCATCAACT","CCGTGTCCTTGGTTGCCTGC","561307.5.peg.1353"," 395"
"3965",972,1251,279,"CCGCAAGTTGCTCCATACTC","CCGTGTCCTTGGTTGCCTGC","561307.5.peg.1353"," 395"
"3966",337,1251,914,"AAAGAAGCTAAATCAACTA","CCGTGTCCTTGGTTGCCTGC","561307.5.peg.1353"," 395"
"3967",782,1251,469,"CACCAATAACCTCTGGAATT","CCGTGTCCTTGGTTGCCTGC","561307.5.peg.1353"," 395"
"3968",936,1251,315,"ATTGTAGCACGGTCTGCTAG","CCGTGTCCTTGGTTGCCTGC","561307.5.peg.1353"," 395"
"3969",405,1251,846,"ACTAAATCCACCGGTACTTC","CCGTGTCCTTGGTTGCCTGC","561307.5.peg.1353"," 395"
"3970",771,1251,480,"TCTGGAATTGGGAAATAAGA","CCGTGTCCTTGGTTGCCTGC","561307.5.peg.1353"," 395"
"3971",158,12,146,"GACTAAATCCTTGCTTGAGT","ATTTATTACAGAATGGGAGT","561307.5.peg.1355"," 397"
"3972",12,158,146,"ATTTATTACAGAATGGGAGT","GACTAAATCCTTGCTTGAGT","561307.5.peg.1355"," 397"
"3973",201,98,103,"AATGTTACCAAGAATCCTGC","TTCCAATTACGAATCCACTT","561307.5.peg.1356"," 398"
"3974",260,98,162,"CGTGAACTTGTAACCATAAA","TTCCAATTACGAATCCACTT","561307.5.peg.1356"," 398"
"3975",98,201,103,"TTCCAATTACGAATCCACTT","AATGTTACCAAGAATCCTGC","561307.5.peg.1356"," 398"
"3976",98,260,162,"TTCCAATTACGAATCCACTT","CGTGAACTTGTAACCATAAA","561307.5.peg.1356"," 398"
"3977",199,9,190,"ACCATTCAATACTTCATCGA","AACGAACGTACGTTTGCAGG","561307.5.peg.1357"," 399"
"3978",321,9,312,"GTAAAGATAACTTCGACTGT","AACGAACGTACGTTTGCAGG","561307.5.peg.1357"," 399"
"3979",129,9,120,"GTTGATCCAATATACATACC","AACGAACGTACGTTTGCAGG","561307.5.peg.1357"," 399"
"3980",294,9,285,"CCTGATTTATGTATACCTGT","AACGAACGTACGTTTGCAGG","561307.5.peg.1357"," 399"
"3981",321,129,192,"GTAAAGATAACTTCGACTGT","GTTGATCCAATATACATACC","561307.5.peg.1357"," 399"
"3982",9,129,120,"AACGAACGTACGTTTGCAGG","GTTGATCCAATATACATACC","561307.5.peg.1357"," 399"
"3983",294,129,165,"CCTGATTTATGTATACCTGT","GTTGATCCAATATACATACC","561307.5.peg.1357"," 399"
"3984",9,199,190,"AACGAACGTACGTTTGCAGG","ACCATTCAATACTTCATCGA","561307.5.peg.1357"," 399"
"3985",321,199,122,"GTAAAGATAACTTCGACTGT","ACCATTCAATACTTCATCGA","561307.5.peg.1357"," 399"
"3986",9,294,285,"AACGAACGTACGTTTGCAGG","CCTGATTTATGTATACCTGT","561307.5.peg.1357"," 399"
"3987",129,294,165,"GTTGATCCAATATACATACC","CCTGATTTATGTATACCTGT","561307.5.peg.1357"," 399"
"3988",9,321,312,"AACGAACGTACGTTTGCAGG","GTAAAGATAACTTCGACTGT","561307.5.peg.1357"," 399"
"3989",129,321,192,"GTTGATCCAATATACATACC","GTAAAGATAACTTCGACTGT","561307.5.peg.1357"," 399"
"3990",199,321,122,"ACCATTCAATACTTCATCGA","GTAAAGATAACTTCGACTGT","561307.5.peg.1357"," 399"
"3991",144,8,136,"TTTAAACCATCACGAACATC","AATGATCAATTTGATGAGG","561307.5.peg.1358"," 400"
"3992",519,8,511,"GTAAGTTAGGAAATCTTGA","AATGATCAATTTGATGAGG","561307.5.peg.1358"," 400"
"3993",387,8,379,"GTGTAACGCATTGCCGCTGG","AATGATCAATTTGATGAGG","561307.5.peg.1358"," 400"
"3994",276,8,268,"TACACTGAGGAGTCTCCATG","AATGATCAATTTGATGAGG","561307.5.peg.1358"," 400"
"3995",693,8,685,"CCTTGAATAATACCACCAGT","AATGATCAATTTGATGAGG","561307.5.peg.1358"," 400"
"3996",311,8,303,"ACTTCCAGTCTTGACTTAAA","AATGATCAATTTGATGAGG","561307.5.peg.1358"," 400"
"3997",390,8,382,"TCAGTGTAACGCATTGCCGC","AATGATCAATTTGATGAGG","561307.5.peg.1358"," 400"
"3998",642,8,634,"ATTGATTGACTGTAATATC","AATGATCAATTTGATGAGG","561307.5.peg.1358"," 400"
"3999",1109,8,1101,"ATTTGCAACAACCTCAATT","AATGATCAATTTGATGAGG","561307.5.peg.1358"," 400"
"4000",507,8,499,"AATCTTGATGGCAATACCAT","AATGATCAATTTGATGAGG","561307.5.peg.1358"," 400"
"4001",531,8,523,"GAACCATTCACTAGTAAGTT","AATGATCAATTTGATGAGG","561307.5.peg.1358"," 400"
"4002",591,8,583,"TCACTTCAGCTAAATTATG","AATGATCAATTTGATGAGG","561307.5.peg.1358"," 400"
"4003",289,8,281,"GACCATTGCTTCGTACACTG","AATGATCAATTTGATGAGG","561307.5.peg.1358"," 400"
"4004",480,8,472,"AGTGTCGTATCATCATAGTT","AATGATCAATTTGATGAGG","561307.5.peg.1358"," 400"
"4005",519,144,375,"GTAAGTTAGGAAATCTTGA","TTTAAACCATCACGAACATC","561307.5.peg.1358"," 400"
"4006",591,144,447,"TCACTTCAGCTAAATTATG","TTTAAACCATCACGAACATC","561307.5.peg.1358"," 400"
"4007",387,144,243,"GTGTAACGCATTGCCGCTGG","TTTAAACCATCACGAACATC","561307.5.peg.1358"," 400"
"4008",693,144,549,"CCTTGAATAATACCACCAGT","TTTAAACCATCACGAACATC","561307.5.peg.1358"," 400"
"4009",1109,144,965,"ATTTGCAACAACCTCAATT","TTTAAACCATCACGAACATC","561307.5.peg.1358"," 400"
"4010",642,144,498,"ATTGATTGACTGTAATATC","TTTAAACCATCACGAACATC","561307.5.peg.1358"," 400"
"4011",311,144,167,"ACTTCCAGTCTTGACTTAAA","TTTAAACCATCACGAACATC","561307.5.peg.1358"," 400"
"4012",289,144,145,"GACCATTGCTTCGTACACTG","TTTAAACCATCACGAACATC","561307.5.peg.1358"," 400"
"4013",8,144,136,"AATGATCAATTTGATGAGG","TTTAAACCATCACGAACATC","561307.5.peg.1358"," 400"
"4014",531,144,387,"GAACCATTCACTAGTAAGTT","TTTAAACCATCACGAACATC","561307.5.peg.1358"," 400"
"4015",480,144,336,"AGTGTCGTATCATCATAGTT","TTTAAACCATCACGAACATC","561307.5.peg.1358"," 400"
"4016",507,144,363,"AATCTTGATGGCAATACCAT","TTTAAACCATCACGAACATC","561307.5.peg.1358"," 400"
"4017",276,144,132,"TACACTGAGGAGTCTCCATG","TTTAAACCATCACGAACATC","561307.5.peg.1358"," 400"
"4018",390,144,246,"TCAGTGTAACGCATTGCCGC","TTTAAACCATCACGAACATC","561307.5.peg.1358"," 400"
"4019",8,276,268,"AATGATCAATTTGATGAGG","TACACTGAGGAGTCTCCATG","561307.5.peg.1358"," 400"
"4020",591,276,315,"TCACTTCAGCTAAATTATG","TACACTGAGGAGTCTCCATG","561307.5.peg.1358"," 400"
"4021",693,276,417,"CCTTGAATAATACCACCAGT","TACACTGAGGAGTCTCCATG","561307.5.peg.1358"," 400"
"4022",390,276,114,"TCAGTGTAACGCATTGCCGC","TACACTGAGGAGTCTCCATG","561307.5.peg.1358"," 400"
"4023",480,276,204,"AGTGTCGTATCATCATAGTT","TACACTGAGGAGTCTCCATG","561307.5.peg.1358"," 400"
"4024",1109,276,833,"ATTTGCAACAACCTCAATT","TACACTGAGGAGTCTCCATG","561307.5.peg.1358"," 400"
"4025",642,276,366,"ATTGATTGACTGTAATATC","TACACTGAGGAGTCTCCATG","561307.5.peg.1358"," 400"
"4026",519,276,243,"GTAAGTTAGGAAATCTTGA","TACACTGAGGAGTCTCCATG","561307.5.peg.1358"," 400"
"4027",387,276,111,"GTGTAACGCATTGCCGCTGG","TACACTGAGGAGTCTCCATG","561307.5.peg.1358"," 400"
"4028",144,276,132,"TTTAAACCATCACGAACATC","TACACTGAGGAGTCTCCATG","561307.5.peg.1358"," 400"
"4029",507,276,231,"AATCTTGATGGCAATACCAT","TACACTGAGGAGTCTCCATG","561307.5.peg.1358"," 400"
"4030",531,276,255,"GAACCATTCACTAGTAAGTT","TACACTGAGGAGTCTCCATG","561307.5.peg.1358"," 400"
"4031",531,289,242,"GAACCATTCACTAGTAAGTT","GACCATTGCTTCGTACACTG","561307.5.peg.1358"," 400"
"4032",480,289,191,"AGTGTCGTATCATCATAGTT","GACCATTGCTTCGTACACTG","561307.5.peg.1358"," 400"
"4033",1109,289,820,"ATTTGCAACAACCTCAATT","GACCATTGCTTCGTACACTG","561307.5.peg.1358"," 400"
"4034",507,289,218,"AATCTTGATGGCAATACCAT","GACCATTGCTTCGTACACTG","561307.5.peg.1358"," 400"
"4035",519,289,230,"GTAAGTTAGGAAATCTTGA","GACCATTGCTTCGTACACTG","561307.5.peg.1358"," 400"
"4036",144,289,145,"TTTAAACCATCACGAACATC","GACCATTGCTTCGTACACTG","561307.5.peg.1358"," 400"
"4037",8,289,281,"AATGATCAATTTGATGAGG","GACCATTGCTTCGTACACTG","561307.5.peg.1358"," 400"
"4038",693,289,404,"CCTTGAATAATACCACCAGT","GACCATTGCTTCGTACACTG","561307.5.peg.1358"," 400"
"4039",642,289,353,"ATTGATTGACTGTAATATC","GACCATTGCTTCGTACACTG","561307.5.peg.1358"," 400"
"4040",390,289,101,"TCAGTGTAACGCATTGCCGC","GACCATTGCTTCGTACACTG","561307.5.peg.1358"," 400"
"4041",591,289,302,"TCACTTCAGCTAAATTATG","GACCATTGCTTCGTACACTG","561307.5.peg.1358"," 400"
"4042",1109,311,798,"ATTTGCAACAACCTCAATT","ACTTCCAGTCTTGACTTAAA","561307.5.peg.1358"," 400"
"4043",8,311,303,"AATGATCAATTTGATGAGG","ACTTCCAGTCTTGACTTAAA","561307.5.peg.1358"," 400"
"4044",693,311,382,"CCTTGAATAATACCACCAGT","ACTTCCAGTCTTGACTTAAA","561307.5.peg.1358"," 400"
"4045",144,311,167,"TTTAAACCATCACGAACATC","ACTTCCAGTCTTGACTTAAA","561307.5.peg.1358"," 400"
"4046",642,311,331,"ATTGATTGACTGTAATATC","ACTTCCAGTCTTGACTTAAA","561307.5.peg.1358"," 400"
"4047",591,311,280,"TCACTTCAGCTAAATTATG","ACTTCCAGTCTTGACTTAAA","561307.5.peg.1358"," 400"
"4048",531,311,220,"GAACCATTCACTAGTAAGTT","ACTTCCAGTCTTGACTTAAA","561307.5.peg.1358"," 400"
"4049",480,311,169,"AGTGTCGTATCATCATAGTT","ACTTCCAGTCTTGACTTAAA","561307.5.peg.1358"," 400"
"4050",507,311,196,"AATCTTGATGGCAATACCAT","ACTTCCAGTCTTGACTTAAA","561307.5.peg.1358"," 400"
"4051",519,311,208,"GTAAGTTAGGAAATCTTGA","ACTTCCAGTCTTGACTTAAA","561307.5.peg.1358"," 400"
"4052",642,387,255,"ATTGATTGACTGTAATATC","GTGTAACGCATTGCCGCTGG","561307.5.peg.1358"," 400"
"4053",8,387,379,"AATGATCAATTTGATGAGG","GTGTAACGCATTGCCGCTGG","561307.5.peg.1358"," 400"
"4054",276,387,111,"TACACTGAGGAGTCTCCATG","GTGTAACGCATTGCCGCTGG","561307.5.peg.1358"," 400"
"4055",507,387,120,"AATCTTGATGGCAATACCAT","GTGTAACGCATTGCCGCTGG","561307.5.peg.1358"," 400"
"4056",519,387,132,"GTAAGTTAGGAAATCTTGA","GTGTAACGCATTGCCGCTGG","561307.5.peg.1358"," 400"
"4057",144,387,243,"TTTAAACCATCACGAACATC","GTGTAACGCATTGCCGCTGG","561307.5.peg.1358"," 400"
"4058",693,387,306,"CCTTGAATAATACCACCAGT","GTGTAACGCATTGCCGCTGG","561307.5.peg.1358"," 400"
"4059",591,387,204,"TCACTTCAGCTAAATTATG","GTGTAACGCATTGCCGCTGG","561307.5.peg.1358"," 400"
"4060",1109,387,722,"ATTTGCAACAACCTCAATT","GTGTAACGCATTGCCGCTGG","561307.5.peg.1358"," 400"
"4061",531,387,144,"GAACCATTCACTAGTAAGTT","GTGTAACGCATTGCCGCTGG","561307.5.peg.1358"," 400"
"4062",507,390,117,"AATCTTGATGGCAATACCAT","TCAGTGTAACGCATTGCCGC","561307.5.peg.1358"," 400"
"4063",276,390,114,"TACACTGAGGAGTCTCCATG","TCAGTGTAACGCATTGCCGC","561307.5.peg.1358"," 400"
"4064",289,390,101,"GACCATTGCTTCGTACACTG","TCAGTGTAACGCATTGCCGC","561307.5.peg.1358"," 400"
"4065",531,390,141,"GAACCATTCACTAGTAAGTT","TCAGTGTAACGCATTGCCGC","561307.5.peg.1358"," 400"
"4066",1109,390,719,"ATTTGCAACAACCTCAATT","TCAGTGTAACGCATTGCCGC","561307.5.peg.1358"," 400"
"4067",519,390,129,"GTAAGTTAGGAAATCTTGA","TCAGTGTAACGCATTGCCGC","561307.5.peg.1358"," 400"
"4068",144,390,246,"TTTAAACCATCACGAACATC","TCAGTGTAACGCATTGCCGC","561307.5.peg.1358"," 400"
"4069",591,390,201,"TCACTTCAGCTAAATTATG","TCAGTGTAACGCATTGCCGC","561307.5.peg.1358"," 400"
"4070",642,390,252,"ATTGATTGACTGTAATATC","TCAGTGTAACGCATTGCCGC","561307.5.peg.1358"," 400"
"4071",693,390,303,"CCTTGAATAATACCACCAGT","TCAGTGTAACGCATTGCCGC","561307.5.peg.1358"," 400"
"4072",8,390,382,"AATGATCAATTTGATGAGG","TCAGTGTAACGCATTGCCGC","561307.5.peg.1358"," 400"
"4073",311,480,169,"ACTTCCAGTCTTGACTTAAA","AGTGTCGTATCATCATAGTT","561307.5.peg.1358"," 400"
"4074",276,480,204,"TACACTGAGGAGTCTCCATG","AGTGTCGTATCATCATAGTT","561307.5.peg.1358"," 400"
"4075",642,480,162,"ATTGATTGACTGTAATATC","AGTGTCGTATCATCATAGTT","561307.5.peg.1358"," 400"
"4076",8,480,472,"AATGATCAATTTGATGAGG","AGTGTCGTATCATCATAGTT","561307.5.peg.1358"," 400"
"4077",1109,480,629,"ATTTGCAACAACCTCAATT","AGTGTCGTATCATCATAGTT","561307.5.peg.1358"," 400"
"4078",144,480,336,"TTTAAACCATCACGAACATC","AGTGTCGTATCATCATAGTT","561307.5.peg.1358"," 400"
"4079",289,480,191,"GACCATTGCTTCGTACACTG","AGTGTCGTATCATCATAGTT","561307.5.peg.1358"," 400"
"4080",693,480,213,"CCTTGAATAATACCACCAGT","AGTGTCGTATCATCATAGTT","561307.5.peg.1358"," 400"
"4081",591,480,111,"TCACTTCAGCTAAATTATG","AGTGTCGTATCATCATAGTT","561307.5.peg.1358"," 400"
"4082",642,507,135,"ATTGATTGACTGTAATATC","AATCTTGATGGCAATACCAT","561307.5.peg.1358"," 400"
"4083",387,507,120,"GTGTAACGCATTGCCGCTGG","AATCTTGATGGCAATACCAT","561307.5.peg.1358"," 400"
"4084",144,507,363,"TTTAAACCATCACGAACATC","AATCTTGATGGCAATACCAT","561307.5.peg.1358"," 400"
"4085",8,507,499,"AATGATCAATTTGATGAGG","AATCTTGATGGCAATACCAT","561307.5.peg.1358"," 400"
"4086",311,507,196,"ACTTCCAGTCTTGACTTAAA","AATCTTGATGGCAATACCAT","561307.5.peg.1358"," 400"
"4087",1109,507,602,"ATTTGCAACAACCTCAATT","AATCTTGATGGCAATACCAT","561307.5.peg.1358"," 400"
"4088",390,507,117,"TCAGTGTAACGCATTGCCGC","AATCTTGATGGCAATACCAT","561307.5.peg.1358"," 400"
"4089",289,507,218,"GACCATTGCTTCGTACACTG","AATCTTGATGGCAATACCAT","561307.5.peg.1358"," 400"
"4090",276,507,231,"TACACTGAGGAGTCTCCATG","AATCTTGATGGCAATACCAT","561307.5.peg.1358"," 400"
"4091",693,507,186,"CCTTGAATAATACCACCAGT","AATCTTGATGGCAATACCAT","561307.5.peg.1358"," 400"
"4092",144,519,375,"TTTAAACCATCACGAACATC","GTAAGTTAGGAAATCTTGA","561307.5.peg.1358"," 400"
"4093",1109,519,590,"ATTTGCAACAACCTCAATT","GTAAGTTAGGAAATCTTGA","561307.5.peg.1358"," 400"
"4094",289,519,230,"GACCATTGCTTCGTACACTG","GTAAGTTAGGAAATCTTGA","561307.5.peg.1358"," 400"
"4095",642,519,123,"ATTGATTGACTGTAATATC","GTAAGTTAGGAAATCTTGA","561307.5.peg.1358"," 400"
"4096",390,519,129,"TCAGTGTAACGCATTGCCGC","GTAAGTTAGGAAATCTTGA","561307.5.peg.1358"," 400"
"4097",387,519,132,"GTGTAACGCATTGCCGCTGG","GTAAGTTAGGAAATCTTGA","561307.5.peg.1358"," 400"
"4098",276,519,243,"TACACTGAGGAGTCTCCATG","GTAAGTTAGGAAATCTTGA","561307.5.peg.1358"," 400"
"4099",693,519,174,"CCTTGAATAATACCACCAGT","GTAAGTTAGGAAATCTTGA","561307.5.peg.1358"," 400"
"4100",311,519,208,"ACTTCCAGTCTTGACTTAAA","GTAAGTTAGGAAATCTTGA","561307.5.peg.1358"," 400"
"4101",8,519,511,"AATGATCAATTTGATGAGG","GTAAGTTAGGAAATCTTGA","561307.5.peg.1358"," 400"
"4102",1109,531,578,"ATTTGCAACAACCTCAATT","GAACCATTCACTAGTAAGTT","561307.5.peg.1358"," 400"
"4103",289,531,242,"GACCATTGCTTCGTACACTG","GAACCATTCACTAGTAAGTT","561307.5.peg.1358"," 400"
"4104",642,531,111,"ATTGATTGACTGTAATATC","GAACCATTCACTAGTAAGTT","561307.5.peg.1358"," 400"
"4105",387,531,144,"GTGTAACGCATTGCCGCTGG","GAACCATTCACTAGTAAGTT","561307.5.peg.1358"," 400"
"4106",390,531,141,"TCAGTGTAACGCATTGCCGC","GAACCATTCACTAGTAAGTT","561307.5.peg.1358"," 400"
"4107",693,531,162,"CCTTGAATAATACCACCAGT","GAACCATTCACTAGTAAGTT","561307.5.peg.1358"," 400"
"4108",276,531,255,"TACACTGAGGAGTCTCCATG","GAACCATTCACTAGTAAGTT","561307.5.peg.1358"," 400"
"4109",144,531,387,"TTTAAACCATCACGAACATC","GAACCATTCACTAGTAAGTT","561307.5.peg.1358"," 400"
"4110",8,531,523,"AATGATCAATTTGATGAGG","GAACCATTCACTAGTAAGTT","561307.5.peg.1358"," 400"
"4111",311,531,220,"ACTTCCAGTCTTGACTTAAA","GAACCATTCACTAGTAAGTT","561307.5.peg.1358"," 400"
"4112",693,591,102,"CCTTGAATAATACCACCAGT","TCACTTCAGCTAAATTATG","561307.5.peg.1358"," 400"
"4113",1109,591,518,"ATTTGCAACAACCTCAATT","TCACTTCAGCTAAATTATG","561307.5.peg.1358"," 400"
"4114",387,591,204,"GTGTAACGCATTGCCGCTGG","TCACTTCAGCTAAATTATG","561307.5.peg.1358"," 400"
"4115",311,591,280,"ACTTCCAGTCTTGACTTAAA","TCACTTCAGCTAAATTATG","561307.5.peg.1358"," 400"
"4116",390,591,201,"TCAGTGTAACGCATTGCCGC","TCACTTCAGCTAAATTATG","561307.5.peg.1358"," 400"
"4117",8,591,583,"AATGATCAATTTGATGAGG","TCACTTCAGCTAAATTATG","561307.5.peg.1358"," 400"
"4118",276,591,315,"TACACTGAGGAGTCTCCATG","TCACTTCAGCTAAATTATG","561307.5.peg.1358"," 400"
"4119",480,591,111,"AGTGTCGTATCATCATAGTT","TCACTTCAGCTAAATTATG","561307.5.peg.1358"," 400"
"4120",289,591,302,"GACCATTGCTTCGTACACTG","TCACTTCAGCTAAATTATG","561307.5.peg.1358"," 400"
"4121",144,591,447,"TTTAAACCATCACGAACATC","TCACTTCAGCTAAATTATG","561307.5.peg.1358"," 400"
"4122",276,642,366,"TACACTGAGGAGTCTCCATG","ATTGATTGACTGTAATATC","561307.5.peg.1358"," 400"
"4123",144,642,498,"TTTAAACCATCACGAACATC","ATTGATTGACTGTAATATC","561307.5.peg.1358"," 400"
"4124",480,642,162,"AGTGTCGTATCATCATAGTT","ATTGATTGACTGTAATATC","561307.5.peg.1358"," 400"
"4125",289,642,353,"GACCATTGCTTCGTACACTG","ATTGATTGACTGTAATATC","561307.5.peg.1358"," 400"
"4126",531,642,111,"GAACCATTCACTAGTAAGTT","ATTGATTGACTGTAATATC","561307.5.peg.1358"," 400"
"4127",507,642,135,"AATCTTGATGGCAATACCAT","ATTGATTGACTGTAATATC","561307.5.peg.1358"," 400"
"4128",519,642,123,"GTAAGTTAGGAAATCTTGA","ATTGATTGACTGTAATATC","561307.5.peg.1358"," 400"
"4129",311,642,331,"ACTTCCAGTCTTGACTTAAA","ATTGATTGACTGTAATATC","561307.5.peg.1358"," 400"
"4130",387,642,255,"GTGTAACGCATTGCCGCTGG","ATTGATTGACTGTAATATC","561307.5.peg.1358"," 400"
"4131",390,642,252,"TCAGTGTAACGCATTGCCGC","ATTGATTGACTGTAATATC","561307.5.peg.1358"," 400"
"4132",1109,642,467,"ATTTGCAACAACCTCAATT","ATTGATTGACTGTAATATC","561307.5.peg.1358"," 400"
"4133",8,642,634,"AATGATCAATTTGATGAGG","ATTGATTGACTGTAATATC","561307.5.peg.1358"," 400"
"4134",144,693,549,"TTTAAACCATCACGAACATC","CCTTGAATAATACCACCAGT","561307.5.peg.1358"," 400"
"4135",591,693,102,"TCACTTCAGCTAAATTATG","CCTTGAATAATACCACCAGT","561307.5.peg.1358"," 400"
"4136",507,693,186,"AATCTTGATGGCAATACCAT","CCTTGAATAATACCACCAGT","561307.5.peg.1358"," 400"
"4137",531,693,162,"GAACCATTCACTAGTAAGTT","CCTTGAATAATACCACCAGT","561307.5.peg.1358"," 400"
"4138",1109,693,416,"ATTTGCAACAACCTCAATT","CCTTGAATAATACCACCAGT","561307.5.peg.1358"," 400"
"4139",390,693,303,"TCAGTGTAACGCATTGCCGC","CCTTGAATAATACCACCAGT","561307.5.peg.1358"," 400"
"4140",8,693,685,"AATGATCAATTTGATGAGG","CCTTGAATAATACCACCAGT","561307.5.peg.1358"," 400"
"4141",289,693,404,"GACCATTGCTTCGTACACTG","CCTTGAATAATACCACCAGT","561307.5.peg.1358"," 400"
"4142",519,693,174,"GTAAGTTAGGAAATCTTGA","CCTTGAATAATACCACCAGT","561307.5.peg.1358"," 400"
"4143",387,693,306,"GTGTAACGCATTGCCGCTGG","CCTTGAATAATACCACCAGT","561307.5.peg.1358"," 400"
"4144",311,693,382,"ACTTCCAGTCTTGACTTAAA","CCTTGAATAATACCACCAGT","561307.5.peg.1358"," 400"
"4145",480,693,213,"AGTGTCGTATCATCATAGTT","CCTTGAATAATACCACCAGT","561307.5.peg.1358"," 400"
"4146",276,693,417,"TACACTGAGGAGTCTCCATG","CCTTGAATAATACCACCAGT","561307.5.peg.1358"," 400"
"4147",8,1109,1101,"AATGATCAATTTGATGAGG","ATTTGCAACAACCTCAATT","561307.5.peg.1358"," 400"
"4148",507,1109,602,"AATCTTGATGGCAATACCAT","ATTTGCAACAACCTCAATT","561307.5.peg.1358"," 400"
"4149",144,1109,965,"TTTAAACCATCACGAACATC","ATTTGCAACAACCTCAATT","561307.5.peg.1358"," 400"
"4150",591,1109,518,"TCACTTCAGCTAAATTATG","ATTTGCAACAACCTCAATT","561307.5.peg.1358"," 400"
"4151",693,1109,416,"CCTTGAATAATACCACCAGT","ATTTGCAACAACCTCAATT","561307.5.peg.1358"," 400"
"4152",276,1109,833,"TACACTGAGGAGTCTCCATG","ATTTGCAACAACCTCAATT","561307.5.peg.1358"," 400"
"4153",311,1109,798,"ACTTCCAGTCTTGACTTAAA","ATTTGCAACAACCTCAATT","561307.5.peg.1358"," 400"
"4154",519,1109,590,"GTAAGTTAGGAAATCTTGA","ATTTGCAACAACCTCAATT","561307.5.peg.1358"," 400"
"4155",480,1109,629,"AGTGTCGTATCATCATAGTT","ATTTGCAACAACCTCAATT","561307.5.peg.1358"," 400"
"4156",289,1109,820,"GACCATTGCTTCGTACACTG","ATTTGCAACAACCTCAATT","561307.5.peg.1358"," 400"
"4157",390,1109,719,"TCAGTGTAACGCATTGCCGC","ATTTGCAACAACCTCAATT","561307.5.peg.1358"," 400"
"4158",642,1109,467,"ATTGATTGACTGTAATATC","ATTTGCAACAACCTCAATT","561307.5.peg.1358"," 400"
"4159",531,1109,578,"GAACCATTCACTAGTAAGTT","ATTTGCAACAACCTCAATT","561307.5.peg.1358"," 400"
"4160",387,1109,722,"GTGTAACGCATTGCCGCTGG","ATTTGCAACAACCTCAATT","561307.5.peg.1358"," 400"
"4161",467,7,460,"TATAGTAAGCTGGACCACCA","ATTCATGTAGAGGATGCGAG","561307.5.peg.1359"," 401"
"4162",717,7,710,"TGTAAATGATAGCCATAAT","ATTCATGTAGAGGATGCGAG","561307.5.peg.1359"," 401"
"4163",467,9,458,"TATAGTAAGCTGGACCACCA","TGATTCATGTAGAGGATGCG","561307.5.peg.1359"," 401"
"4164",717,9,708,"TGTAAATGATAGCCATAAT","TGATTCATGTAGAGGATGCG","561307.5.peg.1359"," 401"
"4165",717,98,619,"TGTAAATGATAGCCATAAT","TATTAAATCGGTACCAACA","561307.5.peg.1359"," 401"
"4166",467,98,369,"TATAGTAAGCTGGACCACCA","TATTAAATCGGTACCAACA","561307.5.peg.1359"," 401"
"4167",7,467,460,"ATTCATGTAGAGGATGCGAG","TATAGTAAGCTGGACCACCA","561307.5.peg.1359"," 401"
"4168",717,467,250,"TGTAAATGATAGCCATAAT","TATAGTAAGCTGGACCACCA","561307.5.peg.1359"," 401"
"4169",9,467,458,"TGATTCATGTAGAGGATGCG","TATAGTAAGCTGGACCACCA","561307.5.peg.1359"," 401"
"4170",98,467,369,"TATTAAATCGGTACCAACA","TATAGTAAGCTGGACCACCA","561307.5.peg.1359"," 401"
"4171",9,717,708,"TGATTCATGTAGAGGATGCG","TGTAAATGATAGCCATAAT","561307.5.peg.1359"," 401"
"4172",7,717,710,"ATTCATGTAGAGGATGCGAG","TGTAAATGATAGCCATAAT","561307.5.peg.1359"," 401"
"4173",467,717,250,"TATAGTAAGCTGGACCACCA","TGTAAATGATAGCCATAAT","561307.5.peg.1359"," 401"
"4174",98,717,619,"TATTAAATCGGTACCAACA","TGTAAATGATAGCCATAAT","561307.5.peg.1359"," 401"
"4175",117,1,116,"TTAATCATGCCTCTTCCCAT","TATCAGATTGGGGTGAATTA","561307.5.peg.136"," 402"
"4176",162,1,161,"TGAATCGTTTCGAATTGTTC","TATCAGATTGGGGTGAATTA","561307.5.peg.136"," 402"
"4177",1,117,116,"TATCAGATTGGGGTGAATTA","TTAATCATGCCTCTTCCCAT","561307.5.peg.136"," 402"
"4178",1,162,161,"TATCAGATTGGGGTGAATTA","TGAATCGTTTCGAATTGTTC","561307.5.peg.136"," 402"
"4179",186,37,149,"GAATTAAAGAGACGATGAT","AAACTTCATATACCGTGATT","561307.5.peg.1361"," 404"
"4180",224,37,187,"GTTCCATCATATTTACGATT","AAACTTCATATACCGTGATT","561307.5.peg.1361"," 404"
"4181",258,37,221,"ATAGAAATACCTGCAACTCT","AAACTTCATATACCGTGATT","561307.5.peg.1361"," 404"
"4182",333,37,296,"TCTACTTGCGAACCAATAAT","AAACTTCATATACCGTGATT","561307.5.peg.1361"," 404"
"4183",37,186,149,"AAACTTCATATACCGTGATT","GAATTAAAGAGACGATGAT","561307.5.peg.1361"," 404"
"4184",333,186,147,"TCTACTTGCGAACCAATAAT","GAATTAAAGAGACGATGAT","561307.5.peg.1361"," 404"
"4185",37,224,187,"AAACTTCATATACCGTGATT","GTTCCATCATATTTACGATT","561307.5.peg.1361"," 404"
"4186",333,224,109,"TCTACTTGCGAACCAATAAT","GTTCCATCATATTTACGATT","561307.5.peg.1361"," 404"
"4187",37,258,221,"AAACTTCATATACCGTGATT","ATAGAAATACCTGCAACTCT","561307.5.peg.1361"," 404"
"4188",37,333,296,"AAACTTCATATACCGTGATT","TCTACTTGCGAACCAATAAT","561307.5.peg.1361"," 404"
"4189",224,333,109,"GTTCCATCATATTTACGATT","TCTACTTGCGAACCAATAAT","561307.5.peg.1361"," 404"
"4190",186,333,147,"GAATTAAAGAGACGATGAT","TCTACTTGCGAACCAATAAT","561307.5.peg.1361"," 404"
"4191",789,197,592,"TCGAAAGCGCCGAAACCACC","ATAGTAACACTAAGGACATA","561307.5.peg.1362"," 405"
"4192",197,789,592,"ATAGTAACACTAAGGACATA","TCGAAAGCGCCGAAACCACC","561307.5.peg.1362"," 405"
"4193",360,8,352,"TATTGGTGTAAATCTTCAGG","AATAAGATTCAAGTAAGGG","561307.5.peg.1366"," 409"
"4194",618,8,610,"AAATCTCGCAAGGGCTGAAT","AATAAGATTCAAGTAAGGG","561307.5.peg.1366"," 409"
"4195",147,8,139,"ACAGCTAGCTTTGTTTCTAA","AATAAGATTCAAGTAAGGG","561307.5.peg.1366"," 409"
"4196",8,147,139,"AATAAGATTCAAGTAAGGG","ACAGCTAGCTTTGTTTCTAA","561307.5.peg.1366"," 409"
"4197",360,147,213,"TATTGGTGTAAATCTTCAGG","ACAGCTAGCTTTGTTTCTAA","561307.5.peg.1366"," 409"
"4198",618,147,471,"AAATCTCGCAAGGGCTGAAT","ACAGCTAGCTTTGTTTCTAA","561307.5.peg.1366"," 409"
"4199",8,360,352,"AATAAGATTCAAGTAAGGG","TATTGGTGTAAATCTTCAGG","561307.5.peg.1366"," 409"
"4200",618,360,258,"AAATCTCGCAAGGGCTGAAT","TATTGGTGTAAATCTTCAGG","561307.5.peg.1366"," 409"
"4201",147,360,213,"ACAGCTAGCTTTGTTTCTAA","TATTGGTGTAAATCTTCAGG","561307.5.peg.1366"," 409"
"4202",8,618,610,"AATAAGATTCAAGTAAGGG","AAATCTCGCAAGGGCTGAAT","561307.5.peg.1366"," 409"
"4203",147,618,471,"ACAGCTAGCTTTGTTTCTAA","AAATCTCGCAAGGGCTGAAT","561307.5.peg.1366"," 409"
"4204",360,618,258,"TATTGGTGTAAATCTTCAGG","AAATCTCGCAAGGGCTGAAT","561307.5.peg.1366"," 409"
"4205",411,303,108,"GATTTATGACTACCAGCCAT","ACAATAACACCAGGTTTAGT","561307.5.peg.1367"," 410"
"4206",303,411,108,"ACAATAACACCAGGTTTAGT","GATTTATGACTACCAGCCAT","561307.5.peg.1367"," 410"
"4207",584,264,320,"CTTGTGTAGGCATGAATGGT","TAGTCGTTAAATAATGGTA","561307.5.peg.1369"," 412"
"4208",710,264,446,"AAATTCTTGATGGCACAACT","TAGTCGTTAAATAATGGTA","561307.5.peg.1369"," 412"
"4209",588,264,324,"AAATCTTGTGTAGGCATGAA","TAGTCGTTAAATAATGGTA","561307.5.peg.1369"," 412"
"4210",264,584,320,"TAGTCGTTAAATAATGGTA","CTTGTGTAGGCATGAATGGT","561307.5.peg.1369"," 412"
"4211",710,584,126,"AAATTCTTGATGGCACAACT","CTTGTGTAGGCATGAATGGT","561307.5.peg.1369"," 412"
"4212",264,588,324,"TAGTCGTTAAATAATGGTA","AAATCTTGTGTAGGCATGAA","561307.5.peg.1369"," 412"
"4213",710,588,122,"AAATTCTTGATGGCACAACT","AAATCTTGTGTAGGCATGAA","561307.5.peg.1369"," 412"
"4214",588,710,122,"AAATCTTGTGTAGGCATGAA","AAATTCTTGATGGCACAACT","561307.5.peg.1369"," 412"
"4215",584,710,126,"CTTGTGTAGGCATGAATGGT","AAATTCTTGATGGCACAACT","561307.5.peg.1369"," 412"
"4216",264,710,446,"TAGTCGTTAAATAATGGTA","AAATTCTTGATGGCACAACT","561307.5.peg.1369"," 412"
"4217",189,48,141,"TCTAATGGATGCCCTGGACC","TATCTACAACTAAGATCAT","561307.5.peg.1370"," 414"
"4218",195,48,147,"TGATCGTCTAATGGATGCCC","TATCTACAACTAAGATCAT","561307.5.peg.1370"," 414"
"4219",204,48,156,"TTAACTGTTGATCGTCTAA","TATCTACAACTAAGATCAT","561307.5.peg.1370"," 414"
"4220",189,79,110,"TCTAATGGATGCCCTGGACC","TCCACTAGGTTATATGTAA","561307.5.peg.1370"," 414"
"4221",195,79,116,"TGATCGTCTAATGGATGCCC","TCCACTAGGTTATATGTAA","561307.5.peg.1370"," 414"
"4222",204,79,125,"TTAACTGTTGATCGTCTAA","TCCACTAGGTTATATGTAA","561307.5.peg.1370"," 414"
"4223",195,92,103,"TGATCGTCTAATGGATGCCC","GTTGAGCAACAATATCCACT","561307.5.peg.1370"," 414"
"4224",204,92,112,"TTAACTGTTGATCGTCTAA","GTTGAGCAACAATATCCACT","561307.5.peg.1370"," 414"
"4225",48,189,141,"TATCTACAACTAAGATCAT","TCTAATGGATGCCCTGGACC","561307.5.peg.1370"," 414"
"4226",79,189,110,"TCCACTAGGTTATATGTAA","TCTAATGGATGCCCTGGACC","561307.5.peg.1370"," 414"
"4227",48,195,147,"TATCTACAACTAAGATCAT","TGATCGTCTAATGGATGCCC","561307.5.peg.1370"," 414"
"4228",92,195,103,"GTTGAGCAACAATATCCACT","TGATCGTCTAATGGATGCCC","561307.5.peg.1370"," 414"
"4229",79,195,116,"TCCACTAGGTTATATGTAA","TGATCGTCTAATGGATGCCC","561307.5.peg.1370"," 414"
"4230",48,204,156,"TATCTACAACTAAGATCAT","TTAACTGTTGATCGTCTAA","561307.5.peg.1370"," 414"
"4231",92,204,112,"GTTGAGCAACAATATCCACT","TTAACTGTTGATCGTCTAA","561307.5.peg.1370"," 414"
"4232",79,204,125,"TCCACTAGGTTATATGTAA","TTAACTGTTGATCGTCTAA","561307.5.peg.1370"," 414"
"4233",172,10,162,"TTGGATTTCTCGCTCCGAAT","TCATTAATCTAGTGAAGGA","561307.5.peg.1371"," 415"
"4234",243,10,233,"CCTTCATAACATGGTTGATG","TCATTAATCTAGTGAAGGA","561307.5.peg.1371"," 415"
"4235",252,10,242,"CACATAGCCCCTTCATAACA","TCATTAATCTAGTGAAGGA","561307.5.peg.1371"," 415"
"4236",510,10,500,"GGTTGCATATACTTCATGAT","TCATTAATCTAGTGAAGGA","561307.5.peg.1371"," 415"
"4237",388,10,378,"ATCCGTACTACCTGAATTTG","TCATTAATCTAGTGAAGGA","561307.5.peg.1371"," 415"
"4238",479,10,469,"CAGTTGCACCAATGAATACA","TCATTAATCTAGTGAAGGA","561307.5.peg.1371"," 415"
"4239",10,172,162,"TCATTAATCTAGTGAAGGA","TTGGATTTCTCGCTCCGAAT","561307.5.peg.1371"," 415"
"4240",510,172,338,"GGTTGCATATACTTCATGAT","TTGGATTTCTCGCTCCGAAT","561307.5.peg.1371"," 415"
"4241",388,172,216,"ATCCGTACTACCTGAATTTG","TTGGATTTCTCGCTCCGAAT","561307.5.peg.1371"," 415"
"4242",479,172,307,"CAGTTGCACCAATGAATACA","TTGGATTTCTCGCTCCGAAT","561307.5.peg.1371"," 415"
"4243",510,243,267,"GGTTGCATATACTTCATGAT","CCTTCATAACATGGTTGATG","561307.5.peg.1371"," 415"
"4244",10,243,233,"TCATTAATCTAGTGAAGGA","CCTTCATAACATGGTTGATG","561307.5.peg.1371"," 415"
"4245",388,243,145,"ATCCGTACTACCTGAATTTG","CCTTCATAACATGGTTGATG","561307.5.peg.1371"," 415"
"4246",479,243,236,"CAGTTGCACCAATGAATACA","CCTTCATAACATGGTTGATG","561307.5.peg.1371"," 415"
"4247",10,252,242,"TCATTAATCTAGTGAAGGA","CACATAGCCCCTTCATAACA","561307.5.peg.1371"," 415"
"4248",510,252,258,"GGTTGCATATACTTCATGAT","CACATAGCCCCTTCATAACA","561307.5.peg.1371"," 415"
"4249",479,252,227,"CAGTTGCACCAATGAATACA","CACATAGCCCCTTCATAACA","561307.5.peg.1371"," 415"
"4250",388,252,136,"ATCCGTACTACCTGAATTTG","CACATAGCCCCTTCATAACA","561307.5.peg.1371"," 415"
"4251",10,388,378,"TCATTAATCTAGTGAAGGA","ATCCGTACTACCTGAATTTG","561307.5.peg.1371"," 415"
"4252",243,388,145,"CCTTCATAACATGGTTGATG","ATCCGTACTACCTGAATTTG","561307.5.peg.1371"," 415"
"4253",252,388,136,"CACATAGCCCCTTCATAACA","ATCCGTACTACCTGAATTTG","561307.5.peg.1371"," 415"
"4254",172,388,216,"TTGGATTTCTCGCTCCGAAT","ATCCGTACTACCTGAATTTG","561307.5.peg.1371"," 415"
"4255",510,388,122,"GGTTGCATATACTTCATGAT","ATCCGTACTACCTGAATTTG","561307.5.peg.1371"," 415"
"4256",10,479,469,"TCATTAATCTAGTGAAGGA","CAGTTGCACCAATGAATACA","561307.5.peg.1371"," 415"
"4257",172,479,307,"TTGGATTTCTCGCTCCGAAT","CAGTTGCACCAATGAATACA","561307.5.peg.1371"," 415"
"4258",243,479,236,"CCTTCATAACATGGTTGATG","CAGTTGCACCAATGAATACA","561307.5.peg.1371"," 415"
"4259",252,479,227,"CACATAGCCCCTTCATAACA","CAGTTGCACCAATGAATACA","561307.5.peg.1371"," 415"
"4260",388,510,122,"ATCCGTACTACCTGAATTTG","GGTTGCATATACTTCATGAT","561307.5.peg.1371"," 415"
"4261",243,510,267,"CCTTCATAACATGGTTGATG","GGTTGCATATACTTCATGAT","561307.5.peg.1371"," 415"
"4262",252,510,258,"CACATAGCCCCTTCATAACA","GGTTGCATATACTTCATGAT","561307.5.peg.1371"," 415"
"4263",10,510,500,"TCATTAATCTAGTGAAGGA","GGTTGCATATACTTCATGAT","561307.5.peg.1371"," 415"
"4264",172,510,338,"TTGGATTTCTCGCTCCGAAT","GGTTGCATATACTTCATGAT","561307.5.peg.1371"," 415"
"4265",225,28,197,"TCAGGTAAGTCATTAACTGT","TTATTCACCTCTCATTTGA","561307.5.peg.1372"," 416"
"4266",281,28,253,"ACACGGCATTTGCACCATAT","TTATTCACCTCTCATTTGA","561307.5.peg.1372"," 416"
"4267",186,28,158,"TCTGCAATAATTGCTAGCTT","TTATTCACCTCTCATTTGA","561307.5.peg.1372"," 416"
"4268",407,28,379,"TAGCAACATCAATTTGAAGC","TTATTCACCTCTCATTTGA","561307.5.peg.1372"," 416"
"4269",281,31,250,"ACACGGCATTTGCACCATAT","TGATAATGGTGAAGCAT","561307.5.peg.1372"," 416"
"4270",186,31,155,"TCTGCAATAATTGCTAGCTT","TGATAATGGTGAAGCAT","561307.5.peg.1372"," 416"
"4271",407,31,376,"TAGCAACATCAATTTGAAGC","TGATAATGGTGAAGCAT","561307.5.peg.1372"," 416"
"4272",225,31,194,"TCAGGTAAGTCATTAACTGT","TGATAATGGTGAAGCAT","561307.5.peg.1372"," 416"
"4273",31,186,155,"TGATAATGGTGAAGCAT","TCTGCAATAATTGCTAGCTT","561307.5.peg.1372"," 416"
"4274",28,186,158,"TTATTCACCTCTCATTTGA","TCTGCAATAATTGCTAGCTT","561307.5.peg.1372"," 416"
"4275",407,186,221,"TAGCAACATCAATTTGAAGC","TCTGCAATAATTGCTAGCTT","561307.5.peg.1372"," 416"
"4276",31,225,194,"TGATAATGGTGAAGCAT","TCAGGTAAGTCATTAACTGT","561307.5.peg.1372"," 416"
"4277",28,225,197,"TTATTCACCTCTCATTTGA","TCAGGTAAGTCATTAACTGT","561307.5.peg.1372"," 416"
"4278",407,225,182,"TAGCAACATCAATTTGAAGC","TCAGGTAAGTCATTAACTGT","561307.5.peg.1372"," 416"
"4279",28,281,253,"TTATTCACCTCTCATTTGA","ACACGGCATTTGCACCATAT","561307.5.peg.1372"," 416"
"4280",31,281,250,"TGATAATGGTGAAGCAT","ACACGGCATTTGCACCATAT","561307.5.peg.1372"," 416"
"4281",407,281,126,"TAGCAACATCAATTTGAAGC","ACACGGCATTTGCACCATAT","561307.5.peg.1372"," 416"
"4282",28,407,379,"TTATTCACCTCTCATTTGA","TAGCAACATCAATTTGAAGC","561307.5.peg.1372"," 416"
"4283",31,407,376,"TGATAATGGTGAAGCAT","TAGCAACATCAATTTGAAGC","561307.5.peg.1372"," 416"
"4284",281,407,126,"ACACGGCATTTGCACCATAT","TAGCAACATCAATTTGAAGC","561307.5.peg.1372"," 416"
"4285",186,407,221,"TCTGCAATAATTGCTAGCTT","TAGCAACATCAATTTGAAGC","561307.5.peg.1372"," 416"
"4286",225,407,182,"TCAGGTAAGTCATTAACTGT","TAGCAACATCAATTTGAAGC","561307.5.peg.1372"," 416"
"4287",165,9,156,"ATAACTGGACCATCAGCAAC","AGACAATATATGGTAGAGCG","561307.5.peg.1375"," 419"
"4288",153,9,144,"TCAGCAACCGGATCAGAGAA","AGACAATATATGGTAGAGCG","561307.5.peg.1375"," 419"
"4289",387,9,378,"AAACGCTGCGATAATTCATA","AGACAATATATGGTAGAGCG","561307.5.peg.1375"," 419"
"4290",180,9,171,"TGACCTGCTTCCATGATAAC","AGACAATATATGGTAGAGCG","561307.5.peg.1375"," 419"
"4291",9,153,144,"AGACAATATATGGTAGAGCG","TCAGCAACCGGATCAGAGAA","561307.5.peg.1375"," 419"
"4292",387,153,234,"AAACGCTGCGATAATTCATA","TCAGCAACCGGATCAGAGAA","561307.5.peg.1375"," 419"
"4293",9,165,156,"AGACAATATATGGTAGAGCG","ATAACTGGACCATCAGCAAC","561307.5.peg.1375"," 419"
"4294",387,165,222,"AAACGCTGCGATAATTCATA","ATAACTGGACCATCAGCAAC","561307.5.peg.1375"," 419"
"4295",9,180,171,"AGACAATATATGGTAGAGCG","TGACCTGCTTCCATGATAAC","561307.5.peg.1375"," 419"
"4296",387,180,207,"AAACGCTGCGATAATTCATA","TGACCTGCTTCCATGATAAC","561307.5.peg.1375"," 419"
"4297",9,387,378,"AGACAATATATGGTAGAGCG","AAACGCTGCGATAATTCATA","561307.5.peg.1375"," 419"
"4298",153,387,234,"TCAGCAACCGGATCAGAGAA","AAACGCTGCGATAATTCATA","561307.5.peg.1375"," 419"
"4299",165,387,222,"ATAACTGGACCATCAGCAAC","AAACGCTGCGATAATTCATA","561307.5.peg.1375"," 419"
"4300",180,387,207,"TGACCTGCTTCCATGATAAC","AAACGCTGCGATAATTCATA","561307.5.peg.1375"," 419"
"4301",234,88,146,"ACTTGAACACTTTCATAAC","GTATGGCATGCTATCTGTAA","561307.5.peg.1376"," 420"
"4302",501,88,413,"TGATAACGAATTTGTAGCAC","GTATGGCATGCTATCTGTAA","561307.5.peg.1376"," 420"
"4303",234,105,129,"ACTTGAACACTTTCATAAC","GTTTGCGTGAAATGACTGTA","561307.5.peg.1376"," 420"
"4304",501,105,396,"TGATAACGAATTTGTAGCAC","GTTTGCGTGAAATGACTGTA","561307.5.peg.1376"," 420"
"4305",501,134,367,"TGATAACGAATTTGTAGCAC","CAGCAAGCTTTAACTCATAG","561307.5.peg.1376"," 420"
"4306",234,134,100,"ACTTGAACACTTTCATAAC","CAGCAAGCTTTAACTCATAG","561307.5.peg.1376"," 420"
"4307",88,234,146,"GTATGGCATGCTATCTGTAA","ACTTGAACACTTTCATAAC","561307.5.peg.1376"," 420"
"4308",501,234,267,"TGATAACGAATTTGTAGCAC","ACTTGAACACTTTCATAAC","561307.5.peg.1376"," 420"
"4309",105,234,129,"GTTTGCGTGAAATGACTGTA","ACTTGAACACTTTCATAAC","561307.5.peg.1376"," 420"
"4310",134,234,100,"CAGCAAGCTTTAACTCATAG","ACTTGAACACTTTCATAAC","561307.5.peg.1376"," 420"
"4311",105,501,396,"GTTTGCGTGAAATGACTGTA","TGATAACGAATTTGTAGCAC","561307.5.peg.1376"," 420"
"4312",88,501,413,"GTATGGCATGCTATCTGTAA","TGATAACGAATTTGTAGCAC","561307.5.peg.1376"," 420"
"4313",234,501,267,"ACTTGAACACTTTCATAAC","TGATAACGAATTTGTAGCAC","561307.5.peg.1376"," 420"
"4314",134,501,367,"CAGCAAGCTTTAACTCATAG","TGATAACGAATTTGTAGCAC","561307.5.peg.1376"," 420"
"4315",237,76,161,"AAACATAACTTCCCATAGT","TGTACAAAGTTGTCAAATT","561307.5.peg.1377"," 421"
"4316",512,76,436,"ATACGCCCATCCATCGTACT","TGTACAAAGTTGTCAAATT","561307.5.peg.1377"," 421"
"4317",512,148,364,"ATACGCCCATCCATCGTACT","TTCAAAGCCATCATTCTCAC","561307.5.peg.1377"," 421"
"4318",76,237,161,"TGTACAAAGTTGTCAAATT","AAACATAACTTCCCATAGT","561307.5.peg.1377"," 421"
"4319",512,237,275,"ATACGCCCATCCATCGTACT","AAACATAACTTCCCATAGT","561307.5.peg.1377"," 421"
"4320",76,512,436,"TGTACAAAGTTGTCAAATT","ATACGCCCATCCATCGTACT","561307.5.peg.1377"," 421"
"4321",148,512,364,"TTCAAAGCCATCATTCTCAC","ATACGCCCATCCATCGTACT","561307.5.peg.1377"," 421"
"4322",237,512,275,"AAACATAACTTCCCATAGT","ATACGCCCATCCATCGTACT","561307.5.peg.1377"," 421"
"4323",204,95,109,"GTGTGCTGATGAAATACTGA","AATAGTCTGGTCAATTAAT","561307.5.peg.1378"," 422"
"4324",95,204,109,"AATAGTCTGGTCAATTAAT","GTGTGCTGATGAAATACTGA","561307.5.peg.1378"," 422"
"4325",666,465,201,"CCGCCCATTTCTAATGTCAC","ACATTAGGCGTCAACTCAGA","561307.5.peg.138"," 424"
"4326",696,465,231,"GCTGTTTCATCAACGATGAC","ACATTAGGCGTCAACTCAGA","561307.5.peg.138"," 424"
"4327",666,480,186,"CCGCCCATTTCTAATGTCAC","TTAATCACTCGTGCAACATT","561307.5.peg.138"," 424"
"4328",696,480,216,"GCTGTTTCATCAACGATGAC","TTAATCACTCGTGCAACATT","561307.5.peg.138"," 424"
"4329",465,666,201,"ACATTAGGCGTCAACTCAGA","CCGCCCATTTCTAATGTCAC","561307.5.peg.138"," 424"
"4330",480,666,186,"TTAATCACTCGTGCAACATT","CCGCCCATTTCTAATGTCAC","561307.5.peg.138"," 424"
"4331",465,696,231,"ACATTAGGCGTCAACTCAGA","GCTGTTTCATCAACGATGAC","561307.5.peg.138"," 424"
"4332",480,696,216,"TTAATCACTCGTGCAACATT","GCTGTTTCATCAACGATGAC","561307.5.peg.138"," 424"
"4333",151,3,148,"AGCGCCGCTCTCTCCAATCA","TCTATCTCTTAGTGCATCAC","561307.5.peg.1381"," 426"
"4334",151,9,142,"AGCGCCGCTCTCTCCAATCA","GATAGATTGCTGAAACAACG","561307.5.peg.1381"," 426"
"4335",3,151,148,"TCTATCTCTTAGTGCATCAC","AGCGCCGCTCTCTCCAATCA","561307.5.peg.1381"," 426"
"4336",9,151,142,"GATAGATTGCTGAAACAACG","AGCGCCGCTCTCTCCAATCA","561307.5.peg.1381"," 426"
"4337",321,7,314,"TGAATAATATCTGTGTTAC","TAGTAACTTACACAAGGAGG","561307.5.peg.1383"," 428"
"4338",408,7,401,"TTGGCTGCTATAATGCCGAG","TAGTAACTTACACAAGGAGG","561307.5.peg.1383"," 428"
"4339",427,7,420,"CGTCCACTTATGAAATCGTT","TAGTAACTTACACAAGGAGG","561307.5.peg.1383"," 428"
"4340",492,7,485,"ATAATACCGATAAAGAACGC","TAGTAACTTACACAAGGAGG","561307.5.peg.1383"," 428"
"4341",321,9,312,"TGAATAATATCTGTGTTAC","GTTAGTAACTTACACAAGGA","561307.5.peg.1383"," 428"
"4342",408,9,399,"TTGGCTGCTATAATGCCGAG","GTTAGTAACTTACACAAGGA","561307.5.peg.1383"," 428"
"4343",492,9,483,"ATAATACCGATAAAGAACGC","GTTAGTAACTTACACAAGGA","561307.5.peg.1383"," 428"
"4344",427,9,418,"CGTCCACTTATGAAATCGTT","GTTAGTAACTTACACAAGGA","561307.5.peg.1383"," 428"
"4345",408,13,395,"TTGGCTGCTATAATGCCGAG","AGTGTTAGTAACTTACACA","561307.5.peg.1383"," 428"
"4346",321,13,308,"TGAATAATATCTGTGTTAC","AGTGTTAGTAACTTACACA","561307.5.peg.1383"," 428"
"4347",427,13,414,"CGTCCACTTATGAAATCGTT","AGTGTTAGTAACTTACACA","561307.5.peg.1383"," 428"
"4348",492,13,479,"ATAATACCGATAAAGAACGC","AGTGTTAGTAACTTACACA","561307.5.peg.1383"," 428"
"4349",7,321,314,"TAGTAACTTACACAAGGAGG","TGAATAATATCTGTGTTAC","561307.5.peg.1383"," 428"
"4350",9,321,312,"GTTAGTAACTTACACAAGGA","TGAATAATATCTGTGTTAC","561307.5.peg.1383"," 428"
"4351",427,321,106,"CGTCCACTTATGAAATCGTT","TGAATAATATCTGTGTTAC","561307.5.peg.1383"," 428"
"4352",13,321,308,"AGTGTTAGTAACTTACACA","TGAATAATATCTGTGTTAC","561307.5.peg.1383"," 428"
"4353",492,321,171,"ATAATACCGATAAAGAACGC","TGAATAATATCTGTGTTAC","561307.5.peg.1383"," 428"
"4354",7,408,401,"TAGTAACTTACACAAGGAGG","TTGGCTGCTATAATGCCGAG","561307.5.peg.1383"," 428"
"4355",13,408,395,"AGTGTTAGTAACTTACACA","TTGGCTGCTATAATGCCGAG","561307.5.peg.1383"," 428"
"4356",9,408,399,"GTTAGTAACTTACACAAGGA","TTGGCTGCTATAATGCCGAG","561307.5.peg.1383"," 428"
"4357",7,427,420,"TAGTAACTTACACAAGGAGG","CGTCCACTTATGAAATCGTT","561307.5.peg.1383"," 428"
"4358",9,427,418,"GTTAGTAACTTACACAAGGA","CGTCCACTTATGAAATCGTT","561307.5.peg.1383"," 428"
"4359",13,427,414,"AGTGTTAGTAACTTACACA","CGTCCACTTATGAAATCGTT","561307.5.peg.1383"," 428"
"4360",321,427,106,"TGAATAATATCTGTGTTAC","CGTCCACTTATGAAATCGTT","561307.5.peg.1383"," 428"
"4361",13,492,479,"AGTGTTAGTAACTTACACA","ATAATACCGATAAAGAACGC","561307.5.peg.1383"," 428"
"4362",7,492,485,"TAGTAACTTACACAAGGAGG","ATAATACCGATAAAGAACGC","561307.5.peg.1383"," 428"
"4363",9,492,483,"GTTAGTAACTTACACAAGGA","ATAATACCGATAAAGAACGC","561307.5.peg.1383"," 428"
"4364",321,492,171,"TGAATAATATCTGTGTTAC","ATAATACCGATAAAGAACGC","561307.5.peg.1383"," 428"
"4365",733,488,245,"TTGCATATTATATGTAGCCG","GTTCTACCGACGCAGATAAT","561307.5.peg.1385"," 430"
"4366",620,488,132,"CAAACGTAGCATAGTCGACA","GTTCTACCGACGCAGATAAT","561307.5.peg.1385"," 430"
"4367",885,488,397,"TAGCATATTTCTGCATAAC","GTTCTACCGACGCAGATAAT","561307.5.peg.1385"," 430"
"4368",733,531,202,"TTGCATATTATATGTAGCCG","TCGTAAGGACTGTTTAGCGT","561307.5.peg.1385"," 430"
"4369",885,531,354,"TAGCATATTTCTGCATAAC","TCGTAAGGACTGTTTAGCGT","561307.5.peg.1385"," 430"
"4370",885,546,339,"TAGCATATTTCTGCATAAC","GTCGTGCCGTATAAATCGTA","561307.5.peg.1385"," 430"
"4371",733,546,187,"TTGCATATTATATGTAGCCG","GTCGTGCCGTATAAATCGTA","561307.5.peg.1385"," 430"
"4372",488,620,132,"GTTCTACCGACGCAGATAAT","CAAACGTAGCATAGTCGACA","561307.5.peg.1385"," 430"
"4373",885,620,265,"TAGCATATTTCTGCATAAC","CAAACGTAGCATAGTCGACA","561307.5.peg.1385"," 430"
"4374",733,620,113,"TTGCATATTATATGTAGCCG","CAAACGTAGCATAGTCGACA","561307.5.peg.1385"," 430"
"4375",531,733,202,"TCGTAAGGACTGTTTAGCGT","TTGCATATTATATGTAGCCG","561307.5.peg.1385"," 430"
"4376",620,733,113,"CAAACGTAGCATAGTCGACA","TTGCATATTATATGTAGCCG","561307.5.peg.1385"," 430"
"4377",488,733,245,"GTTCTACCGACGCAGATAAT","TTGCATATTATATGTAGCCG","561307.5.peg.1385"," 430"
"4378",885,733,152,"TAGCATATTTCTGCATAAC","TTGCATATTATATGTAGCCG","561307.5.peg.1385"," 430"
"4379",546,733,187,"GTCGTGCCGTATAAATCGTA","TTGCATATTATATGTAGCCG","561307.5.peg.1385"," 430"
"4380",488,885,397,"GTTCTACCGACGCAGATAAT","TAGCATATTTCTGCATAAC","561307.5.peg.1385"," 430"
"4381",620,885,265,"CAAACGTAGCATAGTCGACA","TAGCATATTTCTGCATAAC","561307.5.peg.1385"," 430"
"4382",546,885,339,"GTCGTGCCGTATAAATCGTA","TAGCATATTTCTGCATAAC","561307.5.peg.1385"," 430"
"4383",531,885,354,"TCGTAAGGACTGTTTAGCGT","TAGCATATTTCTGCATAAC","561307.5.peg.1385"," 430"
"4384",733,885,152,"TTGCATATTATATGTAGCCG","TAGCATATTTCTGCATAAC","561307.5.peg.1385"," 430"
"4385",258,129,129,"GTTGATTTGCCACAACCAGA","GAATGTGAGTTTGTATCATC","561307.5.peg.1387"," 432"
"4386",129,258,129,"GAATGTGAGTTTGTATCATC","GTTGATTTGCCACAACCAGA","561307.5.peg.1387"," 432"
"4387",268,142,126,"ACCAAACTTAGGGTCTGAAC","AATGGAAATCGCTGAAATTG","561307.5.peg.1389"," 434"
"4388",398,142,256,"GTTTAATTATGCGTCGTGCA","AATGGAAATCGCTGAAATTG","561307.5.peg.1389"," 434"
"4389",264,142,122,"AACTTAGGGTCTGAACCGGT","AATGGAAATCGCTGAAATTG","561307.5.peg.1389"," 434"
"4390",278,142,136,"ATGCCCAGATACCAAACTTA","AATGGAAATCGCTGAAATTG","561307.5.peg.1389"," 434"
"4391",351,142,209,"ATTGCTGCACCAAGCCCGAC","AATGGAAATCGCTGAAATTG","561307.5.peg.1389"," 434"
"4392",142,264,122,"AATGGAAATCGCTGAAATTG","AACTTAGGGTCTGAACCGGT","561307.5.peg.1389"," 434"
"4393",398,264,134,"GTTTAATTATGCGTCGTGCA","AACTTAGGGTCTGAACCGGT","561307.5.peg.1389"," 434"
"4394",142,268,126,"AATGGAAATCGCTGAAATTG","ACCAAACTTAGGGTCTGAAC","561307.5.peg.1389"," 434"
"4395",398,268,130,"GTTTAATTATGCGTCGTGCA","ACCAAACTTAGGGTCTGAAC","561307.5.peg.1389"," 434"
"4396",142,278,136,"AATGGAAATCGCTGAAATTG","ATGCCCAGATACCAAACTTA","561307.5.peg.1389"," 434"
"4397",398,278,120,"GTTTAATTATGCGTCGTGCA","ATGCCCAGATACCAAACTTA","561307.5.peg.1389"," 434"
"4398",142,351,209,"AATGGAAATCGCTGAAATTG","ATTGCTGCACCAAGCCCGAC","561307.5.peg.1389"," 434"
"4399",268,398,130,"ACCAAACTTAGGGTCTGAAC","GTTTAATTATGCGTCGTGCA","561307.5.peg.1389"," 434"
"4400",142,398,256,"AATGGAAATCGCTGAAATTG","GTTTAATTATGCGTCGTGCA","561307.5.peg.1389"," 434"
"4401",278,398,120,"ATGCCCAGATACCAAACTTA","GTTTAATTATGCGTCGTGCA","561307.5.peg.1389"," 434"
"4402",264,398,134,"AACTTAGGGTCTGAACCGGT","GTTTAATTATGCGTCGTGCA","561307.5.peg.1389"," 434"
"4403",263,144,119,"AGTTGGATGTACTTTGAGCT","TTGAAGCAATCGGAGCTAAA","561307.5.peg.1391"," 437"
"4404",280,144,136,"TAGGGCGATGTTATCAAAGT","TTGAAGCAATCGGAGCTAAA","561307.5.peg.1391"," 437"
"4405",298,144,154,"CTCAGCTGCTTTATAAGCTA","TTGAAGCAATCGGAGCTAAA","561307.5.peg.1391"," 437"
"4406",144,263,119,"TTGAAGCAATCGGAGCTAAA","AGTTGGATGTACTTTGAGCT","561307.5.peg.1391"," 437"
"4407",144,280,136,"TTGAAGCAATCGGAGCTAAA","TAGGGCGATGTTATCAAAGT","561307.5.peg.1391"," 437"
"4408",144,298,154,"TTGAAGCAATCGGAGCTAAA","CTCAGCTGCTTTATAAGCTA","561307.5.peg.1391"," 437"
"4409",169,8,161,"TCATCTAATGTATACGCAA","AATGTTATGGAATAAGAGG","561307.5.peg.1394"," 440"
"4410",8,169,161,"AATGTTATGGAATAAGAGG","TCATCTAATGTATACGCAA","561307.5.peg.1394"," 440"
"4411",231,10,221,"CTTCTCTTAACCTATCAAA","ATTCGACATTGAATAAAGCG","561307.5.peg.1395"," 441"
"4412",231,12,219,"CTTCTCTTAACCTATCAAA","ACATTCGACATTGAATAAAG","561307.5.peg.1395"," 441"
"4413",231,78,153,"CTTCTCTTAACCTATCAAA","TCATCAACCGCTTGCTTATA","561307.5.peg.1395"," 441"
"4414",10,231,221,"ATTCGACATTGAATAAAGCG","CTTCTCTTAACCTATCAAA","561307.5.peg.1395"," 441"
"4415",12,231,219,"ACATTCGACATTGAATAAAG","CTTCTCTTAACCTATCAAA","561307.5.peg.1395"," 441"
"4416",78,231,153,"TCATCAACCGCTTGCTTATA","CTTCTCTTAACCTATCAAA","561307.5.peg.1395"," 441"
"4417",206,82,124,"ATAACATGTGGCTATACTGA","ATGCTTTAAGGCATTAGACT","561307.5.peg.1396"," 442"
"4418",82,206,124,"ATGCTTTAAGGCATTAGACT","ATAACATGTGGCTATACTGA","561307.5.peg.1396"," 442"
"4419",258,1,257,"ACTTCTAGCTTACGAGCATA","TCGTGCACACGTTTCCAGAA","561307.5.peg.1397"," 443"
"4420",174,1,173,"AATTGCTTACGCACTGTGAC","TCGTGCACACGTTTCCAGAA","561307.5.peg.1397"," 443"
"4421",416,1,415,"CTAGACGCGTAACAATATGT","TCGTGCACACGTTTCCAGAA","561307.5.peg.1397"," 443"
"4422",228,1,227,"TTAACACTCGGTATTTCTCG","TCGTGCACACGTTTCCAGAA","561307.5.peg.1397"," 443"
"4423",339,1,338,"TCATGAGGATGTTCTCTCGA","TCGTGCACACGTTTCCAGAA","561307.5.peg.1397"," 443"
"4424",416,174,242,"CTAGACGCGTAACAATATGT","AATTGCTTACGCACTGTGAC","561307.5.peg.1397"," 443"
"4425",1,174,173,"TCGTGCACACGTTTCCAGAA","AATTGCTTACGCACTGTGAC","561307.5.peg.1397"," 443"
"4426",339,174,165,"TCATGAGGATGTTCTCTCGA","AATTGCTTACGCACTGTGAC","561307.5.peg.1397"," 443"
"4427",1,228,227,"TCGTGCACACGTTTCCAGAA","TTAACACTCGGTATTTCTCG","561307.5.peg.1397"," 443"
"4428",339,228,111,"TCATGAGGATGTTCTCTCGA","TTAACACTCGGTATTTCTCG","561307.5.peg.1397"," 443"
"4429",416,228,188,"CTAGACGCGTAACAATATGT","TTAACACTCGGTATTTCTCG","561307.5.peg.1397"," 443"
"4430",1,258,257,"TCGTGCACACGTTTCCAGAA","ACTTCTAGCTTACGAGCATA","561307.5.peg.1397"," 443"
"4431",416,258,158,"CTAGACGCGTAACAATATGT","ACTTCTAGCTTACGAGCATA","561307.5.peg.1397"," 443"
"4432",228,339,111,"TTAACACTCGGTATTTCTCG","TCATGAGGATGTTCTCTCGA","561307.5.peg.1397"," 443"
"4433",1,339,338,"TCGTGCACACGTTTCCAGAA","TCATGAGGATGTTCTCTCGA","561307.5.peg.1397"," 443"
"4434",174,339,165,"AATTGCTTACGCACTGTGAC","TCATGAGGATGTTCTCTCGA","561307.5.peg.1397"," 443"
"4435",1,416,415,"TCGTGCACACGTTTCCAGAA","CTAGACGCGTAACAATATGT","561307.5.peg.1397"," 443"
"4436",174,416,242,"AATTGCTTACGCACTGTGAC","CTAGACGCGTAACAATATGT","561307.5.peg.1397"," 443"
"4437",258,416,158,"ACTTCTAGCTTACGAGCATA","CTAGACGCGTAACAATATGT","561307.5.peg.1397"," 443"
"4438",228,416,188,"TTAACACTCGGTATTTCTCG","CTAGACGCGTAACAATATGT","561307.5.peg.1397"," 443"
"4439",800,1,799,"CATCATCACCGATTAGTTTA","TTATCGCTTTGGAGGGATTT","561307.5.peg.1398"," 444"
"4440",684,1,683,"ATGCTCATAATATCTTGCAT","TTATCGCTTTGGAGGGATTT","561307.5.peg.1398"," 444"
"4441",794,1,793,"CACCGATTAGTTTACGGTGT","TTATCGCTTTGGAGGGATTT","561307.5.peg.1398"," 444"
"4442",510,1,509,"GCAGAAACGATAGTGAAGTT","TTATCGCTTTGGAGGGATTT","561307.5.peg.1398"," 444"
"4443",781,1,780,"ACGGTGTGGGTCAGCCGATA","TTATCGCTTTGGAGGGATTT","561307.5.peg.1398"," 444"
"4444",684,8,676,"ATGCTCATAATATCTTGCAT","TTTAAATTATCGCTTTGGA","561307.5.peg.1398"," 444"
"4445",794,8,786,"CACCGATTAGTTTACGGTGT","TTTAAATTATCGCTTTGGA","561307.5.peg.1398"," 444"
"4446",800,8,792,"CATCATCACCGATTAGTTTA","TTTAAATTATCGCTTTGGA","561307.5.peg.1398"," 444"
"4447",781,8,773,"ACGGTGTGGGTCAGCCGATA","TTTAAATTATCGCTTTGGA","561307.5.peg.1398"," 444"
"4448",510,8,502,"GCAGAAACGATAGTGAAGTT","TTTAAATTATCGCTTTGGA","561307.5.peg.1398"," 444"
"4449",1,510,509,"TTATCGCTTTGGAGGGATTT","GCAGAAACGATAGTGAAGTT","561307.5.peg.1398"," 444"
"4450",800,510,290,"CATCATCACCGATTAGTTTA","GCAGAAACGATAGTGAAGTT","561307.5.peg.1398"," 444"
"4451",684,510,174,"ATGCTCATAATATCTTGCAT","GCAGAAACGATAGTGAAGTT","561307.5.peg.1398"," 444"
"4452",8,510,502,"TTTAAATTATCGCTTTGGA","GCAGAAACGATAGTGAAGTT","561307.5.peg.1398"," 444"
"4453",781,510,271,"ACGGTGTGGGTCAGCCGATA","GCAGAAACGATAGTGAAGTT","561307.5.peg.1398"," 444"
"4454",794,510,284,"CACCGATTAGTTTACGGTGT","GCAGAAACGATAGTGAAGTT","561307.5.peg.1398"," 444"
"4455",800,684,116,"CATCATCACCGATTAGTTTA","ATGCTCATAATATCTTGCAT","561307.5.peg.1398"," 444"
"4456",794,684,110,"CACCGATTAGTTTACGGTGT","ATGCTCATAATATCTTGCAT","561307.5.peg.1398"," 444"
"4457",1,684,683,"TTATCGCTTTGGAGGGATTT","ATGCTCATAATATCTTGCAT","561307.5.peg.1398"," 444"
"4458",510,684,174,"GCAGAAACGATAGTGAAGTT","ATGCTCATAATATCTTGCAT","561307.5.peg.1398"," 444"
"4459",8,684,676,"TTTAAATTATCGCTTTGGA","ATGCTCATAATATCTTGCAT","561307.5.peg.1398"," 444"
"4460",1,781,780,"TTATCGCTTTGGAGGGATTT","ACGGTGTGGGTCAGCCGATA","561307.5.peg.1398"," 444"
"4461",510,781,271,"GCAGAAACGATAGTGAAGTT","ACGGTGTGGGTCAGCCGATA","561307.5.peg.1398"," 444"
"4462",8,781,773,"TTTAAATTATCGCTTTGGA","ACGGTGTGGGTCAGCCGATA","561307.5.peg.1398"," 444"
"4463",1,794,793,"TTATCGCTTTGGAGGGATTT","CACCGATTAGTTTACGGTGT","561307.5.peg.1398"," 444"
"4464",8,794,786,"TTTAAATTATCGCTTTGGA","CACCGATTAGTTTACGGTGT","561307.5.peg.1398"," 444"
"4465",510,794,284,"GCAGAAACGATAGTGAAGTT","CACCGATTAGTTTACGGTGT","561307.5.peg.1398"," 444"
"4466",684,794,110,"ATGCTCATAATATCTTGCAT","CACCGATTAGTTTACGGTGT","561307.5.peg.1398"," 444"
"4467",8,800,792,"TTTAAATTATCGCTTTGGA","CATCATCACCGATTAGTTTA","561307.5.peg.1398"," 444"
"4468",1,800,799,"TTATCGCTTTGGAGGGATTT","CATCATCACCGATTAGTTTA","561307.5.peg.1398"," 444"
"4469",510,800,290,"GCAGAAACGATAGTGAAGTT","CATCATCACCGATTAGTTTA","561307.5.peg.1398"," 444"
"4470",684,800,116,"ATGCTCATAATATCTTGCAT","CATCATCACCGATTAGTTTA","561307.5.peg.1398"," 444"
"4471",252,119,133,"TTGTTTCTCTAACAACTTT","CTAATATTGCATCTGACACT","561307.5.peg.1399"," 445"
"4472",443,119,324,"CGTAACCAAACATTAAACCT","CTAATATTGCATCTGACACT","561307.5.peg.1399"," 445"
"4473",620,119,501,"CAATCGTATCAATACGTACT","CTAATATTGCATCTGACACT","561307.5.peg.1399"," 445"
"4474",573,119,454,"GTGACCTGAACTTTACCGTC","CTAATATTGCATCTGACACT","561307.5.peg.1399"," 445"
"4475",573,162,411,"GTGACCTGAACTTTACCGTC","TCACAAGCTACACGTGCATT","561307.5.peg.1399"," 445"
"4476",443,162,281,"CGTAACCAAACATTAAACCT","TCACAAGCTACACGTGCATT","561307.5.peg.1399"," 445"
"4477",620,162,458,"CAATCGTATCAATACGTACT","TCACAAGCTACACGTGCATT","561307.5.peg.1399"," 445"
"4478",443,217,226,"CGTAACCAAACATTAAACCT","TGTTGTTGTAGAAATTTCGC","561307.5.peg.1399"," 445"
"4479",573,217,356,"GTGACCTGAACTTTACCGTC","TGTTGTTGTAGAAATTTCGC","561307.5.peg.1399"," 445"
"4480",620,217,403,"CAATCGTATCAATACGTACT","TGTTGTTGTAGAAATTTCGC","561307.5.peg.1399"," 445"
"4481",119,252,133,"CTAATATTGCATCTGACACT","TTGTTTCTCTAACAACTTT","561307.5.peg.1399"," 445"
"4482",620,252,368,"CAATCGTATCAATACGTACT","TTGTTTCTCTAACAACTTT","561307.5.peg.1399"," 445"
"4483",443,252,191,"CGTAACCAAACATTAAACCT","TTGTTTCTCTAACAACTTT","561307.5.peg.1399"," 445"
"4484",573,252,321,"GTGACCTGAACTTTACCGTC","TTGTTTCTCTAACAACTTT","561307.5.peg.1399"," 445"
"4485",252,443,191,"TTGTTTCTCTAACAACTTT","CGTAACCAAACATTAAACCT","561307.5.peg.1399"," 445"
"4486",119,443,324,"CTAATATTGCATCTGACACT","CGTAACCAAACATTAAACCT","561307.5.peg.1399"," 445"
"4487",620,443,177,"CAATCGTATCAATACGTACT","CGTAACCAAACATTAAACCT","561307.5.peg.1399"," 445"
"4488",162,443,281,"TCACAAGCTACACGTGCATT","CGTAACCAAACATTAAACCT","561307.5.peg.1399"," 445"
"4489",217,443,226,"TGTTGTTGTAGAAATTTCGC","CGTAACCAAACATTAAACCT","561307.5.peg.1399"," 445"
"4490",573,443,130,"GTGACCTGAACTTTACCGTC","CGTAACCAAACATTAAACCT","561307.5.peg.1399"," 445"
"4491",119,573,454,"CTAATATTGCATCTGACACT","GTGACCTGAACTTTACCGTC","561307.5.peg.1399"," 445"
"4492",217,573,356,"TGTTGTTGTAGAAATTTCGC","GTGACCTGAACTTTACCGTC","561307.5.peg.1399"," 445"
"4493",162,573,411,"TCACAAGCTACACGTGCATT","GTGACCTGAACTTTACCGTC","561307.5.peg.1399"," 445"
"4494",443,573,130,"CGTAACCAAACATTAAACCT","GTGACCTGAACTTTACCGTC","561307.5.peg.1399"," 445"
"4495",252,573,321,"TTGTTTCTCTAACAACTTT","GTGACCTGAACTTTACCGTC","561307.5.peg.1399"," 445"
"4496",119,620,501,"CTAATATTGCATCTGACACT","CAATCGTATCAATACGTACT","561307.5.peg.1399"," 445"
"4497",162,620,458,"TCACAAGCTACACGTGCATT","CAATCGTATCAATACGTACT","561307.5.peg.1399"," 445"
"4498",217,620,403,"TGTTGTTGTAGAAATTTCGC","CAATCGTATCAATACGTACT","561307.5.peg.1399"," 445"
"4499",252,620,368,"TTGTTTCTCTAACAACTTT","CAATCGTATCAATACGTACT","561307.5.peg.1399"," 445"
"4500",443,620,177,"CGTAACCAAACATTAAACCT","CAATCGTATCAATACGTACT","561307.5.peg.1399"," 445"
"4501",363,10,353,"ATGGAACTTTGTCTAATAC","CCACGAATTCGTGTTCAAGG","561307.5.peg.14"," 446"
"4502",174,10,164,"TTGCTTTCTCGTTGCATTTC","CCACGAATTCGTGTTCAAGG","561307.5.peg.14"," 446"
"4503",115,10,105,"AGATGATGCGATAGCGTCAG","CCACGAATTCGTGTTCAAGG","561307.5.peg.14"," 446"
"4504",174,19,155,"TTGCTTTCTCGTTGCATTTC","CCTCCTTGAACACGAATTCG","561307.5.peg.14"," 446"
"4505",363,19,344,"ATGGAACTTTGTCTAATAC","CCTCCTTGAACACGAATTCG","561307.5.peg.14"," 446"
"4506",10,115,105,"CCACGAATTCGTGTTCAAGG","AGATGATGCGATAGCGTCAG","561307.5.peg.14"," 446"
"4507",363,115,248,"ATGGAACTTTGTCTAATAC","AGATGATGCGATAGCGTCAG","561307.5.peg.14"," 446"
"4508",10,174,164,"CCACGAATTCGTGTTCAAGG","TTGCTTTCTCGTTGCATTTC","561307.5.peg.14"," 446"
"4509",363,174,189,"ATGGAACTTTGTCTAATAC","TTGCTTTCTCGTTGCATTTC","561307.5.peg.14"," 446"
"4510",19,174,155,"CCTCCTTGAACACGAATTCG","TTGCTTTCTCGTTGCATTTC","561307.5.peg.14"," 446"
"4511",115,363,248,"AGATGATGCGATAGCGTCAG","ATGGAACTTTGTCTAATAC","561307.5.peg.14"," 446"
"4512",19,363,344,"CCTCCTTGAACACGAATTCG","ATGGAACTTTGTCTAATAC","561307.5.peg.14"," 446"
"4513",10,363,353,"CCACGAATTCGTGTTCAAGG","ATGGAACTTTGTCTAATAC","561307.5.peg.14"," 446"
"4514",174,363,189,"TTGCTTTCTCGTTGCATTTC","ATGGAACTTTGTCTAATAC","561307.5.peg.14"," 446"
"4515",393,84,309,"ATTGTAGCTGTACAACCAAC","GATGAAATTGCATCAGTGTC","561307.5.peg.140"," 447"
"4516",219,84,135,"TCTGTTAATAATTCCGGAGC","GATGAAATTGCATCAGTGTC","561307.5.peg.140"," 447"
"4517",372,84,288,"GGTTCAGCACGATAACATAA","GATGAAATTGCATCAGTGTC","561307.5.peg.140"," 447"
"4518",287,84,203,"CAATCGTATCAGAACTTTGT","GATGAAATTGCATCAGTGTC","561307.5.peg.140"," 447"
"4519",456,84,372,"AACATTAAACCGGCAATTTC","GATGAAATTGCATCAGTGTC","561307.5.peg.140"," 447"
"4520",310,84,226,"TACATGCTTAATTGTAGCAG","GATGAAATTGCATCAGTGTC","561307.5.peg.140"," 447"
"4521",372,154,218,"GGTTCAGCACGATAACATAA","ATCACCTAAACGGTATGCTT","561307.5.peg.140"," 447"
"4522",393,154,239,"ATTGTAGCTGTACAACCAAC","ATCACCTAAACGGTATGCTT","561307.5.peg.140"," 447"
"4523",310,154,156,"TACATGCTTAATTGTAGCAG","ATCACCTAAACGGTATGCTT","561307.5.peg.140"," 447"
"4524",287,154,133,"CAATCGTATCAGAACTTTGT","ATCACCTAAACGGTATGCTT","561307.5.peg.140"," 447"
"4525",456,154,302,"AACATTAAACCGGCAATTTC","ATCACCTAAACGGTATGCTT","561307.5.peg.140"," 447"
"4526",456,164,292,"AACATTAAACCGGCAATTTC","CTGCACTCACATCACCTAAA","561307.5.peg.140"," 447"
"4527",310,164,146,"TACATGCTTAATTGTAGCAG","CTGCACTCACATCACCTAAA","561307.5.peg.140"," 447"
"4528",287,164,123,"CAATCGTATCAGAACTTTGT","CTGCACTCACATCACCTAAA","561307.5.peg.140"," 447"
"4529",393,164,229,"ATTGTAGCTGTACAACCAAC","CTGCACTCACATCACCTAAA","561307.5.peg.140"," 447"
"4530",372,164,208,"GGTTCAGCACGATAACATAA","CTGCACTCACATCACCTAAA","561307.5.peg.140"," 447"
"4531",84,219,135,"GATGAAATTGCATCAGTGTC","TCTGTTAATAATTCCGGAGC","561307.5.peg.140"," 447"
"4532",456,219,237,"AACATTAAACCGGCAATTTC","TCTGTTAATAATTCCGGAGC","561307.5.peg.140"," 447"
"4533",393,219,174,"ATTGTAGCTGTACAACCAAC","TCTGTTAATAATTCCGGAGC","561307.5.peg.140"," 447"
"4534",372,219,153,"GGTTCAGCACGATAACATAA","TCTGTTAATAATTCCGGAGC","561307.5.peg.140"," 447"
"4535",154,287,133,"ATCACCTAAACGGTATGCTT","CAATCGTATCAGAACTTTGT","561307.5.peg.140"," 447"
"4536",164,287,123,"CTGCACTCACATCACCTAAA","CAATCGTATCAGAACTTTGT","561307.5.peg.140"," 447"
"4537",84,287,203,"GATGAAATTGCATCAGTGTC","CAATCGTATCAGAACTTTGT","561307.5.peg.140"," 447"
"4538",456,287,169,"AACATTAAACCGGCAATTTC","CAATCGTATCAGAACTTTGT","561307.5.peg.140"," 447"
"4539",393,287,106,"ATTGTAGCTGTACAACCAAC","CAATCGTATCAGAACTTTGT","561307.5.peg.140"," 447"
"4540",164,310,146,"CTGCACTCACATCACCTAAA","TACATGCTTAATTGTAGCAG","561307.5.peg.140"," 447"
"4541",84,310,226,"GATGAAATTGCATCAGTGTC","TACATGCTTAATTGTAGCAG","561307.5.peg.140"," 447"
"4542",456,310,146,"AACATTAAACCGGCAATTTC","TACATGCTTAATTGTAGCAG","561307.5.peg.140"," 447"
"4543",154,310,156,"ATCACCTAAACGGTATGCTT","TACATGCTTAATTGTAGCAG","561307.5.peg.140"," 447"
"4544",154,372,218,"ATCACCTAAACGGTATGCTT","GGTTCAGCACGATAACATAA","561307.5.peg.140"," 447"
"4545",84,372,288,"GATGAAATTGCATCAGTGTC","GGTTCAGCACGATAACATAA","561307.5.peg.140"," 447"
"4546",219,372,153,"TCTGTTAATAATTCCGGAGC","GGTTCAGCACGATAACATAA","561307.5.peg.140"," 447"
"4547",164,372,208,"CTGCACTCACATCACCTAAA","GGTTCAGCACGATAACATAA","561307.5.peg.140"," 447"
"4548",219,393,174,"TCTGTTAATAATTCCGGAGC","ATTGTAGCTGTACAACCAAC","561307.5.peg.140"," 447"
"4549",154,393,239,"ATCACCTAAACGGTATGCTT","ATTGTAGCTGTACAACCAAC","561307.5.peg.140"," 447"
"4550",84,393,309,"GATGAAATTGCATCAGTGTC","ATTGTAGCTGTACAACCAAC","561307.5.peg.140"," 447"
"4551",164,393,229,"CTGCACTCACATCACCTAAA","ATTGTAGCTGTACAACCAAC","561307.5.peg.140"," 447"
"4552",287,393,106,"CAATCGTATCAGAACTTTGT","ATTGTAGCTGTACAACCAAC","561307.5.peg.140"," 447"
"4553",84,456,372,"GATGAAATTGCATCAGTGTC","AACATTAAACCGGCAATTTC","561307.5.peg.140"," 447"
"4554",164,456,292,"CTGCACTCACATCACCTAAA","AACATTAAACCGGCAATTTC","561307.5.peg.140"," 447"
"4555",154,456,302,"ATCACCTAAACGGTATGCTT","AACATTAAACCGGCAATTTC","561307.5.peg.140"," 447"
"4556",219,456,237,"TCTGTTAATAATTCCGGAGC","AACATTAAACCGGCAATTTC","561307.5.peg.140"," 447"
"4557",287,456,169,"CAATCGTATCAGAACTTTGT","AACATTAAACCGGCAATTTC","561307.5.peg.140"," 447"
"4558",310,456,146,"TACATGCTTAATTGTAGCAG","AACATTAAACCGGCAATTTC","561307.5.peg.140"," 447"
"4559",232,87,145,"AATACCAGTTGACTCCAATC","AATGTCCCTAAACCAATTTG","561307.5.peg.1401"," 449"
"4560",387,87,300,"ATTACGGCTTCGTTCGTACC","AATGTCCCTAAACCAATTTG","561307.5.peg.1401"," 449"
"4561",87,232,145,"AATGTCCCTAAACCAATTTG","AATACCAGTTGACTCCAATC","561307.5.peg.1401"," 449"
"4562",387,232,155,"ATTACGGCTTCGTTCGTACC","AATACCAGTTGACTCCAATC","561307.5.peg.1401"," 449"
"4563",87,387,300,"AATGTCCCTAAACCAATTTG","ATTACGGCTTCGTTCGTACC","561307.5.peg.1401"," 449"
"4564",232,387,155,"AATACCAGTTGACTCCAATC","ATTACGGCTTCGTTCGTACC","561307.5.peg.1401"," 449"
"4565",206,93,113,"CTGTAATCATTTCGAAACCA","ACTGCAGCAGTCATACCAGC","561307.5.peg.1402"," 450"
"4566",411,93,318,"CCACCAAGTTCTTGTTCACC","ACTGCAGCAGTCATACCAGC","561307.5.peg.1402"," 450"
"4567",488,93,395,"CACCACCACCGATAACGAAT","ACTGCAGCAGTCATACCAGC","561307.5.peg.1402"," 450"
"4568",488,165,323,"CACCACCACCGATAACGAAT","GTATTAGCCATTTGACCGCC","561307.5.peg.1402"," 450"
"4569",411,165,246,"CCACCAAGTTCTTGTTCACC","GTATTAGCCATTTGACCGCC","561307.5.peg.1402"," 450"
"4570",93,206,113,"ACTGCAGCAGTCATACCAGC","CTGTAATCATTTCGAAACCA","561307.5.peg.1402"," 450"
"4571",411,206,205,"CCACCAAGTTCTTGTTCACC","CTGTAATCATTTCGAAACCA","561307.5.peg.1402"," 450"
"4572",488,206,282,"CACCACCACCGATAACGAAT","CTGTAATCATTTCGAAACCA","561307.5.peg.1402"," 450"
"4573",93,411,318,"ACTGCAGCAGTCATACCAGC","CCACCAAGTTCTTGTTCACC","561307.5.peg.1402"," 450"
"4574",206,411,205,"CTGTAATCATTTCGAAACCA","CCACCAAGTTCTTGTTCACC","561307.5.peg.1402"," 450"
"4575",165,411,246,"GTATTAGCCATTTGACCGCC","CCACCAAGTTCTTGTTCACC","561307.5.peg.1402"," 450"
"4576",93,488,395,"ACTGCAGCAGTCATACCAGC","CACCACCACCGATAACGAAT","561307.5.peg.1402"," 450"
"4577",165,488,323,"GTATTAGCCATTTGACCGCC","CACCACCACCGATAACGAAT","561307.5.peg.1402"," 450"
"4578",206,488,282,"CTGTAATCATTTCGAAACCA","CACCACCACCGATAACGAAT","561307.5.peg.1402"," 450"
"4579",345,186,159,"CCAAACAAGAATGCCTTGTT","TTTGAATTTCCAGATCATC","561307.5.peg.1403"," 451"
"4580",555,186,369,"CGATGATCTTGAACTTCTTG","TTTGAATTTCCAGATCATC","561307.5.peg.1403"," 451"
"4581",186,345,159,"TTTGAATTTCCAGATCATC","CCAAACAAGAATGCCTTGTT","561307.5.peg.1403"," 451"
"4582",555,345,210,"CGATGATCTTGAACTTCTTG","CCAAACAAGAATGCCTTGTT","561307.5.peg.1403"," 451"
"4583",186,555,369,"TTTGAATTTCCAGATCATC","CGATGATCTTGAACTTCTTG","561307.5.peg.1403"," 451"
"4584",345,555,210,"CCAAACAAGAATGCCTTGTT","CGATGATCTTGAACTTCTTG","561307.5.peg.1403"," 451"
"4585",401,5,396,"CGATATCACCAATTTGAAAT","CAGTCATAAGAGTGAGGAGT","561307.5.peg.1405"," 453"
"4586",272,5,267,"TTTCCGCGTAATATGGCCAT","CAGTCATAAGAGTGAGGAGT","561307.5.peg.1405"," 453"
"4587",401,11,390,"CGATATCACCAATTTGAAAT","CAAGAACAGTCATAAGAGTG","561307.5.peg.1405"," 453"
"4588",272,11,261,"TTTCCGCGTAATATGGCCAT","CAAGAACAGTCATAAGAGTG","561307.5.peg.1405"," 453"
"4589",272,78,194,"TTTCCGCGTAATATGGCCAT","GGTCCTAAGTTAAATGCCAC","561307.5.peg.1405"," 453"
"4590",401,78,323,"CGATATCACCAATTTGAAAT","GGTCCTAAGTTAAATGCCAC","561307.5.peg.1405"," 453"
"4591",401,99,302,"CGATATCACCAATTTGAAAT","CCATACCATCGTACACTCAG","561307.5.peg.1405"," 453"
"4592",272,99,173,"TTTCCGCGTAATATGGCCAT","CCATACCATCGTACACTCAG","561307.5.peg.1405"," 453"
"4593",5,272,267,"CAGTCATAAGAGTGAGGAGT","TTTCCGCGTAATATGGCCAT","561307.5.peg.1405"," 453"
"4594",78,272,194,"GGTCCTAAGTTAAATGCCAC","TTTCCGCGTAATATGGCCAT","561307.5.peg.1405"," 453"
"4595",99,272,173,"CCATACCATCGTACACTCAG","TTTCCGCGTAATATGGCCAT","561307.5.peg.1405"," 453"
"4596",11,272,261,"CAAGAACAGTCATAAGAGTG","TTTCCGCGTAATATGGCCAT","561307.5.peg.1405"," 453"
"4597",401,272,129,"CGATATCACCAATTTGAAAT","TTTCCGCGTAATATGGCCAT","561307.5.peg.1405"," 453"
"4598",5,401,396,"CAGTCATAAGAGTGAGGAGT","CGATATCACCAATTTGAAAT","561307.5.peg.1405"," 453"
"4599",11,401,390,"CAAGAACAGTCATAAGAGTG","CGATATCACCAATTTGAAAT","561307.5.peg.1405"," 453"
"4600",99,401,302,"CCATACCATCGTACACTCAG","CGATATCACCAATTTGAAAT","561307.5.peg.1405"," 453"
"4601",78,401,323,"GGTCCTAAGTTAAATGCCAC","CGATATCACCAATTTGAAAT","561307.5.peg.1405"," 453"
"4602",272,401,129,"TTTCCGCGTAATATGGCCAT","CGATATCACCAATTTGAAAT","561307.5.peg.1405"," 453"
"4603",150,24,126,"TAACCTGCCATCTCTAAGCC","TAAGAAGAGATGTAAGAGTA","561307.5.peg.1406"," 454"
"4604",285,24,261,"ACAATAATTGCAGGCGTTTC","TAAGAAGAGATGTAAGAGTA","561307.5.peg.1406"," 454"
"4605",243,24,219,"CGACCTGCGCGATCCTTATC","TAAGAAGAGATGTAAGAGTA","561307.5.peg.1406"," 454"
"4606",294,24,270,"CCACGTGTCACAATAATTGC","TAAGAAGAGATGTAAGAGTA","561307.5.peg.1406"," 454"
"4607",366,24,342,"GCATCTTTAGCAACTATAAG","TAAGAAGAGATGTAAGAGTA","561307.5.peg.1406"," 454"
"4608",364,24,340,"ATCTTTAGCAACTATAAGTG","TAAGAAGAGATGTAAGAGTA","561307.5.peg.1406"," 454"
"4609",24,150,126,"TAAGAAGAGATGTAAGAGTA","TAACCTGCCATCTCTAAGCC","561307.5.peg.1406"," 454"
"4610",366,150,216,"GCATCTTTAGCAACTATAAG","TAACCTGCCATCTCTAAGCC","561307.5.peg.1406"," 454"
"4611",364,150,214,"ATCTTTAGCAACTATAAGTG","TAACCTGCCATCTCTAAGCC","561307.5.peg.1406"," 454"
"4612",285,150,135,"ACAATAATTGCAGGCGTTTC","TAACCTGCCATCTCTAAGCC","561307.5.peg.1406"," 454"
"4613",294,150,144,"CCACGTGTCACAATAATTGC","TAACCTGCCATCTCTAAGCC","561307.5.peg.1406"," 454"
"4614",364,243,121,"ATCTTTAGCAACTATAAGTG","CGACCTGCGCGATCCTTATC","561307.5.peg.1406"," 454"
"4615",24,243,219,"TAAGAAGAGATGTAAGAGTA","CGACCTGCGCGATCCTTATC","561307.5.peg.1406"," 454"
"4616",366,243,123,"GCATCTTTAGCAACTATAAG","CGACCTGCGCGATCCTTATC","561307.5.peg.1406"," 454"
"4617",24,285,261,"TAAGAAGAGATGTAAGAGTA","ACAATAATTGCAGGCGTTTC","561307.5.peg.1406"," 454"
"4618",150,285,135,"TAACCTGCCATCTCTAAGCC","ACAATAATTGCAGGCGTTTC","561307.5.peg.1406"," 454"
"4619",24,294,270,"TAAGAAGAGATGTAAGAGTA","CCACGTGTCACAATAATTGC","561307.5.peg.1406"," 454"
"4620",150,294,144,"TAACCTGCCATCTCTAAGCC","CCACGTGTCACAATAATTGC","561307.5.peg.1406"," 454"
"4621",150,364,214,"TAACCTGCCATCTCTAAGCC","ATCTTTAGCAACTATAAGTG","561307.5.peg.1406"," 454"
"4622",24,364,340,"TAAGAAGAGATGTAAGAGTA","ATCTTTAGCAACTATAAGTG","561307.5.peg.1406"," 454"
"4623",243,364,121,"CGACCTGCGCGATCCTTATC","ATCTTTAGCAACTATAAGTG","561307.5.peg.1406"," 454"
"4624",150,366,216,"TAACCTGCCATCTCTAAGCC","GCATCTTTAGCAACTATAAG","561307.5.peg.1406"," 454"
"4625",24,366,342,"TAAGAAGAGATGTAAGAGTA","GCATCTTTAGCAACTATAAG","561307.5.peg.1406"," 454"
"4626",243,366,123,"CGACCTGCGCGATCCTTATC","GCATCTTTAGCAACTATAAG","561307.5.peg.1406"," 454"
"4627",413,282,131,"TATCAGTCCACGAGTCATAT","TATCTAGAGACAGTCGTCTC","561307.5.peg.1412"," 461"
"4628",413,309,104,"TATCAGTCCACGAGTCATAT","TGTTTCAACTCAGCCTTATC","561307.5.peg.1412"," 461"
"4629",282,413,131,"TATCTAGAGACAGTCGTCTC","TATCAGTCCACGAGTCATAT","561307.5.peg.1412"," 461"
"4630",309,413,104,"TGTTTCAACTCAGCCTTATC","TATCAGTCCACGAGTCATAT","561307.5.peg.1412"," 461"
"4631",227,126,101,"GATCTTCAATCGCGCGTTTG","AAGATAGGAAGCATTTCCTT","561307.5.peg.1414"," 463"
"4632",423,126,297,"TCACCTAATAATACCGCAAA","AAGATAGGAAGCATTTCCTT","561307.5.peg.1414"," 463"
"4633",423,156,267,"TCACCTAATAATACCGCAAA","CAACGATATATTGTATTGT","561307.5.peg.1414"," 463"
"4634",126,227,101,"AAGATAGGAAGCATTTCCTT","GATCTTCAATCGCGCGTTTG","561307.5.peg.1414"," 463"
"4635",423,227,196,"TCACCTAATAATACCGCAAA","GATCTTCAATCGCGCGTTTG","561307.5.peg.1414"," 463"
"4636",126,423,297,"AAGATAGGAAGCATTTCCTT","TCACCTAATAATACCGCAAA","561307.5.peg.1414"," 463"
"4637",156,423,267,"CAACGATATATTGTATTGT","TCACCTAATAATACCGCAAA","561307.5.peg.1414"," 463"
"4638",227,423,196,"GATCTTCAATCGCGCGTTTG","TCACCTAATAATACCGCAAA","561307.5.peg.1414"," 463"
"4639",430,165,265,"ACCACTCACTACATTCTTAA","CAAATATCATACGTCCCTTT","561307.5.peg.142"," 469"
"4640",430,248,182,"ACCACTCACTACATTCTTAA","ATAAAGGACCAGAATGACAT","561307.5.peg.142"," 469"
"4641",165,430,265,"CAAATATCATACGTCCCTTT","ACCACTCACTACATTCTTAA","561307.5.peg.142"," 469"
"4642",248,430,182,"ATAAAGGACCAGAATGACAT","ACCACTCACTACATTCTTAA","561307.5.peg.142"," 469"
"4643",264,123,141,"GCGTGTTGGGCATTTGTTTG","GTAGGTAATGCATGGCCACT","561307.5.peg.1423"," 473"
"4644",277,123,154,"ATCCATACTTGAAGCGTGTT","GTAGGTAATGCATGGCCACT","561307.5.peg.1423"," 473"
"4645",312,123,189,"GCTAGCAATATTTGATCAAG","GTAGGTAATGCATGGCCACT","561307.5.peg.1423"," 473"
"4646",123,264,141,"GTAGGTAATGCATGGCCACT","GCGTGTTGGGCATTTGTTTG","561307.5.peg.1423"," 473"
"4647",123,277,154,"GTAGGTAATGCATGGCCACT","ATCCATACTTGAAGCGTGTT","561307.5.peg.1423"," 473"
"4648",123,312,189,"GTAGGTAATGCATGGCCACT","GCTAGCAATATTTGATCAAG","561307.5.peg.1423"," 473"
"4649",114,9,105,"TTAGCTCTTAACGGATCTCC","TCACTATACAAATATTGGG","561307.5.peg.1424"," 474"
"4650",123,9,114,"GCAATGAACTTAGCTCTTAA","TCACTATACAAATATTGGG","561307.5.peg.1424"," 474"
"4651",9,114,105,"TCACTATACAAATATTGGG","TTAGCTCTTAACGGATCTCC","561307.5.peg.1424"," 474"
"4652",9,123,114,"TCACTATACAAATATTGGG","GCAATGAACTTAGCTCTTAA","561307.5.peg.1424"," 474"
"4653",382,211,171,"TGTCTCTGCAGCAGCTAAAC","GCCAATACCAATTACTAAAC","561307.5.peg.1425"," 475"
"4654",458,211,247,"AACTGCTCGTACTTAAGCCA","GCCAATACCAATTACTAAAC","561307.5.peg.1425"," 475"
"4655",335,211,124,"AAGTAATGGGAATTGATGT","GCCAATACCAATTACTAAAC","561307.5.peg.1425"," 475"
"4656",484,211,273,"TGTACCGATAACTAATGACA","GCCAATACCAATTACTAAAC","561307.5.peg.1425"," 475"
"4657",458,262,196,"AACTGCTCGTACTTAAGCCA","AATAGTGTGCGTATACTAA","561307.5.peg.1425"," 475"
"4658",484,262,222,"TGTACCGATAACTAATGACA","AATAGTGTGCGTATACTAA","561307.5.peg.1425"," 475"
"4659",382,262,120,"TGTCTCTGCAGCAGCTAAAC","AATAGTGTGCGTATACTAA","561307.5.peg.1425"," 475"
"4660",484,335,149,"TGTACCGATAACTAATGACA","AAGTAATGGGAATTGATGT","561307.5.peg.1425"," 475"
"4661",211,335,124,"GCCAATACCAATTACTAAAC","AAGTAATGGGAATTGATGT","561307.5.peg.1425"," 475"
"4662",458,335,123,"AACTGCTCGTACTTAAGCCA","AAGTAATGGGAATTGATGT","561307.5.peg.1425"," 475"
"4663",262,382,120,"AATAGTGTGCGTATACTAA","TGTCTCTGCAGCAGCTAAAC","561307.5.peg.1425"," 475"
"4664",484,382,102,"TGTACCGATAACTAATGACA","TGTCTCTGCAGCAGCTAAAC","561307.5.peg.1425"," 475"
"4665",211,382,171,"GCCAATACCAATTACTAAAC","TGTCTCTGCAGCAGCTAAAC","561307.5.peg.1425"," 475"
"4666",211,458,247,"GCCAATACCAATTACTAAAC","AACTGCTCGTACTTAAGCCA","561307.5.peg.1425"," 475"
"4667",262,458,196,"AATAGTGTGCGTATACTAA","AACTGCTCGTACTTAAGCCA","561307.5.peg.1425"," 475"
"4668",335,458,123,"AAGTAATGGGAATTGATGT","AACTGCTCGTACTTAAGCCA","561307.5.peg.1425"," 475"
"4669",262,484,222,"AATAGTGTGCGTATACTAA","TGTACCGATAACTAATGACA","561307.5.peg.1425"," 475"
"4670",211,484,273,"GCCAATACCAATTACTAAAC","TGTACCGATAACTAATGACA","561307.5.peg.1425"," 475"
"4671",335,484,149,"AAGTAATGGGAATTGATGT","TGTACCGATAACTAATGACA","561307.5.peg.1425"," 475"
"4672",382,484,102,"TGTCTCTGCAGCAGCTAAAC","TGTACCGATAACTAATGACA","561307.5.peg.1425"," 475"
"4673",513,397,116,"TCATCAATACCCATCATATC","ACCGACACCACCTTTACCGG","561307.5.peg.1426"," 476"
"4674",513,400,113,"TCATCAATACCCATCATATC","TTTACCGACACCACCTTTAC","561307.5.peg.1426"," 476"
"4675",397,513,116,"ACCGACACCACCTTTACCGG","TCATCAATACCCATCATATC","561307.5.peg.1426"," 476"
"4676",400,513,113,"TTTACCGACACCACCTTTAC","TCATCAATACCCATCATATC","561307.5.peg.1426"," 476"
"4677",447,195,252,"GTAACTGTAGGTCCTATTGC","TCCATTAGATATGCCGTCAG","561307.5.peg.1427"," 477"
"4678",684,195,489,"ATCAACGCACCTATTACTAT","TCCATTAGATATGCCGTCAG","561307.5.peg.1427"," 477"
"4679",447,234,213,"GTAACTGTAGGTCCTATTGC","CCCATCGCCGCTAAGTATAA","561307.5.peg.1427"," 477"
"4680",684,234,450,"ATCAACGCACCTATTACTAT","CCCATCGCCGCTAAGTATAA","561307.5.peg.1427"," 477"
"4681",195,447,252,"TCCATTAGATATGCCGTCAG","GTAACTGTAGGTCCTATTGC","561307.5.peg.1427"," 477"
"4682",684,447,237,"ATCAACGCACCTATTACTAT","GTAACTGTAGGTCCTATTGC","561307.5.peg.1427"," 477"
"4683",234,447,213,"CCCATCGCCGCTAAGTATAA","GTAACTGTAGGTCCTATTGC","561307.5.peg.1427"," 477"
"4684",234,684,450,"CCCATCGCCGCTAAGTATAA","ATCAACGCACCTATTACTAT","561307.5.peg.1427"," 477"
"4685",195,684,489,"TCCATTAGATATGCCGTCAG","ATCAACGCACCTATTACTAT","561307.5.peg.1427"," 477"
"4686",447,684,237,"GTAACTGTAGGTCCTATTGC","ATCAACGCACCTATTACTAT","561307.5.peg.1427"," 477"
"4687",204,7,197,"CCTTTCCAAGGTAAGTCTTG","TTGTCATAATCATCATGAGG","561307.5.peg.143"," 480"
"4688",324,7,317,"GGTGTAAGTATATGACCTAA","TTGTCATAATCATCATGAGG","561307.5.peg.143"," 480"
"4689",129,7,122,"ATAAGTTGTCCCGCACTAAA","TTGTCATAATCATCATGAGG","561307.5.peg.143"," 480"
"4690",345,7,338,"TATTCGGATGATACTTGTTC","TTGTCATAATCATCATGAGG","561307.5.peg.143"," 480"
"4691",7,129,122,"TTGTCATAATCATCATGAGG","ATAAGTTGTCCCGCACTAAA","561307.5.peg.143"," 480"
"4692",324,129,195,"GGTGTAAGTATATGACCTAA","ATAAGTTGTCCCGCACTAAA","561307.5.peg.143"," 480"
"4693",345,129,216,"TATTCGGATGATACTTGTTC","ATAAGTTGTCCCGCACTAAA","561307.5.peg.143"," 480"
"4694",7,204,197,"TTGTCATAATCATCATGAGG","CCTTTCCAAGGTAAGTCTTG","561307.5.peg.143"," 480"
"4695",324,204,120,"GGTGTAAGTATATGACCTAA","CCTTTCCAAGGTAAGTCTTG","561307.5.peg.143"," 480"
"4696",345,204,141,"TATTCGGATGATACTTGTTC","CCTTTCCAAGGTAAGTCTTG","561307.5.peg.143"," 480"
"4697",204,324,120,"CCTTTCCAAGGTAAGTCTTG","GGTGTAAGTATATGACCTAA","561307.5.peg.143"," 480"
"4698",7,324,317,"TTGTCATAATCATCATGAGG","GGTGTAAGTATATGACCTAA","561307.5.peg.143"," 480"
"4699",129,324,195,"ATAAGTTGTCCCGCACTAAA","GGTGTAAGTATATGACCTAA","561307.5.peg.143"," 480"
"4700",7,345,338,"TTGTCATAATCATCATGAGG","TATTCGGATGATACTTGTTC","561307.5.peg.143"," 480"
"4701",129,345,216,"ATAAGTTGTCCCGCACTAAA","TATTCGGATGATACTTGTTC","561307.5.peg.143"," 480"
"4702",204,345,141,"CCTTTCCAAGGTAAGTCTTG","TATTCGGATGATACTTGTTC","561307.5.peg.143"," 480"
"4703",511,23,488,"ATTACCGCCATCCGCCACAA","CTGTGCACCCCATATTCTAT","561307.5.peg.1430"," 481"
"4704",246,23,223,"ATTATTGTCTGTTGACCAGT","CTGTGCACCCCATATTCTAT","561307.5.peg.1430"," 481"
"4705",615,23,592,"AATTTCTGCCAAGCAGCATA","CTGTGCACCCCATATTCTAT","561307.5.peg.1430"," 481"
"4706",759,23,736,"CTATTAAAGTATCTAACCT","CTGTGCACCCCATATTCTAT","561307.5.peg.1430"," 481"
"4707",939,23,916,"TCTCCTGTCCAAACATTTAT","CTGTGCACCCCATATTCTAT","561307.5.peg.1430"," 481"
"4708",23,246,223,"CTGTGCACCCCATATTCTAT","ATTATTGTCTGTTGACCAGT","561307.5.peg.1430"," 481"
"4709",759,246,513,"CTATTAAAGTATCTAACCT","ATTATTGTCTGTTGACCAGT","561307.5.peg.1430"," 481"
"4710",939,246,693,"TCTCCTGTCCAAACATTTAT","ATTATTGTCTGTTGACCAGT","561307.5.peg.1430"," 481"
"4711",511,246,265,"ATTACCGCCATCCGCCACAA","ATTATTGTCTGTTGACCAGT","561307.5.peg.1430"," 481"
"4712",615,246,369,"AATTTCTGCCAAGCAGCATA","ATTATTGTCTGTTGACCAGT","561307.5.peg.1430"," 481"
"4713",23,511,488,"CTGTGCACCCCATATTCTAT","ATTACCGCCATCCGCCACAA","561307.5.peg.1430"," 481"
"4714",615,511,104,"AATTTCTGCCAAGCAGCATA","ATTACCGCCATCCGCCACAA","561307.5.peg.1430"," 481"
"4715",246,511,265,"ATTATTGTCTGTTGACCAGT","ATTACCGCCATCCGCCACAA","561307.5.peg.1430"," 481"
"4716",939,511,428,"TCTCCTGTCCAAACATTTAT","ATTACCGCCATCCGCCACAA","561307.5.peg.1430"," 481"
"4717",759,511,248,"CTATTAAAGTATCTAACCT","ATTACCGCCATCCGCCACAA","561307.5.peg.1430"," 481"
"4718",23,615,592,"CTGTGCACCCCATATTCTAT","AATTTCTGCCAAGCAGCATA","561307.5.peg.1430"," 481"
"4719",246,615,369,"ATTATTGTCTGTTGACCAGT","AATTTCTGCCAAGCAGCATA","561307.5.peg.1430"," 481"
"4720",511,615,104,"ATTACCGCCATCCGCCACAA","AATTTCTGCCAAGCAGCATA","561307.5.peg.1430"," 481"
"4721",759,615,144,"CTATTAAAGTATCTAACCT","AATTTCTGCCAAGCAGCATA","561307.5.peg.1430"," 481"
"4722",939,615,324,"TCTCCTGTCCAAACATTTAT","AATTTCTGCCAAGCAGCATA","561307.5.peg.1430"," 481"
"4723",246,759,513,"ATTATTGTCTGTTGACCAGT","CTATTAAAGTATCTAACCT","561307.5.peg.1430"," 481"
"4724",511,759,248,"ATTACCGCCATCCGCCACAA","CTATTAAAGTATCTAACCT","561307.5.peg.1430"," 481"
"4725",939,759,180,"TCTCCTGTCCAAACATTTAT","CTATTAAAGTATCTAACCT","561307.5.peg.1430"," 481"
"4726",23,759,736,"CTGTGCACCCCATATTCTAT","CTATTAAAGTATCTAACCT","561307.5.peg.1430"," 481"
"4727",615,759,144,"AATTTCTGCCAAGCAGCATA","CTATTAAAGTATCTAACCT","561307.5.peg.1430"," 481"
"4728",759,939,180,"CTATTAAAGTATCTAACCT","TCTCCTGTCCAAACATTTAT","561307.5.peg.1430"," 481"
"4729",23,939,916,"CTGTGCACCCCATATTCTAT","TCTCCTGTCCAAACATTTAT","561307.5.peg.1430"," 481"
"4730",615,939,324,"AATTTCTGCCAAGCAGCATA","TCTCCTGTCCAAACATTTAT","561307.5.peg.1430"," 481"
"4731",511,939,428,"ATTACCGCCATCCGCCACAA","TCTCCTGTCCAAACATTTAT","561307.5.peg.1430"," 481"
"4732",246,939,693,"ATTATTGTCTGTTGACCAGT","TCTCCTGTCCAAACATTTAT","561307.5.peg.1430"," 481"
"4733",756,100,656,"ACCCCATAATATTCTGGGTT","CTTCAAGGTAATCGTTATTA","561307.5.peg.1432"," 483"
"4734",761,100,661,"TTGCCACCCCATAATATTCT","CTTCAAGGTAATCGTTATTA","561307.5.peg.1432"," 483"
"4735",362,100,262,"TAGATTCTACGTTACCTACT","CTTCAAGGTAATCGTTATTA","561307.5.peg.1432"," 483"
"4736",516,100,416,"ACTGAAGCCGCCATTACGAC","CTTCAAGGTAATCGTTATTA","561307.5.peg.1432"," 483"
"4737",516,198,318,"ACTGAAGCCGCCATTACGAC","ACCAGTGCTACTAAACTATA","561307.5.peg.1432"," 483"
"4738",362,198,164,"TAGATTCTACGTTACCTACT","ACCAGTGCTACTAAACTATA","561307.5.peg.1432"," 483"
"4739",761,198,563,"TTGCCACCCCATAATATTCT","ACCAGTGCTACTAAACTATA","561307.5.peg.1432"," 483"
"4740",756,198,558,"ACCCCATAATATTCTGGGTT","ACCAGTGCTACTAAACTATA","561307.5.peg.1432"," 483"
"4741",100,362,262,"CTTCAAGGTAATCGTTATTA","TAGATTCTACGTTACCTACT","561307.5.peg.1432"," 483"
"4742",516,362,154,"ACTGAAGCCGCCATTACGAC","TAGATTCTACGTTACCTACT","561307.5.peg.1432"," 483"
"4743",198,362,164,"ACCAGTGCTACTAAACTATA","TAGATTCTACGTTACCTACT","561307.5.peg.1432"," 483"
"4744",756,362,394,"ACCCCATAATATTCTGGGTT","TAGATTCTACGTTACCTACT","561307.5.peg.1432"," 483"
"4745",761,362,399,"TTGCCACCCCATAATATTCT","TAGATTCTACGTTACCTACT","561307.5.peg.1432"," 483"
"4746",100,516,416,"CTTCAAGGTAATCGTTATTA","ACTGAAGCCGCCATTACGAC","561307.5.peg.1432"," 483"
"4747",198,516,318,"ACCAGTGCTACTAAACTATA","ACTGAAGCCGCCATTACGAC","561307.5.peg.1432"," 483"
"4748",362,516,154,"TAGATTCTACGTTACCTACT","ACTGAAGCCGCCATTACGAC","561307.5.peg.1432"," 483"
"4749",761,516,245,"TTGCCACCCCATAATATTCT","ACTGAAGCCGCCATTACGAC","561307.5.peg.1432"," 483"
"4750",756,516,240,"ACCCCATAATATTCTGGGTT","ACTGAAGCCGCCATTACGAC","561307.5.peg.1432"," 483"
"4751",100,756,656,"CTTCAAGGTAATCGTTATTA","ACCCCATAATATTCTGGGTT","561307.5.peg.1432"," 483"
"4752",362,756,394,"TAGATTCTACGTTACCTACT","ACCCCATAATATTCTGGGTT","561307.5.peg.1432"," 483"
"4753",198,756,558,"ACCAGTGCTACTAAACTATA","ACCCCATAATATTCTGGGTT","561307.5.peg.1432"," 483"
"4754",516,756,240,"ACTGAAGCCGCCATTACGAC","ACCCCATAATATTCTGGGTT","561307.5.peg.1432"," 483"
"4755",100,761,661,"CTTCAAGGTAATCGTTATTA","TTGCCACCCCATAATATTCT","561307.5.peg.1432"," 483"
"4756",198,761,563,"ACCAGTGCTACTAAACTATA","TTGCCACCCCATAATATTCT","561307.5.peg.1432"," 483"
"4757",516,761,245,"ACTGAAGCCGCCATTACGAC","TTGCCACCCCATAATATTCT","561307.5.peg.1432"," 483"
"4758",362,761,399,"TAGATTCTACGTTACCTACT","TTGCCACCCCATAATATTCT","561307.5.peg.1432"," 483"
"4759",252,135,117,"CCTGCTAATGCAATCAGCGT","AAAGTATCAAGTGCACCACA","561307.5.peg.1433"," 484"
"4760",135,252,117,"AAAGTATCAAGTGCACCACA","CCTGCTAATGCAATCAGCGT","561307.5.peg.1433"," 484"
"4761",189,28,161,"ATCATCATGTCTGATTCTGA","TGTACACCTCTTCAATATT","561307.5.peg.1434"," 485"
"4762",189,74,115,"ATCATCATGTCTGATTCTGA","CAATTGCGACTACAATGGCT","561307.5.peg.1434"," 485"
"4763",28,189,161,"TGTACACCTCTTCAATATT","ATCATCATGTCTGATTCTGA","561307.5.peg.1434"," 485"
"4764",74,189,115,"CAATTGCGACTACAATGGCT","ATCATCATGTCTGATTCTGA","561307.5.peg.1434"," 485"
"4765",315,92,223,"AAGTTGGATTAACTACTTT","AGTATGATAAGTAAGTCTA","561307.5.peg.1435"," 486"
"4766",92,315,223,"AGTATGATAAGTAAGTCTA","AAGTTGGATTAACTACTTT","561307.5.peg.1435"," 486"
"4767",276,79,197,"TCATGTTGTGTTAATGCGTT","ACCACCACTAAAGACAACGA","561307.5.peg.1438"," 489"
"4768",79,276,197,"ACCACCACTAAAGACAACGA","TCATGTTGTGTTAATGCGTT","561307.5.peg.1438"," 489"
"4769",366,10,356,"TTTGTTGTTTGACTGATTGC","CTTAATGATGGAAAGGGCAC","561307.5.peg.144"," 491"
"4770",366,16,350,"TTTGTTGTTTGACTGATTGC","ACTAACTTAATGATGGAAA","561307.5.peg.144"," 491"
"4771",366,22,344,"TTTGTTGTTTGACTGATTGC","CACCTCTACTAACTTAATGA","561307.5.peg.144"," 491"
"4772",10,366,356,"CTTAATGATGGAAAGGGCAC","TTTGTTGTTTGACTGATTGC","561307.5.peg.144"," 491"
"4773",16,366,350,"ACTAACTTAATGATGGAAA","TTTGTTGTTTGACTGATTGC","561307.5.peg.144"," 491"
"4774",22,366,344,"CACCTCTACTAACTTAATGA","TTTGTTGTTTGACTGATTGC","561307.5.peg.144"," 491"
"4775",275,9,266,"TACCACCAGAAATTGTAACG","CGTATTTAGACCAAAGGAAC","561307.5.peg.1440"," 492"
"4776",275,15,260,"TACCACCAGAAATTGTAACG","TATGTCGTATTTAGACCAA","561307.5.peg.1440"," 492"
"4777",275,30,245,"TACCACCAGAAATTGTAACG","ATTAGTTACACCTGTTCCTT","561307.5.peg.1440"," 492"
"4778",275,63,212,"TACCACCAGAAATTGTAACG","GGACCGAATATTTCGAGTAC","561307.5.peg.1440"," 492"
"4779",275,84,191,"TACCACCAGAAATTGTAACG","CGACCTTCACCCTGAATGGT","561307.5.peg.1440"," 492"
"4780",275,88,187,"TACCACCAGAAATTGTAACG","TACTCGACCTTCACCCTGAA","561307.5.peg.1440"," 492"
"4781",9,275,266,"CGTATTTAGACCAAAGGAAC","TACCACCAGAAATTGTAACG","561307.5.peg.1440"," 492"
"4782",15,275,260,"TATGTCGTATTTAGACCAA","TACCACCAGAAATTGTAACG","561307.5.peg.1440"," 492"
"4783",30,275,245,"ATTAGTTACACCTGTTCCTT","TACCACCAGAAATTGTAACG","561307.5.peg.1440"," 492"
"4784",63,275,212,"GGACCGAATATTTCGAGTAC","TACCACCAGAAATTGTAACG","561307.5.peg.1440"," 492"
"4785",84,275,191,"CGACCTTCACCCTGAATGGT","TACCACCAGAAATTGTAACG","561307.5.peg.1440"," 492"
"4786",88,275,187,"TACTCGACCTTCACCCTGAA","TACCACCAGAAATTGTAACG","561307.5.peg.1440"," 492"
"4787",269,12,257,"TGGCAGTTAAATAGATAAAG","TTTAGAGGTCGTAAGAACAG","561307.5.peg.1444"," 496"
"4788",310,12,298,"ACCTAAAGTTAAGGCGTAAA","TTTAGAGGTCGTAAGAACAG","561307.5.peg.1444"," 496"
"4789",319,12,307,"GTCATCTGCACCTAAAGTTA","TTTAGAGGTCGTAAGAACAG","561307.5.peg.1444"," 496"
"4790",354,12,342,"ACGAGTTCCCTTGGACTAAA","TTTAGAGGTCGTAAGAACAG","561307.5.peg.1444"," 496"
"4791",269,55,214,"TGGCAGTTAAATAGATAAAG","ATCATCCACGATCAGTAAGT","561307.5.peg.1444"," 496"
"4792",310,55,255,"ACCTAAAGTTAAGGCGTAAA","ATCATCCACGATCAGTAAGT","561307.5.peg.1444"," 496"
"4793",319,55,264,"GTCATCTGCACCTAAAGTTA","ATCATCCACGATCAGTAAGT","561307.5.peg.1444"," 496"
"4794",354,55,299,"ACGAGTTCCCTTGGACTAAA","ATCATCCACGATCAGTAAGT","561307.5.peg.1444"," 496"
"4795",12,269,257,"TTTAGAGGTCGTAAGAACAG","TGGCAGTTAAATAGATAAAG","561307.5.peg.1444"," 496"
"4796",55,269,214,"ATCATCCACGATCAGTAAGT","TGGCAGTTAAATAGATAAAG","561307.5.peg.1444"," 496"
"4797",12,310,298,"TTTAGAGGTCGTAAGAACAG","ACCTAAAGTTAAGGCGTAAA","561307.5.peg.1444"," 496"
"4798",55,310,255,"ATCATCCACGATCAGTAAGT","ACCTAAAGTTAAGGCGTAAA","561307.5.peg.1444"," 496"
"4799",12,319,307,"TTTAGAGGTCGTAAGAACAG","GTCATCTGCACCTAAAGTTA","561307.5.peg.1444"," 496"
"4800",55,319,264,"ATCATCCACGATCAGTAAGT","GTCATCTGCACCTAAAGTTA","561307.5.peg.1444"," 496"
"4801",12,354,342,"TTTAGAGGTCGTAAGAACAG","ACGAGTTCCCTTGGACTAAA","561307.5.peg.1444"," 496"
"4802",55,354,299,"ATCATCCACGATCAGTAAGT","ACGAGTTCCCTTGGACTAAA","561307.5.peg.1444"," 496"
"4803",155,2,153,"AGGTCAAAGTTAGTGTCATA","TAATCCCCATACAGTTGTGA","561307.5.peg.1445"," 497"
"4804",155,25,130,"AGGTCAAAGTTAGTGTCATA","ATCACAACTGTATGGGGATT","561307.5.peg.1445"," 497"
"4805",155,31,124,"AGGTCAAAGTTAGTGTCATA","ACCATCACAACTGTATG","561307.5.peg.1445"," 497"
"4806",2,155,153,"TAATCCCCATACAGTTGTGA","AGGTCAAAGTTAGTGTCATA","561307.5.peg.1445"," 497"
"4807",25,155,130,"ATCACAACTGTATGGGGATT","AGGTCAAAGTTAGTGTCATA","561307.5.peg.1445"," 497"
"4808",31,155,124,"ACCATCACAACTGTATG","AGGTCAAAGTTAGTGTCATA","561307.5.peg.1445"," 497"
"4809",302,199,103,"CATCAAATTCAGTACTATGC","TGTTGCATTTCATCTATAG","561307.5.peg.1446"," 498"
"4810",199,302,103,"TGTTGCATTTCATCTATAG","CATCAAATTCAGTACTATGC","561307.5.peg.1446"," 498"
"4811",378,86,292,"AATAGACCATCTGCTTCACA","CTAACCCAACTGAAGGCATC","561307.5.peg.1447"," 499"
"4812",378,93,285,"AATAGACCATCTGCTTCACA","TAAACACCTAACCCAACTGA","561307.5.peg.1447"," 499"
"4813",86,378,292,"CTAACCCAACTGAAGGCATC","AATAGACCATCTGCTTCACA","561307.5.peg.1447"," 499"
"4814",93,378,285,"TAAACACCTAACCCAACTGA","AATAGACCATCTGCTTCACA","561307.5.peg.1447"," 499"
"4815",318,31,287,"ATCGTCGTCGTTAATGCAGT","GTGAATCCCTAGAAATA","561307.5.peg.1448"," 500"
"4816",546,31,515,"ATTGCATCAGTTTGGGCATC","GTGAATCCCTAGAAATA","561307.5.peg.1448"," 500"
"4817",456,31,425,"TGTTACCGAAATAGAACAA","GTGAATCCCTAGAAATA","561307.5.peg.1448"," 500"
"4818",486,31,455,"CCATTCATCAGCCAAATCAA","GTGAATCCCTAGAAATA","561307.5.peg.1448"," 500"
"4819",553,31,522,"TTCTGACATTGCATCAGTTT","GTGAATCCCTAGAAATA","561307.5.peg.1448"," 500"
"4820",626,31,595,"GCATATATGCCAATTCAGTT","GTGAATCCCTAGAAATA","561307.5.peg.1448"," 500"
"4821",318,82,236,"ATCGTCGTCGTTAATGCAGT","TTCTGAACCAACAAATACAG","561307.5.peg.1448"," 500"
"4822",553,82,471,"TTCTGACATTGCATCAGTTT","TTCTGAACCAACAAATACAG","561307.5.peg.1448"," 500"
"4823",546,82,464,"ATTGCATCAGTTTGGGCATC","TTCTGAACCAACAAATACAG","561307.5.peg.1448"," 500"
"4824",456,82,374,"TGTTACCGAAATAGAACAA","TTCTGAACCAACAAATACAG","561307.5.peg.1448"," 500"
"4825",486,82,404,"CCATTCATCAGCCAAATCAA","TTCTGAACCAACAAATACAG","561307.5.peg.1448"," 500"
"4826",626,82,544,"GCATATATGCCAATTCAGTT","TTCTGAACCAACAAATACAG","561307.5.peg.1448"," 500"
"4827",82,318,236,"TTCTGAACCAACAAATACAG","ATCGTCGTCGTTAATGCAGT","561307.5.peg.1448"," 500"
"4828",626,318,308,"GCATATATGCCAATTCAGTT","ATCGTCGTCGTTAATGCAGT","561307.5.peg.1448"," 500"
"4829",553,318,235,"TTCTGACATTGCATCAGTTT","ATCGTCGTCGTTAATGCAGT","561307.5.peg.1448"," 500"
"4830",486,318,168,"CCATTCATCAGCCAAATCAA","ATCGTCGTCGTTAATGCAGT","561307.5.peg.1448"," 500"
"4831",546,318,228,"ATTGCATCAGTTTGGGCATC","ATCGTCGTCGTTAATGCAGT","561307.5.peg.1448"," 500"
"4832",456,318,138,"TGTTACCGAAATAGAACAA","ATCGTCGTCGTTAATGCAGT","561307.5.peg.1448"," 500"
"4833",31,318,287,"GTGAATCCCTAGAAATA","ATCGTCGTCGTTAATGCAGT","561307.5.peg.1448"," 500"
"4834",31,456,425,"GTGAATCCCTAGAAATA","TGTTACCGAAATAGAACAA","561307.5.peg.1448"," 500"
"4835",318,456,138,"ATCGTCGTCGTTAATGCAGT","TGTTACCGAAATAGAACAA","561307.5.peg.1448"," 500"
"4836",626,456,170,"GCATATATGCCAATTCAGTT","TGTTACCGAAATAGAACAA","561307.5.peg.1448"," 500"
"4837",82,456,374,"TTCTGAACCAACAAATACAG","TGTTACCGAAATAGAACAA","561307.5.peg.1448"," 500"
"4838",626,486,140,"GCATATATGCCAATTCAGTT","CCATTCATCAGCCAAATCAA","561307.5.peg.1448"," 500"
"4839",31,486,455,"GTGAATCCCTAGAAATA","CCATTCATCAGCCAAATCAA","561307.5.peg.1448"," 500"
"4840",318,486,168,"ATCGTCGTCGTTAATGCAGT","CCATTCATCAGCCAAATCAA","561307.5.peg.1448"," 500"
"4841",82,486,404,"TTCTGAACCAACAAATACAG","CCATTCATCAGCCAAATCAA","561307.5.peg.1448"," 500"
"4842",82,546,464,"TTCTGAACCAACAAATACAG","ATTGCATCAGTTTGGGCATC","561307.5.peg.1448"," 500"
"4843",31,546,515,"GTGAATCCCTAGAAATA","ATTGCATCAGTTTGGGCATC","561307.5.peg.1448"," 500"
"4844",318,546,228,"ATCGTCGTCGTTAATGCAGT","ATTGCATCAGTTTGGGCATC","561307.5.peg.1448"," 500"
"4845",31,553,522,"GTGAATCCCTAGAAATA","TTCTGACATTGCATCAGTTT","561307.5.peg.1448"," 500"
"4846",82,553,471,"TTCTGAACCAACAAATACAG","TTCTGACATTGCATCAGTTT","561307.5.peg.1448"," 500"
"4847",318,553,235,"ATCGTCGTCGTTAATGCAGT","TTCTGACATTGCATCAGTTT","561307.5.peg.1448"," 500"
"4848",31,626,595,"GTGAATCCCTAGAAATA","GCATATATGCCAATTCAGTT","561307.5.peg.1448"," 500"
"4849",318,626,308,"ATCGTCGTCGTTAATGCAGT","GCATATATGCCAATTCAGTT","561307.5.peg.1448"," 500"
"4850",456,626,170,"TGTTACCGAAATAGAACAA","GCATATATGCCAATTCAGTT","561307.5.peg.1448"," 500"
"4851",82,626,544,"TTCTGAACCAACAAATACAG","GCATATATGCCAATTCAGTT","561307.5.peg.1448"," 500"
"4852",486,626,140,"CCATTCATCAGCCAAATCAA","GCATATATGCCAATTCAGTT","561307.5.peg.1448"," 500"
"4853",510,355,155,"AATGGGCGTACAACGTATTG","AGTCGATTGCGTCATTGTAG","561307.5.peg.1449"," 501"
"4854",355,510,155,"AGTCGATTGCGTCATTGTAG","AATGGGCGTACAACGTATTG","561307.5.peg.1449"," 501"
"4855",253,11,242,"TGACTTAACTGCGGCCACTT","TACGATTAGCGTACTTGATG","561307.5.peg.1450"," 503"
"4856",262,11,251,"AATAGCTGGTGACTTAACTG","TACGATTAGCGTACTTGATG","561307.5.peg.1450"," 503"
"4857",366,11,355,"TGTGTTTGGGCGCCACCTTC","TACGATTAGCGTACTTGATG","561307.5.peg.1450"," 503"
"4858",246,11,235,"ACTGCGGCCACTTTGGCATG","TACGATTAGCGTACTTGATG","561307.5.peg.1450"," 503"
"4859",276,11,265,"GATTTACCAAACGCAATAGC","TACGATTAGCGTACTTGATG","561307.5.peg.1450"," 503"
"4860",241,11,230,"GGCCACTTTGGCATGTGGAA","TACGATTAGCGTACTTGATG","561307.5.peg.1450"," 503"
"4861",585,11,574,"GCAGTTACTGCTAACACATA","TACGATTAGCGTACTTGATG","561307.5.peg.1450"," 503"
"4862",825,11,814,"CGTTTAATACCATCTGCTAC","TACGATTAGCGTACTTGATG","561307.5.peg.1450"," 503"
"4863",953,11,942,"GTTTATAGAATGCTTTACCT","TACGATTAGCGTACTTGATG","561307.5.peg.1450"," 503"
"4864",336,11,325,"TCATAAAGAATAAGTGTGC","TACGATTAGCGTACTTGATG","561307.5.peg.1450"," 503"
"4865",379,11,368,"TAAAGCATCTAGATGTGTTT","TACGATTAGCGTACTTGATG","561307.5.peg.1450"," 503"
"4866",379,13,366,"TAAAGCATCTAGATGTGTTT","GTTACGATTAGCGTACTTGA","561307.5.peg.1450"," 503"
"4867",276,13,263,"GATTTACCAAACGCAATAGC","GTTACGATTAGCGTACTTGA","561307.5.peg.1450"," 503"
"4868",253,13,240,"TGACTTAACTGCGGCCACTT","GTTACGATTAGCGTACTTGA","561307.5.peg.1450"," 503"
"4869",585,13,572,"GCAGTTACTGCTAACACATA","GTTACGATTAGCGTACTTGA","561307.5.peg.1450"," 503"
"4870",366,13,353,"TGTGTTTGGGCGCCACCTTC","GTTACGATTAGCGTACTTGA","561307.5.peg.1450"," 503"
"4871",825,13,812,"CGTTTAATACCATCTGCTAC","GTTACGATTAGCGTACTTGA","561307.5.peg.1450"," 503"
"4872",336,13,323,"TCATAAAGAATAAGTGTGC","GTTACGATTAGCGTACTTGA","561307.5.peg.1450"," 503"
"4873",246,13,233,"ACTGCGGCCACTTTGGCATG","GTTACGATTAGCGTACTTGA","561307.5.peg.1450"," 503"
"4874",262,13,249,"AATAGCTGGTGACTTAACTG","GTTACGATTAGCGTACTTGA","561307.5.peg.1450"," 503"
"4875",241,13,228,"GGCCACTTTGGCATGTGGAA","GTTACGATTAGCGTACTTGA","561307.5.peg.1450"," 503"
"4876",953,13,940,"GTTTATAGAATGCTTTACCT","GTTACGATTAGCGTACTTGA","561307.5.peg.1450"," 503"
"4877",379,241,138,"TAAAGCATCTAGATGTGTTT","GGCCACTTTGGCATGTGGAA","561307.5.peg.1450"," 503"
"4878",11,241,230,"TACGATTAGCGTACTTGATG","GGCCACTTTGGCATGTGGAA","561307.5.peg.1450"," 503"
"4879",366,241,125,"TGTGTTTGGGCGCCACCTTC","GGCCACTTTGGCATGTGGAA","561307.5.peg.1450"," 503"
"4880",953,241,712,"GTTTATAGAATGCTTTACCT","GGCCACTTTGGCATGTGGAA","561307.5.peg.1450"," 503"
"4881",825,241,584,"CGTTTAATACCATCTGCTAC","GGCCACTTTGGCATGTGGAA","561307.5.peg.1450"," 503"
"4882",13,241,228,"GTTACGATTAGCGTACTTGA","GGCCACTTTGGCATGTGGAA","561307.5.peg.1450"," 503"
"4883",585,241,344,"GCAGTTACTGCTAACACATA","GGCCACTTTGGCATGTGGAA","561307.5.peg.1450"," 503"
"4884",825,246,579,"CGTTTAATACCATCTGCTAC","ACTGCGGCCACTTTGGCATG","561307.5.peg.1450"," 503"
"4885",585,246,339,"GCAGTTACTGCTAACACATA","ACTGCGGCCACTTTGGCATG","561307.5.peg.1450"," 503"
"4886",366,246,120,"TGTGTTTGGGCGCCACCTTC","ACTGCGGCCACTTTGGCATG","561307.5.peg.1450"," 503"
"4887",13,246,233,"GTTACGATTAGCGTACTTGA","ACTGCGGCCACTTTGGCATG","561307.5.peg.1450"," 503"
"4888",379,246,133,"TAAAGCATCTAGATGTGTTT","ACTGCGGCCACTTTGGCATG","561307.5.peg.1450"," 503"
"4889",953,246,707,"GTTTATAGAATGCTTTACCT","ACTGCGGCCACTTTGGCATG","561307.5.peg.1450"," 503"
"4890",11,246,235,"TACGATTAGCGTACTTGATG","ACTGCGGCCACTTTGGCATG","561307.5.peg.1450"," 503"
"4891",11,253,242,"TACGATTAGCGTACTTGATG","TGACTTAACTGCGGCCACTT","561307.5.peg.1450"," 503"
"4892",825,253,572,"CGTTTAATACCATCTGCTAC","TGACTTAACTGCGGCCACTT","561307.5.peg.1450"," 503"
"4893",366,253,113,"TGTGTTTGGGCGCCACCTTC","TGACTTAACTGCGGCCACTT","561307.5.peg.1450"," 503"
"4894",13,253,240,"GTTACGATTAGCGTACTTGA","TGACTTAACTGCGGCCACTT","561307.5.peg.1450"," 503"
"4895",585,253,332,"GCAGTTACTGCTAACACATA","TGACTTAACTGCGGCCACTT","561307.5.peg.1450"," 503"
"4896",379,253,126,"TAAAGCATCTAGATGTGTTT","TGACTTAACTGCGGCCACTT","561307.5.peg.1450"," 503"
"4897",953,253,700,"GTTTATAGAATGCTTTACCT","TGACTTAACTGCGGCCACTT","561307.5.peg.1450"," 503"
"4898",379,262,117,"TAAAGCATCTAGATGTGTTT","AATAGCTGGTGACTTAACTG","561307.5.peg.1450"," 503"
"4899",11,262,251,"TACGATTAGCGTACTTGATG","AATAGCTGGTGACTTAACTG","561307.5.peg.1450"," 503"
"4900",366,262,104,"TGTGTTTGGGCGCCACCTTC","AATAGCTGGTGACTTAACTG","561307.5.peg.1450"," 503"
"4901",953,262,691,"GTTTATAGAATGCTTTACCT","AATAGCTGGTGACTTAACTG","561307.5.peg.1450"," 503"
"4902",13,262,249,"GTTACGATTAGCGTACTTGA","AATAGCTGGTGACTTAACTG","561307.5.peg.1450"," 503"
"4903",825,262,563,"CGTTTAATACCATCTGCTAC","AATAGCTGGTGACTTAACTG","561307.5.peg.1450"," 503"
"4904",585,262,323,"GCAGTTACTGCTAACACATA","AATAGCTGGTGACTTAACTG","561307.5.peg.1450"," 503"
"4905",379,276,103,"TAAAGCATCTAGATGTGTTT","GATTTACCAAACGCAATAGC","561307.5.peg.1450"," 503"
"4906",13,276,263,"GTTACGATTAGCGTACTTGA","GATTTACCAAACGCAATAGC","561307.5.peg.1450"," 503"
"4907",825,276,549,"CGTTTAATACCATCTGCTAC","GATTTACCAAACGCAATAGC","561307.5.peg.1450"," 503"
"4908",11,276,265,"TACGATTAGCGTACTTGATG","GATTTACCAAACGCAATAGC","561307.5.peg.1450"," 503"
"4909",953,276,677,"GTTTATAGAATGCTTTACCT","GATTTACCAAACGCAATAGC","561307.5.peg.1450"," 503"
"4910",585,276,309,"GCAGTTACTGCTAACACATA","GATTTACCAAACGCAATAGC","561307.5.peg.1450"," 503"
"4911",953,336,617,"GTTTATAGAATGCTTTACCT","TCATAAAGAATAAGTGTGC","561307.5.peg.1450"," 503"
"4912",585,336,249,"GCAGTTACTGCTAACACATA","TCATAAAGAATAAGTGTGC","561307.5.peg.1450"," 503"
"4913",11,336,325,"TACGATTAGCGTACTTGATG","TCATAAAGAATAAGTGTGC","561307.5.peg.1450"," 503"
"4914",825,336,489,"CGTTTAATACCATCTGCTAC","TCATAAAGAATAAGTGTGC","561307.5.peg.1450"," 503"
"4915",13,336,323,"GTTACGATTAGCGTACTTGA","TCATAAAGAATAAGTGTGC","561307.5.peg.1450"," 503"
"4916",11,366,355,"TACGATTAGCGTACTTGATG","TGTGTTTGGGCGCCACCTTC","561307.5.peg.1450"," 503"
"4917",825,366,459,"CGTTTAATACCATCTGCTAC","TGTGTTTGGGCGCCACCTTC","561307.5.peg.1450"," 503"
"4918",13,366,353,"GTTACGATTAGCGTACTTGA","TGTGTTTGGGCGCCACCTTC","561307.5.peg.1450"," 503"
"4919",241,366,125,"GGCCACTTTGGCATGTGGAA","TGTGTTTGGGCGCCACCTTC","561307.5.peg.1450"," 503"
"4920",253,366,113,"TGACTTAACTGCGGCCACTT","TGTGTTTGGGCGCCACCTTC","561307.5.peg.1450"," 503"
"4921",246,366,120,"ACTGCGGCCACTTTGGCATG","TGTGTTTGGGCGCCACCTTC","561307.5.peg.1450"," 503"
"4922",953,366,587,"GTTTATAGAATGCTTTACCT","TGTGTTTGGGCGCCACCTTC","561307.5.peg.1450"," 503"
"4923",585,366,219,"GCAGTTACTGCTAACACATA","TGTGTTTGGGCGCCACCTTC","561307.5.peg.1450"," 503"
"4924",262,366,104,"AATAGCTGGTGACTTAACTG","TGTGTTTGGGCGCCACCTTC","561307.5.peg.1450"," 503"
"4925",246,379,133,"ACTGCGGCCACTTTGGCATG","TAAAGCATCTAGATGTGTTT","561307.5.peg.1450"," 503"
"4926",13,379,366,"GTTACGATTAGCGTACTTGA","TAAAGCATCTAGATGTGTTT","561307.5.peg.1450"," 503"
"4927",241,379,138,"GGCCACTTTGGCATGTGGAA","TAAAGCATCTAGATGTGTTT","561307.5.peg.1450"," 503"
"4928",825,379,446,"CGTTTAATACCATCTGCTAC","TAAAGCATCTAGATGTGTTT","561307.5.peg.1450"," 503"
"4929",253,379,126,"TGACTTAACTGCGGCCACTT","TAAAGCATCTAGATGTGTTT","561307.5.peg.1450"," 503"
"4930",585,379,206,"GCAGTTACTGCTAACACATA","TAAAGCATCTAGATGTGTTT","561307.5.peg.1450"," 503"
"4931",276,379,103,"GATTTACCAAACGCAATAGC","TAAAGCATCTAGATGTGTTT","561307.5.peg.1450"," 503"
"4932",11,379,368,"TACGATTAGCGTACTTGATG","TAAAGCATCTAGATGTGTTT","561307.5.peg.1450"," 503"
"4933",262,379,117,"AATAGCTGGTGACTTAACTG","TAAAGCATCTAGATGTGTTT","561307.5.peg.1450"," 503"
"4934",953,379,574,"GTTTATAGAATGCTTTACCT","TAAAGCATCTAGATGTGTTT","561307.5.peg.1450"," 503"
"4935",11,585,574,"TACGATTAGCGTACTTGATG","GCAGTTACTGCTAACACATA","561307.5.peg.1450"," 503"
"4936",262,585,323,"AATAGCTGGTGACTTAACTG","GCAGTTACTGCTAACACATA","561307.5.peg.1450"," 503"
"4937",366,585,219,"TGTGTTTGGGCGCCACCTTC","GCAGTTACTGCTAACACATA","561307.5.peg.1450"," 503"
"4938",253,585,332,"TGACTTAACTGCGGCCACTT","GCAGTTACTGCTAACACATA","561307.5.peg.1450"," 503"
"4939",241,585,344,"GGCCACTTTGGCATGTGGAA","GCAGTTACTGCTAACACATA","561307.5.peg.1450"," 503"
"4940",13,585,572,"GTTACGATTAGCGTACTTGA","GCAGTTACTGCTAACACATA","561307.5.peg.1450"," 503"
"4941",825,585,240,"CGTTTAATACCATCTGCTAC","GCAGTTACTGCTAACACATA","561307.5.peg.1450"," 503"
"4942",336,585,249,"TCATAAAGAATAAGTGTGC","GCAGTTACTGCTAACACATA","561307.5.peg.1450"," 503"
"4943",953,585,368,"GTTTATAGAATGCTTTACCT","GCAGTTACTGCTAACACATA","561307.5.peg.1450"," 503"
"4944",246,585,339,"ACTGCGGCCACTTTGGCATG","GCAGTTACTGCTAACACATA","561307.5.peg.1450"," 503"
"4945",379,585,206,"TAAAGCATCTAGATGTGTTT","GCAGTTACTGCTAACACATA","561307.5.peg.1450"," 503"
"4946",276,585,309,"GATTTACCAAACGCAATAGC","GCAGTTACTGCTAACACATA","561307.5.peg.1450"," 503"
"4947",11,825,814,"TACGATTAGCGTACTTGATG","CGTTTAATACCATCTGCTAC","561307.5.peg.1450"," 503"
"4948",366,825,459,"TGTGTTTGGGCGCCACCTTC","CGTTTAATACCATCTGCTAC","561307.5.peg.1450"," 503"
"4949",336,825,489,"TCATAAAGAATAAGTGTGC","CGTTTAATACCATCTGCTAC","561307.5.peg.1450"," 503"
"4950",13,825,812,"GTTACGATTAGCGTACTTGA","CGTTTAATACCATCTGCTAC","561307.5.peg.1450"," 503"
"4951",246,825,579,"ACTGCGGCCACTTTGGCATG","CGTTTAATACCATCTGCTAC","561307.5.peg.1450"," 503"
"4952",241,825,584,"GGCCACTTTGGCATGTGGAA","CGTTTAATACCATCTGCTAC","561307.5.peg.1450"," 503"
"4953",253,825,572,"TGACTTAACTGCGGCCACTT","CGTTTAATACCATCTGCTAC","561307.5.peg.1450"," 503"
"4954",262,825,563,"AATAGCTGGTGACTTAACTG","CGTTTAATACCATCTGCTAC","561307.5.peg.1450"," 503"
"4955",276,825,549,"GATTTACCAAACGCAATAGC","CGTTTAATACCATCTGCTAC","561307.5.peg.1450"," 503"
"4956",953,825,128,"GTTTATAGAATGCTTTACCT","CGTTTAATACCATCTGCTAC","561307.5.peg.1450"," 503"
"4957",379,825,446,"TAAAGCATCTAGATGTGTTT","CGTTTAATACCATCTGCTAC","561307.5.peg.1450"," 503"
"4958",585,825,240,"GCAGTTACTGCTAACACATA","CGTTTAATACCATCTGCTAC","561307.5.peg.1450"," 503"
"4959",366,953,587,"TGTGTTTGGGCGCCACCTTC","GTTTATAGAATGCTTTACCT","561307.5.peg.1450"," 503"
"4960",336,953,617,"TCATAAAGAATAAGTGTGC","GTTTATAGAATGCTTTACCT","561307.5.peg.1450"," 503"
"4961",825,953,128,"CGTTTAATACCATCTGCTAC","GTTTATAGAATGCTTTACCT","561307.5.peg.1450"," 503"
"4962",11,953,942,"TACGATTAGCGTACTTGATG","GTTTATAGAATGCTTTACCT","561307.5.peg.1450"," 503"
"4963",13,953,940,"GTTACGATTAGCGTACTTGA","GTTTATAGAATGCTTTACCT","561307.5.peg.1450"," 503"
"4964",585,953,368,"GCAGTTACTGCTAACACATA","GTTTATAGAATGCTTTACCT","561307.5.peg.1450"," 503"
"4965",246,953,707,"ACTGCGGCCACTTTGGCATG","GTTTATAGAATGCTTTACCT","561307.5.peg.1450"," 503"
"4966",241,953,712,"GGCCACTTTGGCATGTGGAA","GTTTATAGAATGCTTTACCT","561307.5.peg.1450"," 503"
"4967",379,953,574,"TAAAGCATCTAGATGTGTTT","GTTTATAGAATGCTTTACCT","561307.5.peg.1450"," 503"
"4968",253,953,700,"TGACTTAACTGCGGCCACTT","GTTTATAGAATGCTTTACCT","561307.5.peg.1450"," 503"
"4969",262,953,691,"AATAGCTGGTGACTTAACTG","GTTTATAGAATGCTTTACCT","561307.5.peg.1450"," 503"
"4970",276,953,677,"GATTTACCAAACGCAATAGC","GTTTATAGAATGCTTTACCT","561307.5.peg.1450"," 503"
"4971",360,214,146,"GTTGACGTTATATGAGGACC","AAATCCACCTGCAAATCCCA","561307.5.peg.1451"," 504"
"4972",366,214,152,"ATTGTGTTGACGTTATATG","AAATCCACCTGCAAATCCCA","561307.5.peg.1451"," 504"
"4973",456,214,242,"GCATCGCTTGGAATACTACT","AAATCCACCTGCAAATCCCA","561307.5.peg.1451"," 504"
"4974",214,360,146,"AAATCCACCTGCAAATCCCA","GTTGACGTTATATGAGGACC","561307.5.peg.1451"," 504"
"4975",214,366,152,"AAATCCACCTGCAAATCCCA","ATTGTGTTGACGTTATATG","561307.5.peg.1451"," 504"
"4976",214,456,242,"AAATCCACCTGCAAATCCCA","GCATCGCTTGGAATACTACT","561307.5.peg.1451"," 504"
"4977",216,20,196,"TCAGCTAGCGTACCACCAAA","TAACAGCTTTAAGCATGACA","561307.5.peg.1455"," 508"
"4978",378,20,358,"GCTATTAAACCTGTCACACC","TAACAGCTTTAAGCATGACA","561307.5.peg.1455"," 508"
"4979",480,20,460,"GCCATAAATCCACCAATCCC","TAACAGCTTTAAGCATGACA","561307.5.peg.1455"," 508"
"4980",120,20,100,"TTAAATAAACAGGCAAGAC","TAACAGCTTTAAGCATGACA","561307.5.peg.1455"," 508"
"4981",20,120,100,"TAACAGCTTTAAGCATGACA","TTAAATAAACAGGCAAGAC","561307.5.peg.1455"," 508"
"4982",378,120,258,"GCTATTAAACCTGTCACACC","TTAAATAAACAGGCAAGAC","561307.5.peg.1455"," 508"
"4983",480,120,360,"GCCATAAATCCACCAATCCC","TTAAATAAACAGGCAAGAC","561307.5.peg.1455"," 508"
"4984",20,216,196,"TAACAGCTTTAAGCATGACA","TCAGCTAGCGTACCACCAAA","561307.5.peg.1455"," 508"
"4985",480,216,264,"GCCATAAATCCACCAATCCC","TCAGCTAGCGTACCACCAAA","561307.5.peg.1455"," 508"
"4986",378,216,162,"GCTATTAAACCTGTCACACC","TCAGCTAGCGTACCACCAAA","561307.5.peg.1455"," 508"
"4987",20,378,358,"TAACAGCTTTAAGCATGACA","GCTATTAAACCTGTCACACC","561307.5.peg.1455"," 508"
"4988",120,378,258,"TTAAATAAACAGGCAAGAC","GCTATTAAACCTGTCACACC","561307.5.peg.1455"," 508"
"4989",216,378,162,"TCAGCTAGCGTACCACCAAA","GCTATTAAACCTGTCACACC","561307.5.peg.1455"," 508"
"4990",480,378,102,"GCCATAAATCCACCAATCCC","GCTATTAAACCTGTCACACC","561307.5.peg.1455"," 508"
"4991",120,480,360,"TTAAATAAACAGGCAAGAC","GCCATAAATCCACCAATCCC","561307.5.peg.1455"," 508"
"4992",378,480,102,"GCTATTAAACCTGTCACACC","GCCATAAATCCACCAATCCC","561307.5.peg.1455"," 508"
"4993",20,480,460,"TAACAGCTTTAAGCATGACA","GCCATAAATCCACCAATCCC","561307.5.peg.1455"," 508"
"4994",216,480,264,"TCAGCTAGCGTACCACCAAA","GCCATAAATCCACCAATCCC","561307.5.peg.1455"," 508"
"4995",406,159,247,"ATTCCCACGTATCAAAGTAA","GCTGAAGACATGTCCTCTTC","561307.5.peg.1458"," 511"
"4996",510,159,351,"ACGTCTCTATGCCTCAAGTA","GCTGAAGACATGTCCTCTTC","561307.5.peg.1458"," 511"
"4997",579,159,420,"CATCAAACACTAAATCATC","GCTGAAGACATGTCCTCTTC","561307.5.peg.1458"," 511"
"4998",406,258,148,"ATTCCCACGTATCAAAGTAA","CGTCATAAGACATAACATA","561307.5.peg.1458"," 511"
"4999",579,258,321,"CATCAAACACTAAATCATC","CGTCATAAGACATAACATA","561307.5.peg.1458"," 511"
"5000",510,258,252,"ACGTCTCTATGCCTCAAGTA","CGTCATAAGACATAACATA","561307.5.peg.1458"," 511"
"5001",159,406,247,"GCTGAAGACATGTCCTCTTC","ATTCCCACGTATCAAAGTAA","561307.5.peg.1458"," 511"
"5002",258,406,148,"CGTCATAAGACATAACATA","ATTCCCACGTATCAAAGTAA","561307.5.peg.1458"," 511"
"5003",510,406,104,"ACGTCTCTATGCCTCAAGTA","ATTCCCACGTATCAAAGTAA","561307.5.peg.1458"," 511"
"5004",579,406,173,"CATCAAACACTAAATCATC","ATTCCCACGTATCAAAGTAA","561307.5.peg.1458"," 511"
"5005",159,510,351,"GCTGAAGACATGTCCTCTTC","ACGTCTCTATGCCTCAAGTA","561307.5.peg.1458"," 511"
"5006",258,510,252,"CGTCATAAGACATAACATA","ACGTCTCTATGCCTCAAGTA","561307.5.peg.1458"," 511"
"5007",406,510,104,"ATTCCCACGTATCAAAGTAA","ACGTCTCTATGCCTCAAGTA","561307.5.peg.1458"," 511"
"5008",159,579,420,"GCTGAAGACATGTCCTCTTC","CATCAAACACTAAATCATC","561307.5.peg.1458"," 511"
"5009",406,579,173,"ATTCCCACGTATCAAAGTAA","CATCAAACACTAAATCATC","561307.5.peg.1458"," 511"
"5010",258,579,321,"CGTCATAAGACATAACATA","CATCAAACACTAAATCATC","561307.5.peg.1458"," 511"
"5011",636,170,466,"GCAATCATACCCAGCAAGAT","TCGGCAGACTTGAAGGTGCC","561307.5.peg.1459"," 512"
"5012",603,170,433,"CCTGCTCTAGCTGTTGCAGA","TCGGCAGACTTGAAGGTGCC","561307.5.peg.1459"," 512"
"5013",386,170,216,"ATGCATGATTAGTTCCTAGA","TCGGCAGACTTGAAGGTGCC","561307.5.peg.1459"," 512"
"5014",386,177,209,"ATGCATGATTAGTTCCTAGA","GCCATTATCGGCAGACTTGA","561307.5.peg.1459"," 512"
"5015",603,177,426,"CCTGCTCTAGCTGTTGCAGA","GCCATTATCGGCAGACTTGA","561307.5.peg.1459"," 512"
"5016",636,177,459,"GCAATCATACCCAGCAAGAT","GCCATTATCGGCAGACTTGA","561307.5.peg.1459"," 512"
"5017",386,189,197,"ATGCATGATTAGTTCCTAGA","AGTACTGCCTTAGCCATTAT","561307.5.peg.1459"," 512"
"5018",603,189,414,"CCTGCTCTAGCTGTTGCAGA","AGTACTGCCTTAGCCATTAT","561307.5.peg.1459"," 512"
"5019",636,189,447,"GCAATCATACCCAGCAAGAT","AGTACTGCCTTAGCCATTAT","561307.5.peg.1459"," 512"
"5020",636,264,372,"GCAATCATACCCAGCAAGAT","ATAATTAAAGTTGCTGACAC","561307.5.peg.1459"," 512"
"5021",386,264,122,"ATGCATGATTAGTTCCTAGA","ATAATTAAAGTTGCTGACAC","561307.5.peg.1459"," 512"
"5022",603,264,339,"CCTGCTCTAGCTGTTGCAGA","ATAATTAAAGTTGCTGACAC","561307.5.peg.1459"," 512"
"5023",170,386,216,"TCGGCAGACTTGAAGGTGCC","ATGCATGATTAGTTCCTAGA","561307.5.peg.1459"," 512"
"5024",636,386,250,"GCAATCATACCCAGCAAGAT","ATGCATGATTAGTTCCTAGA","561307.5.peg.1459"," 512"
"5025",177,386,209,"GCCATTATCGGCAGACTTGA","ATGCATGATTAGTTCCTAGA","561307.5.peg.1459"," 512"
"5026",603,386,217,"CCTGCTCTAGCTGTTGCAGA","ATGCATGATTAGTTCCTAGA","561307.5.peg.1459"," 512"
"5027",189,386,197,"AGTACTGCCTTAGCCATTAT","ATGCATGATTAGTTCCTAGA","561307.5.peg.1459"," 512"
"5028",264,386,122,"ATAATTAAAGTTGCTGACAC","ATGCATGATTAGTTCCTAGA","561307.5.peg.1459"," 512"
"5029",170,603,433,"TCGGCAGACTTGAAGGTGCC","CCTGCTCTAGCTGTTGCAGA","561307.5.peg.1459"," 512"
"5030",189,603,414,"AGTACTGCCTTAGCCATTAT","CCTGCTCTAGCTGTTGCAGA","561307.5.peg.1459"," 512"
"5031",177,603,426,"GCCATTATCGGCAGACTTGA","CCTGCTCTAGCTGTTGCAGA","561307.5.peg.1459"," 512"
"5032",386,603,217,"ATGCATGATTAGTTCCTAGA","CCTGCTCTAGCTGTTGCAGA","561307.5.peg.1459"," 512"
"5033",264,603,339,"ATAATTAAAGTTGCTGACAC","CCTGCTCTAGCTGTTGCAGA","561307.5.peg.1459"," 512"
"5034",170,636,466,"TCGGCAGACTTGAAGGTGCC","GCAATCATACCCAGCAAGAT","561307.5.peg.1459"," 512"
"5035",189,636,447,"AGTACTGCCTTAGCCATTAT","GCAATCATACCCAGCAAGAT","561307.5.peg.1459"," 512"
"5036",264,636,372,"ATAATTAAAGTTGCTGACAC","GCAATCATACCCAGCAAGAT","561307.5.peg.1459"," 512"
"5037",177,636,459,"GCCATTATCGGCAGACTTGA","GCAATCATACCCAGCAAGAT","561307.5.peg.1459"," 512"
"5038",386,636,250,"ATGCATGATTAGTTCCTAGA","GCAATCATACCCAGCAAGAT","561307.5.peg.1459"," 512"
"5039",341,180,161,"ATTCGCCTTCTTGCATCGAA","ACAGCATAGCCACTATTAAA","561307.5.peg.146"," 513"
"5040",381,180,201,"GGTGCTTCTACGCGTAACAA","ACAGCATAGCCACTATTAAA","561307.5.peg.146"," 513"
"5041",402,180,222,"TTAATTGCGCTTGAATCAA","ACAGCATAGCCACTATTAAA","561307.5.peg.146"," 513"
"5042",636,180,456,"TGTGCATGTGTACCAGACAC","ACAGCATAGCCACTATTAAA","561307.5.peg.146"," 513"
"5043",668,180,488,"CATATTCGTCTCCATAAGTT","ACAGCATAGCCACTATTAAA","561307.5.peg.146"," 513"
"5044",734,180,554,"AGTATGGAATGTATCTACT","ACAGCATAGCCACTATTAAA","561307.5.peg.146"," 513"
"5045",180,341,161,"ACAGCATAGCCACTATTAAA","ATTCGCCTTCTTGCATCGAA","561307.5.peg.146"," 513"
"5046",636,341,295,"TGTGCATGTGTACCAGACAC","ATTCGCCTTCTTGCATCGAA","561307.5.peg.146"," 513"
"5047",668,341,327,"CATATTCGTCTCCATAAGTT","ATTCGCCTTCTTGCATCGAA","561307.5.peg.146"," 513"
"5048",734,341,393,"AGTATGGAATGTATCTACT","ATTCGCCTTCTTGCATCGAA","561307.5.peg.146"," 513"
"5049",180,381,201,"ACAGCATAGCCACTATTAAA","GGTGCTTCTACGCGTAACAA","561307.5.peg.146"," 513"
"5050",636,381,255,"TGTGCATGTGTACCAGACAC","GGTGCTTCTACGCGTAACAA","561307.5.peg.146"," 513"
"5051",668,381,287,"CATATTCGTCTCCATAAGTT","GGTGCTTCTACGCGTAACAA","561307.5.peg.146"," 513"
"5052",734,381,353,"AGTATGGAATGTATCTACT","GGTGCTTCTACGCGTAACAA","561307.5.peg.146"," 513"
"5053",180,402,222,"ACAGCATAGCCACTATTAAA","TTAATTGCGCTTGAATCAA","561307.5.peg.146"," 513"
"5054",636,402,234,"TGTGCATGTGTACCAGACAC","TTAATTGCGCTTGAATCAA","561307.5.peg.146"," 513"
"5055",668,402,266,"CATATTCGTCTCCATAAGTT","TTAATTGCGCTTGAATCAA","561307.5.peg.146"," 513"
"5056",734,402,332,"AGTATGGAATGTATCTACT","TTAATTGCGCTTGAATCAA","561307.5.peg.146"," 513"
"5057",180,636,456,"ACAGCATAGCCACTATTAAA","TGTGCATGTGTACCAGACAC","561307.5.peg.146"," 513"
"5058",341,636,295,"ATTCGCCTTCTTGCATCGAA","TGTGCATGTGTACCAGACAC","561307.5.peg.146"," 513"
"5059",381,636,255,"GGTGCTTCTACGCGTAACAA","TGTGCATGTGTACCAGACAC","561307.5.peg.146"," 513"
"5060",402,636,234,"TTAATTGCGCTTGAATCAA","TGTGCATGTGTACCAGACAC","561307.5.peg.146"," 513"
"5061",180,668,488,"ACAGCATAGCCACTATTAAA","CATATTCGTCTCCATAAGTT","561307.5.peg.146"," 513"
"5062",341,668,327,"ATTCGCCTTCTTGCATCGAA","CATATTCGTCTCCATAAGTT","561307.5.peg.146"," 513"
"5063",381,668,287,"GGTGCTTCTACGCGTAACAA","CATATTCGTCTCCATAAGTT","561307.5.peg.146"," 513"
"5064",402,668,266,"TTAATTGCGCTTGAATCAA","CATATTCGTCTCCATAAGTT","561307.5.peg.146"," 513"
"5065",180,734,554,"ACAGCATAGCCACTATTAAA","AGTATGGAATGTATCTACT","561307.5.peg.146"," 513"
"5066",341,734,393,"ATTCGCCTTCTTGCATCGAA","AGTATGGAATGTATCTACT","561307.5.peg.146"," 513"
"5067",381,734,353,"GGTGCTTCTACGCGTAACAA","AGTATGGAATGTATCTACT","561307.5.peg.146"," 513"
"5068",402,734,332,"TTAATTGCGCTTGAATCAA","AGTATGGAATGTATCTACT","561307.5.peg.146"," 513"
"5069",438,8,430,"TCTGGATCCATCAATGGTGA","TGTGACATTGAGGGATGGAG","561307.5.peg.1461"," 515"
"5070",444,8,436,"ACTTGTTCTGGATCCATCAA","TGTGACATTGAGGGATGGAG","561307.5.peg.1461"," 515"
"5071",456,8,448,"AATGCATCAGCAACTTGTTC","TGTGACATTGAGGGATGGAG","561307.5.peg.1461"," 515"
"5072",8,438,430,"TGTGACATTGAGGGATGGAG","TCTGGATCCATCAATGGTGA","561307.5.peg.1461"," 515"
"5073",8,444,436,"TGTGACATTGAGGGATGGAG","ACTTGTTCTGGATCCATCAA","561307.5.peg.1461"," 515"
"5074",8,456,448,"TGTGACATTGAGGGATGGAG","AATGCATCAGCAACTTGTTC","561307.5.peg.1461"," 515"
"5075",363,118,245,"CATGCAACTAGTAATTCCAA","ATATAATGTGTCAGTAACG","561307.5.peg.1462"," 516"
"5076",393,118,275,"CAAAGAAATTAACGATTTG","ATATAATGTGTCAGTAACG","561307.5.peg.1462"," 516"
"5077",118,363,245,"ATATAATGTGTCAGTAACG","CATGCAACTAGTAATTCCAA","561307.5.peg.1462"," 516"
"5078",118,393,275,"ATATAATGTGTCAGTAACG","CAAAGAAATTAACGATTTG","561307.5.peg.1462"," 516"
"5079",506,345,161,"TAACCATAATCAATAGCGCA","CTCAGTTTACGGTAAACATT","561307.5.peg.1464"," 518"
"5080",506,356,150,"TAACCATAATCAATAGCGCA","AATCACTAGAACTCAGTTTA","561307.5.peg.1464"," 518"
"5081",345,506,161,"CTCAGTTTACGGTAAACATT","TAACCATAATCAATAGCGCA","561307.5.peg.1464"," 518"
"5082",356,506,150,"AATCACTAGAACTCAGTTTA","TAACCATAATCAATAGCGCA","561307.5.peg.1464"," 518"
"5083",345,93,252,"ATAGTCATTTGTTCACCGAT","CTGACCAAGAACATGAGTAC","561307.5.peg.1465"," 519"
"5084",93,345,252,"CTGACCAAGAACATGAGTAC","ATAGTCATTTGTTCACCGAT","561307.5.peg.1465"," 519"
"5085",218,117,101,"CTGCAAAGACGGATCCTAAT","ATATGTCCAGTAGAGGAAAC","561307.5.peg.1466"," 520"
"5086",254,117,137,"AAATCTCTAAGAAGCGTTCG","ATATGTCCAGTAGAGGAAAC","561307.5.peg.1466"," 520"
"5087",229,117,112,"CACCCATGCTGCTGCAAAGA","ATATGTCCAGTAGAGGAAAC","561307.5.peg.1466"," 520"
"5088",438,117,321,"ATAAGCCAATCATAACAGT","ATATGTCCAGTAGAGGAAAC","561307.5.peg.1466"," 520"
"5089",229,124,105,"CACCCATGCTGCTGCAAAGA","TAGGATCATATGTCCAGTAG","561307.5.peg.1466"," 520"
"5090",438,124,314,"ATAAGCCAATCATAACAGT","TAGGATCATATGTCCAGTAG","561307.5.peg.1466"," 520"
"5091",254,124,130,"AAATCTCTAAGAAGCGTTCG","TAGGATCATATGTCCAGTAG","561307.5.peg.1466"," 520"
"5092",438,218,220,"ATAAGCCAATCATAACAGT","CTGCAAAGACGGATCCTAAT","561307.5.peg.1466"," 520"
"5093",117,218,101,"ATATGTCCAGTAGAGGAAAC","CTGCAAAGACGGATCCTAAT","561307.5.peg.1466"," 520"
"5094",124,229,105,"TAGGATCATATGTCCAGTAG","CACCCATGCTGCTGCAAAGA","561307.5.peg.1466"," 520"
"5095",117,229,112,"ATATGTCCAGTAGAGGAAAC","CACCCATGCTGCTGCAAAGA","561307.5.peg.1466"," 520"
"5096",438,229,209,"ATAAGCCAATCATAACAGT","CACCCATGCTGCTGCAAAGA","561307.5.peg.1466"," 520"
"5097",117,254,137,"ATATGTCCAGTAGAGGAAAC","AAATCTCTAAGAAGCGTTCG","561307.5.peg.1466"," 520"
"5098",124,254,130,"TAGGATCATATGTCCAGTAG","AAATCTCTAAGAAGCGTTCG","561307.5.peg.1466"," 520"
"5099",438,254,184,"ATAAGCCAATCATAACAGT","AAATCTCTAAGAAGCGTTCG","561307.5.peg.1466"," 520"
"5100",117,438,321,"ATATGTCCAGTAGAGGAAAC","ATAAGCCAATCATAACAGT","561307.5.peg.1466"," 520"
"5101",124,438,314,"TAGGATCATATGTCCAGTAG","ATAAGCCAATCATAACAGT","561307.5.peg.1466"," 520"
"5102",229,438,209,"CACCCATGCTGCTGCAAAGA","ATAAGCCAATCATAACAGT","561307.5.peg.1466"," 520"
"5103",218,438,220,"CTGCAAAGACGGATCCTAAT","ATAAGCCAATCATAACAGT","561307.5.peg.1466"," 520"
"5104",254,438,184,"AAATCTCTAAGAAGCGTTCG","ATAAGCCAATCATAACAGT","561307.5.peg.1466"," 520"
"5105",193,7,186,"TCTAATACACCATCTTGAA","CATTCATCGAATTAAGGAGC","561307.5.peg.1469"," 523"
"5106",7,193,186,"CATTCATCGAATTAAGGAGC","TCTAATACACCATCTTGAA","561307.5.peg.1469"," 523"
"5107",354,10,344,"TGACTGTTACTATTTCATC","TGCGGAACACGTTAAGGAGA","561307.5.peg.147"," 524"
"5108",384,10,374,"TGCACACTTTGATCAACTGC","TGCGGAACACGTTAAGGAGA","561307.5.peg.147"," 524"
"5109",421,10,411,"GAAATCTGTAAGAACAATAC","TGCGGAACACGTTAAGGAGA","561307.5.peg.147"," 524"
"5110",354,16,338,"TGACTGTTACTATTTCATC","TGAAGTTGCGGAACACGTTA","561307.5.peg.147"," 524"
"5111",384,16,368,"TGCACACTTTGATCAACTGC","TGAAGTTGCGGAACACGTTA","561307.5.peg.147"," 524"
"5112",421,16,405,"GAAATCTGTAAGAACAATAC","TGAAGTTGCGGAACACGTTA","561307.5.peg.147"," 524"
"5113",10,354,344,"TGCGGAACACGTTAAGGAGA","TGACTGTTACTATTTCATC","561307.5.peg.147"," 524"
"5114",16,354,338,"TGAAGTTGCGGAACACGTTA","TGACTGTTACTATTTCATC","561307.5.peg.147"," 524"
"5115",10,384,374,"TGCGGAACACGTTAAGGAGA","TGCACACTTTGATCAACTGC","561307.5.peg.147"," 524"
"5116",16,384,368,"TGAAGTTGCGGAACACGTTA","TGCACACTTTGATCAACTGC","561307.5.peg.147"," 524"
"5117",10,421,411,"TGCGGAACACGTTAAGGAGA","GAAATCTGTAAGAACAATAC","561307.5.peg.147"," 524"
"5118",16,421,405,"TGAAGTTGCGGAACACGTTA","GAAATCTGTAAGAACAATAC","561307.5.peg.147"," 524"
"5119",525,386,139,"TTAATTGGGCACCAATAAA","TTGCTGGTGCAAATAATCCT","561307.5.peg.1476"," 531"
"5120",525,402,123,"TTAATTGGGCACCAATAAA","GCGTAAAGTTGGGGCATTGC","561307.5.peg.1476"," 531"
"5121",525,411,114,"TTAATTGGGCACCAATAAA","CTAGCAGATGCGTAAAGTTG","561307.5.peg.1476"," 531"
"5122",386,525,139,"TTGCTGGTGCAAATAATCCT","TTAATTGGGCACCAATAAA","561307.5.peg.1476"," 531"
"5123",402,525,123,"GCGTAAAGTTGGGGCATTGC","TTAATTGGGCACCAATAAA","561307.5.peg.1476"," 531"
"5124",411,525,114,"CTAGCAGATGCGTAAAGTTG","TTAATTGGGCACCAATAAA","561307.5.peg.1476"," 531"
"5125",293,171,122,"GGCCAAATCCTTCATATCTT","CTTAAAGCTTGGTTAGATTC","561307.5.peg.1481"," 537"
"5126",314,171,143,"CAATTAGCATTGATCCGCTT","CTTAAAGCTTGGTTAGATTC","561307.5.peg.1481"," 537"
"5127",293,182,111,"GGCCAAATCCTTCATATCTT","CAAGCACCAACCTTAAAGCT","561307.5.peg.1481"," 537"
"5128",314,182,132,"CAATTAGCATTGATCCGCTT","CAAGCACCAACCTTAAAGCT","561307.5.peg.1481"," 537"
"5129",171,293,122,"CTTAAAGCTTGGTTAGATTC","GGCCAAATCCTTCATATCTT","561307.5.peg.1481"," 537"
"5130",182,293,111,"CAAGCACCAACCTTAAAGCT","GGCCAAATCCTTCATATCTT","561307.5.peg.1481"," 537"
"5131",171,314,143,"CTTAAAGCTTGGTTAGATTC","CAATTAGCATTGATCCGCTT","561307.5.peg.1481"," 537"
"5132",182,314,132,"CAAGCACCAACCTTAAAGCT","CAATTAGCATTGATCCGCTT","561307.5.peg.1481"," 537"
"5133",305,132,173,"AATCAACTTTGCTGTATAG","AGTTCGATTTCCCCGTCAAT","561307.5.peg.1483"," 539"
"5134",377,132,245,"CATTAAGAGGCTGATTATCA","AGTTCGATTTCCCCGTCAAT","561307.5.peg.1483"," 539"
"5135",911,132,779,"ATGTATAACATCAGTTAGG","AGTTCGATTTCCCCGTCAAT","561307.5.peg.1483"," 539"
"5136",614,132,482,"AACCCATGCCCATAAGTAAG","AGTTCGATTTCCCCGTCAAT","561307.5.peg.1483"," 539"
"5137",390,132,258,"CTAATATCAGCGTCATTAAG","AGTTCGATTTCCCCGTCAAT","561307.5.peg.1483"," 539"
"5138",911,305,606,"ATGTATAACATCAGTTAGG","AATCAACTTTGCTGTATAG","561307.5.peg.1483"," 539"
"5139",614,305,309,"AACCCATGCCCATAAGTAAG","AATCAACTTTGCTGTATAG","561307.5.peg.1483"," 539"
"5140",132,305,173,"AGTTCGATTTCCCCGTCAAT","AATCAACTTTGCTGTATAG","561307.5.peg.1483"," 539"
"5141",911,377,534,"ATGTATAACATCAGTTAGG","CATTAAGAGGCTGATTATCA","561307.5.peg.1483"," 539"
"5142",132,377,245,"AGTTCGATTTCCCCGTCAAT","CATTAAGAGGCTGATTATCA","561307.5.peg.1483"," 539"
"5143",614,377,237,"AACCCATGCCCATAAGTAAG","CATTAAGAGGCTGATTATCA","561307.5.peg.1483"," 539"
"5144",132,390,258,"AGTTCGATTTCCCCGTCAAT","CTAATATCAGCGTCATTAAG","561307.5.peg.1483"," 539"
"5145",614,390,224,"AACCCATGCCCATAAGTAAG","CTAATATCAGCGTCATTAAG","561307.5.peg.1483"," 539"
"5146",911,390,521,"ATGTATAACATCAGTTAGG","CTAATATCAGCGTCATTAAG","561307.5.peg.1483"," 539"
"5147",390,614,224,"CTAATATCAGCGTCATTAAG","AACCCATGCCCATAAGTAAG","561307.5.peg.1483"," 539"
"5148",132,614,482,"AGTTCGATTTCCCCGTCAAT","AACCCATGCCCATAAGTAAG","561307.5.peg.1483"," 539"
"5149",305,614,309,"AATCAACTTTGCTGTATAG","AACCCATGCCCATAAGTAAG","561307.5.peg.1483"," 539"
"5150",911,614,297,"ATGTATAACATCAGTTAGG","AACCCATGCCCATAAGTAAG","561307.5.peg.1483"," 539"
"5151",377,614,237,"CATTAAGAGGCTGATTATCA","AACCCATGCCCATAAGTAAG","561307.5.peg.1483"," 539"
"5152",132,911,779,"AGTTCGATTTCCCCGTCAAT","ATGTATAACATCAGTTAGG","561307.5.peg.1483"," 539"
"5153",390,911,521,"CTAATATCAGCGTCATTAAG","ATGTATAACATCAGTTAGG","561307.5.peg.1483"," 539"
"5154",377,911,534,"CATTAAGAGGCTGATTATCA","ATGTATAACATCAGTTAGG","561307.5.peg.1483"," 539"
"5155",614,911,297,"AACCCATGCCCATAAGTAAG","ATGTATAACATCAGTTAGG","561307.5.peg.1483"," 539"
"5156",305,911,606,"AATCAACTTTGCTGTATAG","ATGTATAACATCAGTTAGG","561307.5.peg.1483"," 539"
"5157",198,89,109,"ATCAGTAATCCAAATGACAA","TACTTATTGATTGAGCATGC","561307.5.peg.1484"," 540"
"5158",89,198,109,"TACTTATTGATTGAGCATGC","ATCAGTAATCCAAATGACAA","561307.5.peg.1484"," 540"
"5159",247,133,114,"TCGACAATGTCTTTAGTAA","TACAGCAGTAGCTACTGCAT","561307.5.peg.1486"," 542"
"5160",360,133,227,"AGTGCATGTGAAGACGAACT","TACAGCAGTAGCTACTGCAT","561307.5.peg.1486"," 542"
"5161",133,247,114,"TACAGCAGTAGCTACTGCAT","TCGACAATGTCTTTAGTAA","561307.5.peg.1486"," 542"
"5162",360,247,113,"AGTGCATGTGAAGACGAACT","TCGACAATGTCTTTAGTAA","561307.5.peg.1486"," 542"
"5163",133,360,227,"TACAGCAGTAGCTACTGCAT","AGTGCATGTGAAGACGAACT","561307.5.peg.1486"," 542"
"5164",247,360,113,"TCGACAATGTCTTTAGTAA","AGTGCATGTGAAGACGAACT","561307.5.peg.1486"," 542"
"5165",688,201,487,"CAAAGATAGATAGTATCCTG","TGTGAGCCTTCCTTTATAAT","561307.5.peg.1488"," 544"
"5166",201,688,487,"TGTGAGCCTTCCTTTATAAT","CAAAGATAGATAGTATCCTG","561307.5.peg.1488"," 544"
"5167",375,3,372,"TCTAACTTCTGTACCGTTAG","ACTTCATTTCCTTTAGGCTT","561307.5.peg.1489"," 545"
"5168",3,375,372,"ACTTCATTTCCTTTAGGCTT","TCTAACTTCTGTACCGTTAG","561307.5.peg.1489"," 545"
"5169",318,128,190,"TCAACTGTATGACGTTGAAA","TAGACTAATGCCTAACATA","561307.5.peg.1490"," 547"
"5170",450,128,322,"ATAATTTCATAGCTGTCAC","TAGACTAATGCCTAACATA","561307.5.peg.1490"," 547"
"5171",128,318,190,"TAGACTAATGCCTAACATA","TCAACTGTATGACGTTGAAA","561307.5.peg.1490"," 547"
"5172",450,318,132,"ATAATTTCATAGCTGTCAC","TCAACTGTATGACGTTGAAA","561307.5.peg.1490"," 547"
"5173",128,450,322,"TAGACTAATGCCTAACATA","ATAATTTCATAGCTGTCAC","561307.5.peg.1490"," 547"
"5174",318,450,132,"TCAACTGTATGACGTTGAAA","ATAATTTCATAGCTGTCAC","561307.5.peg.1490"," 547"
"5175",165,55,110,"TTACTAGCCGATGTGACGCT","CTAACTCTACGTATAATAT","561307.5.peg.1493"," 550"
"5176",213,55,158,"GCAACGAAGATGACTTTATG","CTAACTCTACGTATAATAT","561307.5.peg.1493"," 550"
"5177",265,55,210,"AATGGTGTCGTATTAACAA","CTAACTCTACGTATAATAT","561307.5.peg.1493"," 550"
"5178",265,132,133,"AATGGTGTCGTATTAACAA","CCTGGTGTGTAGAACATATA","561307.5.peg.1493"," 550"
"5179",55,165,110,"CTAACTCTACGTATAATAT","TTACTAGCCGATGTGACGCT","561307.5.peg.1493"," 550"
"5180",265,165,100,"AATGGTGTCGTATTAACAA","TTACTAGCCGATGTGACGCT","561307.5.peg.1493"," 550"
"5181",55,213,158,"CTAACTCTACGTATAATAT","GCAACGAAGATGACTTTATG","561307.5.peg.1493"," 550"
"5182",55,265,210,"CTAACTCTACGTATAATAT","AATGGTGTCGTATTAACAA","561307.5.peg.1493"," 550"
"5183",132,265,133,"CCTGGTGTGTAGAACATATA","AATGGTGTCGTATTAACAA","561307.5.peg.1493"," 550"
"5184",165,265,100,"TTACTAGCCGATGTGACGCT","AATGGTGTCGTATTAACAA","561307.5.peg.1493"," 550"
"5185",435,267,168,"TCATTTGAATTAATGGTGT","GCATTAGAAGACATATCAAC","561307.5.peg.1495"," 552"
"5186",267,435,168,"GCATTAGAAGACATATCAAC","TCATTTGAATTAATGGTGT","561307.5.peg.1495"," 552"
"5187",349,241,108,"TGCGCCTGCACCAGCTATCA","TTCATGATTTGTCGCTTCAA","561307.5.peg.1496"," 553"
"5188",396,241,155,"ATTAAAGCACCTAGCCATGT","TTCATGATTTGTCGCTTCAA","561307.5.peg.1496"," 553"
"5189",241,349,108,"TTCATGATTTGTCGCTTCAA","TGCGCCTGCACCAGCTATCA","561307.5.peg.1496"," 553"
"5190",241,396,155,"TTCATGATTTGTCGCTTCAA","ATTAAAGCACCTAGCCATGT","561307.5.peg.1496"," 553"
"5191",279,155,124,"ACAAAGCTAAAGCCATACAG","CACGAACCATGTTAACCCCG","561307.5.peg.1499"," 556"
"5192",155,279,124,"CACGAACCATGTTAACCCCG","ACAAAGCTAAAGCCATACAG","561307.5.peg.1499"," 556"
"5193",141,6,135,"GCATCGTTAAATGGCGAACC","ATCGGAATTTGTTAGAGGAG","561307.5.peg.15"," 557"
"5194",219,6,213,"TGTAAATACTGCGTAGCTAC","ATCGGAATTTGTTAGAGGAG","561307.5.peg.15"," 557"
"5195",284,6,278,"ACACAGGTTGATTATGATAC","ATCGGAATTTGTTAGAGGAG","561307.5.peg.15"," 557"
"5196",300,6,294,"GGTTTAATCAAATCCCACAC","ATCGGAATTTGTTAGAGGAG","561307.5.peg.15"," 557"
"5197",141,8,133,"GCATCGTTAAATGGCGAACC","AAATCGGAATTTGTTAGAGG","561307.5.peg.15"," 557"
"5198",219,8,211,"TGTAAATACTGCGTAGCTAC","AAATCGGAATTTGTTAGAGG","561307.5.peg.15"," 557"
"5199",300,8,292,"GGTTTAATCAAATCCCACAC","AAATCGGAATTTGTTAGAGG","561307.5.peg.15"," 557"
"5200",284,8,276,"ACACAGGTTGATTATGATAC","AAATCGGAATTTGTTAGAGG","561307.5.peg.15"," 557"
"5201",219,11,208,"TGTAAATACTGCGTAGCTAC","AGAAATCGGAATTTGTTAG","561307.5.peg.15"," 557"
"5202",141,11,130,"GCATCGTTAAATGGCGAACC","AGAAATCGGAATTTGTTAG","561307.5.peg.15"," 557"
"5203",284,11,273,"ACACAGGTTGATTATGATAC","AGAAATCGGAATTTGTTAG","561307.5.peg.15"," 557"
"5204",300,11,289,"GGTTTAATCAAATCCCACAC","AGAAATCGGAATTTGTTAG","561307.5.peg.15"," 557"
"5205",6,141,135,"ATCGGAATTTGTTAGAGGAG","GCATCGTTAAATGGCGAACC","561307.5.peg.15"," 557"
"5206",8,141,133,"AAATCGGAATTTGTTAGAGG","GCATCGTTAAATGGCGAACC","561307.5.peg.15"," 557"
"5207",284,141,143,"ACACAGGTTGATTATGATAC","GCATCGTTAAATGGCGAACC","561307.5.peg.15"," 557"
"5208",11,141,130,"AGAAATCGGAATTTGTTAG","GCATCGTTAAATGGCGAACC","561307.5.peg.15"," 557"
"5209",300,141,159,"GGTTTAATCAAATCCCACAC","GCATCGTTAAATGGCGAACC","561307.5.peg.15"," 557"
"5210",6,219,213,"ATCGGAATTTGTTAGAGGAG","TGTAAATACTGCGTAGCTAC","561307.5.peg.15"," 557"
"5211",11,219,208,"AGAAATCGGAATTTGTTAG","TGTAAATACTGCGTAGCTAC","561307.5.peg.15"," 557"
"5212",8,219,211,"AAATCGGAATTTGTTAGAGG","TGTAAATACTGCGTAGCTAC","561307.5.peg.15"," 557"
"5213",6,284,278,"ATCGGAATTTGTTAGAGGAG","ACACAGGTTGATTATGATAC","561307.5.peg.15"," 557"
"5214",8,284,276,"AAATCGGAATTTGTTAGAGG","ACACAGGTTGATTATGATAC","561307.5.peg.15"," 557"
"5215",11,284,273,"AGAAATCGGAATTTGTTAG","ACACAGGTTGATTATGATAC","561307.5.peg.15"," 557"
"5216",141,284,143,"GCATCGTTAAATGGCGAACC","ACACAGGTTGATTATGATAC","561307.5.peg.15"," 557"
"5217",11,300,289,"AGAAATCGGAATTTGTTAG","GGTTTAATCAAATCCCACAC","561307.5.peg.15"," 557"
"5218",6,300,294,"ATCGGAATTTGTTAGAGGAG","GGTTTAATCAAATCCCACAC","561307.5.peg.15"," 557"
"5219",8,300,292,"AAATCGGAATTTGTTAGAGG","GGTTTAATCAAATCCCACAC","561307.5.peg.15"," 557"
"5220",141,300,159,"GCATCGTTAAATGGCGAACC","GGTTTAATCAAATCCCACAC","561307.5.peg.15"," 557"
"5221",122,7,115,"TAGCAATCAGATCTAACTCT","TATGACTGATAATACCAAGG","561307.5.peg.1500"," 559"
"5222",7,122,115,"TATGACTGATAATACCAAGG","TAGCAATCAGATCTAACTCT","561307.5.peg.1500"," 559"
"5223",327,139,188,"GCGTTAATACCTAATATACC","AGGTATGTTGTATTCACCTG","561307.5.peg.1501"," 560"
"5224",504,139,365,"CCTATTAATACCATACTCGC","AGGTATGTTGTATTCACCTG","561307.5.peg.1501"," 560"
"5225",315,139,176,"AATATACCTGGTTCAGCTAT","AGGTATGTTGTATTCACCTG","561307.5.peg.1501"," 560"
"5226",423,139,284,"CCACCTAGTATACTTATTAA","AGGTATGTTGTATTCACCTG","561307.5.peg.1501"," 560"
"5227",504,315,189,"CCTATTAATACCATACTCGC","AATATACCTGGTTCAGCTAT","561307.5.peg.1501"," 560"
"5228",139,315,176,"AGGTATGTTGTATTCACCTG","AATATACCTGGTTCAGCTAT","561307.5.peg.1501"," 560"
"5229",423,315,108,"CCACCTAGTATACTTATTAA","AATATACCTGGTTCAGCTAT","561307.5.peg.1501"," 560"
"5230",139,327,188,"AGGTATGTTGTATTCACCTG","GCGTTAATACCTAATATACC","561307.5.peg.1501"," 560"
"5231",504,327,177,"CCTATTAATACCATACTCGC","GCGTTAATACCTAATATACC","561307.5.peg.1501"," 560"
"5232",139,423,284,"AGGTATGTTGTATTCACCTG","CCACCTAGTATACTTATTAA","561307.5.peg.1501"," 560"
"5233",315,423,108,"AATATACCTGGTTCAGCTAT","CCACCTAGTATACTTATTAA","561307.5.peg.1501"," 560"
"5234",139,504,365,"AGGTATGTTGTATTCACCTG","CCTATTAATACCATACTCGC","561307.5.peg.1501"," 560"
"5235",315,504,189,"AATATACCTGGTTCAGCTAT","CCTATTAATACCATACTCGC","561307.5.peg.1501"," 560"
"5236",327,504,177,"GCGTTAATACCTAATATACC","CCTATTAATACCATACTCGC","561307.5.peg.1501"," 560"
"5237",336,169,167,"GAATTTAAACCTATGAGCGC","ATAGCCTCTATAATTGTAG","561307.5.peg.1502"," 561"
"5238",479,169,310,"TAAATCCATCACGTCTAGAT","ATAGCCTCTATAATTGTAG","561307.5.peg.1502"," 561"
"5239",479,246,233,"TAAATCCATCACGTCTAGAT","ATTACTGCTGCTATATTTCT","561307.5.peg.1502"," 561"
"5240",169,336,167,"ATAGCCTCTATAATTGTAG","GAATTTAAACCTATGAGCGC","561307.5.peg.1502"," 561"
"5241",479,336,143,"TAAATCCATCACGTCTAGAT","GAATTTAAACCTATGAGCGC","561307.5.peg.1502"," 561"
"5242",169,479,310,"ATAGCCTCTATAATTGTAG","TAAATCCATCACGTCTAGAT","561307.5.peg.1502"," 561"
"5243",246,479,233,"ATTACTGCTGCTATATTTCT","TAAATCCATCACGTCTAGAT","561307.5.peg.1502"," 561"
"5244",336,479,143,"GAATTTAAACCTATGAGCGC","TAAATCCATCACGTCTAGAT","561307.5.peg.1502"," 561"
"5245",413,201,212,"CTGCTGTTGTACCGCCTGCA","ACCAAGAAGTTAGTGATGGC","561307.5.peg.1504"," 563"
"5246",413,205,208,"CTGCTGTTGTACCGCCTGCA","GTTGACCAAGAAGTTAGTGA","561307.5.peg.1504"," 563"
"5247",201,413,212,"ACCAAGAAGTTAGTGATGGC","CTGCTGTTGTACCGCCTGCA","561307.5.peg.1504"," 563"
"5248",205,413,208,"GTTGACCAAGAAGTTAGTGA","CTGCTGTTGTACCGCCTGCA","561307.5.peg.1504"," 563"
"5249",441,229,212,"CCAAAGAATGACTCGAATTT","AACTACCCAAGCGATACCAT","561307.5.peg.1505"," 564"
"5250",615,229,386,"GCCGTTAGTACCAGTTCTCC","AACTACCCAAGCGATACCAT","561307.5.peg.1505"," 564"
"5251",229,441,212,"AACTACCCAAGCGATACCAT","CCAAAGAATGACTCGAATTT","561307.5.peg.1505"," 564"
"5252",615,441,174,"GCCGTTAGTACCAGTTCTCC","CCAAAGAATGACTCGAATTT","561307.5.peg.1505"," 564"
"5253",229,615,386,"AACTACCCAAGCGATACCAT","GCCGTTAGTACCAGTTCTCC","561307.5.peg.1505"," 564"
"5254",441,615,174,"CCAAAGAATGACTCGAATTT","GCCGTTAGTACCAGTTCTCC","561307.5.peg.1505"," 564"
"5255",465,99,366,"CCAACTAATGTAACGATTGA","GCTGCAACGATAAGACCCAC","561307.5.peg.1506"," 565"
"5256",199,99,100,"ATTCCAATTGATATGGCTCA","GCTGCAACGATAAGACCCAC","561307.5.peg.1506"," 565"
"5257",653,99,554,"TAACAAGACGCATTTCAGTT","GCTGCAACGATAAGACCCAC","561307.5.peg.1506"," 565"
"5258",653,165,488,"TAACAAGACGCATTTCAGTT","ACAATTCGTCCAGTAAACAG","561307.5.peg.1506"," 565"
"5259",465,165,300,"CCAACTAATGTAACGATTGA","ACAATTCGTCCAGTAAACAG","561307.5.peg.1506"," 565"
"5260",99,199,100,"GCTGCAACGATAAGACCCAC","ATTCCAATTGATATGGCTCA","561307.5.peg.1506"," 565"
"5261",653,199,454,"TAACAAGACGCATTTCAGTT","ATTCCAATTGATATGGCTCA","561307.5.peg.1506"," 565"
"5262",465,199,266,"CCAACTAATGTAACGATTGA","ATTCCAATTGATATGGCTCA","561307.5.peg.1506"," 565"
"5263",199,465,266,"ATTCCAATTGATATGGCTCA","CCAACTAATGTAACGATTGA","561307.5.peg.1506"," 565"
"5264",99,465,366,"GCTGCAACGATAAGACCCAC","CCAACTAATGTAACGATTGA","561307.5.peg.1506"," 565"
"5265",165,465,300,"ACAATTCGTCCAGTAAACAG","CCAACTAATGTAACGATTGA","561307.5.peg.1506"," 565"
"5266",653,465,188,"TAACAAGACGCATTTCAGTT","CCAACTAATGTAACGATTGA","561307.5.peg.1506"," 565"
"5267",165,653,488,"ACAATTCGTCCAGTAAACAG","TAACAAGACGCATTTCAGTT","561307.5.peg.1506"," 565"
"5268",99,653,554,"GCTGCAACGATAAGACCCAC","TAACAAGACGCATTTCAGTT","561307.5.peg.1506"," 565"
"5269",465,653,188,"CCAACTAATGTAACGATTGA","TAACAAGACGCATTTCAGTT","561307.5.peg.1506"," 565"
"5270",199,653,454,"ATTCCAATTGATATGGCTCA","TAACAAGACGCATTTCAGTT","561307.5.peg.1506"," 565"
"5271",387,139,248,"AGTTTCGTATTACTCAACTC","TTGATTTGCTGCTTGTACAG","561307.5.peg.1507"," 566"
"5272",267,139,128,"TTAATTTAGTCATAGACGC","TTGATTTGCTGCTTGTACAG","561307.5.peg.1507"," 566"
"5273",414,139,275,"GCGATTGTCCATACTTGTCC","TTGATTTGCTGCTTGTACAG","561307.5.peg.1507"," 566"
"5274",514,139,375,"CATTAAATCAACGAAATCGC","TTGATTTGCTGCTTGTACAG","561307.5.peg.1507"," 566"
"5275",414,141,273,"GCGATTGTCCATACTTGTCC","TATTGATTTGCTGCTTGTAC","561307.5.peg.1507"," 566"
"5276",267,141,126,"TTAATTTAGTCATAGACGC","TATTGATTTGCTGCTTGTAC","561307.5.peg.1507"," 566"
"5277",514,141,373,"CATTAAATCAACGAAATCGC","TATTGATTTGCTGCTTGTAC","561307.5.peg.1507"," 566"
"5278",387,141,246,"AGTTTCGTATTACTCAACTC","TATTGATTTGCTGCTTGTAC","561307.5.peg.1507"," 566"
"5279",414,195,219,"GCGATTGTCCATACTTGTCC","CTTACATTAACAGCACTCGT","561307.5.peg.1507"," 566"
"5280",514,195,319,"CATTAAATCAACGAAATCGC","CTTACATTAACAGCACTCGT","561307.5.peg.1507"," 566"
"5281",387,195,192,"AGTTTCGTATTACTCAACTC","CTTACATTAACAGCACTCGT","561307.5.peg.1507"," 566"
"5282",139,267,128,"TTGATTTGCTGCTTGTACAG","TTAATTTAGTCATAGACGC","561307.5.peg.1507"," 566"
"5283",514,267,247,"CATTAAATCAACGAAATCGC","TTAATTTAGTCATAGACGC","561307.5.peg.1507"," 566"
"5284",141,267,126,"TATTGATTTGCTGCTTGTAC","TTAATTTAGTCATAGACGC","561307.5.peg.1507"," 566"
"5285",387,267,120,"AGTTTCGTATTACTCAACTC","TTAATTTAGTCATAGACGC","561307.5.peg.1507"," 566"
"5286",414,267,147,"GCGATTGTCCATACTTGTCC","TTAATTTAGTCATAGACGC","561307.5.peg.1507"," 566"
"5287",139,387,248,"TTGATTTGCTGCTTGTACAG","AGTTTCGTATTACTCAACTC","561307.5.peg.1507"," 566"
"5288",195,387,192,"CTTACATTAACAGCACTCGT","AGTTTCGTATTACTCAACTC","561307.5.peg.1507"," 566"
"5289",141,387,246,"TATTGATTTGCTGCTTGTAC","AGTTTCGTATTACTCAACTC","561307.5.peg.1507"," 566"
"5290",514,387,127,"CATTAAATCAACGAAATCGC","AGTTTCGTATTACTCAACTC","561307.5.peg.1507"," 566"
"5291",267,387,120,"TTAATTTAGTCATAGACGC","AGTTTCGTATTACTCAACTC","561307.5.peg.1507"," 566"
"5292",139,414,275,"TTGATTTGCTGCTTGTACAG","GCGATTGTCCATACTTGTCC","561307.5.peg.1507"," 566"
"5293",267,414,147,"TTAATTTAGTCATAGACGC","GCGATTGTCCATACTTGTCC","561307.5.peg.1507"," 566"
"5294",141,414,273,"TATTGATTTGCTGCTTGTAC","GCGATTGTCCATACTTGTCC","561307.5.peg.1507"," 566"
"5295",514,414,100,"CATTAAATCAACGAAATCGC","GCGATTGTCCATACTTGTCC","561307.5.peg.1507"," 566"
"5296",195,414,219,"CTTACATTAACAGCACTCGT","GCGATTGTCCATACTTGTCC","561307.5.peg.1507"," 566"
"5297",141,514,373,"TATTGATTTGCTGCTTGTAC","CATTAAATCAACGAAATCGC","561307.5.peg.1507"," 566"
"5298",414,514,100,"GCGATTGTCCATACTTGTCC","CATTAAATCAACGAAATCGC","561307.5.peg.1507"," 566"
"5299",195,514,319,"CTTACATTAACAGCACTCGT","CATTAAATCAACGAAATCGC","561307.5.peg.1507"," 566"
"5300",139,514,375,"TTGATTTGCTGCTTGTACAG","CATTAAATCAACGAAATCGC","561307.5.peg.1507"," 566"
"5301",267,514,247,"TTAATTTAGTCATAGACGC","CATTAAATCAACGAAATCGC","561307.5.peg.1507"," 566"
"5302",387,514,127,"AGTTTCGTATTACTCAACTC","CATTAAATCAACGAAATCGC","561307.5.peg.1507"," 566"
"5303",294,180,114,"ATAAATGCGTCACTATCATG","CTTTGTAACCGTTCAATCAT","561307.5.peg.1509"," 568"
"5304",327,180,147,"CCTGGCAATACGATTGATGT","CTTTGTAACCGTTCAATCAT","561307.5.peg.1509"," 568"
"5305",180,294,114,"CTTTGTAACCGTTCAATCAT","ATAAATGCGTCACTATCATG","561307.5.peg.1509"," 568"
"5306",180,327,147,"CTTTGTAACCGTTCAATCAT","CCTGGCAATACGATTGATGT","561307.5.peg.1509"," 568"
"5307",277,109,168,"AGGTTCACCAAGTGTATACG","GCTCTCAGCGTTTGCAATAG","561307.5.peg.151"," 569"
"5308",109,277,168,"GCTCTCAGCGTTTGCAATAG","AGGTTCACCAAGTGTATACG","561307.5.peg.151"," 569"
"5309",302,105,197,"ATTATATCCACCTAGCAAT","TGATAGGCTTAATATCTTC","561307.5.peg.1510"," 570"
"5310",437,105,332,"CCGTCGCTTGATAAACTTTA","TGATAGGCTTAATATCTTC","561307.5.peg.1510"," 570"
"5311",302,186,116,"ATTATATCCACCTAGCAAT","CGCTAAGTTCAGATAAATA","561307.5.peg.1510"," 570"
"5312",437,186,251,"CCGTCGCTTGATAAACTTTA","CGCTAAGTTCAGATAAATA","561307.5.peg.1510"," 570"
"5313",105,302,197,"TGATAGGCTTAATATCTTC","ATTATATCCACCTAGCAAT","561307.5.peg.1510"," 570"
"5314",437,302,135,"CCGTCGCTTGATAAACTTTA","ATTATATCCACCTAGCAAT","561307.5.peg.1510"," 570"
"5315",186,302,116,"CGCTAAGTTCAGATAAATA","ATTATATCCACCTAGCAAT","561307.5.peg.1510"," 570"
"5316",186,437,251,"CGCTAAGTTCAGATAAATA","CCGTCGCTTGATAAACTTTA","561307.5.peg.1510"," 570"
"5317",105,437,332,"TGATAGGCTTAATATCTTC","CCGTCGCTTGATAAACTTTA","561307.5.peg.1510"," 570"
"5318",302,437,135,"ATTATATCCACCTAGCAAT","CCGTCGCTTGATAAACTTTA","561307.5.peg.1510"," 570"
"5319",387,179,208,"CTACTTGTCACAATATATGT","AACCATAATTTGCATAACA","561307.5.peg.1511"," 571"
"5320",179,387,208,"AACCATAATTTGCATAACA","CTACTTGTCACAATATATGT","561307.5.peg.1511"," 571"
"5321",193,45,148,"GTAATTCACTATTTCAGGGT","CTTTCTTCAACAGTCATAAC","561307.5.peg.1513"," 573"
"5322",197,45,152,"TCGCGTAATTCACTATTTCA","CTTTCTTCAACAGTCATAAC","561307.5.peg.1513"," 573"
"5323",315,45,270,"CCAGGTATACGATGCGCTAG","CTTTCTTCAACAGTCATAAC","561307.5.peg.1513"," 573"
"5324",333,45,288,"TCATCCATCAACTCAATACC","CTTTCTTCAACAGTCATAAC","561307.5.peg.1513"," 573"
"5325",315,70,245,"CCAGGTATACGATGCGCTAG","AATGTCAACTTTGGCTGTAT","561307.5.peg.1513"," 573"
"5326",193,70,123,"GTAATTCACTATTTCAGGGT","AATGTCAACTTTGGCTGTAT","561307.5.peg.1513"," 573"
"5327",333,70,263,"TCATCCATCAACTCAATACC","AATGTCAACTTTGGCTGTAT","561307.5.peg.1513"," 573"
"5328",197,70,127,"TCGCGTAATTCACTATTTCA","AATGTCAACTTTGGCTGTAT","561307.5.peg.1513"," 573"
"5329",45,193,148,"CTTTCTTCAACAGTCATAAC","GTAATTCACTATTTCAGGGT","561307.5.peg.1513"," 573"
"5330",315,193,122,"CCAGGTATACGATGCGCTAG","GTAATTCACTATTTCAGGGT","561307.5.peg.1513"," 573"
"5331",70,193,123,"AATGTCAACTTTGGCTGTAT","GTAATTCACTATTTCAGGGT","561307.5.peg.1513"," 573"
"5332",333,193,140,"TCATCCATCAACTCAATACC","GTAATTCACTATTTCAGGGT","561307.5.peg.1513"," 573"
"5333",45,197,152,"CTTTCTTCAACAGTCATAAC","TCGCGTAATTCACTATTTCA","561307.5.peg.1513"," 573"
"5334",315,197,118,"CCAGGTATACGATGCGCTAG","TCGCGTAATTCACTATTTCA","561307.5.peg.1513"," 573"
"5335",70,197,127,"AATGTCAACTTTGGCTGTAT","TCGCGTAATTCACTATTTCA","561307.5.peg.1513"," 573"
"5336",333,197,136,"TCATCCATCAACTCAATACC","TCGCGTAATTCACTATTTCA","561307.5.peg.1513"," 573"
"5337",193,315,122,"GTAATTCACTATTTCAGGGT","CCAGGTATACGATGCGCTAG","561307.5.peg.1513"," 573"
"5338",45,315,270,"CTTTCTTCAACAGTCATAAC","CCAGGTATACGATGCGCTAG","561307.5.peg.1513"," 573"
"5339",197,315,118,"TCGCGTAATTCACTATTTCA","CCAGGTATACGATGCGCTAG","561307.5.peg.1513"," 573"
"5340",70,315,245,"AATGTCAACTTTGGCTGTAT","CCAGGTATACGATGCGCTAG","561307.5.peg.1513"," 573"
"5341",45,333,288,"CTTTCTTCAACAGTCATAAC","TCATCCATCAACTCAATACC","561307.5.peg.1513"," 573"
"5342",70,333,263,"AATGTCAACTTTGGCTGTAT","TCATCCATCAACTCAATACC","561307.5.peg.1513"," 573"
"5343",193,333,140,"GTAATTCACTATTTCAGGGT","TCATCCATCAACTCAATACC","561307.5.peg.1513"," 573"
"5344",197,333,136,"TCGCGTAATTCACTATTTCA","TCATCCATCAACTCAATACC","561307.5.peg.1513"," 573"
"5345",306,112,194,"ATCACTTGTTCCACACTTAT","GCCGCGTACTGGTATCGATA","561307.5.peg.1516"," 576"
"5346",306,123,183,"ATCACTTGTTCCACACTTAT","CCAATTATTTCGCCGCGTAC","561307.5.peg.1516"," 576"
"5347",306,155,151,"ATCACTTGTTCCACACTTAT","AAGATTTACCAGCACCATTC","561307.5.peg.1516"," 576"
"5348",306,178,128,"ATCACTTGTTCCACACTTAT","CCAATTAAAGACTTGATAA","561307.5.peg.1516"," 576"
"5349",112,306,194,"GCCGCGTACTGGTATCGATA","ATCACTTGTTCCACACTTAT","561307.5.peg.1516"," 576"
"5350",123,306,183,"CCAATTATTTCGCCGCGTAC","ATCACTTGTTCCACACTTAT","561307.5.peg.1516"," 576"
"5351",155,306,151,"AAGATTTACCAGCACCATTC","ATCACTTGTTCCACACTTAT","561307.5.peg.1516"," 576"
"5352",178,306,128,"CCAATTAAAGACTTGATAA","ATCACTTGTTCCACACTTAT","561307.5.peg.1516"," 576"
"5353",207,12,195,"AAGAATGATAGGGCAACACC","ACTGTAGTGACCCTAGTCAA","561307.5.peg.1517"," 577"
"5354",349,12,337,"AATCCCCGAAGCTAAGAAAG","ACTGTAGTGACCCTAGTCAA","561307.5.peg.1517"," 577"
"5355",321,12,309,"CTAATTCCAATAGCGGCGTC","ACTGTAGTGACCCTAGTCAA","561307.5.peg.1517"," 577"
"5356",240,12,228,"ATAAGTGCGCCTACAAACAT","ACTGTAGTGACCCTAGTCAA","561307.5.peg.1517"," 577"
"5357",207,27,180,"AAGAATGATAGGGCAACACC","TTATATTGCTCCTTTGACTA","561307.5.peg.1517"," 577"
"5358",349,27,322,"AATCCCCGAAGCTAAGAAAG","TTATATTGCTCCTTTGACTA","561307.5.peg.1517"," 577"
"5359",321,27,294,"CTAATTCCAATAGCGGCGTC","TTATATTGCTCCTTTGACTA","561307.5.peg.1517"," 577"
"5360",240,27,213,"ATAAGTGCGCCTACAAACAT","TTATATTGCTCCTTTGACTA","561307.5.peg.1517"," 577"
"5361",12,207,195,"ACTGTAGTGACCCTAGTCAA","AAGAATGATAGGGCAACACC","561307.5.peg.1517"," 577"
"5362",321,207,114,"CTAATTCCAATAGCGGCGTC","AAGAATGATAGGGCAACACC","561307.5.peg.1517"," 577"
"5363",27,207,180,"TTATATTGCTCCTTTGACTA","AAGAATGATAGGGCAACACC","561307.5.peg.1517"," 577"
"5364",349,207,142,"AATCCCCGAAGCTAAGAAAG","AAGAATGATAGGGCAACACC","561307.5.peg.1517"," 577"
"5365",27,240,213,"TTATATTGCTCCTTTGACTA","ATAAGTGCGCCTACAAACAT","561307.5.peg.1517"," 577"
"5366",12,240,228,"ACTGTAGTGACCCTAGTCAA","ATAAGTGCGCCTACAAACAT","561307.5.peg.1517"," 577"
"5367",349,240,109,"AATCCCCGAAGCTAAGAAAG","ATAAGTGCGCCTACAAACAT","561307.5.peg.1517"," 577"
"5368",27,321,294,"TTATATTGCTCCTTTGACTA","CTAATTCCAATAGCGGCGTC","561307.5.peg.1517"," 577"
"5369",12,321,309,"ACTGTAGTGACCCTAGTCAA","CTAATTCCAATAGCGGCGTC","561307.5.peg.1517"," 577"
"5370",207,321,114,"AAGAATGATAGGGCAACACC","CTAATTCCAATAGCGGCGTC","561307.5.peg.1517"," 577"
"5371",12,349,337,"ACTGTAGTGACCCTAGTCAA","AATCCCCGAAGCTAAGAAAG","561307.5.peg.1517"," 577"
"5372",240,349,109,"ATAAGTGCGCCTACAAACAT","AATCCCCGAAGCTAAGAAAG","561307.5.peg.1517"," 577"
"5373",207,349,142,"AAGAATGATAGGGCAACACC","AATCCCCGAAGCTAAGAAAG","561307.5.peg.1517"," 577"
"5374",27,349,322,"TTATATTGCTCCTTTGACTA","AATCCCCGAAGCTAAGAAAG","561307.5.peg.1517"," 577"
"5375",355,10,345,"TGATTTACCAGCCTGTTCTA","TTACGAATAGAAAGAAACG","561307.5.peg.1518"," 578"
"5376",231,10,221,"TCATGAGGATCTTGACCAAC","TTACGAATAGAAAGAAACG","561307.5.peg.1518"," 578"
"5377",465,10,455,"TCTAAACTTAACCATGCGTG","TTACGAATAGAAAGAAACG","561307.5.peg.1518"," 578"
"5378",420,10,410,"CTTCACCGTTTAAATAGAT","TTACGAATAGAAAGAAACG","561307.5.peg.1518"," 578"
"5379",10,231,221,"TTACGAATAGAAAGAAACG","TCATGAGGATCTTGACCAAC","561307.5.peg.1518"," 578"
"5380",355,231,124,"TGATTTACCAGCCTGTTCTA","TCATGAGGATCTTGACCAAC","561307.5.peg.1518"," 578"
"5381",420,231,189,"CTTCACCGTTTAAATAGAT","TCATGAGGATCTTGACCAAC","561307.5.peg.1518"," 578"
"5382",465,231,234,"TCTAAACTTAACCATGCGTG","TCATGAGGATCTTGACCAAC","561307.5.peg.1518"," 578"
"5383",10,355,345,"TTACGAATAGAAAGAAACG","TGATTTACCAGCCTGTTCTA","561307.5.peg.1518"," 578"
"5384",465,355,110,"TCTAAACTTAACCATGCGTG","TGATTTACCAGCCTGTTCTA","561307.5.peg.1518"," 578"
"5385",231,355,124,"TCATGAGGATCTTGACCAAC","TGATTTACCAGCCTGTTCTA","561307.5.peg.1518"," 578"
"5386",10,420,410,"TTACGAATAGAAAGAAACG","CTTCACCGTTTAAATAGAT","561307.5.peg.1518"," 578"
"5387",231,420,189,"TCATGAGGATCTTGACCAAC","CTTCACCGTTTAAATAGAT","561307.5.peg.1518"," 578"
"5388",355,465,110,"TGATTTACCAGCCTGTTCTA","TCTAAACTTAACCATGCGTG","561307.5.peg.1518"," 578"
"5389",10,465,455,"TTACGAATAGAAAGAAACG","TCTAAACTTAACCATGCGTG","561307.5.peg.1518"," 578"
"5390",231,465,234,"TCATGAGGATCTTGACCAAC","TCTAAACTTAACCATGCGTG","561307.5.peg.1518"," 578"
"5391",627,388,239,"CCATTAACTAGGATTTGCTC","ATCACGCTTCGCATTAGCTA","561307.5.peg.1519"," 579"
"5392",1083,388,695,"GTTCAATCGTAAATTGTTC","ATCACGCTTCGCATTAGCTA","561307.5.peg.1519"," 579"
"5393",1020,388,632,"TCTTCAACTGAATGAACATC","ATCACGCTTCGCATTAGCTA","561307.5.peg.1519"," 579"
"5394",747,388,359,"TCAGAAATCGTTGCAGTTGA","ATCACGCTTCGCATTAGCTA","561307.5.peg.1519"," 579"
"5395",388,627,239,"ATCACGCTTCGCATTAGCTA","CCATTAACTAGGATTTGCTC","561307.5.peg.1519"," 579"
"5396",1020,627,393,"TCTTCAACTGAATGAACATC","CCATTAACTAGGATTTGCTC","561307.5.peg.1519"," 579"
"5397",747,627,120,"TCAGAAATCGTTGCAGTTGA","CCATTAACTAGGATTTGCTC","561307.5.peg.1519"," 579"
"5398",1083,627,456,"GTTCAATCGTAAATTGTTC","CCATTAACTAGGATTTGCTC","561307.5.peg.1519"," 579"
"5399",388,747,359,"ATCACGCTTCGCATTAGCTA","TCAGAAATCGTTGCAGTTGA","561307.5.peg.1519"," 579"
"5400",1020,747,273,"TCTTCAACTGAATGAACATC","TCAGAAATCGTTGCAGTTGA","561307.5.peg.1519"," 579"
"5401",627,747,120,"CCATTAACTAGGATTTGCTC","TCAGAAATCGTTGCAGTTGA","561307.5.peg.1519"," 579"
"5402",1083,747,336,"GTTCAATCGTAAATTGTTC","TCAGAAATCGTTGCAGTTGA","561307.5.peg.1519"," 579"
"5403",388,1020,632,"ATCACGCTTCGCATTAGCTA","TCTTCAACTGAATGAACATC","561307.5.peg.1519"," 579"
"5404",747,1020,273,"TCAGAAATCGTTGCAGTTGA","TCTTCAACTGAATGAACATC","561307.5.peg.1519"," 579"
"5405",627,1020,393,"CCATTAACTAGGATTTGCTC","TCTTCAACTGAATGAACATC","561307.5.peg.1519"," 579"
"5406",747,1083,336,"TCAGAAATCGTTGCAGTTGA","GTTCAATCGTAAATTGTTC","561307.5.peg.1519"," 579"
"5407",388,1083,695,"ATCACGCTTCGCATTAGCTA","GTTCAATCGTAAATTGTTC","561307.5.peg.1519"," 579"
"5408",627,1083,456,"CCATTAACTAGGATTTGCTC","GTTCAATCGTAAATTGTTC","561307.5.peg.1519"," 579"
"5409",265,11,254,"TCAGAAACTTGTCTAGTAA","ATTCGAGTATACATACGAT","561307.5.peg.152"," 580"
"5410",621,11,610,"CATAACTTTCTATTTCAGG","ATTCGAGTATACATACGAT","561307.5.peg.152"," 580"
"5411",672,11,661,"TGCAATGTTTGCGTTGATAC","ATTCGAGTATACATACGAT","561307.5.peg.152"," 580"
"5412",621,265,356,"CATAACTTTCTATTTCAGG","TCAGAAACTTGTCTAGTAA","561307.5.peg.152"," 580"
"5413",11,265,254,"ATTCGAGTATACATACGAT","TCAGAAACTTGTCTAGTAA","561307.5.peg.152"," 580"
"5414",672,265,407,"TGCAATGTTTGCGTTGATAC","TCAGAAACTTGTCTAGTAA","561307.5.peg.152"," 580"
"5415",11,621,610,"ATTCGAGTATACATACGAT","CATAACTTTCTATTTCAGG","561307.5.peg.152"," 580"
"5416",265,621,356,"TCAGAAACTTGTCTAGTAA","CATAACTTTCTATTTCAGG","561307.5.peg.152"," 580"
"5417",265,672,407,"TCAGAAACTTGTCTAGTAA","TGCAATGTTTGCGTTGATAC","561307.5.peg.152"," 580"
"5418",11,672,661,"ATTCGAGTATACATACGAT","TGCAATGTTTGCGTTGATAC","561307.5.peg.152"," 580"
"5419",276,159,117,"CCATTGTTACCTCGGTAGTA","ATGCGATTTACTTCATGATG","561307.5.peg.1521"," 582"
"5420",378,159,219,"ACCATGTGGATAAATGCATG","ATGCGATTTACTTCATGATG","561307.5.peg.1521"," 582"
"5421",159,276,117,"ATGCGATTTACTTCATGATG","CCATTGTTACCTCGGTAGTA","561307.5.peg.1521"," 582"
"5422",378,276,102,"ACCATGTGGATAAATGCATG","CCATTGTTACCTCGGTAGTA","561307.5.peg.1521"," 582"
"5423",159,378,219,"ATGCGATTTACTTCATGATG","ACCATGTGGATAAATGCATG","561307.5.peg.1521"," 582"
"5424",276,378,102,"CCATTGTTACCTCGGTAGTA","ACCATGTGGATAAATGCATG","561307.5.peg.1521"," 582"
"5425",132,9,123,"CTAGTGTACTCTGAACATGT","AGTTAATTACTATCGTTGG","561307.5.peg.1523"," 584"
"5426",9,132,123,"AGTTAATTACTATCGTTGG","CTAGTGTACTCTGAACATGT","561307.5.peg.1523"," 584"
"5427",501,192,309,"ACCTGACCATAATACTTAGG","ATAAGTGATGCCTTGGCAGT","561307.5.peg.1525"," 586"
"5428",501,199,302,"ACCTGACCATAATACTTAGG","ACCTTTAATAAGTGATGCCT","561307.5.peg.1525"," 586"
"5429",501,234,267,"ACCTGACCATAATACTTAGG","CCTGCACCAATTACCGTAGC","561307.5.peg.1525"," 586"
"5430",192,501,309,"ATAAGTGATGCCTTGGCAGT","ACCTGACCATAATACTTAGG","561307.5.peg.1525"," 586"
"5431",199,501,302,"ACCTTTAATAAGTGATGCCT","ACCTGACCATAATACTTAGG","561307.5.peg.1525"," 586"
"5432",234,501,267,"CCTGCACCAATTACCGTAGC","ACCTGACCATAATACTTAGG","561307.5.peg.1525"," 586"
"5433",231,55,176,"TTAAGATGTCTGAAGAAGCC","ATCAATCGCGATTGATTTAC","561307.5.peg.1527"," 588"
"5434",55,231,176,"ATCAATCGCGATTGATTTAC","TTAAGATGTCTGAAGAAGCC","561307.5.peg.1527"," 588"
"5435",368,198,170,"TATCTTCTTGACCTGAATAA","ATCGAAACGACACCATTGTA","561307.5.peg.1534"," 596"
"5436",368,265,103,"TATCTTCTTGACCTGAATAA","ACCTGCAACGACATGCTTGT","561307.5.peg.1534"," 596"
"5437",198,368,170,"ATCGAAACGACACCATTGTA","TATCTTCTTGACCTGAATAA","561307.5.peg.1534"," 596"
"5438",265,368,103,"ACCTGCAACGACATGCTTGT","TATCTTCTTGACCTGAATAA","561307.5.peg.1534"," 596"
"5439",224,92,132,"TTTCAAGTACTAAAGGCAAT","CATCTGAAATATGTTTAGCT","561307.5.peg.154"," 602"
"5440",294,92,202,"TCTGTACTGTTCAGTACTGT","CATCTGAAATATGTTTAGCT","561307.5.peg.154"," 602"
"5441",92,224,132,"CATCTGAAATATGTTTAGCT","TTTCAAGTACTAAAGGCAAT","561307.5.peg.154"," 602"
"5442",92,294,202,"CATCTGAAATATGTTTAGCT","TCTGTACTGTTCAGTACTGT","561307.5.peg.154"," 602"
"5443",140,7,133,"TCGCGATTAATAGAAACGCT","GTCCACGAGTGTTGTAAGGG","561307.5.peg.1540"," 603"
"5444",140,10,130,"TCGCGATTAATAGAAACGCT","CTGGTCCACGAGTGTTGTAA","561307.5.peg.1540"," 603"
"5445",140,24,116,"TCGCGATTAATAGAAACGCT","TACCTCCCTTACAACACTCG","561307.5.peg.1540"," 603"
"5446",7,140,133,"GTCCACGAGTGTTGTAAGGG","TCGCGATTAATAGAAACGCT","561307.5.peg.1540"," 603"
"5447",10,140,130,"CTGGTCCACGAGTGTTGTAA","TCGCGATTAATAGAAACGCT","561307.5.peg.1540"," 603"
"5448",24,140,116,"TACCTCCCTTACAACACTCG","TCGCGATTAATAGAAACGCT","561307.5.peg.1540"," 603"
"5449",183,1,182,"GCAGCAAGTGAAATAAGTAA","TAACTAAGGAGGTGTCGTTA","561307.5.peg.1541"," 604"
"5450",1,183,182,"TAACTAAGGAGGTGTCGTTA","GCAGCAAGTGAAATAAGTAA","561307.5.peg.1541"," 604"
"5451",597,306,291,"ACATCAATGGCACCACCTAA","AATAACATAGCAAACCAAGA","561307.5.peg.1542"," 605"
"5452",461,306,155,"CCCATGCATGAATCCCCCAA","AATAACATAGCAAACCAAGA","561307.5.peg.1542"," 605"
"5453",540,306,234,"AATGTAGCGCTGACTAAGCC","AATAACATAGCAAACCAAGA","561307.5.peg.1542"," 605"
"5454",714,306,408,"ACTTGCATCGTGAAGTTACT","AATAACATAGCAAACCAAGA","561307.5.peg.1542"," 605"
"5455",610,306,304,"TATGACTGCCAATACATCAA","AATAACATAGCAAACCAAGA","561307.5.peg.1542"," 605"
"5456",540,375,165,"AATGTAGCGCTGACTAAGCC","AATTTGAAGGCATGACTGAT","561307.5.peg.1542"," 605"
"5457",610,375,235,"TATGACTGCCAATACATCAA","AATTTGAAGGCATGACTGAT","561307.5.peg.1542"," 605"
"5458",714,375,339,"ACTTGCATCGTGAAGTTACT","AATTTGAAGGCATGACTGAT","561307.5.peg.1542"," 605"
"5459",597,375,222,"ACATCAATGGCACCACCTAA","AATTTGAAGGCATGACTGAT","561307.5.peg.1542"," 605"
"5460",540,388,152,"AATGTAGCGCTGACTAAGCC","TGAATAGGCGTTAATTTGA","561307.5.peg.1542"," 605"
"5461",610,388,222,"TATGACTGCCAATACATCAA","TGAATAGGCGTTAATTTGA","561307.5.peg.1542"," 605"
"5462",714,388,326,"ACTTGCATCGTGAAGTTACT","TGAATAGGCGTTAATTTGA","561307.5.peg.1542"," 605"
"5463",597,388,209,"ACATCAATGGCACCACCTAA","TGAATAGGCGTTAATTTGA","561307.5.peg.1542"," 605"
"5464",597,402,195,"ACATCAATGGCACCACCTAA","TGCGTGCCAGCTTTATGAAT","561307.5.peg.1542"," 605"
"5465",714,402,312,"ACTTGCATCGTGAAGTTACT","TGCGTGCCAGCTTTATGAAT","561307.5.peg.1542"," 605"
"5466",610,402,208,"TATGACTGCCAATACATCAA","TGCGTGCCAGCTTTATGAAT","561307.5.peg.1542"," 605"
"5467",540,402,138,"AATGTAGCGCTGACTAAGCC","TGCGTGCCAGCTTTATGAAT","561307.5.peg.1542"," 605"
"5468",597,461,136,"ACATCAATGGCACCACCTAA","CCCATGCATGAATCCCCCAA","561307.5.peg.1542"," 605"
"5469",714,461,253,"ACTTGCATCGTGAAGTTACT","CCCATGCATGAATCCCCCAA","561307.5.peg.1542"," 605"
"5470",306,461,155,"AATAACATAGCAAACCAAGA","CCCATGCATGAATCCCCCAA","561307.5.peg.1542"," 605"
"5471",610,461,149,"TATGACTGCCAATACATCAA","CCCATGCATGAATCCCCCAA","561307.5.peg.1542"," 605"
"5472",306,540,234,"AATAACATAGCAAACCAAGA","AATGTAGCGCTGACTAAGCC","561307.5.peg.1542"," 605"
"5473",375,540,165,"AATTTGAAGGCATGACTGAT","AATGTAGCGCTGACTAAGCC","561307.5.peg.1542"," 605"
"5474",388,540,152,"TGAATAGGCGTTAATTTGA","AATGTAGCGCTGACTAAGCC","561307.5.peg.1542"," 605"
"5475",402,540,138,"TGCGTGCCAGCTTTATGAAT","AATGTAGCGCTGACTAAGCC","561307.5.peg.1542"," 605"
"5476",714,540,174,"ACTTGCATCGTGAAGTTACT","AATGTAGCGCTGACTAAGCC","561307.5.peg.1542"," 605"
"5477",306,597,291,"AATAACATAGCAAACCAAGA","ACATCAATGGCACCACCTAA","561307.5.peg.1542"," 605"
"5478",402,597,195,"TGCGTGCCAGCTTTATGAAT","ACATCAATGGCACCACCTAA","561307.5.peg.1542"," 605"
"5479",375,597,222,"AATTTGAAGGCATGACTGAT","ACATCAATGGCACCACCTAA","561307.5.peg.1542"," 605"
"5480",461,597,136,"CCCATGCATGAATCCCCCAA","ACATCAATGGCACCACCTAA","561307.5.peg.1542"," 605"
"5481",388,597,209,"TGAATAGGCGTTAATTTGA","ACATCAATGGCACCACCTAA","561307.5.peg.1542"," 605"
"5482",714,597,117,"ACTTGCATCGTGAAGTTACT","ACATCAATGGCACCACCTAA","561307.5.peg.1542"," 605"
"5483",388,610,222,"TGAATAGGCGTTAATTTGA","TATGACTGCCAATACATCAA","561307.5.peg.1542"," 605"
"5484",402,610,208,"TGCGTGCCAGCTTTATGAAT","TATGACTGCCAATACATCAA","561307.5.peg.1542"," 605"
"5485",375,610,235,"AATTTGAAGGCATGACTGAT","TATGACTGCCAATACATCAA","561307.5.peg.1542"," 605"
"5486",461,610,149,"CCCATGCATGAATCCCCCAA","TATGACTGCCAATACATCAA","561307.5.peg.1542"," 605"
"5487",306,610,304,"AATAACATAGCAAACCAAGA","TATGACTGCCAATACATCAA","561307.5.peg.1542"," 605"
"5488",714,610,104,"ACTTGCATCGTGAAGTTACT","TATGACTGCCAATACATCAA","561307.5.peg.1542"," 605"
"5489",375,714,339,"AATTTGAAGGCATGACTGAT","ACTTGCATCGTGAAGTTACT","561307.5.peg.1542"," 605"
"5490",388,714,326,"TGAATAGGCGTTAATTTGA","ACTTGCATCGTGAAGTTACT","561307.5.peg.1542"," 605"
"5491",306,714,408,"AATAACATAGCAAACCAAGA","ACTTGCATCGTGAAGTTACT","561307.5.peg.1542"," 605"
"5492",597,714,117,"ACATCAATGGCACCACCTAA","ACTTGCATCGTGAAGTTACT","561307.5.peg.1542"," 605"
"5493",610,714,104,"TATGACTGCCAATACATCAA","ACTTGCATCGTGAAGTTACT","561307.5.peg.1542"," 605"
"5494",540,714,174,"AATGTAGCGCTGACTAAGCC","ACTTGCATCGTGAAGTTACT","561307.5.peg.1542"," 605"
"5495",402,714,312,"TGCGTGCCAGCTTTATGAAT","ACTTGCATCGTGAAGTTACT","561307.5.peg.1542"," 605"
"5496",461,714,253,"CCCATGCATGAATCCCCCAA","ACTTGCATCGTGAAGTTACT","561307.5.peg.1542"," 605"
"5497",222,75,147,"GCATCAAACCCAAGTACACG","TTCCTTCTTCCAATTTAAA","561307.5.peg.1543"," 606"
"5498",420,75,345,"TATGCCGTAATACCAGTTAG","TTCCTTCTTCCAATTTAAA","561307.5.peg.1543"," 606"
"5499",180,75,105,"TGTCGTTGCTTTGTATCTAC","TTCCTTCTTCCAATTTAAA","561307.5.peg.1543"," 606"
"5500",321,75,246,"GCATTTGATCCTTGTCTATT","TTCCTTCTTCCAATTTAAA","561307.5.peg.1543"," 606"
"5501",420,180,240,"TATGCCGTAATACCAGTTAG","TGTCGTTGCTTTGTATCTAC","561307.5.peg.1543"," 606"
"5502",75,180,105,"TTCCTTCTTCCAATTTAAA","TGTCGTTGCTTTGTATCTAC","561307.5.peg.1543"," 606"
"5503",321,180,141,"GCATTTGATCCTTGTCTATT","TGTCGTTGCTTTGTATCTAC","561307.5.peg.1543"," 606"
"5504",75,222,147,"TTCCTTCTTCCAATTTAAA","GCATCAAACCCAAGTACACG","561307.5.peg.1543"," 606"
"5505",420,222,198,"TATGCCGTAATACCAGTTAG","GCATCAAACCCAAGTACACG","561307.5.peg.1543"," 606"
"5506",75,321,246,"TTCCTTCTTCCAATTTAAA","GCATTTGATCCTTGTCTATT","561307.5.peg.1543"," 606"
"5507",180,321,141,"TGTCGTTGCTTTGTATCTAC","GCATTTGATCCTTGTCTATT","561307.5.peg.1543"," 606"
"5508",75,420,345,"TTCCTTCTTCCAATTTAAA","TATGCCGTAATACCAGTTAG","561307.5.peg.1543"," 606"
"5509",180,420,240,"TGTCGTTGCTTTGTATCTAC","TATGCCGTAATACCAGTTAG","561307.5.peg.1543"," 606"
"5510",222,420,198,"GCATCAAACCCAAGTACACG","TATGCCGTAATACCAGTTAG","561307.5.peg.1543"," 606"
"5511",189,84,105,"GTCATACGTCCTCTCATATA","TCCTCTTGAGGCATGCCTTC","561307.5.peg.1544"," 607"
"5512",384,84,300,"TCAAGTGGTACATCTGTCGT","TCCTCTTGAGGCATGCCTTC","561307.5.peg.1544"," 607"
"5513",432,84,348,"CCATGATATGCTGTTTGTCC","TCCTCTTGAGGCATGCCTTC","561307.5.peg.1544"," 607"
"5514",432,135,297,"CCATGATATGCTGTTTGTCC","ACACCATCGCTCTCAAGTTT","561307.5.peg.1544"," 607"
"5515",384,135,249,"TCAAGTGGTACATCTGTCGT","ACACCATCGCTCTCAAGTTT","561307.5.peg.1544"," 607"
"5516",84,189,105,"TCCTCTTGAGGCATGCCTTC","GTCATACGTCCTCTCATATA","561307.5.peg.1544"," 607"
"5517",384,189,195,"TCAAGTGGTACATCTGTCGT","GTCATACGTCCTCTCATATA","561307.5.peg.1544"," 607"
"5518",432,189,243,"CCATGATATGCTGTTTGTCC","GTCATACGTCCTCTCATATA","561307.5.peg.1544"," 607"
"5519",84,384,300,"TCCTCTTGAGGCATGCCTTC","TCAAGTGGTACATCTGTCGT","561307.5.peg.1544"," 607"
"5520",189,384,195,"GTCATACGTCCTCTCATATA","TCAAGTGGTACATCTGTCGT","561307.5.peg.1544"," 607"
"5521",135,384,249,"ACACCATCGCTCTCAAGTTT","TCAAGTGGTACATCTGTCGT","561307.5.peg.1544"," 607"
"5522",84,432,348,"TCCTCTTGAGGCATGCCTTC","CCATGATATGCTGTTTGTCC","561307.5.peg.1544"," 607"
"5523",135,432,297,"ACACCATCGCTCTCAAGTTT","CCATGATATGCTGTTTGTCC","561307.5.peg.1544"," 607"
"5524",189,432,243,"GTCATACGTCCTCTCATATA","CCATGATATGCTGTTTGTCC","561307.5.peg.1544"," 607"
"5525",408,219,189,"CCATCTTTGTGTAACACTTC","CACTTAATTCTAAATCCAC","561307.5.peg.1546"," 609"
"5526",572,219,353,"ATCATATTTAATACCTGGA","CACTTAATTCTAAATCCAC","561307.5.peg.1546"," 609"
"5527",726,219,507,"CGAACATCTTCAGGATTTGA","CACTTAATTCTAAATCCAC","561307.5.peg.1546"," 609"
"5528",608,219,389,"CCATCATGTTATGATGTGAT","CACTTAATTCTAAATCCAC","561307.5.peg.1546"," 609"
"5529",717,219,498,"TCAGGATTTGATGGATCGAA","CACTTAATTCTAAATCCAC","561307.5.peg.1546"," 609"
"5530",408,293,115,"CCATCTTTGTGTAACACTTC","TAACTTCGCCATATCCATTT","561307.5.peg.1546"," 609"
"5531",608,293,315,"CCATCATGTTATGATGTGAT","TAACTTCGCCATATCCATTT","561307.5.peg.1546"," 609"
"5532",726,293,433,"CGAACATCTTCAGGATTTGA","TAACTTCGCCATATCCATTT","561307.5.peg.1546"," 609"
"5533",572,293,279,"ATCATATTTAATACCTGGA","TAACTTCGCCATATCCATTT","561307.5.peg.1546"," 609"
"5534",717,293,424,"TCAGGATTTGATGGATCGAA","TAACTTCGCCATATCCATTT","561307.5.peg.1546"," 609"
"5535",219,408,189,"CACTTAATTCTAAATCCAC","CCATCTTTGTGTAACACTTC","561307.5.peg.1546"," 609"
"5536",293,408,115,"TAACTTCGCCATATCCATTT","CCATCTTTGTGTAACACTTC","561307.5.peg.1546"," 609"
"5537",717,408,309,"TCAGGATTTGATGGATCGAA","CCATCTTTGTGTAACACTTC","561307.5.peg.1546"," 609"
"5538",726,408,318,"CGAACATCTTCAGGATTTGA","CCATCTTTGTGTAACACTTC","561307.5.peg.1546"," 609"
"5539",572,408,164,"ATCATATTTAATACCTGGA","CCATCTTTGTGTAACACTTC","561307.5.peg.1546"," 609"
"5540",608,408,200,"CCATCATGTTATGATGTGAT","CCATCTTTGTGTAACACTTC","561307.5.peg.1546"," 609"
"5541",219,572,353,"CACTTAATTCTAAATCCAC","ATCATATTTAATACCTGGA","561307.5.peg.1546"," 609"
"5542",717,572,145,"TCAGGATTTGATGGATCGAA","ATCATATTTAATACCTGGA","561307.5.peg.1546"," 609"
"5543",408,572,164,"CCATCTTTGTGTAACACTTC","ATCATATTTAATACCTGGA","561307.5.peg.1546"," 609"
"5544",726,572,154,"CGAACATCTTCAGGATTTGA","ATCATATTTAATACCTGGA","561307.5.peg.1546"," 609"
"5545",293,572,279,"TAACTTCGCCATATCCATTT","ATCATATTTAATACCTGGA","561307.5.peg.1546"," 609"
"5546",293,608,315,"TAACTTCGCCATATCCATTT","CCATCATGTTATGATGTGAT","561307.5.peg.1546"," 609"
"5547",219,608,389,"CACTTAATTCTAAATCCAC","CCATCATGTTATGATGTGAT","561307.5.peg.1546"," 609"
"5548",726,608,118,"CGAACATCTTCAGGATTTGA","CCATCATGTTATGATGTGAT","561307.5.peg.1546"," 609"
"5549",408,608,200,"CCATCTTTGTGTAACACTTC","CCATCATGTTATGATGTGAT","561307.5.peg.1546"," 609"
"5550",717,608,109,"TCAGGATTTGATGGATCGAA","CCATCATGTTATGATGTGAT","561307.5.peg.1546"," 609"
"5551",408,717,309,"CCATCTTTGTGTAACACTTC","TCAGGATTTGATGGATCGAA","561307.5.peg.1546"," 609"
"5552",219,717,498,"CACTTAATTCTAAATCCAC","TCAGGATTTGATGGATCGAA","561307.5.peg.1546"," 609"
"5553",608,717,109,"CCATCATGTTATGATGTGAT","TCAGGATTTGATGGATCGAA","561307.5.peg.1546"," 609"
"5554",293,717,424,"TAACTTCGCCATATCCATTT","TCAGGATTTGATGGATCGAA","561307.5.peg.1546"," 609"
"5555",572,717,145,"ATCATATTTAATACCTGGA","TCAGGATTTGATGGATCGAA","561307.5.peg.1546"," 609"
"5556",608,726,118,"CCATCATGTTATGATGTGAT","CGAACATCTTCAGGATTTGA","561307.5.peg.1546"," 609"
"5557",408,726,318,"CCATCTTTGTGTAACACTTC","CGAACATCTTCAGGATTTGA","561307.5.peg.1546"," 609"
"5558",293,726,433,"TAACTTCGCCATATCCATTT","CGAACATCTTCAGGATTTGA","561307.5.peg.1546"," 609"
"5559",572,726,154,"ATCATATTTAATACCTGGA","CGAACATCTTCAGGATTTGA","561307.5.peg.1546"," 609"
"5560",219,726,507,"CACTTAATTCTAAATCCAC","CGAACATCTTCAGGATTTGA","561307.5.peg.1546"," 609"
"5561",567,136,431,"AATACTTGTGAAATATTCGG","AGAAATAAATCCATCACGGA","561307.5.peg.1547"," 610"
"5562",555,136,419,"ATATTCGGCGGTACTTCTTT","AGAAATAAATCCATCACGGA","561307.5.peg.1547"," 610"
"5563",341,136,205,"GATTTGTACTTTCTAGCTTA","AGAAATAAATCCATCACGGA","561307.5.peg.1547"," 610"
"5564",426,136,290,"AAGAATCCACCATCTTTGGC","AGAAATAAATCCATCACGGA","561307.5.peg.1547"," 610"
"5565",804,136,668,"TATGTAATGGCTGCAATTGC","AGAAATAAATCCATCACGGA","561307.5.peg.1547"," 610"
"5566",754,136,618,"ACAAACCAGAATAATGCAA","AGAAATAAATCCATCACGGA","561307.5.peg.1547"," 610"
"5567",789,136,653,"ATTGCTGGCTCTACAATTGA","AGAAATAAATCCATCACGGA","561307.5.peg.1547"," 610"
"5568",754,165,589,"ACAAACCAGAATAATGCAA","TACTTGAGAATAAGATGAC","561307.5.peg.1547"," 610"
"5569",341,165,176,"GATTTGTACTTTCTAGCTTA","TACTTGAGAATAAGATGAC","561307.5.peg.1547"," 610"
"5570",426,165,261,"AAGAATCCACCATCTTTGGC","TACTTGAGAATAAGATGAC","561307.5.peg.1547"," 610"
"5571",789,165,624,"ATTGCTGGCTCTACAATTGA","TACTTGAGAATAAGATGAC","561307.5.peg.1547"," 610"
"5572",555,165,390,"ATATTCGGCGGTACTTCTTT","TACTTGAGAATAAGATGAC","561307.5.peg.1547"," 610"
"5573",567,165,402,"AATACTTGTGAAATATTCGG","TACTTGAGAATAAGATGAC","561307.5.peg.1547"," 610"
"5574",804,165,639,"TATGTAATGGCTGCAATTGC","TACTTGAGAATAAGATGAC","561307.5.peg.1547"," 610"
"5575",165,341,176,"TACTTGAGAATAAGATGAC","GATTTGTACTTTCTAGCTTA","561307.5.peg.1547"," 610"
"5576",136,341,205,"AGAAATAAATCCATCACGGA","GATTTGTACTTTCTAGCTTA","561307.5.peg.1547"," 610"
"5577",789,341,448,"ATTGCTGGCTCTACAATTGA","GATTTGTACTTTCTAGCTTA","561307.5.peg.1547"," 610"
"5578",754,341,413,"ACAAACCAGAATAATGCAA","GATTTGTACTTTCTAGCTTA","561307.5.peg.1547"," 610"
"5579",567,341,226,"AATACTTGTGAAATATTCGG","GATTTGTACTTTCTAGCTTA","561307.5.peg.1547"," 610"
"5580",555,341,214,"ATATTCGGCGGTACTTCTTT","GATTTGTACTTTCTAGCTTA","561307.5.peg.1547"," 610"
"5581",804,341,463,"TATGTAATGGCTGCAATTGC","GATTTGTACTTTCTAGCTTA","561307.5.peg.1547"," 610"
"5582",567,426,141,"AATACTTGTGAAATATTCGG","AAGAATCCACCATCTTTGGC","561307.5.peg.1547"," 610"
"5583",555,426,129,"ATATTCGGCGGTACTTCTTT","AAGAATCCACCATCTTTGGC","561307.5.peg.1547"," 610"
"5584",165,426,261,"TACTTGAGAATAAGATGAC","AAGAATCCACCATCTTTGGC","561307.5.peg.1547"," 610"
"5585",136,426,290,"AGAAATAAATCCATCACGGA","AAGAATCCACCATCTTTGGC","561307.5.peg.1547"," 610"
"5586",804,426,378,"TATGTAATGGCTGCAATTGC","AAGAATCCACCATCTTTGGC","561307.5.peg.1547"," 610"
"5587",789,426,363,"ATTGCTGGCTCTACAATTGA","AAGAATCCACCATCTTTGGC","561307.5.peg.1547"," 610"
"5588",754,426,328,"ACAAACCAGAATAATGCAA","AAGAATCCACCATCTTTGGC","561307.5.peg.1547"," 610"
"5589",136,555,419,"AGAAATAAATCCATCACGGA","ATATTCGGCGGTACTTCTTT","561307.5.peg.1547"," 610"
"5590",754,555,199,"ACAAACCAGAATAATGCAA","ATATTCGGCGGTACTTCTTT","561307.5.peg.1547"," 610"
"5591",426,555,129,"AAGAATCCACCATCTTTGGC","ATATTCGGCGGTACTTCTTT","561307.5.peg.1547"," 610"
"5592",341,555,214,"GATTTGTACTTTCTAGCTTA","ATATTCGGCGGTACTTCTTT","561307.5.peg.1547"," 610"
"5593",165,555,390,"TACTTGAGAATAAGATGAC","ATATTCGGCGGTACTTCTTT","561307.5.peg.1547"," 610"
"5594",789,555,234,"ATTGCTGGCTCTACAATTGA","ATATTCGGCGGTACTTCTTT","561307.5.peg.1547"," 610"
"5595",804,555,249,"TATGTAATGGCTGCAATTGC","ATATTCGGCGGTACTTCTTT","561307.5.peg.1547"," 610"
"5596",136,567,431,"AGAAATAAATCCATCACGGA","AATACTTGTGAAATATTCGG","561307.5.peg.1547"," 610"
"5597",754,567,187,"ACAAACCAGAATAATGCAA","AATACTTGTGAAATATTCGG","561307.5.peg.1547"," 610"
"5598",341,567,226,"GATTTGTACTTTCTAGCTTA","AATACTTGTGAAATATTCGG","561307.5.peg.1547"," 610"
"5599",165,567,402,"TACTTGAGAATAAGATGAC","AATACTTGTGAAATATTCGG","561307.5.peg.1547"," 610"
"5600",426,567,141,"AAGAATCCACCATCTTTGGC","AATACTTGTGAAATATTCGG","561307.5.peg.1547"," 610"
"5601",804,567,237,"TATGTAATGGCTGCAATTGC","AATACTTGTGAAATATTCGG","561307.5.peg.1547"," 610"
"5602",789,567,222,"ATTGCTGGCTCTACAATTGA","AATACTTGTGAAATATTCGG","561307.5.peg.1547"," 610"
"5603",555,754,199,"ATATTCGGCGGTACTTCTTT","ACAAACCAGAATAATGCAA","561307.5.peg.1547"," 610"
"5604",341,754,413,"GATTTGTACTTTCTAGCTTA","ACAAACCAGAATAATGCAA","561307.5.peg.1547"," 610"
"5605",165,754,589,"TACTTGAGAATAAGATGAC","ACAAACCAGAATAATGCAA","561307.5.peg.1547"," 610"
"5606",426,754,328,"AAGAATCCACCATCTTTGGC","ACAAACCAGAATAATGCAA","561307.5.peg.1547"," 610"
"5607",136,754,618,"AGAAATAAATCCATCACGGA","ACAAACCAGAATAATGCAA","561307.5.peg.1547"," 610"
"5608",567,754,187,"AATACTTGTGAAATATTCGG","ACAAACCAGAATAATGCAA","561307.5.peg.1547"," 610"
"5609",555,789,234,"ATATTCGGCGGTACTTCTTT","ATTGCTGGCTCTACAATTGA","561307.5.peg.1547"," 610"
"5610",165,789,624,"TACTTGAGAATAAGATGAC","ATTGCTGGCTCTACAATTGA","561307.5.peg.1547"," 610"
"5611",341,789,448,"GATTTGTACTTTCTAGCTTA","ATTGCTGGCTCTACAATTGA","561307.5.peg.1547"," 610"
"5612",567,789,222,"AATACTTGTGAAATATTCGG","ATTGCTGGCTCTACAATTGA","561307.5.peg.1547"," 610"
"5613",136,789,653,"AGAAATAAATCCATCACGGA","ATTGCTGGCTCTACAATTGA","561307.5.peg.1547"," 610"
"5614",426,789,363,"AAGAATCCACCATCTTTGGC","ATTGCTGGCTCTACAATTGA","561307.5.peg.1547"," 610"
"5615",426,804,378,"AAGAATCCACCATCTTTGGC","TATGTAATGGCTGCAATTGC","561307.5.peg.1547"," 610"
"5616",136,804,668,"AGAAATAAATCCATCACGGA","TATGTAATGGCTGCAATTGC","561307.5.peg.1547"," 610"
"5617",555,804,249,"ATATTCGGCGGTACTTCTTT","TATGTAATGGCTGCAATTGC","561307.5.peg.1547"," 610"
"5618",567,804,237,"AATACTTGTGAAATATTCGG","TATGTAATGGCTGCAATTGC","561307.5.peg.1547"," 610"
"5619",341,804,463,"GATTTGTACTTTCTAGCTTA","TATGTAATGGCTGCAATTGC","561307.5.peg.1547"," 610"
"5620",165,804,639,"TACTTGAGAATAAGATGAC","TATGTAATGGCTGCAATTGC","561307.5.peg.1547"," 610"
"5621",363,180,183,"GACCACTCTACTAAACAGTC","TGTTCAATTTGAGCTACAGT","561307.5.peg.1549"," 612"
"5622",180,363,183,"TGTTCAATTTGAGCTACAGT","GACCACTCTACTAAACAGTC","561307.5.peg.1549"," 612"
"5623",459,314,145,"ATCGCACCGATAAACATACG","AAATACGAACACACATTGAG","561307.5.peg.155"," 613"
"5624",532,314,218,"CATTTGCGAGTGATAATCTG","AAATACGAACACACATTGAG","561307.5.peg.155"," 613"
"5625",584,314,270,"ACGCTTCATTACGTGACAAT","AAATACGAACACACATTGAG","561307.5.peg.155"," 613"
"5626",314,459,145,"AAATACGAACACACATTGAG","ATCGCACCGATAAACATACG","561307.5.peg.155"," 613"
"5627",584,459,125,"ACGCTTCATTACGTGACAAT","ATCGCACCGATAAACATACG","561307.5.peg.155"," 613"
"5628",314,532,218,"AAATACGAACACACATTGAG","CATTTGCGAGTGATAATCTG","561307.5.peg.155"," 613"
"5629",314,584,270,"AAATACGAACACACATTGAG","ACGCTTCATTACGTGACAAT","561307.5.peg.155"," 613"
"5630",459,584,125,"ATCGCACCGATAAACATACG","ACGCTTCATTACGTGACAAT","561307.5.peg.155"," 613"
"5631",369,10,359,"GCCTCTTGATTATCAATCTC","GAGGCGAATACCACGATTAA","561307.5.peg.1550"," 614"
"5632",369,29,340,"GCCTCTTGATTATCAATCTC","TATGTGTCGTCCCTTAATCG","561307.5.peg.1550"," 614"
"5633",369,75,294,"GCCTCTTGATTATCAATCTC","GGGTATGAAATATCAACGGA","561307.5.peg.1550"," 614"
"5634",10,369,359,"GAGGCGAATACCACGATTAA","GCCTCTTGATTATCAATCTC","561307.5.peg.1550"," 614"
"5635",29,369,340,"TATGTGTCGTCCCTTAATCG","GCCTCTTGATTATCAATCTC","561307.5.peg.1550"," 614"
"5636",75,369,294,"GGGTATGAAATATCAACGGA","GCCTCTTGATTATCAATCTC","561307.5.peg.1550"," 614"
"5637",351,11,340,"AATAGTTCCACTGTTGTTCC","ACCCATCGCCTAAATAAAGG","561307.5.peg.1553"," 617"
"5638",351,14,337,"AATAGTTCCACTGTTGTTCC","ATGACCCATCGCCTAAATAA","561307.5.peg.1553"," 617"
"5639",351,19,332,"AATAGTTCCACTGTTGTTCC","GCCTCCTTTATTTAGGCGAT","561307.5.peg.1553"," 617"
"5640",11,351,340,"ACCCATCGCCTAAATAAAGG","AATAGTTCCACTGTTGTTCC","561307.5.peg.1553"," 617"
"5641",14,351,337,"ATGACCCATCGCCTAAATAA","AATAGTTCCACTGTTGTTCC","561307.5.peg.1553"," 617"
"5642",19,351,332,"GCCTCCTTTATTTAGGCGAT","AATAGTTCCACTGTTGTTCC","561307.5.peg.1553"," 617"
"5643",266,147,119,"CGACAAATAGTAAGCGCTTA","CCACCCATTGAACGGAAATC","561307.5.peg.1554"," 618"
"5644",266,155,111,"CGACAAATAGTAAGCGCTTA","CAAATAAGCCACCCATTGAA","561307.5.peg.1554"," 618"
"5645",147,266,119,"CCACCCATTGAACGGAAATC","CGACAAATAGTAAGCGCTTA","561307.5.peg.1554"," 618"
"5646",155,266,111,"CAAATAAGCCACCCATTGAA","CGACAAATAGTAAGCGCTTA","561307.5.peg.1554"," 618"
"5647",117,8,109,"GCTTCTGCTGTTTGTTCTTG","TGTATGTCCACTATAAACCA","561307.5.peg.1557"," 621"
"5648",372,8,364,"GAGCCATATACGTCATTGTA","TGTATGTCCACTATAAACCA","561307.5.peg.1557"," 621"
"5649",117,9,108,"GCTTCTGCTGTTTGTTCTTG","GTGGACATACAAGATAAAGG","561307.5.peg.1557"," 621"
"5650",372,9,363,"GAGCCATATACGTCATTGTA","GTGGACATACAAGATAAAGG","561307.5.peg.1557"," 621"
"5651",117,12,105,"GCTTCTGCTGTTTGTTCTTG","TAGTGGACATACAAGATAA","561307.5.peg.1557"," 621"
"5652",372,12,360,"GAGCCATATACGTCATTGTA","TAGTGGACATACAAGATAA","561307.5.peg.1557"," 621"
"5653",372,28,344,"GAGCCATATACGTCATTGTA","GTTCGCTCCATGGTTTATAG","561307.5.peg.1557"," 621"
"5654",372,87,285,"GAGCCATATACGTCATTGTA","AATACTCCGAAACCTAATAC","561307.5.peg.1557"," 621"
"5655",8,117,109,"TGTATGTCCACTATAAACCA","GCTTCTGCTGTTTGTTCTTG","561307.5.peg.1557"," 621"
"5656",372,117,255,"GAGCCATATACGTCATTGTA","GCTTCTGCTGTTTGTTCTTG","561307.5.peg.1557"," 621"
"5657",9,117,108,"GTGGACATACAAGATAAAGG","GCTTCTGCTGTTTGTTCTTG","561307.5.peg.1557"," 621"
"5658",12,117,105,"TAGTGGACATACAAGATAA","GCTTCTGCTGTTTGTTCTTG","561307.5.peg.1557"," 621"
"5659",9,372,363,"GTGGACATACAAGATAAAGG","GAGCCATATACGTCATTGTA","561307.5.peg.1557"," 621"
"5660",8,372,364,"TGTATGTCCACTATAAACCA","GAGCCATATACGTCATTGTA","561307.5.peg.1557"," 621"
"5661",28,372,344,"GTTCGCTCCATGGTTTATAG","GAGCCATATACGTCATTGTA","561307.5.peg.1557"," 621"
"5662",87,372,285,"AATACTCCGAAACCTAATAC","GAGCCATATACGTCATTGTA","561307.5.peg.1557"," 621"
"5663",12,372,360,"TAGTGGACATACAAGATAA","GAGCCATATACGTCATTGTA","561307.5.peg.1557"," 621"
"5664",117,372,255,"GCTTCTGCTGTTTGTTCTTG","GAGCCATATACGTCATTGTA","561307.5.peg.1557"," 621"
"5665",1054,85,969,"GTCGTCAATCCATGACTTTA","AGCCATTAATAACGTAATGG","561307.5.peg.1559"," 623"
"5666",951,85,866,"ACGCCATAAGCACCAGTGTA","AGCCATTAATAACGTAATGG","561307.5.peg.1559"," 623"
"5667",1153,85,1068,"TGTTGCAGATGCTGAGTGAC","AGCCATTAATAACGTAATGG","561307.5.peg.1559"," 623"
"5668",261,85,176,"CAAACTTCTTCTTCATATC","AGCCATTAATAACGTAATGG","561307.5.peg.1559"," 623"
"5669",586,85,501,"TAATCCCACCAATTTAAGT","AGCCATTAATAACGTAATGG","561307.5.peg.1559"," 623"
"5670",586,88,498,"TAATCCCACCAATTTAAGT","ACCAGCCATTAATAACGTAA","561307.5.peg.1559"," 623"
"5671",1054,88,966,"GTCGTCAATCCATGACTTTA","ACCAGCCATTAATAACGTAA","561307.5.peg.1559"," 623"
"5672",951,88,863,"ACGCCATAAGCACCAGTGTA","ACCAGCCATTAATAACGTAA","561307.5.peg.1559"," 623"
"5673",1153,88,1065,"TGTTGCAGATGCTGAGTGAC","ACCAGCCATTAATAACGTAA","561307.5.peg.1559"," 623"
"5674",261,88,173,"CAAACTTCTTCTTCATATC","ACCAGCCATTAATAACGTAA","561307.5.peg.1559"," 623"
"5675",85,261,176,"AGCCATTAATAACGTAATGG","CAAACTTCTTCTTCATATC","561307.5.peg.1559"," 623"
"5676",1153,261,892,"TGTTGCAGATGCTGAGTGAC","CAAACTTCTTCTTCATATC","561307.5.peg.1559"," 623"
"5677",951,261,690,"ACGCCATAAGCACCAGTGTA","CAAACTTCTTCTTCATATC","561307.5.peg.1559"," 623"
"5678",1054,261,793,"GTCGTCAATCCATGACTTTA","CAAACTTCTTCTTCATATC","561307.5.peg.1559"," 623"
"5679",586,261,325,"TAATCCCACCAATTTAAGT","CAAACTTCTTCTTCATATC","561307.5.peg.1559"," 623"
"5680",88,261,173,"ACCAGCCATTAATAACGTAA","CAAACTTCTTCTTCATATC","561307.5.peg.1559"," 623"
"5681",85,586,501,"AGCCATTAATAACGTAATGG","TAATCCCACCAATTTAAGT","561307.5.peg.1559"," 623"
"5682",88,586,498,"ACCAGCCATTAATAACGTAA","TAATCCCACCAATTTAAGT","561307.5.peg.1559"," 623"
"5683",1054,586,468,"GTCGTCAATCCATGACTTTA","TAATCCCACCAATTTAAGT","561307.5.peg.1559"," 623"
"5684",261,586,325,"CAAACTTCTTCTTCATATC","TAATCCCACCAATTTAAGT","561307.5.peg.1559"," 623"
"5685",1153,586,567,"TGTTGCAGATGCTGAGTGAC","TAATCCCACCAATTTAAGT","561307.5.peg.1559"," 623"
"5686",951,586,365,"ACGCCATAAGCACCAGTGTA","TAATCCCACCAATTTAAGT","561307.5.peg.1559"," 623"
"5687",85,951,866,"AGCCATTAATAACGTAATGG","ACGCCATAAGCACCAGTGTA","561307.5.peg.1559"," 623"
"5688",1153,951,202,"TGTTGCAGATGCTGAGTGAC","ACGCCATAAGCACCAGTGTA","561307.5.peg.1559"," 623"
"5689",88,951,863,"ACCAGCCATTAATAACGTAA","ACGCCATAAGCACCAGTGTA","561307.5.peg.1559"," 623"
"5690",261,951,690,"CAAACTTCTTCTTCATATC","ACGCCATAAGCACCAGTGTA","561307.5.peg.1559"," 623"
"5691",1054,951,103,"GTCGTCAATCCATGACTTTA","ACGCCATAAGCACCAGTGTA","561307.5.peg.1559"," 623"
"5692",586,951,365,"TAATCCCACCAATTTAAGT","ACGCCATAAGCACCAGTGTA","561307.5.peg.1559"," 623"
"5693",85,1054,969,"AGCCATTAATAACGTAATGG","GTCGTCAATCCATGACTTTA","561307.5.peg.1559"," 623"
"5694",88,1054,966,"ACCAGCCATTAATAACGTAA","GTCGTCAATCCATGACTTTA","561307.5.peg.1559"," 623"
"5695",951,1054,103,"ACGCCATAAGCACCAGTGTA","GTCGTCAATCCATGACTTTA","561307.5.peg.1559"," 623"
"5696",261,1054,793,"CAAACTTCTTCTTCATATC","GTCGTCAATCCATGACTTTA","561307.5.peg.1559"," 623"
"5697",586,1054,468,"TAATCCCACCAATTTAAGT","GTCGTCAATCCATGACTTTA","561307.5.peg.1559"," 623"
"5698",88,1153,1065,"ACCAGCCATTAATAACGTAA","TGTTGCAGATGCTGAGTGAC","561307.5.peg.1559"," 623"
"5699",261,1153,892,"CAAACTTCTTCTTCATATC","TGTTGCAGATGCTGAGTGAC","561307.5.peg.1559"," 623"
"5700",586,1153,567,"TAATCCCACCAATTTAAGT","TGTTGCAGATGCTGAGTGAC","561307.5.peg.1559"," 623"
"5701",951,1153,202,"ACGCCATAAGCACCAGTGTA","TGTTGCAGATGCTGAGTGAC","561307.5.peg.1559"," 623"
"5702",85,1153,1068,"AGCCATTAATAACGTAATGG","TGTTGCAGATGCTGAGTGAC","561307.5.peg.1559"," 623"
"5703",253,132,121,"TGGTTGACTTTATTGAAAG","TATTCACTATCTGGTACAGA","561307.5.peg.156"," 624"
"5704",948,132,816,"TTATAAGCAATGGCCCATCT","TATTCACTATCTGGTACAGA","561307.5.peg.156"," 624"
"5705",627,132,495,"GATCCCGCAGCAGCGTTTCT","TATTCACTATCTGGTACAGA","561307.5.peg.156"," 624"
"5706",854,132,722,"CATAAGGTAATGACTCTCTT","TATTCACTATCTGGTACAGA","561307.5.peg.156"," 624"
"5707",247,132,115,"GACTTTATTGAAAGAGGCTT","TATTCACTATCTGGTACAGA","561307.5.peg.156"," 624"
"5708",975,132,843,"TTAGTTACTACTTCCTCAGC","TATTCACTATCTGGTACAGA","561307.5.peg.156"," 624"
"5709",335,132,203,"CAATTTGTTCACGTATGCGT","TATTCACTATCTGGTACAGA","561307.5.peg.156"," 624"
"5710",272,132,140,"AACTTAACATTGGCGTGTCA","TATTCACTATCTGGTACAGA","561307.5.peg.156"," 624"
"5711",948,198,750,"TTATAAGCAATGGCCCATCT","GAATCTACAGTCTTATACTC","561307.5.peg.156"," 624"
"5712",627,198,429,"GATCCCGCAGCAGCGTTTCT","GAATCTACAGTCTTATACTC","561307.5.peg.156"," 624"
"5713",854,198,656,"CATAAGGTAATGACTCTCTT","GAATCTACAGTCTTATACTC","561307.5.peg.156"," 624"
"5714",335,198,137,"CAATTTGTTCACGTATGCGT","GAATCTACAGTCTTATACTC","561307.5.peg.156"," 624"
"5715",975,198,777,"TTAGTTACTACTTCCTCAGC","GAATCTACAGTCTTATACTC","561307.5.peg.156"," 624"
"5716",854,247,607,"CATAAGGTAATGACTCTCTT","GACTTTATTGAAAGAGGCTT","561307.5.peg.156"," 624"
"5717",132,247,115,"TATTCACTATCTGGTACAGA","GACTTTATTGAAAGAGGCTT","561307.5.peg.156"," 624"
"5718",975,247,728,"TTAGTTACTACTTCCTCAGC","GACTTTATTGAAAGAGGCTT","561307.5.peg.156"," 624"
"5719",627,247,380,"GATCCCGCAGCAGCGTTTCT","GACTTTATTGAAAGAGGCTT","561307.5.peg.156"," 624"
"5720",948,247,701,"TTATAAGCAATGGCCCATCT","GACTTTATTGAAAGAGGCTT","561307.5.peg.156"," 624"
"5721",132,253,121,"TATTCACTATCTGGTACAGA","TGGTTGACTTTATTGAAAG","561307.5.peg.156"," 624"
"5722",948,253,695,"TTATAAGCAATGGCCCATCT","TGGTTGACTTTATTGAAAG","561307.5.peg.156"," 624"
"5723",975,253,722,"TTAGTTACTACTTCCTCAGC","TGGTTGACTTTATTGAAAG","561307.5.peg.156"," 624"
"5724",854,253,601,"CATAAGGTAATGACTCTCTT","TGGTTGACTTTATTGAAAG","561307.5.peg.156"," 624"
"5725",627,253,374,"GATCCCGCAGCAGCGTTTCT","TGGTTGACTTTATTGAAAG","561307.5.peg.156"," 624"
"5726",948,272,676,"TTATAAGCAATGGCCCATCT","AACTTAACATTGGCGTGTCA","561307.5.peg.156"," 624"
"5727",975,272,703,"TTAGTTACTACTTCCTCAGC","AACTTAACATTGGCGTGTCA","561307.5.peg.156"," 624"
"5728",627,272,355,"GATCCCGCAGCAGCGTTTCT","AACTTAACATTGGCGTGTCA","561307.5.peg.156"," 624"
"5729",854,272,582,"CATAAGGTAATGACTCTCTT","AACTTAACATTGGCGTGTCA","561307.5.peg.156"," 624"
"5730",132,272,140,"TATTCACTATCTGGTACAGA","AACTTAACATTGGCGTGTCA","561307.5.peg.156"," 624"
"5731",975,335,640,"TTAGTTACTACTTCCTCAGC","CAATTTGTTCACGTATGCGT","561307.5.peg.156"," 624"
"5732",948,335,613,"TTATAAGCAATGGCCCATCT","CAATTTGTTCACGTATGCGT","561307.5.peg.156"," 624"
"5733",198,335,137,"GAATCTACAGTCTTATACTC","CAATTTGTTCACGTATGCGT","561307.5.peg.156"," 624"
"5734",132,335,203,"TATTCACTATCTGGTACAGA","CAATTTGTTCACGTATGCGT","561307.5.peg.156"," 624"
"5735",627,335,292,"GATCCCGCAGCAGCGTTTCT","CAATTTGTTCACGTATGCGT","561307.5.peg.156"," 624"
"5736",854,335,519,"CATAAGGTAATGACTCTCTT","CAATTTGTTCACGTATGCGT","561307.5.peg.156"," 624"
"5737",975,627,348,"TTAGTTACTACTTCCTCAGC","GATCCCGCAGCAGCGTTTCT","561307.5.peg.156"," 624"
"5738",253,627,374,"TGGTTGACTTTATTGAAAG","GATCCCGCAGCAGCGTTTCT","561307.5.peg.156"," 624"
"5739",948,627,321,"TTATAAGCAATGGCCCATCT","GATCCCGCAGCAGCGTTTCT","561307.5.peg.156"," 624"
"5740",247,627,380,"GACTTTATTGAAAGAGGCTT","GATCCCGCAGCAGCGTTTCT","561307.5.peg.156"," 624"
"5741",198,627,429,"GAATCTACAGTCTTATACTC","GATCCCGCAGCAGCGTTTCT","561307.5.peg.156"," 624"
"5742",335,627,292,"CAATTTGTTCACGTATGCGT","GATCCCGCAGCAGCGTTTCT","561307.5.peg.156"," 624"
"5743",854,627,227,"CATAAGGTAATGACTCTCTT","GATCCCGCAGCAGCGTTTCT","561307.5.peg.156"," 624"
"5744",132,627,495,"TATTCACTATCTGGTACAGA","GATCCCGCAGCAGCGTTTCT","561307.5.peg.156"," 624"
"5745",272,627,355,"AACTTAACATTGGCGTGTCA","GATCCCGCAGCAGCGTTTCT","561307.5.peg.156"," 624"
"5746",132,854,722,"TATTCACTATCTGGTACAGA","CATAAGGTAATGACTCTCTT","561307.5.peg.156"," 624"
"5747",272,854,582,"AACTTAACATTGGCGTGTCA","CATAAGGTAATGACTCTCTT","561307.5.peg.156"," 624"
"5748",627,854,227,"GATCCCGCAGCAGCGTTTCT","CATAAGGTAATGACTCTCTT","561307.5.peg.156"," 624"
"5749",247,854,607,"GACTTTATTGAAAGAGGCTT","CATAAGGTAATGACTCTCTT","561307.5.peg.156"," 624"
"5750",198,854,656,"GAATCTACAGTCTTATACTC","CATAAGGTAATGACTCTCTT","561307.5.peg.156"," 624"
"5751",253,854,601,"TGGTTGACTTTATTGAAAG","CATAAGGTAATGACTCTCTT","561307.5.peg.156"," 624"
"5752",335,854,519,"CAATTTGTTCACGTATGCGT","CATAAGGTAATGACTCTCTT","561307.5.peg.156"," 624"
"5753",975,854,121,"TTAGTTACTACTTCCTCAGC","CATAAGGTAATGACTCTCTT","561307.5.peg.156"," 624"
"5754",253,948,695,"TGGTTGACTTTATTGAAAG","TTATAAGCAATGGCCCATCT","561307.5.peg.156"," 624"
"5755",247,948,701,"GACTTTATTGAAAGAGGCTT","TTATAAGCAATGGCCCATCT","561307.5.peg.156"," 624"
"5756",198,948,750,"GAATCTACAGTCTTATACTC","TTATAAGCAATGGCCCATCT","561307.5.peg.156"," 624"
"5757",627,948,321,"GATCCCGCAGCAGCGTTTCT","TTATAAGCAATGGCCCATCT","561307.5.peg.156"," 624"
"5758",132,948,816,"TATTCACTATCTGGTACAGA","TTATAAGCAATGGCCCATCT","561307.5.peg.156"," 624"
"5759",272,948,676,"AACTTAACATTGGCGTGTCA","TTATAAGCAATGGCCCATCT","561307.5.peg.156"," 624"
"5760",335,948,613,"CAATTTGTTCACGTATGCGT","TTATAAGCAATGGCCCATCT","561307.5.peg.156"," 624"
"5761",247,975,728,"GACTTTATTGAAAGAGGCTT","TTAGTTACTACTTCCTCAGC","561307.5.peg.156"," 624"
"5762",253,975,722,"TGGTTGACTTTATTGAAAG","TTAGTTACTACTTCCTCAGC","561307.5.peg.156"," 624"
"5763",627,975,348,"GATCCCGCAGCAGCGTTTCT","TTAGTTACTACTTCCTCAGC","561307.5.peg.156"," 624"
"5764",272,975,703,"AACTTAACATTGGCGTGTCA","TTAGTTACTACTTCCTCAGC","561307.5.peg.156"," 624"
"5765",198,975,777,"GAATCTACAGTCTTATACTC","TTAGTTACTACTTCCTCAGC","561307.5.peg.156"," 624"
"5766",132,975,843,"TATTCACTATCTGGTACAGA","TTAGTTACTACTTCCTCAGC","561307.5.peg.156"," 624"
"5767",335,975,640,"CAATTTGTTCACGTATGCGT","TTAGTTACTACTTCCTCAGC","561307.5.peg.156"," 624"
"5768",854,975,121,"CATAAGGTAATGACTCTCTT","TTAGTTACTACTTCCTCAGC","561307.5.peg.156"," 624"
"5769",192,76,116,"CCATCTACTGAAATTGTGTA","AATAATCCCAATGCTAAAG","561307.5.peg.1562"," 627"
"5770",76,192,116,"AATAATCCCAATGCTAAAG","CCATCTACTGAAATTGTGTA","561307.5.peg.1562"," 627"
"5771",132,13,119,"AGATAGTCAATCTTTGCACC","TCTATACATCACATTTGAA","561307.5.peg.1564"," 629"
"5772",744,13,731,"CCTTGGAATGTTTCTACAAC","TCTATACATCACATTTGAA","561307.5.peg.1564"," 629"
"5773",255,13,242,"CTTGTAACAAGTACTACACC","TCTATACATCACATTTGAA","561307.5.peg.1564"," 629"
"5774",214,13,201,"AATACCTTGCGCCATCATTG","TCTATACATCACATTTGAA","561307.5.peg.1564"," 629"
"5775",761,13,748,"GACTAATTACACCTGCACCT","TCTATACATCACATTTGAA","561307.5.peg.1564"," 629"
"5776",824,13,811,"ATTCATCACCAACTTGATTG","TCTATACATCACATTTGAA","561307.5.peg.1564"," 629"
"5777",180,13,167,"TGACGAGTGACAATAAGTTC","TCTATACATCACATTTGAA","561307.5.peg.1564"," 629"
"5778",336,13,323,"TGGCCACCTAACGCTAATAC","TCTATACATCACATTTGAA","561307.5.peg.1564"," 629"
"5779",712,13,699,"GCGCTCAACTAATTTGCGAA","TCTATACATCACATTTGAA","561307.5.peg.1564"," 629"
"5780",609,13,596,"CATTAATATCTTGTTCACT","TCTATACATCACATTTGAA","561307.5.peg.1564"," 629"
"5781",609,132,477,"CATTAATATCTTGTTCACT","AGATAGTCAATCTTTGCACC","561307.5.peg.1564"," 629"
"5782",336,132,204,"TGGCCACCTAACGCTAATAC","AGATAGTCAATCTTTGCACC","561307.5.peg.1564"," 629"
"5783",712,132,580,"GCGCTCAACTAATTTGCGAA","AGATAGTCAATCTTTGCACC","561307.5.peg.1564"," 629"
"5784",13,132,119,"TCTATACATCACATTTGAA","AGATAGTCAATCTTTGCACC","561307.5.peg.1564"," 629"
"5785",255,132,123,"CTTGTAACAAGTACTACACC","AGATAGTCAATCTTTGCACC","561307.5.peg.1564"," 629"
"5786",824,132,692,"ATTCATCACCAACTTGATTG","AGATAGTCAATCTTTGCACC","561307.5.peg.1564"," 629"
"5787",761,132,629,"GACTAATTACACCTGCACCT","AGATAGTCAATCTTTGCACC","561307.5.peg.1564"," 629"
"5788",744,132,612,"CCTTGGAATGTTTCTACAAC","AGATAGTCAATCTTTGCACC","561307.5.peg.1564"," 629"
"5789",13,180,167,"TCTATACATCACATTTGAA","TGACGAGTGACAATAAGTTC","561307.5.peg.1564"," 629"
"5790",744,180,564,"CCTTGGAATGTTTCTACAAC","TGACGAGTGACAATAAGTTC","561307.5.peg.1564"," 629"
"5791",336,180,156,"TGGCCACCTAACGCTAATAC","TGACGAGTGACAATAAGTTC","561307.5.peg.1564"," 629"
"5792",761,180,581,"GACTAATTACACCTGCACCT","TGACGAGTGACAATAAGTTC","561307.5.peg.1564"," 629"
"5793",609,180,429,"CATTAATATCTTGTTCACT","TGACGAGTGACAATAAGTTC","561307.5.peg.1564"," 629"
"5794",824,180,644,"ATTCATCACCAACTTGATTG","TGACGAGTGACAATAAGTTC","561307.5.peg.1564"," 629"
"5795",712,180,532,"GCGCTCAACTAATTTGCGAA","TGACGAGTGACAATAAGTTC","561307.5.peg.1564"," 629"
"5796",761,214,547,"GACTAATTACACCTGCACCT","AATACCTTGCGCCATCATTG","561307.5.peg.1564"," 629"
"5797",336,214,122,"TGGCCACCTAACGCTAATAC","AATACCTTGCGCCATCATTG","561307.5.peg.1564"," 629"
"5798",13,214,201,"TCTATACATCACATTTGAA","AATACCTTGCGCCATCATTG","561307.5.peg.1564"," 629"
"5799",744,214,530,"CCTTGGAATGTTTCTACAAC","AATACCTTGCGCCATCATTG","561307.5.peg.1564"," 629"
"5800",824,214,610,"ATTCATCACCAACTTGATTG","AATACCTTGCGCCATCATTG","561307.5.peg.1564"," 629"
"5801",712,214,498,"GCGCTCAACTAATTTGCGAA","AATACCTTGCGCCATCATTG","561307.5.peg.1564"," 629"
"5802",609,214,395,"CATTAATATCTTGTTCACT","AATACCTTGCGCCATCATTG","561307.5.peg.1564"," 629"
"5803",13,255,242,"TCTATACATCACATTTGAA","CTTGTAACAAGTACTACACC","561307.5.peg.1564"," 629"
"5804",744,255,489,"CCTTGGAATGTTTCTACAAC","CTTGTAACAAGTACTACACC","561307.5.peg.1564"," 629"
"5805",609,255,354,"CATTAATATCTTGTTCACT","CTTGTAACAAGTACTACACC","561307.5.peg.1564"," 629"
"5806",824,255,569,"ATTCATCACCAACTTGATTG","CTTGTAACAAGTACTACACC","561307.5.peg.1564"," 629"
"5807",132,255,123,"AGATAGTCAATCTTTGCACC","CTTGTAACAAGTACTACACC","561307.5.peg.1564"," 629"
"5808",712,255,457,"GCGCTCAACTAATTTGCGAA","CTTGTAACAAGTACTACACC","561307.5.peg.1564"," 629"
"5809",761,255,506,"GACTAATTACACCTGCACCT","CTTGTAACAAGTACTACACC","561307.5.peg.1564"," 629"
"5810",132,336,204,"AGATAGTCAATCTTTGCACC","TGGCCACCTAACGCTAATAC","561307.5.peg.1564"," 629"
"5811",180,336,156,"TGACGAGTGACAATAAGTTC","TGGCCACCTAACGCTAATAC","561307.5.peg.1564"," 629"
"5812",761,336,425,"GACTAATTACACCTGCACCT","TGGCCACCTAACGCTAATAC","561307.5.peg.1564"," 629"
"5813",214,336,122,"AATACCTTGCGCCATCATTG","TGGCCACCTAACGCTAATAC","561307.5.peg.1564"," 629"
"5814",824,336,488,"ATTCATCACCAACTTGATTG","TGGCCACCTAACGCTAATAC","561307.5.peg.1564"," 629"
"5815",744,336,408,"CCTTGGAATGTTTCTACAAC","TGGCCACCTAACGCTAATAC","561307.5.peg.1564"," 629"
"5816",712,336,376,"GCGCTCAACTAATTTGCGAA","TGGCCACCTAACGCTAATAC","561307.5.peg.1564"," 629"
"5817",13,336,323,"TCTATACATCACATTTGAA","TGGCCACCTAACGCTAATAC","561307.5.peg.1564"," 629"
"5818",609,336,273,"CATTAATATCTTGTTCACT","TGGCCACCTAACGCTAATAC","561307.5.peg.1564"," 629"
"5819",132,609,477,"AGATAGTCAATCTTTGCACC","CATTAATATCTTGTTCACT","561307.5.peg.1564"," 629"
"5820",180,609,429,"TGACGAGTGACAATAAGTTC","CATTAATATCTTGTTCACT","561307.5.peg.1564"," 629"
"5821",13,609,596,"TCTATACATCACATTTGAA","CATTAATATCTTGTTCACT","561307.5.peg.1564"," 629"
"5822",744,609,135,"CCTTGGAATGTTTCTACAAC","CATTAATATCTTGTTCACT","561307.5.peg.1564"," 629"
"5823",712,609,103,"GCGCTCAACTAATTTGCGAA","CATTAATATCTTGTTCACT","561307.5.peg.1564"," 629"
"5824",761,609,152,"GACTAATTACACCTGCACCT","CATTAATATCTTGTTCACT","561307.5.peg.1564"," 629"
"5825",336,609,273,"TGGCCACCTAACGCTAATAC","CATTAATATCTTGTTCACT","561307.5.peg.1564"," 629"
"5826",824,609,215,"ATTCATCACCAACTTGATTG","CATTAATATCTTGTTCACT","561307.5.peg.1564"," 629"
"5827",214,609,395,"AATACCTTGCGCCATCATTG","CATTAATATCTTGTTCACT","561307.5.peg.1564"," 629"
"5828",255,609,354,"CTTGTAACAAGTACTACACC","CATTAATATCTTGTTCACT","561307.5.peg.1564"," 629"
"5829",132,712,580,"AGATAGTCAATCTTTGCACC","GCGCTCAACTAATTTGCGAA","561307.5.peg.1564"," 629"
"5830",180,712,532,"TGACGAGTGACAATAAGTTC","GCGCTCAACTAATTTGCGAA","561307.5.peg.1564"," 629"
"5831",255,712,457,"CTTGTAACAAGTACTACACC","GCGCTCAACTAATTTGCGAA","561307.5.peg.1564"," 629"
"5832",214,712,498,"AATACCTTGCGCCATCATTG","GCGCTCAACTAATTTGCGAA","561307.5.peg.1564"," 629"
"5833",824,712,112,"ATTCATCACCAACTTGATTG","GCGCTCAACTAATTTGCGAA","561307.5.peg.1564"," 629"
"5834",336,712,376,"TGGCCACCTAACGCTAATAC","GCGCTCAACTAATTTGCGAA","561307.5.peg.1564"," 629"
"5835",13,712,699,"TCTATACATCACATTTGAA","GCGCTCAACTAATTTGCGAA","561307.5.peg.1564"," 629"
"5836",609,712,103,"CATTAATATCTTGTTCACT","GCGCTCAACTAATTTGCGAA","561307.5.peg.1564"," 629"
"5837",609,744,135,"CATTAATATCTTGTTCACT","CCTTGGAATGTTTCTACAAC","561307.5.peg.1564"," 629"
"5838",336,744,408,"TGGCCACCTAACGCTAATAC","CCTTGGAATGTTTCTACAAC","561307.5.peg.1564"," 629"
"5839",255,744,489,"CTTGTAACAAGTACTACACC","CCTTGGAATGTTTCTACAAC","561307.5.peg.1564"," 629"
"5840",214,744,530,"AATACCTTGCGCCATCATTG","CCTTGGAATGTTTCTACAAC","561307.5.peg.1564"," 629"
"5841",13,744,731,"TCTATACATCACATTTGAA","CCTTGGAATGTTTCTACAAC","561307.5.peg.1564"," 629"
"5842",180,744,564,"TGACGAGTGACAATAAGTTC","CCTTGGAATGTTTCTACAAC","561307.5.peg.1564"," 629"
"5843",132,744,612,"AGATAGTCAATCTTTGCACC","CCTTGGAATGTTTCTACAAC","561307.5.peg.1564"," 629"
"5844",13,761,748,"TCTATACATCACATTTGAA","GACTAATTACACCTGCACCT","561307.5.peg.1564"," 629"
"5845",132,761,629,"AGATAGTCAATCTTTGCACC","GACTAATTACACCTGCACCT","561307.5.peg.1564"," 629"
"5846",336,761,425,"TGGCCACCTAACGCTAATAC","GACTAATTACACCTGCACCT","561307.5.peg.1564"," 629"
"5847",255,761,506,"CTTGTAACAAGTACTACACC","GACTAATTACACCTGCACCT","561307.5.peg.1564"," 629"
"5848",214,761,547,"AATACCTTGCGCCATCATTG","GACTAATTACACCTGCACCT","561307.5.peg.1564"," 629"
"5849",180,761,581,"TGACGAGTGACAATAAGTTC","GACTAATTACACCTGCACCT","561307.5.peg.1564"," 629"
"5850",609,761,152,"CATTAATATCTTGTTCACT","GACTAATTACACCTGCACCT","561307.5.peg.1564"," 629"
"5851",336,824,488,"TGGCCACCTAACGCTAATAC","ATTCATCACCAACTTGATTG","561307.5.peg.1564"," 629"
"5852",255,824,569,"CTTGTAACAAGTACTACACC","ATTCATCACCAACTTGATTG","561307.5.peg.1564"," 629"
"5853",13,824,811,"TCTATACATCACATTTGAA","ATTCATCACCAACTTGATTG","561307.5.peg.1564"," 629"
"5854",180,824,644,"TGACGAGTGACAATAAGTTC","ATTCATCACCAACTTGATTG","561307.5.peg.1564"," 629"
"5855",214,824,610,"AATACCTTGCGCCATCATTG","ATTCATCACCAACTTGATTG","561307.5.peg.1564"," 629"
"5856",132,824,692,"AGATAGTCAATCTTTGCACC","ATTCATCACCAACTTGATTG","561307.5.peg.1564"," 629"
"5857",609,824,215,"CATTAATATCTTGTTCACT","ATTCATCACCAACTTGATTG","561307.5.peg.1564"," 629"
"5858",712,824,112,"GCGCTCAACTAATTTGCGAA","ATTCATCACCAACTTGATTG","561307.5.peg.1564"," 629"
"5859",125,11,114,"CTCTGATTAATTCCATGAAG","GTGTATGATGTTATTCTTGC","561307.5.peg.1566"," 631"
"5860",543,11,532,"CCATAGTAAAGCATTACGGT","GTGTATGATGTTATTCTTGC","561307.5.peg.1566"," 631"
"5861",11,125,114,"GTGTATGATGTTATTCTTGC","CTCTGATTAATTCCATGAAG","561307.5.peg.1566"," 631"
"5862",543,125,418,"CCATAGTAAAGCATTACGGT","CTCTGATTAATTCCATGAAG","561307.5.peg.1566"," 631"
"5863",11,543,532,"GTGTATGATGTTATTCTTGC","CCATAGTAAAGCATTACGGT","561307.5.peg.1566"," 631"
"5864",125,543,418,"CTCTGATTAATTCCATGAAG","CCATAGTAAAGCATTACGGT","561307.5.peg.1566"," 631"
"5865",486,110,376,"TCTGTTTCACCTTCGTGTGA","TTCCAGCCTGGTCATCCTTA","561307.5.peg.157"," 635"
"5866",110,486,376,"TTCCAGCCTGGTCATCCTTA","TCTGTTTCACCTTCGTGTGA","561307.5.peg.157"," 635"
"5867",117,9,108,"ACTGTGATGTTACCTTCACC","TTACGTGGTTAATTAGAAGG","561307.5.peg.1570"," 636"
"5868",146,9,137,"GTAAGTATTCGCGTACGTCA","TTACGTGGTTAATTAGAAGG","561307.5.peg.1570"," 636"
"5869",197,9,188,"TTCAGTTACATCAAATGGT","TTACGTGGTTAATTAGAAGG","561307.5.peg.1570"," 636"
"5870",9,117,108,"TTACGTGGTTAATTAGAAGG","ACTGTGATGTTACCTTCACC","561307.5.peg.1570"," 636"
"5871",9,146,137,"TTACGTGGTTAATTAGAAGG","GTAAGTATTCGCGTACGTCA","561307.5.peg.1570"," 636"
"5872",9,197,188,"TTACGTGGTTAATTAGAAGG","TTCAGTTACATCAAATGGT","561307.5.peg.1570"," 636"
"5873",287,182,105,"AAATATCATCAGGTAACGTT","TATCAGTCCTACTTGAAGGA","561307.5.peg.1572"," 638"
"5874",404,182,222,"AACCACTTTGAAATGGATCG","TATCAGTCCTACTTGAAGGA","561307.5.peg.1572"," 638"
"5875",287,186,101,"AAATATCATCAGGTAACGTT","CCTCTATCAGTCCTACTTGA","561307.5.peg.1572"," 638"
"5876",404,186,218,"AACCACTTTGAAATGGATCG","CCTCTATCAGTCCTACTTGA","561307.5.peg.1572"," 638"
"5877",404,258,146,"AACCACTTTGAAATGGATCG","GCATATTGCCATTGTGACAT","561307.5.peg.1572"," 638"
"5878",182,287,105,"TATCAGTCCTACTTGAAGGA","AAATATCATCAGGTAACGTT","561307.5.peg.1572"," 638"
"5879",186,287,101,"CCTCTATCAGTCCTACTTGA","AAATATCATCAGGTAACGTT","561307.5.peg.1572"," 638"
"5880",404,287,117,"AACCACTTTGAAATGGATCG","AAATATCATCAGGTAACGTT","561307.5.peg.1572"," 638"
"5881",182,404,222,"TATCAGTCCTACTTGAAGGA","AACCACTTTGAAATGGATCG","561307.5.peg.1572"," 638"
"5882",258,404,146,"GCATATTGCCATTGTGACAT","AACCACTTTGAAATGGATCG","561307.5.peg.1572"," 638"
"5883",186,404,218,"CCTCTATCAGTCCTACTTGA","AACCACTTTGAAATGGATCG","561307.5.peg.1572"," 638"
"5884",287,404,117,"AAATATCATCAGGTAACGTT","AACCACTTTGAAATGGATCG","561307.5.peg.1572"," 638"
"5885",114,5,109,"CAAACATTAACTTTGCTCT","TTGTAAGCTTGTATAAGGAG","561307.5.peg.1573"," 639"
"5886",245,5,240,"TGGTGTTAAACCTTTGATT","TTGTAAGCTTGTATAAGGAG","561307.5.peg.1573"," 639"
"5887",114,10,104,"CAAACATTAACTTTGCTCT","GCATTTGTAAGCTTGTATA","561307.5.peg.1573"," 639"
"5888",245,10,235,"TGGTGTTAAACCTTTGATT","GCATTTGTAAGCTTGTATA","561307.5.peg.1573"," 639"
"5889",5,114,109,"TTGTAAGCTTGTATAAGGAG","CAAACATTAACTTTGCTCT","561307.5.peg.1573"," 639"
"5890",245,114,131,"TGGTGTTAAACCTTTGATT","CAAACATTAACTTTGCTCT","561307.5.peg.1573"," 639"
"5891",10,114,104,"GCATTTGTAAGCTTGTATA","CAAACATTAACTTTGCTCT","561307.5.peg.1573"," 639"
"5892",10,245,235,"GCATTTGTAAGCTTGTATA","TGGTGTTAAACCTTTGATT","561307.5.peg.1573"," 639"
"5893",5,245,240,"TTGTAAGCTTGTATAAGGAG","TGGTGTTAAACCTTTGATT","561307.5.peg.1573"," 639"
"5894",114,245,131,"CAAACATTAACTTTGCTCT","TGGTGTTAAACCTTTGATT","561307.5.peg.1573"," 639"
"5895",424,8,416,"TAAATCCATCAACAGACGAT","CTTAACTTATGAAGGGCTGG","561307.5.peg.1574"," 640"
"5896",225,8,217,"ACTGTAACTGTCCCAGTAGT","CTTAACTTATGAAGGGCTGG","561307.5.peg.1574"," 640"
"5897",330,8,322,"TCCTCAAATAATTGAGATTC","CTTAACTTATGAAGGGCTGG","561307.5.peg.1574"," 640"
"5898",225,11,214,"ACTGTAACTGTCCCAGTAGT","ATTCTTAACTTATGAAGGGC","561307.5.peg.1574"," 640"
"5899",330,11,319,"TCCTCAAATAATTGAGATTC","ATTCTTAACTTATGAAGGGC","561307.5.peg.1574"," 640"
"5900",424,11,413,"TAAATCCATCAACAGACGAT","ATTCTTAACTTATGAAGGGC","561307.5.peg.1574"," 640"
"5901",225,99,126,"ACTGTAACTGTCCCAGTAGT","TGAATAGCTTGATGCTGATA","561307.5.peg.1574"," 640"
"5902",330,99,231,"TCCTCAAATAATTGAGATTC","TGAATAGCTTGATGCTGATA","561307.5.peg.1574"," 640"
"5903",424,99,325,"TAAATCCATCAACAGACGAT","TGAATAGCTTGATGCTGATA","561307.5.peg.1574"," 640"
"5904",99,225,126,"TGAATAGCTTGATGCTGATA","ACTGTAACTGTCCCAGTAGT","561307.5.peg.1574"," 640"
"5905",11,225,214,"ATTCTTAACTTATGAAGGGC","ACTGTAACTGTCCCAGTAGT","561307.5.peg.1574"," 640"
"5906",8,225,217,"CTTAACTTATGAAGGGCTGG","ACTGTAACTGTCCCAGTAGT","561307.5.peg.1574"," 640"
"5907",330,225,105,"TCCTCAAATAATTGAGATTC","ACTGTAACTGTCCCAGTAGT","561307.5.peg.1574"," 640"
"5908",424,225,199,"TAAATCCATCAACAGACGAT","ACTGTAACTGTCCCAGTAGT","561307.5.peg.1574"," 640"
"5909",8,330,322,"CTTAACTTATGAAGGGCTGG","TCCTCAAATAATTGAGATTC","561307.5.peg.1574"," 640"
"5910",99,330,231,"TGAATAGCTTGATGCTGATA","TCCTCAAATAATTGAGATTC","561307.5.peg.1574"," 640"
"5911",11,330,319,"ATTCTTAACTTATGAAGGGC","TCCTCAAATAATTGAGATTC","561307.5.peg.1574"," 640"
"5912",225,330,105,"ACTGTAACTGTCCCAGTAGT","TCCTCAAATAATTGAGATTC","561307.5.peg.1574"," 640"
"5913",8,424,416,"CTTAACTTATGAAGGGCTGG","TAAATCCATCAACAGACGAT","561307.5.peg.1574"," 640"
"5914",11,424,413,"ATTCTTAACTTATGAAGGGC","TAAATCCATCAACAGACGAT","561307.5.peg.1574"," 640"
"5915",225,424,199,"ACTGTAACTGTCCCAGTAGT","TAAATCCATCAACAGACGAT","561307.5.peg.1574"," 640"
"5916",99,424,325,"TGAATAGCTTGATGCTGATA","TAAATCCATCAACAGACGAT","561307.5.peg.1574"," 640"
"5917",205,11,194,"CTCTATGCCAATCATTAACT","GATAGATACACGAATCGTAA","561307.5.peg.1575"," 641"
"5918",147,11,136,"ATAGATGTCCACTGACCTTT","GATAGATACACGAATCGTAA","561307.5.peg.1575"," 641"
"5919",324,11,313,"GAACCAACAAATTGATTATC","GATAGATACACGAATCGTAA","561307.5.peg.1575"," 641"
"5920",393,11,382,"CTTCTATGCATTTCGTCATA","GATAGATACACGAATCGTAA","561307.5.peg.1575"," 641"
"5921",115,11,104,"GAAACATCTTTCAATGTGA","GATAGATACACGAATCGTAA","561307.5.peg.1575"," 641"
"5922",393,115,278,"CTTCTATGCATTTCGTCATA","GAAACATCTTTCAATGTGA","561307.5.peg.1575"," 641"
"5923",11,115,104,"GATAGATACACGAATCGTAA","GAAACATCTTTCAATGTGA","561307.5.peg.1575"," 641"
"5924",324,115,209,"GAACCAACAAATTGATTATC","GAAACATCTTTCAATGTGA","561307.5.peg.1575"," 641"
"5925",11,147,136,"GATAGATACACGAATCGTAA","ATAGATGTCCACTGACCTTT","561307.5.peg.1575"," 641"
"5926",393,147,246,"CTTCTATGCATTTCGTCATA","ATAGATGTCCACTGACCTTT","561307.5.peg.1575"," 641"
"5927",324,147,177,"GAACCAACAAATTGATTATC","ATAGATGTCCACTGACCTTT","561307.5.peg.1575"," 641"
"5928",324,205,119,"GAACCAACAAATTGATTATC","CTCTATGCCAATCATTAACT","561307.5.peg.1575"," 641"
"5929",11,205,194,"GATAGATACACGAATCGTAA","CTCTATGCCAATCATTAACT","561307.5.peg.1575"," 641"
"5930",393,205,188,"CTTCTATGCATTTCGTCATA","CTCTATGCCAATCATTAACT","561307.5.peg.1575"," 641"
"5931",11,324,313,"GATAGATACACGAATCGTAA","GAACCAACAAATTGATTATC","561307.5.peg.1575"," 641"
"5932",147,324,177,"ATAGATGTCCACTGACCTTT","GAACCAACAAATTGATTATC","561307.5.peg.1575"," 641"
"5933",115,324,209,"GAAACATCTTTCAATGTGA","GAACCAACAAATTGATTATC","561307.5.peg.1575"," 641"
"5934",205,324,119,"CTCTATGCCAATCATTAACT","GAACCAACAAATTGATTATC","561307.5.peg.1575"," 641"
"5935",115,393,278,"GAAACATCTTTCAATGTGA","CTTCTATGCATTTCGTCATA","561307.5.peg.1575"," 641"
"5936",11,393,382,"GATAGATACACGAATCGTAA","CTTCTATGCATTTCGTCATA","561307.5.peg.1575"," 641"
"5937",147,393,246,"ATAGATGTCCACTGACCTTT","CTTCTATGCATTTCGTCATA","561307.5.peg.1575"," 641"
"5938",205,393,188,"CTCTATGCCAATCATTAACT","CTTCTATGCATTTCGTCATA","561307.5.peg.1575"," 641"
"5939",129,9,120,"GTACCGTAGCCACGTTCTAG","TTAAGTCGACGTATATAAGG","561307.5.peg.1577"," 643"
"5940",166,9,157,"AGATAGTAGGATACGACGTA","TTAAGTCGACGTATATAAGG","561307.5.peg.1577"," 643"
"5941",179,9,170,"CACCTGGTAATGAAGATAGT","TTAAGTCGACGTATATAAGG","561307.5.peg.1577"," 643"
"5942",195,9,186,"ATATACTTAACGGCTGCACC","TTAAGTCGACGTATATAAGG","561307.5.peg.1577"," 643"
"5943",9,129,120,"TTAAGTCGACGTATATAAGG","GTACCGTAGCCACGTTCTAG","561307.5.peg.1577"," 643"
"5944",9,166,157,"TTAAGTCGACGTATATAAGG","AGATAGTAGGATACGACGTA","561307.5.peg.1577"," 643"
"5945",9,179,170,"TTAAGTCGACGTATATAAGG","CACCTGGTAATGAAGATAGT","561307.5.peg.1577"," 643"
"5946",9,195,186,"TTAAGTCGACGTATATAAGG","ATATACTTAACGGCTGCACC","561307.5.peg.1577"," 643"
"5947",279,118,161,"CCAGTGCTATAGACAGAACC","GATTAGTATCAAGAAGTAGA","561307.5.peg.158"," 646"
"5948",689,118,571,"ATTCATCATAGCAACAATA","GATTAGTATCAAGAAGTAGA","561307.5.peg.158"," 646"
"5949",369,118,251,"TCGGTATAAACACGAAGTCT","GATTAGTATCAAGAAGTAGA","561307.5.peg.158"," 646"
"5950",388,118,270,"AATTGCATCTCCAGCTAATT","GATTAGTATCAAGAAGTAGA","561307.5.peg.158"," 646"
"5951",388,179,209,"AATTGCATCTCCAGCTAATT","CACCTAACATGTACTCGCTT","561307.5.peg.158"," 646"
"5952",279,179,100,"CCAGTGCTATAGACAGAACC","CACCTAACATGTACTCGCTT","561307.5.peg.158"," 646"
"5953",369,179,190,"TCGGTATAAACACGAAGTCT","CACCTAACATGTACTCGCTT","561307.5.peg.158"," 646"
"5954",689,179,510,"ATTCATCATAGCAACAATA","CACCTAACATGTACTCGCTT","561307.5.peg.158"," 646"
"5955",689,216,473,"ATTCATCATAGCAACAATA","GCTGATAATGCAGTAATATA","561307.5.peg.158"," 646"
"5956",388,216,172,"AATTGCATCTCCAGCTAATT","GCTGATAATGCAGTAATATA","561307.5.peg.158"," 646"
"5957",369,216,153,"TCGGTATAAACACGAAGTCT","GCTGATAATGCAGTAATATA","561307.5.peg.158"," 646"
"5958",179,279,100,"CACCTAACATGTACTCGCTT","CCAGTGCTATAGACAGAACC","561307.5.peg.158"," 646"
"5959",388,279,109,"AATTGCATCTCCAGCTAATT","CCAGTGCTATAGACAGAACC","561307.5.peg.158"," 646"
"5960",689,279,410,"ATTCATCATAGCAACAATA","CCAGTGCTATAGACAGAACC","561307.5.peg.158"," 646"
"5961",118,279,161,"GATTAGTATCAAGAAGTAGA","CCAGTGCTATAGACAGAACC","561307.5.peg.158"," 646"
"5962",118,369,251,"GATTAGTATCAAGAAGTAGA","TCGGTATAAACACGAAGTCT","561307.5.peg.158"," 646"
"5963",216,369,153,"GCTGATAATGCAGTAATATA","TCGGTATAAACACGAAGTCT","561307.5.peg.158"," 646"
"5964",179,369,190,"CACCTAACATGTACTCGCTT","TCGGTATAAACACGAAGTCT","561307.5.peg.158"," 646"
"5965",689,369,320,"ATTCATCATAGCAACAATA","TCGGTATAAACACGAAGTCT","561307.5.peg.158"," 646"
"5966",118,388,270,"GATTAGTATCAAGAAGTAGA","AATTGCATCTCCAGCTAATT","561307.5.peg.158"," 646"
"5967",179,388,209,"CACCTAACATGTACTCGCTT","AATTGCATCTCCAGCTAATT","561307.5.peg.158"," 646"
"5968",689,388,301,"ATTCATCATAGCAACAATA","AATTGCATCTCCAGCTAATT","561307.5.peg.158"," 646"
"5969",279,388,109,"CCAGTGCTATAGACAGAACC","AATTGCATCTCCAGCTAATT","561307.5.peg.158"," 646"
"5970",216,388,172,"GCTGATAATGCAGTAATATA","AATTGCATCTCCAGCTAATT","561307.5.peg.158"," 646"
"5971",118,689,571,"GATTAGTATCAAGAAGTAGA","ATTCATCATAGCAACAATA","561307.5.peg.158"," 646"
"5972",179,689,510,"CACCTAACATGTACTCGCTT","ATTCATCATAGCAACAATA","561307.5.peg.158"," 646"
"5973",369,689,320,"TCGGTATAAACACGAAGTCT","ATTCATCATAGCAACAATA","561307.5.peg.158"," 646"
"5974",388,689,301,"AATTGCATCTCCAGCTAATT","ATTCATCATAGCAACAATA","561307.5.peg.158"," 646"
"5975",216,689,473,"GCTGATAATGCAGTAATATA","ATTCATCATAGCAACAATA","561307.5.peg.158"," 646"
"5976",279,689,410,"CCAGTGCTATAGACAGAACC","ATTCATCATAGCAACAATA","561307.5.peg.158"," 646"
"5977",228,122,106,"ATACCTACAGTCACTTCATC","CAGTTGAAATGTGGGGTATT","561307.5.peg.1582"," 649"
"5978",308,122,186,"CAGCTTGCTCGATTGTTCTT","CAGTTGAAATGTGGGGTATT","561307.5.peg.1582"," 649"
"5979",308,129,179,"CAGCTTGCTCGATTGTTCTT","ATGTCACCAGTTGAAATGTG","561307.5.peg.1582"," 649"
"5980",308,131,177,"CAGCTTGCTCGATTGTTCTT","ACATGTCACCAGTTGAAATG","561307.5.peg.1582"," 649"
"5981",122,228,106,"CAGTTGAAATGTGGGGTATT","ATACCTACAGTCACTTCATC","561307.5.peg.1582"," 649"
"5982",122,308,186,"CAGTTGAAATGTGGGGTATT","CAGCTTGCTCGATTGTTCTT","561307.5.peg.1582"," 649"
"5983",129,308,179,"ATGTCACCAGTTGAAATGTG","CAGCTTGCTCGATTGTTCTT","561307.5.peg.1582"," 649"
"5984",131,308,177,"ACATGTCACCAGTTGAAATG","CAGCTTGCTCGATTGTTCTT","561307.5.peg.1582"," 649"
"5985",159,8,151,"AAAGCTGCAGGATTTACTCC","TGCTAAAGGTGGAGCACACG","561307.5.peg.1583"," 650"
"5986",422,8,414,"GGAATGCCATACCTATAGAT","TGCTAAAGGTGGAGCACACG","561307.5.peg.1583"," 650"
"5987",153,8,145,"GCAGGATTTACTCCTGGAGC","TGCTAAAGGTGGAGCACACG","561307.5.peg.1583"," 650"
"5988",191,8,183,"CAGTGGCACCTTGAGAACCT","TGCTAAAGGTGGAGCACACG","561307.5.peg.1583"," 650"
"5989",189,8,181,"GTGGCACCTTGAGAACCTTG","TGCTAAAGGTGGAGCACACG","561307.5.peg.1583"," 650"
"5990",329,8,321,"TTGCCCATTCTGAGAATTTA","TGCTAAAGGTGGAGCACACG","561307.5.peg.1583"," 650"
"5991",631,8,623,"TGTCCAAATTGAATTAGAC","TGCTAAAGGTGGAGCACACG","561307.5.peg.1583"," 650"
"5992",627,8,619,"CCAAATTGAATTAGACTGGC","TGCTAAAGGTGGAGCACACG","561307.5.peg.1583"," 650"
"5993",279,8,271,"ACGATTGATGCAGTGATGTA","TGCTAAAGGTGGAGCACACG","561307.5.peg.1583"," 650"
"5994",189,22,167,"GTGGCACCTTGAGAACCTTG","GCAGAAGCTATTGATGCTAA","561307.5.peg.1583"," 650"
"5995",329,22,307,"TTGCCCATTCTGAGAATTTA","GCAGAAGCTATTGATGCTAA","561307.5.peg.1583"," 650"
"5996",159,22,137,"AAAGCTGCAGGATTTACTCC","GCAGAAGCTATTGATGCTAA","561307.5.peg.1583"," 650"
"5997",279,22,257,"ACGATTGATGCAGTGATGTA","GCAGAAGCTATTGATGCTAA","561307.5.peg.1583"," 650"
"5998",191,22,169,"CAGTGGCACCTTGAGAACCT","GCAGAAGCTATTGATGCTAA","561307.5.peg.1583"," 650"
"5999",627,22,605,"CCAAATTGAATTAGACTGGC","GCAGAAGCTATTGATGCTAA","561307.5.peg.1583"," 650"
"6000",422,22,400,"GGAATGCCATACCTATAGAT","GCAGAAGCTATTGATGCTAA","561307.5.peg.1583"," 650"
"6001",631,22,609,"TGTCCAAATTGAATTAGAC","GCAGAAGCTATTGATGCTAA","561307.5.peg.1583"," 650"
"6002",153,22,131,"GCAGGATTTACTCCTGGAGC","GCAGAAGCTATTGATGCTAA","561307.5.peg.1583"," 650"
"6003",191,61,130,"CAGTGGCACCTTGAGAACCT","TGTTCTAAAGAAGTTCACAA","561307.5.peg.1583"," 650"
"6004",627,61,566,"CCAAATTGAATTAGACTGGC","TGTTCTAAAGAAGTTCACAA","561307.5.peg.1583"," 650"
"6005",422,61,361,"GGAATGCCATACCTATAGAT","TGTTCTAAAGAAGTTCACAA","561307.5.peg.1583"," 650"
"6006",189,61,128,"GTGGCACCTTGAGAACCTTG","TGTTCTAAAGAAGTTCACAA","561307.5.peg.1583"," 650"
"6007",631,61,570,"TGTCCAAATTGAATTAGAC","TGTTCTAAAGAAGTTCACAA","561307.5.peg.1583"," 650"
"6008",329,61,268,"TTGCCCATTCTGAGAATTTA","TGTTCTAAAGAAGTTCACAA","561307.5.peg.1583"," 650"
"6009",279,61,218,"ACGATTGATGCAGTGATGTA","TGTTCTAAAGAAGTTCACAA","561307.5.peg.1583"," 650"
"6010",329,153,176,"TTGCCCATTCTGAGAATTTA","GCAGGATTTACTCCTGGAGC","561307.5.peg.1583"," 650"
"6011",631,153,478,"TGTCCAAATTGAATTAGAC","GCAGGATTTACTCCTGGAGC","561307.5.peg.1583"," 650"
"6012",8,153,145,"TGCTAAAGGTGGAGCACACG","GCAGGATTTACTCCTGGAGC","561307.5.peg.1583"," 650"
"6013",22,153,131,"GCAGAAGCTATTGATGCTAA","GCAGGATTTACTCCTGGAGC","561307.5.peg.1583"," 650"
"6014",279,153,126,"ACGATTGATGCAGTGATGTA","GCAGGATTTACTCCTGGAGC","561307.5.peg.1583"," 650"
"6015",422,153,269,"GGAATGCCATACCTATAGAT","GCAGGATTTACTCCTGGAGC","561307.5.peg.1583"," 650"
"6016",627,153,474,"CCAAATTGAATTAGACTGGC","GCAGGATTTACTCCTGGAGC","561307.5.peg.1583"," 650"
"6017",22,159,137,"GCAGAAGCTATTGATGCTAA","AAAGCTGCAGGATTTACTCC","561307.5.peg.1583"," 650"
"6018",422,159,263,"GGAATGCCATACCTATAGAT","AAAGCTGCAGGATTTACTCC","561307.5.peg.1583"," 650"
"6019",329,159,170,"TTGCCCATTCTGAGAATTTA","AAAGCTGCAGGATTTACTCC","561307.5.peg.1583"," 650"
"6020",8,159,151,"TGCTAAAGGTGGAGCACACG","AAAGCTGCAGGATTTACTCC","561307.5.peg.1583"," 650"
"6021",631,159,472,"TGTCCAAATTGAATTAGAC","AAAGCTGCAGGATTTACTCC","561307.5.peg.1583"," 650"
"6022",279,159,120,"ACGATTGATGCAGTGATGTA","AAAGCTGCAGGATTTACTCC","561307.5.peg.1583"," 650"
"6023",627,159,468,"CCAAATTGAATTAGACTGGC","AAAGCTGCAGGATTTACTCC","561307.5.peg.1583"," 650"
"6024",8,189,181,"TGCTAAAGGTGGAGCACACG","GTGGCACCTTGAGAACCTTG","561307.5.peg.1583"," 650"
"6025",631,189,442,"TGTCCAAATTGAATTAGAC","GTGGCACCTTGAGAACCTTG","561307.5.peg.1583"," 650"
"6026",422,189,233,"GGAATGCCATACCTATAGAT","GTGGCACCTTGAGAACCTTG","561307.5.peg.1583"," 650"
"6027",627,189,438,"CCAAATTGAATTAGACTGGC","GTGGCACCTTGAGAACCTTG","561307.5.peg.1583"," 650"
"6028",61,189,128,"TGTTCTAAAGAAGTTCACAA","GTGGCACCTTGAGAACCTTG","561307.5.peg.1583"," 650"
"6029",22,189,167,"GCAGAAGCTATTGATGCTAA","GTGGCACCTTGAGAACCTTG","561307.5.peg.1583"," 650"
"6030",329,189,140,"TTGCCCATTCTGAGAATTTA","GTGGCACCTTGAGAACCTTG","561307.5.peg.1583"," 650"
"6031",422,191,231,"GGAATGCCATACCTATAGAT","CAGTGGCACCTTGAGAACCT","561307.5.peg.1583"," 650"
"6032",22,191,169,"GCAGAAGCTATTGATGCTAA","CAGTGGCACCTTGAGAACCT","561307.5.peg.1583"," 650"
"6033",627,191,436,"CCAAATTGAATTAGACTGGC","CAGTGGCACCTTGAGAACCT","561307.5.peg.1583"," 650"
"6034",8,191,183,"TGCTAAAGGTGGAGCACACG","CAGTGGCACCTTGAGAACCT","561307.5.peg.1583"," 650"
"6035",61,191,130,"TGTTCTAAAGAAGTTCACAA","CAGTGGCACCTTGAGAACCT","561307.5.peg.1583"," 650"
"6036",329,191,138,"TTGCCCATTCTGAGAATTTA","CAGTGGCACCTTGAGAACCT","561307.5.peg.1583"," 650"
"6037",631,191,440,"TGTCCAAATTGAATTAGAC","CAGTGGCACCTTGAGAACCT","561307.5.peg.1583"," 650"
"6038",422,279,143,"GGAATGCCATACCTATAGAT","ACGATTGATGCAGTGATGTA","561307.5.peg.1583"," 650"
"6039",631,279,352,"TGTCCAAATTGAATTAGAC","ACGATTGATGCAGTGATGTA","561307.5.peg.1583"," 650"
"6040",159,279,120,"AAAGCTGCAGGATTTACTCC","ACGATTGATGCAGTGATGTA","561307.5.peg.1583"," 650"
"6041",153,279,126,"GCAGGATTTACTCCTGGAGC","ACGATTGATGCAGTGATGTA","561307.5.peg.1583"," 650"
"6042",8,279,271,"TGCTAAAGGTGGAGCACACG","ACGATTGATGCAGTGATGTA","561307.5.peg.1583"," 650"
"6043",61,279,218,"TGTTCTAAAGAAGTTCACAA","ACGATTGATGCAGTGATGTA","561307.5.peg.1583"," 650"
"6044",627,279,348,"CCAAATTGAATTAGACTGGC","ACGATTGATGCAGTGATGTA","561307.5.peg.1583"," 650"
"6045",22,279,257,"GCAGAAGCTATTGATGCTAA","ACGATTGATGCAGTGATGTA","561307.5.peg.1583"," 650"
"6046",22,329,307,"GCAGAAGCTATTGATGCTAA","TTGCCCATTCTGAGAATTTA","561307.5.peg.1583"," 650"
"6047",631,329,302,"TGTCCAAATTGAATTAGAC","TTGCCCATTCTGAGAATTTA","561307.5.peg.1583"," 650"
"6048",8,329,321,"TGCTAAAGGTGGAGCACACG","TTGCCCATTCTGAGAATTTA","561307.5.peg.1583"," 650"
"6049",627,329,298,"CCAAATTGAATTAGACTGGC","TTGCCCATTCTGAGAATTTA","561307.5.peg.1583"," 650"
"6050",159,329,170,"AAAGCTGCAGGATTTACTCC","TTGCCCATTCTGAGAATTTA","561307.5.peg.1583"," 650"
"6051",61,329,268,"TGTTCTAAAGAAGTTCACAA","TTGCCCATTCTGAGAATTTA","561307.5.peg.1583"," 650"
"6052",153,329,176,"GCAGGATTTACTCCTGGAGC","TTGCCCATTCTGAGAATTTA","561307.5.peg.1583"," 650"
"6053",189,329,140,"GTGGCACCTTGAGAACCTTG","TTGCCCATTCTGAGAATTTA","561307.5.peg.1583"," 650"
"6054",191,329,138,"CAGTGGCACCTTGAGAACCT","TTGCCCATTCTGAGAATTTA","561307.5.peg.1583"," 650"
"6055",191,422,231,"CAGTGGCACCTTGAGAACCT","GGAATGCCATACCTATAGAT","561307.5.peg.1583"," 650"
"6056",279,422,143,"ACGATTGATGCAGTGATGTA","GGAATGCCATACCTATAGAT","561307.5.peg.1583"," 650"
"6057",22,422,400,"GCAGAAGCTATTGATGCTAA","GGAATGCCATACCTATAGAT","561307.5.peg.1583"," 650"
"6058",631,422,209,"TGTCCAAATTGAATTAGAC","GGAATGCCATACCTATAGAT","561307.5.peg.1583"," 650"
"6059",153,422,269,"GCAGGATTTACTCCTGGAGC","GGAATGCCATACCTATAGAT","561307.5.peg.1583"," 650"
"6060",159,422,263,"AAAGCTGCAGGATTTACTCC","GGAATGCCATACCTATAGAT","561307.5.peg.1583"," 650"
"6061",627,422,205,"CCAAATTGAATTAGACTGGC","GGAATGCCATACCTATAGAT","561307.5.peg.1583"," 650"
"6062",8,422,414,"TGCTAAAGGTGGAGCACACG","GGAATGCCATACCTATAGAT","561307.5.peg.1583"," 650"
"6063",189,422,233,"GTGGCACCTTGAGAACCTTG","GGAATGCCATACCTATAGAT","561307.5.peg.1583"," 650"
"6064",61,422,361,"TGTTCTAAAGAAGTTCACAA","GGAATGCCATACCTATAGAT","561307.5.peg.1583"," 650"
"6065",159,627,468,"AAAGCTGCAGGATTTACTCC","CCAAATTGAATTAGACTGGC","561307.5.peg.1583"," 650"
"6066",61,627,566,"TGTTCTAAAGAAGTTCACAA","CCAAATTGAATTAGACTGGC","561307.5.peg.1583"," 650"
"6067",329,627,298,"TTGCCCATTCTGAGAATTTA","CCAAATTGAATTAGACTGGC","561307.5.peg.1583"," 650"
"6068",8,627,619,"TGCTAAAGGTGGAGCACACG","CCAAATTGAATTAGACTGGC","561307.5.peg.1583"," 650"
"6069",279,627,348,"ACGATTGATGCAGTGATGTA","CCAAATTGAATTAGACTGGC","561307.5.peg.1583"," 650"
"6070",422,627,205,"GGAATGCCATACCTATAGAT","CCAAATTGAATTAGACTGGC","561307.5.peg.1583"," 650"
"6071",22,627,605,"GCAGAAGCTATTGATGCTAA","CCAAATTGAATTAGACTGGC","561307.5.peg.1583"," 650"
"6072",191,627,436,"CAGTGGCACCTTGAGAACCT","CCAAATTGAATTAGACTGGC","561307.5.peg.1583"," 650"
"6073",189,627,438,"GTGGCACCTTGAGAACCTTG","CCAAATTGAATTAGACTGGC","561307.5.peg.1583"," 650"
"6074",153,627,474,"GCAGGATTTACTCCTGGAGC","CCAAATTGAATTAGACTGGC","561307.5.peg.1583"," 650"
"6075",22,631,609,"GCAGAAGCTATTGATGCTAA","TGTCCAAATTGAATTAGAC","561307.5.peg.1583"," 650"
"6076",189,631,442,"GTGGCACCTTGAGAACCTTG","TGTCCAAATTGAATTAGAC","561307.5.peg.1583"," 650"
"6077",159,631,472,"AAAGCTGCAGGATTTACTCC","TGTCCAAATTGAATTAGAC","561307.5.peg.1583"," 650"
"6078",8,631,623,"TGCTAAAGGTGGAGCACACG","TGTCCAAATTGAATTAGAC","561307.5.peg.1583"," 650"
"6079",153,631,478,"GCAGGATTTACTCCTGGAGC","TGTCCAAATTGAATTAGAC","561307.5.peg.1583"," 650"
"6080",191,631,440,"CAGTGGCACCTTGAGAACCT","TGTCCAAATTGAATTAGAC","561307.5.peg.1583"," 650"
"6081",329,631,302,"TTGCCCATTCTGAGAATTTA","TGTCCAAATTGAATTAGAC","561307.5.peg.1583"," 650"
"6082",422,631,209,"GGAATGCCATACCTATAGAT","TGTCCAAATTGAATTAGAC","561307.5.peg.1583"," 650"
"6083",61,631,570,"TGTTCTAAAGAAGTTCACAA","TGTCCAAATTGAATTAGAC","561307.5.peg.1583"," 650"
"6084",279,631,352,"ACGATTGATGCAGTGATGTA","TGTCCAAATTGAATTAGAC","561307.5.peg.1583"," 650"
"6085",192,72,120,"AATTGACCACCTTCAAATCC","TCTTTACGTGAACCTTCTGC","561307.5.peg.1584"," 651"
"6086",216,72,144,"TTTGGTAAACGACGGAATAA","TCTTTACGTGAACCTTCTGC","561307.5.peg.1584"," 651"
"6087",72,192,120,"TCTTTACGTGAACCTTCTGC","AATTGACCACCTTCAAATCC","561307.5.peg.1584"," 651"
"6088",72,216,144,"TCTTTACGTGAACCTTCTGC","TTTGGTAAACGACGGAATAA","561307.5.peg.1584"," 651"
"6089",273,143,130,"GGAGTTGTACCTTCAACACG","CTACAACTAATGCAGTGAAA","561307.5.peg.1586"," 653"
"6090",143,273,130,"CTACAACTAATGCAGTGAAA","GGAGTTGTACCTTCAACACG","561307.5.peg.1586"," 653"
"6091",242,28,214,"ATAAAGCACGAGTTGTACCA","GAGAAATTATCGCATACGTT","561307.5.peg.1588"," 655"
"6092",242,44,198,"ATAAAGCACGAGTTGTACCA","TACCAACACGACTCATGTTA","561307.5.peg.1588"," 655"
"6093",242,83,159,"ATAAAGCACGAGTTGTACCA","AAGTTACTGTTACGTCACTA","561307.5.peg.1588"," 655"
"6094",28,242,214,"GAGAAATTATCGCATACGTT","ATAAAGCACGAGTTGTACCA","561307.5.peg.1588"," 655"
"6095",44,242,198,"TACCAACACGACTCATGTTA","ATAAAGCACGAGTTGTACCA","561307.5.peg.1588"," 655"
"6096",83,242,159,"AAGTTACTGTTACGTCACTA","ATAAAGCACGAGTTGTACCA","561307.5.peg.1588"," 655"
"6097",233,69,164,"ATGAATTGCAATGTTGATA","ATACCAACACGAAGTCCGAT","561307.5.peg.1597"," 665"
"6098",233,95,138,"ATGAATTGCAATGTTGATA","ACCATTTAGCTTCCCAATCA","561307.5.peg.1597"," 665"
"6099",69,233,164,"ATACCAACACGAAGTCCGAT","ATGAATTGCAATGTTGATA","561307.5.peg.1597"," 665"
"6100",95,233,138,"ACCATTTAGCTTCCCAATCA","ATGAATTGCAATGTTGATA","561307.5.peg.1597"," 665"
"6101",627,10,617,"CGAGATACACGACCGTATGT","GCCTACAATCATGAATGAGG","561307.5.peg.160"," 669"
"6102",488,10,478,"AACCACCTGGCACTGCTTTA","GCCTACAATCATGAATGAGG","561307.5.peg.160"," 669"
"6103",594,10,584,"ACAACGCCACAATATGCAGC","GCCTACAATCATGAATGAGG","561307.5.peg.160"," 669"
"6104",501,10,491,"GATCCACCTGATGAACCACC","GCCTACAATCATGAATGAGG","561307.5.peg.160"," 669"
"6105",552,10,542,"GTGTCTGAACCTAAGCTAAA","GCCTACAATCATGAATGAGG","561307.5.peg.160"," 669"
"6106",683,10,673,"TTCGAGTCAATGGACCAATT","GCCTACAATCATGAATGAGG","561307.5.peg.160"," 669"
"6107",627,13,614,"CGAGATACACGACCGTATGT","AGTGCCTACAATCATGAATG","561307.5.peg.160"," 669"
"6108",683,13,670,"TTCGAGTCAATGGACCAATT","AGTGCCTACAATCATGAATG","561307.5.peg.160"," 669"
"6109",488,13,475,"AACCACCTGGCACTGCTTTA","AGTGCCTACAATCATGAATG","561307.5.peg.160"," 669"
"6110",552,13,539,"GTGTCTGAACCTAAGCTAAA","AGTGCCTACAATCATGAATG","561307.5.peg.160"," 669"
"6111",501,13,488,"GATCCACCTGATGAACCACC","AGTGCCTACAATCATGAATG","561307.5.peg.160"," 669"
"6112",594,13,581,"ACAACGCCACAATATGCAGC","AGTGCCTACAATCATGAATG","561307.5.peg.160"," 669"
"6113",488,20,468,"AACCACCTGGCACTGCTTTA","TCCTCCTCATTCATGATTGT","561307.5.peg.160"," 669"
"6114",501,20,481,"GATCCACCTGATGAACCACC","TCCTCCTCATTCATGATTGT","561307.5.peg.160"," 669"
"6115",683,20,663,"TTCGAGTCAATGGACCAATT","TCCTCCTCATTCATGATTGT","561307.5.peg.160"," 669"
"6116",627,20,607,"CGAGATACACGACCGTATGT","TCCTCCTCATTCATGATTGT","561307.5.peg.160"," 669"
"6117",552,20,532,"GTGTCTGAACCTAAGCTAAA","TCCTCCTCATTCATGATTGT","561307.5.peg.160"," 669"
"6118",594,20,574,"ACAACGCCACAATATGCAGC","TCCTCCTCATTCATGATTGT","561307.5.peg.160"," 669"
"6119",10,488,478,"GCCTACAATCATGAATGAGG","AACCACCTGGCACTGCTTTA","561307.5.peg.160"," 669"
"6120",594,488,106,"ACAACGCCACAATATGCAGC","AACCACCTGGCACTGCTTTA","561307.5.peg.160"," 669"
"6121",20,488,468,"TCCTCCTCATTCATGATTGT","AACCACCTGGCACTGCTTTA","561307.5.peg.160"," 669"
"6122",683,488,195,"TTCGAGTCAATGGACCAATT","AACCACCTGGCACTGCTTTA","561307.5.peg.160"," 669"
"6123",13,488,475,"AGTGCCTACAATCATGAATG","AACCACCTGGCACTGCTTTA","561307.5.peg.160"," 669"
"6124",627,488,139,"CGAGATACACGACCGTATGT","AACCACCTGGCACTGCTTTA","561307.5.peg.160"," 669"
"6125",627,501,126,"CGAGATACACGACCGTATGT","GATCCACCTGATGAACCACC","561307.5.peg.160"," 669"
"6126",683,501,182,"TTCGAGTCAATGGACCAATT","GATCCACCTGATGAACCACC","561307.5.peg.160"," 669"
"6127",13,501,488,"AGTGCCTACAATCATGAATG","GATCCACCTGATGAACCACC","561307.5.peg.160"," 669"
"6128",10,501,491,"GCCTACAATCATGAATGAGG","GATCCACCTGATGAACCACC","561307.5.peg.160"," 669"
"6129",20,501,481,"TCCTCCTCATTCATGATTGT","GATCCACCTGATGAACCACC","561307.5.peg.160"," 669"
"6130",10,552,542,"GCCTACAATCATGAATGAGG","GTGTCTGAACCTAAGCTAAA","561307.5.peg.160"," 669"
"6131",20,552,532,"TCCTCCTCATTCATGATTGT","GTGTCTGAACCTAAGCTAAA","561307.5.peg.160"," 669"
"6132",13,552,539,"AGTGCCTACAATCATGAATG","GTGTCTGAACCTAAGCTAAA","561307.5.peg.160"," 669"
"6133",683,552,131,"TTCGAGTCAATGGACCAATT","GTGTCTGAACCTAAGCTAAA","561307.5.peg.160"," 669"
"6134",488,594,106,"AACCACCTGGCACTGCTTTA","ACAACGCCACAATATGCAGC","561307.5.peg.160"," 669"
"6135",20,594,574,"TCCTCCTCATTCATGATTGT","ACAACGCCACAATATGCAGC","561307.5.peg.160"," 669"
"6136",13,594,581,"AGTGCCTACAATCATGAATG","ACAACGCCACAATATGCAGC","561307.5.peg.160"," 669"
"6137",10,594,584,"GCCTACAATCATGAATGAGG","ACAACGCCACAATATGCAGC","561307.5.peg.160"," 669"
"6138",488,627,139,"AACCACCTGGCACTGCTTTA","CGAGATACACGACCGTATGT","561307.5.peg.160"," 669"
"6139",10,627,617,"GCCTACAATCATGAATGAGG","CGAGATACACGACCGTATGT","561307.5.peg.160"," 669"
"6140",13,627,614,"AGTGCCTACAATCATGAATG","CGAGATACACGACCGTATGT","561307.5.peg.160"," 669"
"6141",501,627,126,"GATCCACCTGATGAACCACC","CGAGATACACGACCGTATGT","561307.5.peg.160"," 669"
"6142",20,627,607,"TCCTCCTCATTCATGATTGT","CGAGATACACGACCGTATGT","561307.5.peg.160"," 669"
"6143",10,683,673,"GCCTACAATCATGAATGAGG","TTCGAGTCAATGGACCAATT","561307.5.peg.160"," 669"
"6144",13,683,670,"AGTGCCTACAATCATGAATG","TTCGAGTCAATGGACCAATT","561307.5.peg.160"," 669"
"6145",501,683,182,"GATCCACCTGATGAACCACC","TTCGAGTCAATGGACCAATT","561307.5.peg.160"," 669"
"6146",20,683,663,"TCCTCCTCATTCATGATTGT","TTCGAGTCAATGGACCAATT","561307.5.peg.160"," 669"
"6147",552,683,131,"GTGTCTGAACCTAAGCTAAA","TTCGAGTCAATGGACCAATT","561307.5.peg.160"," 669"
"6148",488,683,195,"AACCACCTGGCACTGCTTTA","TTCGAGTCAATGGACCAATT","561307.5.peg.160"," 669"
"6149",303,30,273,"GCGATGTTTGCTGAGCGGTT","ATTGTCGCTTACCTCCTTAA","561307.5.peg.1600"," 670"
"6150",308,30,278,"CTAAAGCGATGTTTGCTGAG","ATTGTCGCTTACCTCCTTAA","561307.5.peg.1600"," 670"
"6151",369,30,339,"TGACCTACTTCTAATCCTTT","ATTGTCGCTTACCTCCTTAA","561307.5.peg.1600"," 670"
"6152",303,72,231,"GCGATGTTTGCTGAGCGGTT","TTACGACGACCATTTGTTAT","561307.5.peg.1600"," 670"
"6153",308,72,236,"CTAAAGCGATGTTTGCTGAG","TTACGACGACCATTTGTTAT","561307.5.peg.1600"," 670"
"6154",369,72,297,"TGACCTACTTCTAATCCTTT","TTACGACGACCATTTGTTAT","561307.5.peg.1600"," 670"
"6155",30,303,273,"ATTGTCGCTTACCTCCTTAA","GCGATGTTTGCTGAGCGGTT","561307.5.peg.1600"," 670"
"6156",72,303,231,"TTACGACGACCATTTGTTAT","GCGATGTTTGCTGAGCGGTT","561307.5.peg.1600"," 670"
"6157",30,308,278,"ATTGTCGCTTACCTCCTTAA","CTAAAGCGATGTTTGCTGAG","561307.5.peg.1600"," 670"
"6158",72,308,236,"TTACGACGACCATTTGTTAT","CTAAAGCGATGTTTGCTGAG","561307.5.peg.1600"," 670"
"6159",30,369,339,"ATTGTCGCTTACCTCCTTAA","TGACCTACTTCTAATCCTTT","561307.5.peg.1600"," 670"
"6160",72,369,297,"TTACGACGACCATTTGTTAT","TGACCTACTTCTAATCCTTT","561307.5.peg.1600"," 670"
"6161",300,119,181,"AATTCACGAATGAAGCGCTT","TAGCTTCTACTACTGTTACA","561307.5.peg.1603"," 673"
"6162",323,119,204,"AAGCATCCACGTCTACATTG","TAGCTTCTACTACTGTTACA","561307.5.peg.1603"," 673"
"6163",119,300,181,"TAGCTTCTACTACTGTTACA","AATTCACGAATGAAGCGCTT","561307.5.peg.1603"," 673"
"6164",119,323,204,"TAGCTTCTACTACTGTTACA","AAGCATCCACGTCTACATTG","561307.5.peg.1603"," 673"
"6165",165,7,158,"TTCTCAGTTGGTAACGGAAT","TAAATGTAGACGAATAAGGA","561307.5.peg.1604"," 674"
"6166",171,7,164,"ACTGATTTCTCAGTTGGTAA","TAAATGTAGACGAATAAGGA","561307.5.peg.1604"," 674"
"6167",177,7,170,"GTGTAAACTGATTTCTCAGT","TAAATGTAGACGAATAAGGA","561307.5.peg.1604"," 674"
"6168",165,11,154,"TTCTCAGTTGGTAACGGAAT","CACTAAATGTAGACGAATA","561307.5.peg.1604"," 674"
"6169",171,11,160,"ACTGATTTCTCAGTTGGTAA","CACTAAATGTAGACGAATA","561307.5.peg.1604"," 674"
"6170",177,11,166,"GTGTAAACTGATTTCTCAGT","CACTAAATGTAGACGAATA","561307.5.peg.1604"," 674"
"6171",7,165,158,"TAAATGTAGACGAATAAGGA","TTCTCAGTTGGTAACGGAAT","561307.5.peg.1604"," 674"
"6172",11,165,154,"CACTAAATGTAGACGAATA","TTCTCAGTTGGTAACGGAAT","561307.5.peg.1604"," 674"
"6173",7,171,164,"TAAATGTAGACGAATAAGGA","ACTGATTTCTCAGTTGGTAA","561307.5.peg.1604"," 674"
"6174",11,171,160,"CACTAAATGTAGACGAATA","ACTGATTTCTCAGTTGGTAA","561307.5.peg.1604"," 674"
"6175",7,177,170,"TAAATGTAGACGAATAAGGA","GTGTAAACTGATTTCTCAGT","561307.5.peg.1604"," 674"
"6176",11,177,166,"CACTAAATGTAGACGAATA","GTGTAAACTGATTTCTCAGT","561307.5.peg.1604"," 674"
"6177",288,65,223,"ATACCTGGTGCTAACGCAAT","TGTTCCATATTTATCGAAC","561307.5.peg.1606"," 676"
"6178",349,65,284,"AACTTGCCAAGGAATACCCA","TGTTCCATATTTATCGAAC","561307.5.peg.1606"," 676"
"6179",456,65,391,"ACAGCCATCTTCATTTGATA","TGTTCCATATTTATCGAAC","561307.5.peg.1606"," 676"
"6180",418,65,353,"AACTTCCCTAAACCCTGTGA","TGTTCCATATTTATCGAAC","561307.5.peg.1606"," 676"
"6181",360,65,295,"CCTGTTAAACCAACTTGCCA","TGTTCCATATTTATCGAAC","561307.5.peg.1606"," 676"
"6182",645,65,580,"ATACCGATAAAGATAGAACC","TGTTCCATATTTATCGAAC","561307.5.peg.1606"," 676"
"6183",65,288,223,"TGTTCCATATTTATCGAAC","ATACCTGGTGCTAACGCAAT","561307.5.peg.1606"," 676"
"6184",418,288,130,"AACTTCCCTAAACCCTGTGA","ATACCTGGTGCTAACGCAAT","561307.5.peg.1606"," 676"
"6185",456,288,168,"ACAGCCATCTTCATTTGATA","ATACCTGGTGCTAACGCAAT","561307.5.peg.1606"," 676"
"6186",645,288,357,"ATACCGATAAAGATAGAACC","ATACCTGGTGCTAACGCAAT","561307.5.peg.1606"," 676"
"6187",456,349,107,"ACAGCCATCTTCATTTGATA","AACTTGCCAAGGAATACCCA","561307.5.peg.1606"," 676"
"6188",65,349,284,"TGTTCCATATTTATCGAAC","AACTTGCCAAGGAATACCCA","561307.5.peg.1606"," 676"
"6189",645,349,296,"ATACCGATAAAGATAGAACC","AACTTGCCAAGGAATACCCA","561307.5.peg.1606"," 676"
"6190",65,360,295,"TGTTCCATATTTATCGAAC","CCTGTTAAACCAACTTGCCA","561307.5.peg.1606"," 676"
"6191",645,360,285,"ATACCGATAAAGATAGAACC","CCTGTTAAACCAACTTGCCA","561307.5.peg.1606"," 676"
"6192",65,418,353,"TGTTCCATATTTATCGAAC","AACTTCCCTAAACCCTGTGA","561307.5.peg.1606"," 676"
"6193",288,418,130,"ATACCTGGTGCTAACGCAAT","AACTTCCCTAAACCCTGTGA","561307.5.peg.1606"," 676"
"6194",645,418,227,"ATACCGATAAAGATAGAACC","AACTTCCCTAAACCCTGTGA","561307.5.peg.1606"," 676"
"6195",65,456,391,"TGTTCCATATTTATCGAAC","ACAGCCATCTTCATTTGATA","561307.5.peg.1606"," 676"
"6196",645,456,189,"ATACCGATAAAGATAGAACC","ACAGCCATCTTCATTTGATA","561307.5.peg.1606"," 676"
"6197",288,456,168,"ATACCTGGTGCTAACGCAAT","ACAGCCATCTTCATTTGATA","561307.5.peg.1606"," 676"
"6198",349,456,107,"AACTTGCCAAGGAATACCCA","ACAGCCATCTTCATTTGATA","561307.5.peg.1606"," 676"
"6199",288,645,357,"ATACCTGGTGCTAACGCAAT","ATACCGATAAAGATAGAACC","561307.5.peg.1606"," 676"
"6200",360,645,285,"CCTGTTAAACCAACTTGCCA","ATACCGATAAAGATAGAACC","561307.5.peg.1606"," 676"
"6201",65,645,580,"TGTTCCATATTTATCGAAC","ATACCGATAAAGATAGAACC","561307.5.peg.1606"," 676"
"6202",456,645,189,"ACAGCCATCTTCATTTGATA","ATACCGATAAAGATAGAACC","561307.5.peg.1606"," 676"
"6203",349,645,296,"AACTTGCCAAGGAATACCCA","ATACCGATAAAGATAGAACC","561307.5.peg.1606"," 676"
"6204",418,645,227,"AACTTCCCTAAACCCTGTGA","ATACCGATAAAGATAGAACC","561307.5.peg.1606"," 676"
"6205",961,78,883,"GTTTGAATCTGTTCTTGGAT","GCAATATCTCTTGCGACTGA","561307.5.peg.1607"," 677"
"6206",843,78,765,"GTTAAATTGTACAGTGATTG","GCAATATCTCTTGCGACTGA","561307.5.peg.1607"," 677"
"6207",1055,78,977,"TAGACATTAATGGGCGTGCT","GCAATATCTCTTGCGACTGA","561307.5.peg.1607"," 677"
"6208",428,78,350,"CTGAGCTAATCCATAATCGA","GCAATATCTCTTGCGACTGA","561307.5.peg.1607"," 677"
"6209",607,78,529,"TGGTGTCTGAACACGTCCCA","GCAATATCTCTTGCGACTGA","561307.5.peg.1607"," 677"
"6210",607,149,458,"TGGTGTCTGAACACGTCCCA","ACGCCCACGTGACAATATAT","561307.5.peg.1607"," 677"
"6211",961,149,812,"GTTTGAATCTGTTCTTGGAT","ACGCCCACGTGACAATATAT","561307.5.peg.1607"," 677"
"6212",843,149,694,"GTTAAATTGTACAGTGATTG","ACGCCCACGTGACAATATAT","561307.5.peg.1607"," 677"
"6213",1055,149,906,"TAGACATTAATGGGCGTGCT","ACGCCCACGTGACAATATAT","561307.5.peg.1607"," 677"
"6214",428,149,279,"CTGAGCTAATCCATAATCGA","ACGCCCACGTGACAATATAT","561307.5.peg.1607"," 677"
"6215",78,428,350,"GCAATATCTCTTGCGACTGA","CTGAGCTAATCCATAATCGA","561307.5.peg.1607"," 677"
"6216",1055,428,627,"TAGACATTAATGGGCGTGCT","CTGAGCTAATCCATAATCGA","561307.5.peg.1607"," 677"
"6217",843,428,415,"GTTAAATTGTACAGTGATTG","CTGAGCTAATCCATAATCGA","561307.5.peg.1607"," 677"
"6218",961,428,533,"GTTTGAATCTGTTCTTGGAT","CTGAGCTAATCCATAATCGA","561307.5.peg.1607"," 677"
"6219",607,428,179,"TGGTGTCTGAACACGTCCCA","CTGAGCTAATCCATAATCGA","561307.5.peg.1607"," 677"
"6220",149,428,279,"ACGCCCACGTGACAATATAT","CTGAGCTAATCCATAATCGA","561307.5.peg.1607"," 677"
"6221",78,607,529,"GCAATATCTCTTGCGACTGA","TGGTGTCTGAACACGTCCCA","561307.5.peg.1607"," 677"
"6222",149,607,458,"ACGCCCACGTGACAATATAT","TGGTGTCTGAACACGTCCCA","561307.5.peg.1607"," 677"
"6223",961,607,354,"GTTTGAATCTGTTCTTGGAT","TGGTGTCTGAACACGTCCCA","561307.5.peg.1607"," 677"
"6224",428,607,179,"CTGAGCTAATCCATAATCGA","TGGTGTCTGAACACGTCCCA","561307.5.peg.1607"," 677"
"6225",1055,607,448,"TAGACATTAATGGGCGTGCT","TGGTGTCTGAACACGTCCCA","561307.5.peg.1607"," 677"
"6226",843,607,236,"GTTAAATTGTACAGTGATTG","TGGTGTCTGAACACGTCCCA","561307.5.peg.1607"," 677"
"6227",78,843,765,"GCAATATCTCTTGCGACTGA","GTTAAATTGTACAGTGATTG","561307.5.peg.1607"," 677"
"6228",1055,843,212,"TAGACATTAATGGGCGTGCT","GTTAAATTGTACAGTGATTG","561307.5.peg.1607"," 677"
"6229",149,843,694,"ACGCCCACGTGACAATATAT","GTTAAATTGTACAGTGATTG","561307.5.peg.1607"," 677"
"6230",428,843,415,"CTGAGCTAATCCATAATCGA","GTTAAATTGTACAGTGATTG","561307.5.peg.1607"," 677"
"6231",961,843,118,"GTTTGAATCTGTTCTTGGAT","GTTAAATTGTACAGTGATTG","561307.5.peg.1607"," 677"
"6232",607,843,236,"TGGTGTCTGAACACGTCCCA","GTTAAATTGTACAGTGATTG","561307.5.peg.1607"," 677"
"6233",78,961,883,"GCAATATCTCTTGCGACTGA","GTTTGAATCTGTTCTTGGAT","561307.5.peg.1607"," 677"
"6234",149,961,812,"ACGCCCACGTGACAATATAT","GTTTGAATCTGTTCTTGGAT","561307.5.peg.1607"," 677"
"6235",843,961,118,"GTTAAATTGTACAGTGATTG","GTTTGAATCTGTTCTTGGAT","561307.5.peg.1607"," 677"
"6236",428,961,533,"CTGAGCTAATCCATAATCGA","GTTTGAATCTGTTCTTGGAT","561307.5.peg.1607"," 677"
"6237",607,961,354,"TGGTGTCTGAACACGTCCCA","GTTTGAATCTGTTCTTGGAT","561307.5.peg.1607"," 677"
"6238",149,1055,906,"ACGCCCACGTGACAATATAT","TAGACATTAATGGGCGTGCT","561307.5.peg.1607"," 677"
"6239",428,1055,627,"CTGAGCTAATCCATAATCGA","TAGACATTAATGGGCGTGCT","561307.5.peg.1607"," 677"
"6240",607,1055,448,"TGGTGTCTGAACACGTCCCA","TAGACATTAATGGGCGTGCT","561307.5.peg.1607"," 677"
"6241",843,1055,212,"GTTAAATTGTACAGTGATTG","TAGACATTAATGGGCGTGCT","561307.5.peg.1607"," 677"
"6242",78,1055,977,"GCAATATCTCTTGCGACTGA","TAGACATTAATGGGCGTGCT","561307.5.peg.1607"," 677"
"6243",353,141,212,"TAAAGACGGCATCGTCAGGT","CTATTTCATTGTACTGTTG","561307.5.peg.1608"," 678"
"6244",281,141,140,"CATAATTGTCAGCCACGAAA","CTATTTCATTGTACTGTTG","561307.5.peg.1608"," 678"
"6245",466,141,325,"ATCTTCTTCTAATCTTGTAC","CTATTTCATTGTACTGTTG","561307.5.peg.1608"," 678"
"6246",357,141,216,"AAGTTAAAGACGGCATCGTC","CTATTTCATTGTACTGTTG","561307.5.peg.1608"," 678"
"6247",141,281,140,"CTATTTCATTGTACTGTTG","CATAATTGTCAGCCACGAAA","561307.5.peg.1608"," 678"
"6248",466,281,185,"ATCTTCTTCTAATCTTGTAC","CATAATTGTCAGCCACGAAA","561307.5.peg.1608"," 678"
"6249",141,353,212,"CTATTTCATTGTACTGTTG","TAAAGACGGCATCGTCAGGT","561307.5.peg.1608"," 678"
"6250",466,353,113,"ATCTTCTTCTAATCTTGTAC","TAAAGACGGCATCGTCAGGT","561307.5.peg.1608"," 678"
"6251",141,357,216,"CTATTTCATTGTACTGTTG","AAGTTAAAGACGGCATCGTC","561307.5.peg.1608"," 678"
"6252",466,357,109,"ATCTTCTTCTAATCTTGTAC","AAGTTAAAGACGGCATCGTC","561307.5.peg.1608"," 678"
"6253",141,466,325,"CTATTTCATTGTACTGTTG","ATCTTCTTCTAATCTTGTAC","561307.5.peg.1608"," 678"
"6254",281,466,185,"CATAATTGTCAGCCACGAAA","ATCTTCTTCTAATCTTGTAC","561307.5.peg.1608"," 678"
"6255",353,466,113,"TAAAGACGGCATCGTCAGGT","ATCTTCTTCTAATCTTGTAC","561307.5.peg.1608"," 678"
"6256",357,466,109,"AAGTTAAAGACGGCATCGTC","ATCTTCTTCTAATCTTGTAC","561307.5.peg.1608"," 678"
"6257",138,14,124,"GTACCACGAATTTGGTTGTA","GCACTTGCATAAATAGTAT","561307.5.peg.1609"," 679"
"6258",327,14,313,"AATTGCATACCTGTAGAAAC","GCACTTGCATAAATAGTAT","561307.5.peg.1609"," 679"
"6259",146,14,132,"CTAGCGTCGTACCACGAATT","GCACTTGCATAAATAGTAT","561307.5.peg.1609"," 679"
"6260",14,138,124,"GCACTTGCATAAATAGTAT","GTACCACGAATTTGGTTGTA","561307.5.peg.1609"," 679"
"6261",327,138,189,"AATTGCATACCTGTAGAAAC","GTACCACGAATTTGGTTGTA","561307.5.peg.1609"," 679"
"6262",14,146,132,"GCACTTGCATAAATAGTAT","CTAGCGTCGTACCACGAATT","561307.5.peg.1609"," 679"
"6263",327,146,181,"AATTGCATACCTGTAGAAAC","CTAGCGTCGTACCACGAATT","561307.5.peg.1609"," 679"
"6264",146,327,181,"CTAGCGTCGTACCACGAATT","AATTGCATACCTGTAGAAAC","561307.5.peg.1609"," 679"
"6265",138,327,189,"GTACCACGAATTTGGTTGTA","AATTGCATACCTGTAGAAAC","561307.5.peg.1609"," 679"
"6266",14,327,313,"GCACTTGCATAAATAGTAT","AATTGCATACCTGTAGAAAC","561307.5.peg.1609"," 679"
"6267",476,183,293,"CAATTAGCGGTGTACCTTGA","TTAACAACTGGTAAGACACC","561307.5.peg.161"," 680"
"6268",489,183,306,"TCAGATACGATTTCAATTAG","TTAACAACTGGTAAGACACC","561307.5.peg.161"," 680"
"6269",513,183,330,"TCTTTAGGTGAACGAATATC","TTAACAACTGGTAAGACACC","561307.5.peg.161"," 680"
"6270",476,195,281,"CAATTAGCGGTGTACCTTGA","ACTGCACGCTTATTAACAAC","561307.5.peg.161"," 680"
"6271",513,195,318,"TCTTTAGGTGAACGAATATC","ACTGCACGCTTATTAACAAC","561307.5.peg.161"," 680"
"6272",489,195,294,"TCAGATACGATTTCAATTAG","ACTGCACGCTTATTAACAAC","561307.5.peg.161"," 680"
"6273",476,281,195,"CAATTAGCGGTGTACCTTGA","CTGGATAGAAATAGTTCTTA","561307.5.peg.161"," 680"
"6274",513,281,232,"TCTTTAGGTGAACGAATATC","CTGGATAGAAATAGTTCTTA","561307.5.peg.161"," 680"
"6275",489,281,208,"TCAGATACGATTTCAATTAG","CTGGATAGAAATAGTTCTTA","561307.5.peg.161"," 680"
"6276",183,476,293,"TTAACAACTGGTAAGACACC","CAATTAGCGGTGTACCTTGA","561307.5.peg.161"," 680"
"6277",195,476,281,"ACTGCACGCTTATTAACAAC","CAATTAGCGGTGTACCTTGA","561307.5.peg.161"," 680"
"6278",281,476,195,"CTGGATAGAAATAGTTCTTA","CAATTAGCGGTGTACCTTGA","561307.5.peg.161"," 680"
"6279",183,489,306,"TTAACAACTGGTAAGACACC","TCAGATACGATTTCAATTAG","561307.5.peg.161"," 680"
"6280",281,489,208,"CTGGATAGAAATAGTTCTTA","TCAGATACGATTTCAATTAG","561307.5.peg.161"," 680"
"6281",195,489,294,"ACTGCACGCTTATTAACAAC","TCAGATACGATTTCAATTAG","561307.5.peg.161"," 680"
"6282",183,513,330,"TTAACAACTGGTAAGACACC","TCTTTAGGTGAACGAATATC","561307.5.peg.161"," 680"
"6283",281,513,232,"CTGGATAGAAATAGTTCTTA","TCTTTAGGTGAACGAATATC","561307.5.peg.161"," 680"
"6284",195,513,318,"ACTGCACGCTTATTAACAAC","TCTTTAGGTGAACGAATATC","561307.5.peg.161"," 680"
"6285",924,210,714,"AAATCTCCTAGTTTCGCTGT","GTACTTTGTGGCGTTGCACC","561307.5.peg.1614"," 685"
"6286",786,210,576,"TGTCCTCCTGCCAACGTTAA","GTACTTTGTGGCGTTGCACC","561307.5.peg.1614"," 685"
"6287",593,210,383,"AAATTTAAGGGTGATTTCA","GTACTTTGTGGCGTTGCACC","561307.5.peg.1614"," 685"
"6288",693,210,483,"CCAAATTGGAACAATCCAAG","GTACTTTGTGGCGTTGCACC","561307.5.peg.1614"," 685"
"6289",850,210,640,"TGCCTGATTAACGTCTGACA","GTACTTTGTGGCGTTGCACC","561307.5.peg.1614"," 685"
"6290",1515,210,1305,"GAACCTGATACAAACACAAG","GTACTTTGTGGCGTTGCACC","561307.5.peg.1614"," 685"
"6291",1039,210,829,"TTTGGCTACTTGAACTGTAT","GTACTTTGTGGCGTTGCACC","561307.5.peg.1614"," 685"
"6292",1263,210,1053,"AGCGCCATAAGAAGTGATAA","GTACTTTGTGGCGTTGCACC","561307.5.peg.1614"," 685"
"6293",850,222,628,"TGCCTGATTAACGTCTGACA","ATTTCATCTTGGGTACTTTG","561307.5.peg.1614"," 685"
"6294",593,222,371,"AAATTTAAGGGTGATTTCA","ATTTCATCTTGGGTACTTTG","561307.5.peg.1614"," 685"
"6295",924,222,702,"AAATCTCCTAGTTTCGCTGT","ATTTCATCTTGGGTACTTTG","561307.5.peg.1614"," 685"
"6296",786,222,564,"TGTCCTCCTGCCAACGTTAA","ATTTCATCTTGGGTACTTTG","561307.5.peg.1614"," 685"
"6297",693,222,471,"CCAAATTGGAACAATCCAAG","ATTTCATCTTGGGTACTTTG","561307.5.peg.1614"," 685"
"6298",1039,222,817,"TTTGGCTACTTGAACTGTAT","ATTTCATCTTGGGTACTTTG","561307.5.peg.1614"," 685"
"6299",1515,222,1293,"GAACCTGATACAAACACAAG","ATTTCATCTTGGGTACTTTG","561307.5.peg.1614"," 685"
"6300",1263,222,1041,"AGCGCCATAAGAAGTGATAA","ATTTCATCTTGGGTACTTTG","561307.5.peg.1614"," 685"
"6301",693,593,100,"CCAAATTGGAACAATCCAAG","AAATTTAAGGGTGATTTCA","561307.5.peg.1614"," 685"
"6302",850,593,257,"TGCCTGATTAACGTCTGACA","AAATTTAAGGGTGATTTCA","561307.5.peg.1614"," 685"
"6303",222,593,371,"ATTTCATCTTGGGTACTTTG","AAATTTAAGGGTGATTTCA","561307.5.peg.1614"," 685"
"6304",210,593,383,"GTACTTTGTGGCGTTGCACC","AAATTTAAGGGTGATTTCA","561307.5.peg.1614"," 685"
"6305",786,593,193,"TGTCCTCCTGCCAACGTTAA","AAATTTAAGGGTGATTTCA","561307.5.peg.1614"," 685"
"6306",1039,593,446,"TTTGGCTACTTGAACTGTAT","AAATTTAAGGGTGATTTCA","561307.5.peg.1614"," 685"
"6307",1515,593,922,"GAACCTGATACAAACACAAG","AAATTTAAGGGTGATTTCA","561307.5.peg.1614"," 685"
"6308",1263,593,670,"AGCGCCATAAGAAGTGATAA","AAATTTAAGGGTGATTTCA","561307.5.peg.1614"," 685"
"6309",924,593,331,"AAATCTCCTAGTTTCGCTGT","AAATTTAAGGGTGATTTCA","561307.5.peg.1614"," 685"
"6310",1039,693,346,"TTTGGCTACTTGAACTGTAT","CCAAATTGGAACAATCCAAG","561307.5.peg.1614"," 685"
"6311",850,693,157,"TGCCTGATTAACGTCTGACA","CCAAATTGGAACAATCCAAG","561307.5.peg.1614"," 685"
"6312",593,693,100,"AAATTTAAGGGTGATTTCA","CCAAATTGGAACAATCCAAG","561307.5.peg.1614"," 685"
"6313",222,693,471,"ATTTCATCTTGGGTACTTTG","CCAAATTGGAACAATCCAAG","561307.5.peg.1614"," 685"
"6314",1515,693,822,"GAACCTGATACAAACACAAG","CCAAATTGGAACAATCCAAG","561307.5.peg.1614"," 685"
"6315",1263,693,570,"AGCGCCATAAGAAGTGATAA","CCAAATTGGAACAATCCAAG","561307.5.peg.1614"," 685"
"6316",924,693,231,"AAATCTCCTAGTTTCGCTGT","CCAAATTGGAACAATCCAAG","561307.5.peg.1614"," 685"
"6317",210,693,483,"GTACTTTGTGGCGTTGCACC","CCAAATTGGAACAATCCAAG","561307.5.peg.1614"," 685"
"6318",924,786,138,"AAATCTCCTAGTTTCGCTGT","TGTCCTCCTGCCAACGTTAA","561307.5.peg.1614"," 685"
"6319",1263,786,477,"AGCGCCATAAGAAGTGATAA","TGTCCTCCTGCCAACGTTAA","561307.5.peg.1614"," 685"
"6320",593,786,193,"AAATTTAAGGGTGATTTCA","TGTCCTCCTGCCAACGTTAA","561307.5.peg.1614"," 685"
"6321",222,786,564,"ATTTCATCTTGGGTACTTTG","TGTCCTCCTGCCAACGTTAA","561307.5.peg.1614"," 685"
"6322",210,786,576,"GTACTTTGTGGCGTTGCACC","TGTCCTCCTGCCAACGTTAA","561307.5.peg.1614"," 685"
"6323",1515,786,729,"GAACCTGATACAAACACAAG","TGTCCTCCTGCCAACGTTAA","561307.5.peg.1614"," 685"
"6324",1039,786,253,"TTTGGCTACTTGAACTGTAT","TGTCCTCCTGCCAACGTTAA","561307.5.peg.1614"," 685"
"6325",210,850,640,"GTACTTTGTGGCGTTGCACC","TGCCTGATTAACGTCTGACA","561307.5.peg.1614"," 685"
"6326",693,850,157,"CCAAATTGGAACAATCCAAG","TGCCTGATTAACGTCTGACA","561307.5.peg.1614"," 685"
"6327",593,850,257,"AAATTTAAGGGTGATTTCA","TGCCTGATTAACGTCTGACA","561307.5.peg.1614"," 685"
"6328",222,850,628,"ATTTCATCTTGGGTACTTTG","TGCCTGATTAACGTCTGACA","561307.5.peg.1614"," 685"
"6329",1263,850,413,"AGCGCCATAAGAAGTGATAA","TGCCTGATTAACGTCTGACA","561307.5.peg.1614"," 685"
"6330",1515,850,665,"GAACCTGATACAAACACAAG","TGCCTGATTAACGTCTGACA","561307.5.peg.1614"," 685"
"6331",1039,850,189,"TTTGGCTACTTGAACTGTAT","TGCCTGATTAACGTCTGACA","561307.5.peg.1614"," 685"
"6332",210,924,714,"GTACTTTGTGGCGTTGCACC","AAATCTCCTAGTTTCGCTGT","561307.5.peg.1614"," 685"
"6333",1263,924,339,"AGCGCCATAAGAAGTGATAA","AAATCTCCTAGTTTCGCTGT","561307.5.peg.1614"," 685"
"6334",1515,924,591,"GAACCTGATACAAACACAAG","AAATCTCCTAGTTTCGCTGT","561307.5.peg.1614"," 685"
"6335",222,924,702,"ATTTCATCTTGGGTACTTTG","AAATCTCCTAGTTTCGCTGT","561307.5.peg.1614"," 685"
"6336",786,924,138,"TGTCCTCCTGCCAACGTTAA","AAATCTCCTAGTTTCGCTGT","561307.5.peg.1614"," 685"
"6337",693,924,231,"CCAAATTGGAACAATCCAAG","AAATCTCCTAGTTTCGCTGT","561307.5.peg.1614"," 685"
"6338",593,924,331,"AAATTTAAGGGTGATTTCA","AAATCTCCTAGTTTCGCTGT","561307.5.peg.1614"," 685"
"6339",1039,924,115,"TTTGGCTACTTGAACTGTAT","AAATCTCCTAGTTTCGCTGT","561307.5.peg.1614"," 685"
"6340",593,1039,446,"AAATTTAAGGGTGATTTCA","TTTGGCTACTTGAACTGTAT","561307.5.peg.1614"," 685"
"6341",222,1039,817,"ATTTCATCTTGGGTACTTTG","TTTGGCTACTTGAACTGTAT","561307.5.peg.1614"," 685"
"6342",786,1039,253,"TGTCCTCCTGCCAACGTTAA","TTTGGCTACTTGAACTGTAT","561307.5.peg.1614"," 685"
"6343",210,1039,829,"GTACTTTGTGGCGTTGCACC","TTTGGCTACTTGAACTGTAT","561307.5.peg.1614"," 685"
"6344",1263,1039,224,"AGCGCCATAAGAAGTGATAA","TTTGGCTACTTGAACTGTAT","561307.5.peg.1614"," 685"
"6345",1515,1039,476,"GAACCTGATACAAACACAAG","TTTGGCTACTTGAACTGTAT","561307.5.peg.1614"," 685"
"6346",924,1039,115,"AAATCTCCTAGTTTCGCTGT","TTTGGCTACTTGAACTGTAT","561307.5.peg.1614"," 685"
"6347",850,1039,189,"TGCCTGATTAACGTCTGACA","TTTGGCTACTTGAACTGTAT","561307.5.peg.1614"," 685"
"6348",693,1039,346,"CCAAATTGGAACAATCCAAG","TTTGGCTACTTGAACTGTAT","561307.5.peg.1614"," 685"
"6349",1039,1263,224,"TTTGGCTACTTGAACTGTAT","AGCGCCATAAGAAGTGATAA","561307.5.peg.1614"," 685"
"6350",850,1263,413,"TGCCTGATTAACGTCTGACA","AGCGCCATAAGAAGTGATAA","561307.5.peg.1614"," 685"
"6351",210,1263,1053,"GTACTTTGTGGCGTTGCACC","AGCGCCATAAGAAGTGATAA","561307.5.peg.1614"," 685"
"6352",786,1263,477,"TGTCCTCCTGCCAACGTTAA","AGCGCCATAAGAAGTGATAA","561307.5.peg.1614"," 685"
"6353",593,1263,670,"AAATTTAAGGGTGATTTCA","AGCGCCATAAGAAGTGATAA","561307.5.peg.1614"," 685"
"6354",222,1263,1041,"ATTTCATCTTGGGTACTTTG","AGCGCCATAAGAAGTGATAA","561307.5.peg.1614"," 685"
"6355",1515,1263,252,"GAACCTGATACAAACACAAG","AGCGCCATAAGAAGTGATAA","561307.5.peg.1614"," 685"
"6356",924,1263,339,"AAATCTCCTAGTTTCGCTGT","AGCGCCATAAGAAGTGATAA","561307.5.peg.1614"," 685"
"6357",693,1263,570,"CCAAATTGGAACAATCCAAG","AGCGCCATAAGAAGTGATAA","561307.5.peg.1614"," 685"
"6358",210,1515,1305,"GTACTTTGTGGCGTTGCACC","GAACCTGATACAAACACAAG","561307.5.peg.1614"," 685"
"6359",850,1515,665,"TGCCTGATTAACGTCTGACA","GAACCTGATACAAACACAAG","561307.5.peg.1614"," 685"
"6360",693,1515,822,"CCAAATTGGAACAATCCAAG","GAACCTGATACAAACACAAG","561307.5.peg.1614"," 685"
"6361",786,1515,729,"TGTCCTCCTGCCAACGTTAA","GAACCTGATACAAACACAAG","561307.5.peg.1614"," 685"
"6362",1039,1515,476,"TTTGGCTACTTGAACTGTAT","GAACCTGATACAAACACAAG","561307.5.peg.1614"," 685"
"6363",222,1515,1293,"ATTTCATCTTGGGTACTTTG","GAACCTGATACAAACACAAG","561307.5.peg.1614"," 685"
"6364",1263,1515,252,"AGCGCCATAAGAAGTGATAA","GAACCTGATACAAACACAAG","561307.5.peg.1614"," 685"
"6365",924,1515,591,"AAATCTCCTAGTTTCGCTGT","GAACCTGATACAAACACAAG","561307.5.peg.1614"," 685"
"6366",593,1515,922,"AAATTTAAGGGTGATTTCA","GAACCTGATACAAACACAAG","561307.5.peg.1614"," 685"
"6367",476,100,376,"TAATCATAGTCATACGTGGT","TAATAAATCTCCATTTGGGT","561307.5.peg.1615"," 686"
"6368",480,100,380,"GGTGTAATCATAGTCATACG","TAATAAATCTCCATTTGGGT","561307.5.peg.1615"," 686"
"6369",100,476,376,"TAATAAATCTCCATTTGGGT","TAATCATAGTCATACGTGGT","561307.5.peg.1615"," 686"
"6370",100,480,380,"TAATAAATCTCCATTTGGGT","GGTGTAATCATAGTCATACG","561307.5.peg.1615"," 686"
"6371",390,7,383,"GTATCTCTTTCCATTTGAAT","CGTAATTACATGTAAATAGG","561307.5.peg.1616"," 687"
"6372",390,9,381,"GTATCTCTTTCCATTTGAAT","GCGTAATTACATGTAAATA","561307.5.peg.1616"," 687"
"6373",7,390,383,"CGTAATTACATGTAAATAGG","GTATCTCTTTCCATTTGAAT","561307.5.peg.1616"," 687"
"6374",9,390,381,"GCGTAATTACATGTAAATA","GTATCTCTTTCCATTTGAAT","561307.5.peg.1616"," 687"
"6375",190,80,110,"AGCTCTTTCTGCTTCAAGTG","ATAGCTCTTTACCTGATGTC","561307.5.peg.162"," 691"
"6376",294,80,214,"ACACCTAGCTTAGGACGATT","ATAGCTCTTTACCTGATGTC","561307.5.peg.162"," 691"
"6377",303,80,223,"ATAGGAATGACACCTAGCTT","ATAGCTCTTTACCTGATGTC","561307.5.peg.162"," 691"
"6378",321,80,241,"AAGTCATTAACAGTACCCAT","ATAGCTCTTTACCTGATGTC","561307.5.peg.162"," 691"
"6379",80,190,110,"ATAGCTCTTTACCTGATGTC","AGCTCTTTCTGCTTCAAGTG","561307.5.peg.162"," 691"
"6380",294,190,104,"ACACCTAGCTTAGGACGATT","AGCTCTTTCTGCTTCAAGTG","561307.5.peg.162"," 691"
"6381",303,190,113,"ATAGGAATGACACCTAGCTT","AGCTCTTTCTGCTTCAAGTG","561307.5.peg.162"," 691"
"6382",321,190,131,"AAGTCATTAACAGTACCCAT","AGCTCTTTCTGCTTCAAGTG","561307.5.peg.162"," 691"
"6383",80,294,214,"ATAGCTCTTTACCTGATGTC","ACACCTAGCTTAGGACGATT","561307.5.peg.162"," 691"
"6384",190,294,104,"AGCTCTTTCTGCTTCAAGTG","ACACCTAGCTTAGGACGATT","561307.5.peg.162"," 691"
"6385",80,303,223,"ATAGCTCTTTACCTGATGTC","ATAGGAATGACACCTAGCTT","561307.5.peg.162"," 691"
"6386",190,303,113,"AGCTCTTTCTGCTTCAAGTG","ATAGGAATGACACCTAGCTT","561307.5.peg.162"," 691"
"6387",80,321,241,"ATAGCTCTTTACCTGATGTC","AAGTCATTAACAGTACCCAT","561307.5.peg.162"," 691"
"6388",190,321,131,"AGCTCTTTCTGCTTCAAGTG","AAGTCATTAACAGTACCCAT","561307.5.peg.162"," 691"
"6389",279,84,195,"TCTAAATCCCGTCGCATCAA","GATAACCGTAAGTCACGGAT","561307.5.peg.1621"," 693"
"6390",279,89,190,"TCTAAATCCCGTCGCATCAA","TCACAGATAACCGTAAGTCA","561307.5.peg.1621"," 693"
"6391",279,147,132,"TCTAAATCCCGTCGCATCAA","TCATCTCCAAATACCTCTTT","561307.5.peg.1621"," 693"
"6392",84,279,195,"GATAACCGTAAGTCACGGAT","TCTAAATCCCGTCGCATCAA","561307.5.peg.1621"," 693"
"6393",89,279,190,"TCACAGATAACCGTAAGTCA","TCTAAATCCCGTCGCATCAA","561307.5.peg.1621"," 693"
"6394",147,279,132,"TCATCTCCAAATACCTCTTT","TCTAAATCCCGTCGCATCAA","561307.5.peg.1621"," 693"
"6395",597,71,526,"GTTGCAATAACAGCGACACT","TTGCTTCTTTAACTGGGATT","561307.5.peg.1626"," 698"
"6396",378,71,307,"ACAACAGCATCTGCGCCATT","TTGCTTCTTTAACTGGGATT","561307.5.peg.1626"," 698"
"6397",537,71,466,"GCAAGGACCGCGATAGCCCC","TTGCTTCTTTAACTGGGATT","561307.5.peg.1626"," 698"
"6398",201,71,130,"AAGGTGATTTATCAAACCT","TTGCTTCTTTAACTGGGATT","561307.5.peg.1626"," 698"
"6399",378,126,252,"ACAACAGCATCTGCGCCATT","TCAAGTGCTACCGTAATTGC","561307.5.peg.1626"," 698"
"6400",537,126,411,"GCAAGGACCGCGATAGCCCC","TCAAGTGCTACCGTAATTGC","561307.5.peg.1626"," 698"
"6401",597,126,471,"GTTGCAATAACAGCGACACT","TCAAGTGCTACCGTAATTGC","561307.5.peg.1626"," 698"
"6402",378,201,177,"ACAACAGCATCTGCGCCATT","AAGGTGATTTATCAAACCT","561307.5.peg.1626"," 698"
"6403",597,201,396,"GTTGCAATAACAGCGACACT","AAGGTGATTTATCAAACCT","561307.5.peg.1626"," 698"
"6404",71,201,130,"TTGCTTCTTTAACTGGGATT","AAGGTGATTTATCAAACCT","561307.5.peg.1626"," 698"
"6405",537,201,336,"GCAAGGACCGCGATAGCCCC","AAGGTGATTTATCAAACCT","561307.5.peg.1626"," 698"
"6406",201,378,177,"AAGGTGATTTATCAAACCT","ACAACAGCATCTGCGCCATT","561307.5.peg.1626"," 698"
"6407",126,378,252,"TCAAGTGCTACCGTAATTGC","ACAACAGCATCTGCGCCATT","561307.5.peg.1626"," 698"
"6408",597,378,219,"GTTGCAATAACAGCGACACT","ACAACAGCATCTGCGCCATT","561307.5.peg.1626"," 698"
"6409",71,378,307,"TTGCTTCTTTAACTGGGATT","ACAACAGCATCTGCGCCATT","561307.5.peg.1626"," 698"
"6410",537,378,159,"GCAAGGACCGCGATAGCCCC","ACAACAGCATCTGCGCCATT","561307.5.peg.1626"," 698"
"6411",71,537,466,"TTGCTTCTTTAACTGGGATT","GCAAGGACCGCGATAGCCCC","561307.5.peg.1626"," 698"
"6412",201,537,336,"AAGGTGATTTATCAAACCT","GCAAGGACCGCGATAGCCCC","561307.5.peg.1626"," 698"
"6413",378,537,159,"ACAACAGCATCTGCGCCATT","GCAAGGACCGCGATAGCCCC","561307.5.peg.1626"," 698"
"6414",126,537,411,"TCAAGTGCTACCGTAATTGC","GCAAGGACCGCGATAGCCCC","561307.5.peg.1626"," 698"
"6415",126,597,471,"TCAAGTGCTACCGTAATTGC","GTTGCAATAACAGCGACACT","561307.5.peg.1626"," 698"
"6416",71,597,526,"TTGCTTCTTTAACTGGGATT","GTTGCAATAACAGCGACACT","561307.5.peg.1626"," 698"
"6417",201,597,396,"AAGGTGATTTATCAAACCT","GTTGCAATAACAGCGACACT","561307.5.peg.1626"," 698"
"6418",378,597,219,"ACAACAGCATCTGCGCCATT","GTTGCAATAACAGCGACACT","561307.5.peg.1626"," 698"
"6419",193,5,188,"CAATACATTGCCTTTGGTAT","TATACTAGATGCACTAGGAG","561307.5.peg.1627"," 699"
"6420",270,5,265,"AATGGTAATGGATGGCACAT","TATACTAGATGCACTAGGAG","561307.5.peg.1627"," 699"
"6421",193,7,186,"CAATACATTGCCTTTGGTAT","GATATACTAGATGCACTAGG","561307.5.peg.1627"," 699"
"6422",270,7,263,"AATGGTAATGGATGGCACAT","GATATACTAGATGCACTAGG","561307.5.peg.1627"," 699"
"6423",193,10,183,"CAATACATTGCCTTTGGTAT","CATGATATACTAGATGCACT","561307.5.peg.1627"," 699"
"6424",270,10,260,"AATGGTAATGGATGGCACAT","CATGATATACTAGATGCACT","561307.5.peg.1627"," 699"
"6425",5,193,188,"TATACTAGATGCACTAGGAG","CAATACATTGCCTTTGGTAT","561307.5.peg.1627"," 699"
"6426",7,193,186,"GATATACTAGATGCACTAGG","CAATACATTGCCTTTGGTAT","561307.5.peg.1627"," 699"
"6427",10,193,183,"CATGATATACTAGATGCACT","CAATACATTGCCTTTGGTAT","561307.5.peg.1627"," 699"
"6428",5,270,265,"TATACTAGATGCACTAGGAG","AATGGTAATGGATGGCACAT","561307.5.peg.1627"," 699"
"6429",7,270,263,"GATATACTAGATGCACTAGG","AATGGTAATGGATGGCACAT","561307.5.peg.1627"," 699"
"6430",10,270,260,"CATGATATACTAGATGCACT","AATGGTAATGGATGGCACAT","561307.5.peg.1627"," 699"
"6431",480,172,308,"ACAACACCACCATAAATCCA","GCCTGCTCTAACAAGTCCTT","561307.5.peg.1629"," 701"
"6432",172,480,308,"GCCTGCTCTAACAAGTCCTT","ACAACACCACCATAAATCCA","561307.5.peg.1629"," 701"
"6433",423,264,159,"GACTTGTTTCGATATCTCCA","CGTTCATAATATATACATGG","561307.5.peg.163"," 702"
"6434",445,264,181,"ATTCTTACCAACTGGAATCT","CGTTCATAATATATACATGG","561307.5.peg.163"," 702"
"6435",453,264,189,"TTCTGTTCATTCTTACCAAC","CGTTCATAATATATACATGG","561307.5.peg.163"," 702"
"6436",423,299,124,"GACTTGTTTCGATATCTCCA","CGTATGATAAGTGTTGAAGT","561307.5.peg.163"," 702"
"6437",445,299,146,"ATTCTTACCAACTGGAATCT","CGTATGATAAGTGTTGAAGT","561307.5.peg.163"," 702"
"6438",453,299,154,"TTCTGTTCATTCTTACCAAC","CGTATGATAAGTGTTGAAGT","561307.5.peg.163"," 702"
"6439",264,423,159,"CGTTCATAATATATACATGG","GACTTGTTTCGATATCTCCA","561307.5.peg.163"," 702"
"6440",299,423,124,"CGTATGATAAGTGTTGAAGT","GACTTGTTTCGATATCTCCA","561307.5.peg.163"," 702"
"6441",264,445,181,"CGTTCATAATATATACATGG","ATTCTTACCAACTGGAATCT","561307.5.peg.163"," 702"
"6442",299,445,146,"CGTATGATAAGTGTTGAAGT","ATTCTTACCAACTGGAATCT","561307.5.peg.163"," 702"
"6443",264,453,189,"CGTTCATAATATATACATGG","TTCTGTTCATTCTTACCAAC","561307.5.peg.163"," 702"
"6444",299,453,154,"CGTATGATAAGTGTTGAAGT","TTCTGTTCATTCTTACCAAC","561307.5.peg.163"," 702"
"6445",305,184,121,"CCGTCATATTAGGAAACAAT","TTCATCTGCTTTACGTAATC","561307.5.peg.1630"," 703"
"6446",184,305,121,"TTCATCTGCTTTACGTAATC","CCGTCATATTAGGAAACAAT","561307.5.peg.1630"," 703"
"6447",252,12,240,"AATTGACCGATTGGTCCTCT","GAATACCACTTTGCAGCATA","561307.5.peg.1631"," 704"
"6448",261,12,249,"TTCGCAAAGAATTGACCGAT","GAATACCACTTTGCAGCATA","561307.5.peg.1631"," 704"
"6449",297,12,285,"CCTGTCAAAGTGAACACTAC","GAATACCACTTTGCAGCATA","561307.5.peg.1631"," 704"
"6450",252,22,230,"AATTGACCGATTGGTCCTCT","CAACTCCTTATGCTGCAAAG","561307.5.peg.1631"," 704"
"6451",261,22,239,"TTCGCAAAGAATTGACCGAT","CAACTCCTTATGCTGCAAAG","561307.5.peg.1631"," 704"
"6452",297,22,275,"CCTGTCAAAGTGAACACTAC","CAACTCCTTATGCTGCAAAG","561307.5.peg.1631"," 704"
"6453",12,252,240,"GAATACCACTTTGCAGCATA","AATTGACCGATTGGTCCTCT","561307.5.peg.1631"," 704"
"6454",22,252,230,"CAACTCCTTATGCTGCAAAG","AATTGACCGATTGGTCCTCT","561307.5.peg.1631"," 704"
"6455",12,261,249,"GAATACCACTTTGCAGCATA","TTCGCAAAGAATTGACCGAT","561307.5.peg.1631"," 704"
"6456",22,261,239,"CAACTCCTTATGCTGCAAAG","TTCGCAAAGAATTGACCGAT","561307.5.peg.1631"," 704"
"6457",12,297,285,"GAATACCACTTTGCAGCATA","CCTGTCAAAGTGAACACTAC","561307.5.peg.1631"," 704"
"6458",22,297,275,"CAACTCCTTATGCTGCAAAG","CCTGTCAAAGTGAACACTAC","561307.5.peg.1631"," 704"
"6459",352,141,211,"GGCAAGCGCATCACTTTCTA","GTGTTACTTGTGTATCGTTG","561307.5.peg.1634"," 707"
"6460",406,141,265,"TATATGCGACTCGTCAACGA","GTGTTACTTGTGTATCGTTG","561307.5.peg.1634"," 707"
"6461",381,141,240,"ATTTCAACGTCAGAGTTACG","GTGTTACTTGTGTATCGTTG","561307.5.peg.1634"," 707"
"6462",373,141,232,"GTCAGAGTTACGCGGCAAAT","GTGTTACTTGTGTATCGTTG","561307.5.peg.1634"," 707"
"6463",373,183,190,"GTCAGAGTTACGCGGCAAAT","TTCAGCCATCGCTCTTGGGT","561307.5.peg.1634"," 707"
"6464",352,183,169,"GGCAAGCGCATCACTTTCTA","TTCAGCCATCGCTCTTGGGT","561307.5.peg.1634"," 707"
"6465",406,183,223,"TATATGCGACTCGTCAACGA","TTCAGCCATCGCTCTTGGGT","561307.5.peg.1634"," 707"
"6466",381,183,198,"ATTTCAACGTCAGAGTTACG","TTCAGCCATCGCTCTTGGGT","561307.5.peg.1634"," 707"
"6467",381,187,194,"ATTTCAACGTCAGAGTTACG","GTCTTTCAGCCATCGCTCTT","561307.5.peg.1634"," 707"
"6468",373,187,186,"GTCAGAGTTACGCGGCAAAT","GTCTTTCAGCCATCGCTCTT","561307.5.peg.1634"," 707"
"6469",352,187,165,"GGCAAGCGCATCACTTTCTA","GTCTTTCAGCCATCGCTCTT","561307.5.peg.1634"," 707"
"6470",406,187,219,"TATATGCGACTCGTCAACGA","GTCTTTCAGCCATCGCTCTT","561307.5.peg.1634"," 707"
"6471",141,352,211,"GTGTTACTTGTGTATCGTTG","GGCAAGCGCATCACTTTCTA","561307.5.peg.1634"," 707"
"6472",183,352,169,"TTCAGCCATCGCTCTTGGGT","GGCAAGCGCATCACTTTCTA","561307.5.peg.1634"," 707"
"6473",187,352,165,"GTCTTTCAGCCATCGCTCTT","GGCAAGCGCATCACTTTCTA","561307.5.peg.1634"," 707"
"6474",183,373,190,"TTCAGCCATCGCTCTTGGGT","GTCAGAGTTACGCGGCAAAT","561307.5.peg.1634"," 707"
"6475",187,373,186,"GTCTTTCAGCCATCGCTCTT","GTCAGAGTTACGCGGCAAAT","561307.5.peg.1634"," 707"
"6476",141,373,232,"GTGTTACTTGTGTATCGTTG","GTCAGAGTTACGCGGCAAAT","561307.5.peg.1634"," 707"
"6477",187,381,194,"GTCTTTCAGCCATCGCTCTT","ATTTCAACGTCAGAGTTACG","561307.5.peg.1634"," 707"
"6478",183,381,198,"TTCAGCCATCGCTCTTGGGT","ATTTCAACGTCAGAGTTACG","561307.5.peg.1634"," 707"
"6479",141,381,240,"GTGTTACTTGTGTATCGTTG","ATTTCAACGTCAGAGTTACG","561307.5.peg.1634"," 707"
"6480",187,406,219,"GTCTTTCAGCCATCGCTCTT","TATATGCGACTCGTCAACGA","561307.5.peg.1634"," 707"
"6481",141,406,265,"GTGTTACTTGTGTATCGTTG","TATATGCGACTCGTCAACGA","561307.5.peg.1634"," 707"
"6482",183,406,223,"TTCAGCCATCGCTCTTGGGT","TATATGCGACTCGTCAACGA","561307.5.peg.1634"," 707"
"6483",180,74,106,"TTTACTGATGCGCTCAAAGA","AATCATCTACACCACCATCG","561307.5.peg.1636"," 709"
"6484",273,74,199,"GCATGCATACGCCATTCTTT","AATCATCTACACCACCATCG","561307.5.peg.1636"," 709"
"6485",330,74,256,"TTTGAAGCAACATGTTTGAC","AATCATCTACACCACCATCG","561307.5.peg.1636"," 709"
"6486",74,180,106,"AATCATCTACACCACCATCG","TTTACTGATGCGCTCAAAGA","561307.5.peg.1636"," 709"
"6487",330,180,150,"TTTGAAGCAACATGTTTGAC","TTTACTGATGCGCTCAAAGA","561307.5.peg.1636"," 709"
"6488",74,273,199,"AATCATCTACACCACCATCG","GCATGCATACGCCATTCTTT","561307.5.peg.1636"," 709"
"6489",74,330,256,"AATCATCTACACCACCATCG","TTTGAAGCAACATGTTTGAC","561307.5.peg.1636"," 709"
"6490",180,330,150,"TTTACTGATGCGCTCAAAGA","TTTGAAGCAACATGTTTGAC","561307.5.peg.1636"," 709"
"6491",420,180,240,"TATAGTCAACAACTACTGT","GCAATGCGTTTAGGGTCTTT","561307.5.peg.1637"," 710"
"6492",420,188,232,"TATAGTCAACAACTACTGT","CAACTACTGCAATGCGTTTA","561307.5.peg.1637"," 710"
"6493",420,213,207,"TATAGTCAACAACTACTGT","TTAAGTCCACCAGCATATGT","561307.5.peg.1637"," 710"
"6494",180,420,240,"GCAATGCGTTTAGGGTCTTT","TATAGTCAACAACTACTGT","561307.5.peg.1637"," 710"
"6495",188,420,232,"CAACTACTGCAATGCGTTTA","TATAGTCAACAACTACTGT","561307.5.peg.1637"," 710"
"6496",213,420,207,"TTAAGTCCACCAGCATATGT","TATAGTCAACAACTACTGT","561307.5.peg.1637"," 710"
"6497",261,9,252,"AACGCAATGGCAGTTAGCAC","GAGTAATGATTCAAAGGAA","561307.5.peg.1640"," 714"
"6498",384,9,375,"GTCAGCATCGGAACTTTATA","GAGTAATGATTCAAAGGAA","561307.5.peg.1640"," 714"
"6499",148,9,139,"CGCTAATCCAATTGTCCAAT","GAGTAATGATTCAAAGGAA","561307.5.peg.1640"," 714"
"6500",9,148,139,"GAGTAATGATTCAAAGGAA","CGCTAATCCAATTGTCCAAT","561307.5.peg.1640"," 714"
"6501",261,148,113,"AACGCAATGGCAGTTAGCAC","CGCTAATCCAATTGTCCAAT","561307.5.peg.1640"," 714"
"6502",384,148,236,"GTCAGCATCGGAACTTTATA","CGCTAATCCAATTGTCCAAT","561307.5.peg.1640"," 714"
"6503",9,261,252,"GAGTAATGATTCAAAGGAA","AACGCAATGGCAGTTAGCAC","561307.5.peg.1640"," 714"
"6504",384,261,123,"GTCAGCATCGGAACTTTATA","AACGCAATGGCAGTTAGCAC","561307.5.peg.1640"," 714"
"6505",148,261,113,"CGCTAATCCAATTGTCCAAT","AACGCAATGGCAGTTAGCAC","561307.5.peg.1640"," 714"
"6506",9,384,375,"GAGTAATGATTCAAAGGAA","GTCAGCATCGGAACTTTATA","561307.5.peg.1640"," 714"
"6507",148,384,236,"CGCTAATCCAATTGTCCAAT","GTCAGCATCGGAACTTTATA","561307.5.peg.1640"," 714"
"6508",261,384,123,"AACGCAATGGCAGTTAGCAC","GTCAGCATCGGAACTTTATA","561307.5.peg.1640"," 714"
"6509",147,8,139,"CTGATTAAAGCTAATGCCTC","GTATCTAATATGAAATTGG","561307.5.peg.1641"," 715"
"6510",8,147,139,"GTATCTAATATGAAATTGG","CTGATTAAAGCTAATGCCTC","561307.5.peg.1641"," 715"
"6511",108,8,100,"TCAACTTCGATAACTGTTTC","ATCACCCTATTGTTTAAAGG","561307.5.peg.1642"," 716"
"6512",8,108,100,"ATCACCCTATTGTTTAAAGG","TCAACTTCGATAACTGTTTC","561307.5.peg.1642"," 716"
"6513",576,96,480,"CTATGAATATGCCATGGACC","CGAATGGAATCTCCAACAGT","561307.5.peg.1643"," 717"
"6514",358,96,262,"ATCCATTATATCTGGGTTGC","CGAATGGAATCTCCAACAGT","561307.5.peg.1643"," 717"
"6515",613,96,517,"GACATTAATCGGTAAACCTT","CGAATGGAATCTCCAACAGT","561307.5.peg.1643"," 717"
"6516",857,96,761,"TATGGTACATATGAAGTACA","CGAATGGAATCTCCAACAGT","561307.5.peg.1643"," 717"
"6517",228,96,132,"ACGTCATCACGTGTTACACG","CGAATGGAATCTCCAACAGT","561307.5.peg.1643"," 717"
"6518",346,96,250,"TGGGTTGCCGGCATTACCTA","CGAATGGAATCTCCAACAGT","561307.5.peg.1643"," 717"
"6519",875,96,779,"CGCCACCAGCACCTTCAGTA","CGAATGGAATCTCCAACAGT","561307.5.peg.1643"," 717"
"6520",480,96,384,"AATGCGACCTCTGCTTGTTC","CGAATGGAATCTCCAACAGT","561307.5.peg.1643"," 717"
"6521",738,96,642,"AATGCATGACTCAAAGCAGA","CGAATGGAATCTCCAACAGT","561307.5.peg.1643"," 717"
"6522",358,228,130,"ATCCATTATATCTGGGTTGC","ACGTCATCACGTGTTACACG","561307.5.peg.1643"," 717"
"6523",857,228,629,"TATGGTACATATGAAGTACA","ACGTCATCACGTGTTACACG","561307.5.peg.1643"," 717"
"6524",96,228,132,"CGAATGGAATCTCCAACAGT","ACGTCATCACGTGTTACACG","561307.5.peg.1643"," 717"
"6525",576,228,348,"CTATGAATATGCCATGGACC","ACGTCATCACGTGTTACACG","561307.5.peg.1643"," 717"
"6526",738,228,510,"AATGCATGACTCAAAGCAGA","ACGTCATCACGTGTTACACG","561307.5.peg.1643"," 717"
"6527",346,228,118,"TGGGTTGCCGGCATTACCTA","ACGTCATCACGTGTTACACG","561307.5.peg.1643"," 717"
"6528",613,228,385,"GACATTAATCGGTAAACCTT","ACGTCATCACGTGTTACACG","561307.5.peg.1643"," 717"
"6529",480,228,252,"AATGCGACCTCTGCTTGTTC","ACGTCATCACGTGTTACACG","561307.5.peg.1643"," 717"
"6530",875,228,647,"CGCCACCAGCACCTTCAGTA","ACGTCATCACGTGTTACACG","561307.5.peg.1643"," 717"
"6531",96,346,250,"CGAATGGAATCTCCAACAGT","TGGGTTGCCGGCATTACCTA","561307.5.peg.1643"," 717"
"6532",480,346,134,"AATGCGACCTCTGCTTGTTC","TGGGTTGCCGGCATTACCTA","561307.5.peg.1643"," 717"
"6533",228,346,118,"ACGTCATCACGTGTTACACG","TGGGTTGCCGGCATTACCTA","561307.5.peg.1643"," 717"
"6534",576,346,230,"CTATGAATATGCCATGGACC","TGGGTTGCCGGCATTACCTA","561307.5.peg.1643"," 717"
"6535",857,346,511,"TATGGTACATATGAAGTACA","TGGGTTGCCGGCATTACCTA","561307.5.peg.1643"," 717"
"6536",738,346,392,"AATGCATGACTCAAAGCAGA","TGGGTTGCCGGCATTACCTA","561307.5.peg.1643"," 717"
"6537",613,346,267,"GACATTAATCGGTAAACCTT","TGGGTTGCCGGCATTACCTA","561307.5.peg.1643"," 717"
"6538",875,346,529,"CGCCACCAGCACCTTCAGTA","TGGGTTGCCGGCATTACCTA","561307.5.peg.1643"," 717"
"6539",228,358,130,"ACGTCATCACGTGTTACACG","ATCCATTATATCTGGGTTGC","561307.5.peg.1643"," 717"
"6540",96,358,262,"CGAATGGAATCTCCAACAGT","ATCCATTATATCTGGGTTGC","561307.5.peg.1643"," 717"
"6541",738,358,380,"AATGCATGACTCAAAGCAGA","ATCCATTATATCTGGGTTGC","561307.5.peg.1643"," 717"
"6542",857,358,499,"TATGGTACATATGAAGTACA","ATCCATTATATCTGGGTTGC","561307.5.peg.1643"," 717"
"6543",576,358,218,"CTATGAATATGCCATGGACC","ATCCATTATATCTGGGTTGC","561307.5.peg.1643"," 717"
"6544",480,358,122,"AATGCGACCTCTGCTTGTTC","ATCCATTATATCTGGGTTGC","561307.5.peg.1643"," 717"
"6545",613,358,255,"GACATTAATCGGTAAACCTT","ATCCATTATATCTGGGTTGC","561307.5.peg.1643"," 717"
"6546",875,358,517,"CGCCACCAGCACCTTCAGTA","ATCCATTATATCTGGGTTGC","561307.5.peg.1643"," 717"
"6547",857,480,377,"TATGGTACATATGAAGTACA","AATGCGACCTCTGCTTGTTC","561307.5.peg.1643"," 717"
"6548",738,480,258,"AATGCATGACTCAAAGCAGA","AATGCGACCTCTGCTTGTTC","561307.5.peg.1643"," 717"
"6549",228,480,252,"ACGTCATCACGTGTTACACG","AATGCGACCTCTGCTTGTTC","561307.5.peg.1643"," 717"
"6550",346,480,134,"TGGGTTGCCGGCATTACCTA","AATGCGACCTCTGCTTGTTC","561307.5.peg.1643"," 717"
"6551",358,480,122,"ATCCATTATATCTGGGTTGC","AATGCGACCTCTGCTTGTTC","561307.5.peg.1643"," 717"
"6552",96,480,384,"CGAATGGAATCTCCAACAGT","AATGCGACCTCTGCTTGTTC","561307.5.peg.1643"," 717"
"6553",875,480,395,"CGCCACCAGCACCTTCAGTA","AATGCGACCTCTGCTTGTTC","561307.5.peg.1643"," 717"
"6554",613,480,133,"GACATTAATCGGTAAACCTT","AATGCGACCTCTGCTTGTTC","561307.5.peg.1643"," 717"
"6555",875,576,299,"CGCCACCAGCACCTTCAGTA","CTATGAATATGCCATGGACC","561307.5.peg.1643"," 717"
"6556",346,576,230,"TGGGTTGCCGGCATTACCTA","CTATGAATATGCCATGGACC","561307.5.peg.1643"," 717"
"6557",358,576,218,"ATCCATTATATCTGGGTTGC","CTATGAATATGCCATGGACC","561307.5.peg.1643"," 717"
"6558",96,576,480,"CGAATGGAATCTCCAACAGT","CTATGAATATGCCATGGACC","561307.5.peg.1643"," 717"
"6559",228,576,348,"ACGTCATCACGTGTTACACG","CTATGAATATGCCATGGACC","561307.5.peg.1643"," 717"
"6560",738,576,162,"AATGCATGACTCAAAGCAGA","CTATGAATATGCCATGGACC","561307.5.peg.1643"," 717"
"6561",857,576,281,"TATGGTACATATGAAGTACA","CTATGAATATGCCATGGACC","561307.5.peg.1643"," 717"
"6562",738,613,125,"AATGCATGACTCAAAGCAGA","GACATTAATCGGTAAACCTT","561307.5.peg.1643"," 717"
"6563",857,613,244,"TATGGTACATATGAAGTACA","GACATTAATCGGTAAACCTT","561307.5.peg.1643"," 717"
"6564",346,613,267,"TGGGTTGCCGGCATTACCTA","GACATTAATCGGTAAACCTT","561307.5.peg.1643"," 717"
"6565",480,613,133,"AATGCGACCTCTGCTTGTTC","GACATTAATCGGTAAACCTT","561307.5.peg.1643"," 717"
"6566",875,613,262,"CGCCACCAGCACCTTCAGTA","GACATTAATCGGTAAACCTT","561307.5.peg.1643"," 717"
"6567",358,613,255,"ATCCATTATATCTGGGTTGC","GACATTAATCGGTAAACCTT","561307.5.peg.1643"," 717"
"6568",96,613,517,"CGAATGGAATCTCCAACAGT","GACATTAATCGGTAAACCTT","561307.5.peg.1643"," 717"
"6569",228,613,385,"ACGTCATCACGTGTTACACG","GACATTAATCGGTAAACCTT","561307.5.peg.1643"," 717"
"6570",96,738,642,"CGAATGGAATCTCCAACAGT","AATGCATGACTCAAAGCAGA","561307.5.peg.1643"," 717"
"6571",480,738,258,"AATGCGACCTCTGCTTGTTC","AATGCATGACTCAAAGCAGA","561307.5.peg.1643"," 717"
"6572",346,738,392,"TGGGTTGCCGGCATTACCTA","AATGCATGACTCAAAGCAGA","561307.5.peg.1643"," 717"
"6573",875,738,137,"CGCCACCAGCACCTTCAGTA","AATGCATGACTCAAAGCAGA","561307.5.peg.1643"," 717"
"6574",228,738,510,"ACGTCATCACGTGTTACACG","AATGCATGACTCAAAGCAGA","561307.5.peg.1643"," 717"
"6575",358,738,380,"ATCCATTATATCTGGGTTGC","AATGCATGACTCAAAGCAGA","561307.5.peg.1643"," 717"
"6576",857,738,119,"TATGGTACATATGAAGTACA","AATGCATGACTCAAAGCAGA","561307.5.peg.1643"," 717"
"6577",576,738,162,"CTATGAATATGCCATGGACC","AATGCATGACTCAAAGCAGA","561307.5.peg.1643"," 717"
"6578",613,738,125,"GACATTAATCGGTAAACCTT","AATGCATGACTCAAAGCAGA","561307.5.peg.1643"," 717"
"6579",96,857,761,"CGAATGGAATCTCCAACAGT","TATGGTACATATGAAGTACA","561307.5.peg.1643"," 717"
"6580",346,857,511,"TGGGTTGCCGGCATTACCTA","TATGGTACATATGAAGTACA","561307.5.peg.1643"," 717"
"6581",576,857,281,"CTATGAATATGCCATGGACC","TATGGTACATATGAAGTACA","561307.5.peg.1643"," 717"
"6582",228,857,629,"ACGTCATCACGTGTTACACG","TATGGTACATATGAAGTACA","561307.5.peg.1643"," 717"
"6583",738,857,119,"AATGCATGACTCAAAGCAGA","TATGGTACATATGAAGTACA","561307.5.peg.1643"," 717"
"6584",358,857,499,"ATCCATTATATCTGGGTTGC","TATGGTACATATGAAGTACA","561307.5.peg.1643"," 717"
"6585",613,857,244,"GACATTAATCGGTAAACCTT","TATGGTACATATGAAGTACA","561307.5.peg.1643"," 717"
"6586",480,857,377,"AATGCGACCTCTGCTTGTTC","TATGGTACATATGAAGTACA","561307.5.peg.1643"," 717"
"6587",346,875,529,"TGGGTTGCCGGCATTACCTA","CGCCACCAGCACCTTCAGTA","561307.5.peg.1643"," 717"
"6588",738,875,137,"AATGCATGACTCAAAGCAGA","CGCCACCAGCACCTTCAGTA","561307.5.peg.1643"," 717"
"6589",613,875,262,"GACATTAATCGGTAAACCTT","CGCCACCAGCACCTTCAGTA","561307.5.peg.1643"," 717"
"6590",358,875,517,"ATCCATTATATCTGGGTTGC","CGCCACCAGCACCTTCAGTA","561307.5.peg.1643"," 717"
"6591",576,875,299,"CTATGAATATGCCATGGACC","CGCCACCAGCACCTTCAGTA","561307.5.peg.1643"," 717"
"6592",480,875,395,"AATGCGACCTCTGCTTGTTC","CGCCACCAGCACCTTCAGTA","561307.5.peg.1643"," 717"
"6593",228,875,647,"ACGTCATCACGTGTTACACG","CGCCACCAGCACCTTCAGTA","561307.5.peg.1643"," 717"
"6594",96,875,779,"CGAATGGAATCTCCAACAGT","CGCCACCAGCACCTTCAGTA","561307.5.peg.1643"," 717"
"6595",176,9,167,"GAATGCCTATTTCAGTGCCA","AGATACTTCTTATTCTAGG","561307.5.peg.1644"," 718"
"6596",210,9,201,"CTCCATATTGTAAGTCAAT","AGATACTTCTTATTCTAGG","561307.5.peg.1644"," 718"
"6597",176,68,108,"GAATGCCTATTTCAGTGCCA","ACAAATTGGCAATATTGCCT","561307.5.peg.1644"," 718"
"6598",210,68,142,"CTCCATATTGTAAGTCAAT","ACAAATTGGCAATATTGCCT","561307.5.peg.1644"," 718"
"6599",9,176,167,"AGATACTTCTTATTCTAGG","GAATGCCTATTTCAGTGCCA","561307.5.peg.1644"," 718"
"6600",68,176,108,"ACAAATTGGCAATATTGCCT","GAATGCCTATTTCAGTGCCA","561307.5.peg.1644"," 718"
"6601",9,210,201,"AGATACTTCTTATTCTAGG","CTCCATATTGTAAGTCAAT","561307.5.peg.1644"," 718"
"6602",68,210,142,"ACAAATTGGCAATATTGCCT","CTCCATATTGTAAGTCAAT","561307.5.peg.1644"," 718"
"6603",217,8,209,"CATGGCTAAACCATCAGAAT","ATAAGGCTTTCAGACATATA","561307.5.peg.1645"," 719"
"6604",321,8,313,"GCACCAACACGTGTTTCTTT","ATAAGGCTTTCAGACATATA","561307.5.peg.1645"," 719"
"6605",217,102,115,"CATGGCTAAACCATCAGAAT","GAATGACTGAAAGCACCTGT","561307.5.peg.1645"," 719"
"6606",321,102,219,"GCACCAACACGTGTTTCTTT","GAATGACTGAAAGCACCTGT","561307.5.peg.1645"," 719"
"6607",8,217,209,"ATAAGGCTTTCAGACATATA","CATGGCTAAACCATCAGAAT","561307.5.peg.1645"," 719"
"6608",321,217,104,"GCACCAACACGTGTTTCTTT","CATGGCTAAACCATCAGAAT","561307.5.peg.1645"," 719"
"6609",102,217,115,"GAATGACTGAAAGCACCTGT","CATGGCTAAACCATCAGAAT","561307.5.peg.1645"," 719"
"6610",102,321,219,"GAATGACTGAAAGCACCTGT","GCACCAACACGTGTTTCTTT","561307.5.peg.1645"," 719"
"6611",8,321,313,"ATAAGGCTTTCAGACATATA","GCACCAACACGTGTTTCTTT","561307.5.peg.1645"," 719"
"6612",217,321,104,"CATGGCTAAACCATCAGAAT","GCACCAACACGTGTTTCTTT","561307.5.peg.1645"," 719"
"6613",239,10,229,"CTTCGACATTCACATTCATA","GAACGCGACACTTTACTCAA","561307.5.peg.1647"," 721"
"6614",315,10,305,"TACTGCTCAACATGATTGGA","GAACGCGACACTTTACTCAA","561307.5.peg.1647"," 721"
"6615",319,10,309,"TTGATACTGCTCAACATGAT","GAACGCGACACTTTACTCAA","561307.5.peg.1647"," 721"
"6616",10,239,229,"GAACGCGACACTTTACTCAA","CTTCGACATTCACATTCATA","561307.5.peg.1647"," 721"
"6617",10,315,305,"GAACGCGACACTTTACTCAA","TACTGCTCAACATGATTGGA","561307.5.peg.1647"," 721"
"6618",10,319,309,"GAACGCGACACTTTACTCAA","TTGATACTGCTCAACATGAT","561307.5.peg.1647"," 721"
"6619",228,119,109,"AATTTATGCGCTTGTGACAT","CTGGTTTCCCTTTCAATTTG","561307.5.peg.165"," 724"
"6620",293,119,174,"TAATCTGCGCAGATGTTTCT","CTGGTTTCCCTTTCAATTTG","561307.5.peg.165"," 724"
"6621",326,119,207,"CTACCTTATCTGTATAACTT","CTGGTTTCCCTTTCAATTTG","561307.5.peg.165"," 724"
"6622",228,121,107,"AATTTATGCGCTTGTGACAT","GACTGGTTTCCCTTTCAATT","561307.5.peg.165"," 724"
"6623",293,121,172,"TAATCTGCGCAGATGTTTCT","GACTGGTTTCCCTTTCAATT","561307.5.peg.165"," 724"
"6624",326,121,205,"CTACCTTATCTGTATAACTT","GACTGGTTTCCCTTTCAATT","561307.5.peg.165"," 724"
"6625",326,215,111,"CTACCTTATCTGTATAACTT","GTGACATAGGCATTGCTGAA","561307.5.peg.165"," 724"
"6626",119,228,109,"CTGGTTTCCCTTTCAATTTG","AATTTATGCGCTTGTGACAT","561307.5.peg.165"," 724"
"6627",121,228,107,"GACTGGTTTCCCTTTCAATT","AATTTATGCGCTTGTGACAT","561307.5.peg.165"," 724"
"6628",119,293,174,"CTGGTTTCCCTTTCAATTTG","TAATCTGCGCAGATGTTTCT","561307.5.peg.165"," 724"
"6629",121,293,172,"GACTGGTTTCCCTTTCAATT","TAATCTGCGCAGATGTTTCT","561307.5.peg.165"," 724"
"6630",119,326,207,"CTGGTTTCCCTTTCAATTTG","CTACCTTATCTGTATAACTT","561307.5.peg.165"," 724"
"6631",121,326,205,"GACTGGTTTCCCTTTCAATT","CTACCTTATCTGTATAACTT","561307.5.peg.165"," 724"
"6632",215,326,111,"GTGACATAGGCATTGCTGAA","CTACCTTATCTGTATAACTT","561307.5.peg.165"," 724"
"6633",193,9,184,"ACTATCTATTGAAGCGCTAT","ATATAGGCATGGTTTAAGAG","561307.5.peg.1650"," 725"
"6634",236,9,227,"GAAGAAGGGCCATCTTAGAT","ATATAGGCATGGTTTAAGAG","561307.5.peg.1650"," 725"
"6635",193,20,173,"ACTATCTATTGAAGCGCTAT","ATCATCTTGAGATATAGGCA","561307.5.peg.1650"," 725"
"6636",236,20,216,"GAAGAAGGGCCATCTTAGAT","ATCATCTTGAGATATAGGCA","561307.5.peg.1650"," 725"
"6637",9,193,184,"ATATAGGCATGGTTTAAGAG","ACTATCTATTGAAGCGCTAT","561307.5.peg.1650"," 725"
"6638",20,193,173,"ATCATCTTGAGATATAGGCA","ACTATCTATTGAAGCGCTAT","561307.5.peg.1650"," 725"
"6639",9,236,227,"ATATAGGCATGGTTTAAGAG","GAAGAAGGGCCATCTTAGAT","561307.5.peg.1650"," 725"
"6640",20,236,216,"ATCATCTTGAGATATAGGCA","GAAGAAGGGCCATCTTAGAT","561307.5.peg.1650"," 725"
"6641",681,487,194,"CTACTTGCGATTTCTTCAAT","TAAATAATCGTGCACTTCTT","561307.5.peg.1651"," 726"
"6642",737,487,250,"ACCATACGTTTCTTTAAAG","TAAATAATCGTGCACTTCTT","561307.5.peg.1651"," 726"
"6643",487,681,194,"TAAATAATCGTGCACTTCTT","CTACTTGCGATTTCTTCAAT","561307.5.peg.1651"," 726"
"6644",487,737,250,"TAAATAATCGTGCACTTCTT","ACCATACGTTTCTTTAAAG","561307.5.peg.1651"," 726"
"6645",347,159,188,"ATTTGAGTAGTTGTTGTAA","CTATATGATGTTGGGTCGTT","561307.5.peg.1652"," 727"
"6646",422,159,263,"TTGCACCTAAACCACCAGTA","CTATATGATGTTGGGTCGTT","561307.5.peg.1652"," 727"
"6647",347,167,180,"ATTTGAGTAGTTGTTGTAA","AGTATAGCTATATGATGTT","561307.5.peg.1652"," 727"
"6648",422,167,255,"TTGCACCTAAACCACCAGTA","AGTATAGCTATATGATGTT","561307.5.peg.1652"," 727"
"6649",347,215,132,"ATTTGAGTAGTTGTTGTAA","AGTTACCTTTCCATGTGTAA","561307.5.peg.1652"," 727"
"6650",422,215,207,"TTGCACCTAAACCACCAGTA","AGTTACCTTTCCATGTGTAA","561307.5.peg.1652"," 727"
"6651",422,257,165,"TTGCACCTAAACCACCAGTA","AGCTGTAGTAGCCATTATCT","561307.5.peg.1652"," 727"
"6652",159,347,188,"CTATATGATGTTGGGTCGTT","ATTTGAGTAGTTGTTGTAA","561307.5.peg.1652"," 727"
"6653",167,347,180,"AGTATAGCTATATGATGTT","ATTTGAGTAGTTGTTGTAA","561307.5.peg.1652"," 727"
"6654",215,347,132,"AGTTACCTTTCCATGTGTAA","ATTTGAGTAGTTGTTGTAA","561307.5.peg.1652"," 727"
"6655",159,422,263,"CTATATGATGTTGGGTCGTT","TTGCACCTAAACCACCAGTA","561307.5.peg.1652"," 727"
"6656",167,422,255,"AGTATAGCTATATGATGTT","TTGCACCTAAACCACCAGTA","561307.5.peg.1652"," 727"
"6657",215,422,207,"AGTTACCTTTCCATGTGTAA","TTGCACCTAAACCACCAGTA","561307.5.peg.1652"," 727"
"6658",257,422,165,"AGCTGTAGTAGCCATTATCT","TTGCACCTAAACCACCAGTA","561307.5.peg.1652"," 727"
"6659",636,8,628,"ATAAACCTATGATTGATGC","TTTCTCATCAATAAGCGAAG","561307.5.peg.1653"," 728"
"6660",489,8,481,"GCACCCGCTGCCATCCCTGG","TTTCTCATCAATAAGCGAAG","561307.5.peg.1653"," 728"
"6661",492,8,484,"ATAGCACCCGCTGCCATCCC","TTTCTCATCAATAAGCGAAG","561307.5.peg.1653"," 728"
"6662",169,8,161,"AATCCATGTGGCATATGCTG","TTTCTCATCAATAAGCGAAG","561307.5.peg.1653"," 728"
"6663",489,10,479,"GCACCCGCTGCCATCCCTGG","GGTTTCTCATCAATAAGCGA","561307.5.peg.1653"," 728"
"6664",169,10,159,"AATCCATGTGGCATATGCTG","GGTTTCTCATCAATAAGCGA","561307.5.peg.1653"," 728"
"6665",492,10,482,"ATAGCACCCGCTGCCATCCC","GGTTTCTCATCAATAAGCGA","561307.5.peg.1653"," 728"
"6666",636,10,626,"ATAAACCTATGATTGATGC","GGTTTCTCATCAATAAGCGA","561307.5.peg.1653"," 728"
"6667",8,169,161,"TTTCTCATCAATAAGCGAAG","AATCCATGTGGCATATGCTG","561307.5.peg.1653"," 728"
"6668",10,169,159,"GGTTTCTCATCAATAAGCGA","AATCCATGTGGCATATGCTG","561307.5.peg.1653"," 728"
"6669",636,169,467,"ATAAACCTATGATTGATGC","AATCCATGTGGCATATGCTG","561307.5.peg.1653"," 728"
"6670",489,169,320,"GCACCCGCTGCCATCCCTGG","AATCCATGTGGCATATGCTG","561307.5.peg.1653"," 728"
"6671",492,169,323,"ATAGCACCCGCTGCCATCCC","AATCCATGTGGCATATGCTG","561307.5.peg.1653"," 728"
"6672",8,489,481,"TTTCTCATCAATAAGCGAAG","GCACCCGCTGCCATCCCTGG","561307.5.peg.1653"," 728"
"6673",169,489,320,"AATCCATGTGGCATATGCTG","GCACCCGCTGCCATCCCTGG","561307.5.peg.1653"," 728"
"6674",636,489,147,"ATAAACCTATGATTGATGC","GCACCCGCTGCCATCCCTGG","561307.5.peg.1653"," 728"
"6675",10,489,479,"GGTTTCTCATCAATAAGCGA","GCACCCGCTGCCATCCCTGG","561307.5.peg.1653"," 728"
"6676",169,492,323,"AATCCATGTGGCATATGCTG","ATAGCACCCGCTGCCATCCC","561307.5.peg.1653"," 728"
"6677",8,492,484,"TTTCTCATCAATAAGCGAAG","ATAGCACCCGCTGCCATCCC","561307.5.peg.1653"," 728"
"6678",636,492,144,"ATAAACCTATGATTGATGC","ATAGCACCCGCTGCCATCCC","561307.5.peg.1653"," 728"
"6679",10,492,482,"GGTTTCTCATCAATAAGCGA","ATAGCACCCGCTGCCATCCC","561307.5.peg.1653"," 728"
"6680",8,636,628,"TTTCTCATCAATAAGCGAAG","ATAAACCTATGATTGATGC","561307.5.peg.1653"," 728"
"6681",10,636,626,"GGTTTCTCATCAATAAGCGA","ATAAACCTATGATTGATGC","561307.5.peg.1653"," 728"
"6682",169,636,467,"AATCCATGTGGCATATGCTG","ATAAACCTATGATTGATGC","561307.5.peg.1653"," 728"
"6683",492,636,144,"ATAGCACCCGCTGCCATCCC","ATAAACCTATGATTGATGC","561307.5.peg.1653"," 728"
"6684",489,636,147,"GCACCCGCTGCCATCCCTGG","ATAAACCTATGATTGATGC","561307.5.peg.1653"," 728"
"6685",435,7,428,"GTATTAGCTTCCGCTAGTTG","TTAACCAAAGATAGAAAGA","561307.5.peg.1654"," 729"
"6686",7,435,428,"TTAACCAAAGATAGAAAGA","GTATTAGCTTCCGCTAGTTG","561307.5.peg.1654"," 729"
"6687",439,336,103,"TTCTTGTTCCGCGAAATGTA","ATGTCAATTAATGTTTGGCG","561307.5.peg.1658"," 733"
"6688",336,439,103,"ATGTCAATTAATGTTTGGCG","TTCTTGTTCCGCGAAATGTA","561307.5.peg.1658"," 733"
"6689",1100,258,842,"AAATGAATGATAGTGCATCT","TCACAGTATTTACAGTCAT","561307.5.peg.1662"," 738"
"6690",1333,258,1075,"TGCGATAACTGGATGAGCTT","TCACAGTATTTACAGTCAT","561307.5.peg.1662"," 738"
"6691",1461,258,1203,"AACCACGCTAAATCCGTACC","TCACAGTATTTACAGTCAT","561307.5.peg.1662"," 738"
"6692",651,258,393,"ACTTCCATCATGGCATTACA","TCACAGTATTTACAGTCAT","561307.5.peg.1662"," 738"
"6693",759,258,501,"GCAAATAGTGGACCATAACC","TCACAGTATTTACAGTCAT","561307.5.peg.1662"," 738"
"6694",909,258,651,"TTTGCTGGAGAATCATGTGA","TCACAGTATTTACAGTCAT","561307.5.peg.1662"," 738"
"6695",661,258,403,"TTCCATATTCACTTCCATCA","TCACAGTATTTACAGTCAT","561307.5.peg.1662"," 738"
"6696",600,258,342,"ACACATGAAGACTCATTAAT","TCACAGTATTTACAGTCAT","561307.5.peg.1662"," 738"
"6697",1028,258,770,"CTTCATCCCATTCTACTTCA","TCACAGTATTTACAGTCAT","561307.5.peg.1662"," 738"
"6698",1455,258,1197,"GCTAAATCCGTACCTGGTTT","TCACAGTATTTACAGTCAT","561307.5.peg.1662"," 738"
"6699",714,258,456,"ATCATTGCTGCTAATGAACC","TCACAGTATTTACAGTCAT","561307.5.peg.1662"," 738"
"6700",573,258,315,"TCATTATCCCAAATAACACG","TCACAGTATTTACAGTCAT","561307.5.peg.1662"," 738"
"6701",258,573,315,"TCACAGTATTTACAGTCAT","TCATTATCCCAAATAACACG","561307.5.peg.1662"," 738"
"6702",1461,573,888,"AACCACGCTAAATCCGTACC","TCATTATCCCAAATAACACG","561307.5.peg.1662"," 738"
"6703",1333,573,760,"TGCGATAACTGGATGAGCTT","TCATTATCCCAAATAACACG","561307.5.peg.1662"," 738"
"6704",1028,573,455,"CTTCATCCCATTCTACTTCA","TCATTATCCCAAATAACACG","561307.5.peg.1662"," 738"
"6705",714,573,141,"ATCATTGCTGCTAATGAACC","TCATTATCCCAAATAACACG","561307.5.peg.1662"," 738"
"6706",1100,573,527,"AAATGAATGATAGTGCATCT","TCATTATCCCAAATAACACG","561307.5.peg.1662"," 738"
"6707",759,573,186,"GCAAATAGTGGACCATAACC","TCATTATCCCAAATAACACG","561307.5.peg.1662"," 738"
"6708",909,573,336,"TTTGCTGGAGAATCATGTGA","TCATTATCCCAAATAACACG","561307.5.peg.1662"," 738"
"6709",1455,573,882,"GCTAAATCCGTACCTGGTTT","TCATTATCCCAAATAACACG","561307.5.peg.1662"," 738"
"6710",258,600,342,"TCACAGTATTTACAGTCAT","ACACATGAAGACTCATTAAT","561307.5.peg.1662"," 738"
"6711",1333,600,733,"TGCGATAACTGGATGAGCTT","ACACATGAAGACTCATTAAT","561307.5.peg.1662"," 738"
"6712",1028,600,428,"CTTCATCCCATTCTACTTCA","ACACATGAAGACTCATTAAT","561307.5.peg.1662"," 738"
"6713",1461,600,861,"AACCACGCTAAATCCGTACC","ACACATGAAGACTCATTAAT","561307.5.peg.1662"," 738"
"6714",1100,600,500,"AAATGAATGATAGTGCATCT","ACACATGAAGACTCATTAAT","561307.5.peg.1662"," 738"
"6715",714,600,114,"ATCATTGCTGCTAATGAACC","ACACATGAAGACTCATTAAT","561307.5.peg.1662"," 738"
"6716",759,600,159,"GCAAATAGTGGACCATAACC","ACACATGAAGACTCATTAAT","561307.5.peg.1662"," 738"
"6717",909,600,309,"TTTGCTGGAGAATCATGTGA","ACACATGAAGACTCATTAAT","561307.5.peg.1662"," 738"
"6718",1455,600,855,"GCTAAATCCGTACCTGGTTT","ACACATGAAGACTCATTAAT","561307.5.peg.1662"," 738"
"6719",1100,651,449,"AAATGAATGATAGTGCATCT","ACTTCCATCATGGCATTACA","561307.5.peg.1662"," 738"
"6720",1333,651,682,"TGCGATAACTGGATGAGCTT","ACTTCCATCATGGCATTACA","561307.5.peg.1662"," 738"
"6721",759,651,108,"GCAAATAGTGGACCATAACC","ACTTCCATCATGGCATTACA","561307.5.peg.1662"," 738"
"6722",258,651,393,"TCACAGTATTTACAGTCAT","ACTTCCATCATGGCATTACA","561307.5.peg.1662"," 738"
"6723",1461,651,810,"AACCACGCTAAATCCGTACC","ACTTCCATCATGGCATTACA","561307.5.peg.1662"," 738"
"6724",1455,651,804,"GCTAAATCCGTACCTGGTTT","ACTTCCATCATGGCATTACA","561307.5.peg.1662"," 738"
"6725",1028,651,377,"CTTCATCCCATTCTACTTCA","ACTTCCATCATGGCATTACA","561307.5.peg.1662"," 738"
"6726",909,651,258,"TTTGCTGGAGAATCATGTGA","ACTTCCATCATGGCATTACA","561307.5.peg.1662"," 738"
"6727",1461,661,800,"AACCACGCTAAATCCGTACC","TTCCATATTCACTTCCATCA","561307.5.peg.1662"," 738"
"6728",1333,661,672,"TGCGATAACTGGATGAGCTT","TTCCATATTCACTTCCATCA","561307.5.peg.1662"," 738"
"6729",909,661,248,"TTTGCTGGAGAATCATGTGA","TTCCATATTCACTTCCATCA","561307.5.peg.1662"," 738"
"6730",1100,661,439,"AAATGAATGATAGTGCATCT","TTCCATATTCACTTCCATCA","561307.5.peg.1662"," 738"
"6731",258,661,403,"TCACAGTATTTACAGTCAT","TTCCATATTCACTTCCATCA","561307.5.peg.1662"," 738"
"6732",1028,661,367,"CTTCATCCCATTCTACTTCA","TTCCATATTCACTTCCATCA","561307.5.peg.1662"," 738"
"6733",1455,661,794,"GCTAAATCCGTACCTGGTTT","TTCCATATTCACTTCCATCA","561307.5.peg.1662"," 738"
"6734",1455,714,741,"GCTAAATCCGTACCTGGTTT","ATCATTGCTGCTAATGAACC","561307.5.peg.1662"," 738"
"6735",258,714,456,"TCACAGTATTTACAGTCAT","ATCATTGCTGCTAATGAACC","561307.5.peg.1662"," 738"
"6736",1100,714,386,"AAATGAATGATAGTGCATCT","ATCATTGCTGCTAATGAACC","561307.5.peg.1662"," 738"
"6737",1333,714,619,"TGCGATAACTGGATGAGCTT","ATCATTGCTGCTAATGAACC","561307.5.peg.1662"," 738"
"6738",573,714,141,"TCATTATCCCAAATAACACG","ATCATTGCTGCTAATGAACC","561307.5.peg.1662"," 738"
"6739",1461,714,747,"AACCACGCTAAATCCGTACC","ATCATTGCTGCTAATGAACC","561307.5.peg.1662"," 738"
"6740",909,714,195,"TTTGCTGGAGAATCATGTGA","ATCATTGCTGCTAATGAACC","561307.5.peg.1662"," 738"
"6741",1028,714,314,"CTTCATCCCATTCTACTTCA","ATCATTGCTGCTAATGAACC","561307.5.peg.1662"," 738"
"6742",600,714,114,"ACACATGAAGACTCATTAAT","ATCATTGCTGCTAATGAACC","561307.5.peg.1662"," 738"
"6743",573,759,186,"TCATTATCCCAAATAACACG","GCAAATAGTGGACCATAACC","561307.5.peg.1662"," 738"
"6744",258,759,501,"TCACAGTATTTACAGTCAT","GCAAATAGTGGACCATAACC","561307.5.peg.1662"," 738"
"6745",1100,759,341,"AAATGAATGATAGTGCATCT","GCAAATAGTGGACCATAACC","561307.5.peg.1662"," 738"
"6746",600,759,159,"ACACATGAAGACTCATTAAT","GCAAATAGTGGACCATAACC","561307.5.peg.1662"," 738"
"6747",651,759,108,"ACTTCCATCATGGCATTACA","GCAAATAGTGGACCATAACC","561307.5.peg.1662"," 738"
"6748",909,759,150,"TTTGCTGGAGAATCATGTGA","GCAAATAGTGGACCATAACC","561307.5.peg.1662"," 738"
"6749",1461,759,702,"AACCACGCTAAATCCGTACC","GCAAATAGTGGACCATAACC","561307.5.peg.1662"," 738"
"6750",1028,759,269,"CTTCATCCCATTCTACTTCA","GCAAATAGTGGACCATAACC","561307.5.peg.1662"," 738"
"6751",1333,759,574,"TGCGATAACTGGATGAGCTT","GCAAATAGTGGACCATAACC","561307.5.peg.1662"," 738"
"6752",1455,759,696,"GCTAAATCCGTACCTGGTTT","GCAAATAGTGGACCATAACC","561307.5.peg.1662"," 738"
"6753",714,909,195,"ATCATTGCTGCTAATGAACC","TTTGCTGGAGAATCATGTGA","561307.5.peg.1662"," 738"
"6754",759,909,150,"GCAAATAGTGGACCATAACC","TTTGCTGGAGAATCATGTGA","561307.5.peg.1662"," 738"
"6755",1455,909,546,"GCTAAATCCGTACCTGGTTT","TTTGCTGGAGAATCATGTGA","561307.5.peg.1662"," 738"
"6756",1028,909,119,"CTTCATCCCATTCTACTTCA","TTTGCTGGAGAATCATGTGA","561307.5.peg.1662"," 738"
"6757",1461,909,552,"AACCACGCTAAATCCGTACC","TTTGCTGGAGAATCATGTGA","561307.5.peg.1662"," 738"
"6758",600,909,309,"ACACATGAAGACTCATTAAT","TTTGCTGGAGAATCATGTGA","561307.5.peg.1662"," 738"
"6759",1100,909,191,"AAATGAATGATAGTGCATCT","TTTGCTGGAGAATCATGTGA","561307.5.peg.1662"," 738"
"6760",1333,909,424,"TGCGATAACTGGATGAGCTT","TTTGCTGGAGAATCATGTGA","561307.5.peg.1662"," 738"
"6761",661,909,248,"TTCCATATTCACTTCCATCA","TTTGCTGGAGAATCATGTGA","561307.5.peg.1662"," 738"
"6762",651,909,258,"ACTTCCATCATGGCATTACA","TTTGCTGGAGAATCATGTGA","561307.5.peg.1662"," 738"
"6763",573,909,336,"TCATTATCCCAAATAACACG","TTTGCTGGAGAATCATGTGA","561307.5.peg.1662"," 738"
"6764",258,909,651,"TCACAGTATTTACAGTCAT","TTTGCTGGAGAATCATGTGA","561307.5.peg.1662"," 738"
"6765",258,1028,770,"TCACAGTATTTACAGTCAT","CTTCATCCCATTCTACTTCA","561307.5.peg.1662"," 738"
"6766",1333,1028,305,"TGCGATAACTGGATGAGCTT","CTTCATCCCATTCTACTTCA","561307.5.peg.1662"," 738"
"6767",1455,1028,427,"GCTAAATCCGTACCTGGTTT","CTTCATCCCATTCTACTTCA","561307.5.peg.1662"," 738"
"6768",1461,1028,433,"AACCACGCTAAATCCGTACC","CTTCATCCCATTCTACTTCA","561307.5.peg.1662"," 738"
"6769",573,1028,455,"TCATTATCCCAAATAACACG","CTTCATCCCATTCTACTTCA","561307.5.peg.1662"," 738"
"6770",909,1028,119,"TTTGCTGGAGAATCATGTGA","CTTCATCCCATTCTACTTCA","561307.5.peg.1662"," 738"
"6771",759,1028,269,"GCAAATAGTGGACCATAACC","CTTCATCCCATTCTACTTCA","561307.5.peg.1662"," 738"
"6772",651,1028,377,"ACTTCCATCATGGCATTACA","CTTCATCCCATTCTACTTCA","561307.5.peg.1662"," 738"
"6773",661,1028,367,"TTCCATATTCACTTCCATCA","CTTCATCCCATTCTACTTCA","561307.5.peg.1662"," 738"
"6774",714,1028,314,"ATCATTGCTGCTAATGAACC","CTTCATCCCATTCTACTTCA","561307.5.peg.1662"," 738"
"6775",600,1028,428,"ACACATGAAGACTCATTAAT","CTTCATCCCATTCTACTTCA","561307.5.peg.1662"," 738"
"6776",600,1100,500,"ACACATGAAGACTCATTAAT","AAATGAATGATAGTGCATCT","561307.5.peg.1662"," 738"
"6777",759,1100,341,"GCAAATAGTGGACCATAACC","AAATGAATGATAGTGCATCT","561307.5.peg.1662"," 738"
"6778",651,1100,449,"ACTTCCATCATGGCATTACA","AAATGAATGATAGTGCATCT","561307.5.peg.1662"," 738"
"6779",258,1100,842,"TCACAGTATTTACAGTCAT","AAATGAATGATAGTGCATCT","561307.5.peg.1662"," 738"
"6780",909,1100,191,"TTTGCTGGAGAATCATGTGA","AAATGAATGATAGTGCATCT","561307.5.peg.1662"," 738"
"6781",661,1100,439,"TTCCATATTCACTTCCATCA","AAATGAATGATAGTGCATCT","561307.5.peg.1662"," 738"
"6782",714,1100,386,"ATCATTGCTGCTAATGAACC","AAATGAATGATAGTGCATCT","561307.5.peg.1662"," 738"
"6783",573,1100,527,"TCATTATCCCAAATAACACG","AAATGAATGATAGTGCATCT","561307.5.peg.1662"," 738"
"6784",1333,1100,233,"TGCGATAACTGGATGAGCTT","AAATGAATGATAGTGCATCT","561307.5.peg.1662"," 738"
"6785",1461,1100,361,"AACCACGCTAAATCCGTACC","AAATGAATGATAGTGCATCT","561307.5.peg.1662"," 738"
"6786",1455,1100,355,"GCTAAATCCGTACCTGGTTT","AAATGAATGATAGTGCATCT","561307.5.peg.1662"," 738"
"6787",1461,1333,128,"AACCACGCTAAATCCGTACC","TGCGATAACTGGATGAGCTT","561307.5.peg.1662"," 738"
"6788",573,1333,760,"TCATTATCCCAAATAACACG","TGCGATAACTGGATGAGCTT","561307.5.peg.1662"," 738"
"6789",1455,1333,122,"GCTAAATCCGTACCTGGTTT","TGCGATAACTGGATGAGCTT","561307.5.peg.1662"," 738"
"6790",1100,1333,233,"AAATGAATGATAGTGCATCT","TGCGATAACTGGATGAGCTT","561307.5.peg.1662"," 738"
"6791",651,1333,682,"ACTTCCATCATGGCATTACA","TGCGATAACTGGATGAGCTT","561307.5.peg.1662"," 738"
"6792",661,1333,672,"TTCCATATTCACTTCCATCA","TGCGATAACTGGATGAGCTT","561307.5.peg.1662"," 738"
"6793",714,1333,619,"ATCATTGCTGCTAATGAACC","TGCGATAACTGGATGAGCTT","561307.5.peg.1662"," 738"
"6794",258,1333,1075,"TCACAGTATTTACAGTCAT","TGCGATAACTGGATGAGCTT","561307.5.peg.1662"," 738"
"6795",1028,1333,305,"CTTCATCCCATTCTACTTCA","TGCGATAACTGGATGAGCTT","561307.5.peg.1662"," 738"
"6796",759,1333,574,"GCAAATAGTGGACCATAACC","TGCGATAACTGGATGAGCTT","561307.5.peg.1662"," 738"
"6797",600,1333,733,"ACACATGAAGACTCATTAAT","TGCGATAACTGGATGAGCTT","561307.5.peg.1662"," 738"
"6798",909,1333,424,"TTTGCTGGAGAATCATGTGA","TGCGATAACTGGATGAGCTT","561307.5.peg.1662"," 738"
"6799",258,1455,1197,"TCACAGTATTTACAGTCAT","GCTAAATCCGTACCTGGTTT","561307.5.peg.1662"," 738"
"6800",661,1455,794,"TTCCATATTCACTTCCATCA","GCTAAATCCGTACCTGGTTT","561307.5.peg.1662"," 738"
"6801",651,1455,804,"ACTTCCATCATGGCATTACA","GCTAAATCCGTACCTGGTTT","561307.5.peg.1662"," 738"
"6802",1333,1455,122,"TGCGATAACTGGATGAGCTT","GCTAAATCCGTACCTGGTTT","561307.5.peg.1662"," 738"
"6803",909,1455,546,"TTTGCTGGAGAATCATGTGA","GCTAAATCCGTACCTGGTTT","561307.5.peg.1662"," 738"
"6804",759,1455,696,"GCAAATAGTGGACCATAACC","GCTAAATCCGTACCTGGTTT","561307.5.peg.1662"," 738"
"6805",714,1455,741,"ATCATTGCTGCTAATGAACC","GCTAAATCCGTACCTGGTTT","561307.5.peg.1662"," 738"
"6806",600,1455,855,"ACACATGAAGACTCATTAAT","GCTAAATCCGTACCTGGTTT","561307.5.peg.1662"," 738"
"6807",1100,1455,355,"AAATGAATGATAGTGCATCT","GCTAAATCCGTACCTGGTTT","561307.5.peg.1662"," 738"
"6808",1028,1455,427,"CTTCATCCCATTCTACTTCA","GCTAAATCCGTACCTGGTTT","561307.5.peg.1662"," 738"
"6809",573,1455,882,"TCATTATCCCAAATAACACG","GCTAAATCCGTACCTGGTTT","561307.5.peg.1662"," 738"
"6810",759,1461,702,"GCAAATAGTGGACCATAACC","AACCACGCTAAATCCGTACC","561307.5.peg.1662"," 738"
"6811",573,1461,888,"TCATTATCCCAAATAACACG","AACCACGCTAAATCCGTACC","561307.5.peg.1662"," 738"
"6812",909,1461,552,"TTTGCTGGAGAATCATGTGA","AACCACGCTAAATCCGTACC","561307.5.peg.1662"," 738"
"6813",714,1461,747,"ATCATTGCTGCTAATGAACC","AACCACGCTAAATCCGTACC","561307.5.peg.1662"," 738"
"6814",1028,1461,433,"CTTCATCCCATTCTACTTCA","AACCACGCTAAATCCGTACC","561307.5.peg.1662"," 738"
"6815",651,1461,810,"ACTTCCATCATGGCATTACA","AACCACGCTAAATCCGTACC","561307.5.peg.1662"," 738"
"6816",1100,1461,361,"AAATGAATGATAGTGCATCT","AACCACGCTAAATCCGTACC","561307.5.peg.1662"," 738"
"6817",1333,1461,128,"TGCGATAACTGGATGAGCTT","AACCACGCTAAATCCGTACC","561307.5.peg.1662"," 738"
"6818",258,1461,1203,"TCACAGTATTTACAGTCAT","AACCACGCTAAATCCGTACC","561307.5.peg.1662"," 738"
"6819",661,1461,800,"TTCCATATTCACTTCCATCA","AACCACGCTAAATCCGTACC","561307.5.peg.1662"," 738"
"6820",600,1461,861,"ACACATGAAGACTCATTAAT","AACCACGCTAAATCCGTACC","561307.5.peg.1662"," 738"
"6821",192,2,190,"TCTGAATGATTGCGATCTAA","AGGAATAGTAAAGGAGTGGT","561307.5.peg.1663"," 739"
"6822",252,2,250,"CCAAATAAAGCGATTGTGAA","AGGAATAGTAAAGGAGTGGT","561307.5.peg.1663"," 739"
"6823",384,2,382,"ATTTCCGCTCTTGTATCACG","AGGAATAGTAAAGGAGTGGT","561307.5.peg.1663"," 739"
"6824",442,2,440,"ATTTGGTCCACCATATGCAT","AGGAATAGTAAAGGAGTGGT","561307.5.peg.1663"," 739"
"6825",384,6,378,"ATTTCCGCTCTTGTATCACG","TGTAAGGAATAGTAAAGGAG","561307.5.peg.1663"," 739"
"6826",192,6,186,"TCTGAATGATTGCGATCTAA","TGTAAGGAATAGTAAAGGAG","561307.5.peg.1663"," 739"
"6827",442,6,436,"ATTTGGTCCACCATATGCAT","TGTAAGGAATAGTAAAGGAG","561307.5.peg.1663"," 739"
"6828",252,6,246,"CCAAATAAAGCGATTGTGAA","TGTAAGGAATAGTAAAGGAG","561307.5.peg.1663"," 739"
"6829",2,192,190,"AGGAATAGTAAAGGAGTGGT","TCTGAATGATTGCGATCTAA","561307.5.peg.1663"," 739"
"6830",384,192,192,"ATTTCCGCTCTTGTATCACG","TCTGAATGATTGCGATCTAA","561307.5.peg.1663"," 739"
"6831",6,192,186,"TGTAAGGAATAGTAAAGGAG","TCTGAATGATTGCGATCTAA","561307.5.peg.1663"," 739"
"6832",442,192,250,"ATTTGGTCCACCATATGCAT","TCTGAATGATTGCGATCTAA","561307.5.peg.1663"," 739"
"6833",2,252,250,"AGGAATAGTAAAGGAGTGGT","CCAAATAAAGCGATTGTGAA","561307.5.peg.1663"," 739"
"6834",384,252,132,"ATTTCCGCTCTTGTATCACG","CCAAATAAAGCGATTGTGAA","561307.5.peg.1663"," 739"
"6835",6,252,246,"TGTAAGGAATAGTAAAGGAG","CCAAATAAAGCGATTGTGAA","561307.5.peg.1663"," 739"
"6836",442,252,190,"ATTTGGTCCACCATATGCAT","CCAAATAAAGCGATTGTGAA","561307.5.peg.1663"," 739"
"6837",192,384,192,"TCTGAATGATTGCGATCTAA","ATTTCCGCTCTTGTATCACG","561307.5.peg.1663"," 739"
"6838",2,384,382,"AGGAATAGTAAAGGAGTGGT","ATTTCCGCTCTTGTATCACG","561307.5.peg.1663"," 739"
"6839",252,384,132,"CCAAATAAAGCGATTGTGAA","ATTTCCGCTCTTGTATCACG","561307.5.peg.1663"," 739"
"6840",6,384,378,"TGTAAGGAATAGTAAAGGAG","ATTTCCGCTCTTGTATCACG","561307.5.peg.1663"," 739"
"6841",2,442,440,"AGGAATAGTAAAGGAGTGGT","ATTTGGTCCACCATATGCAT","561307.5.peg.1663"," 739"
"6842",6,442,436,"TGTAAGGAATAGTAAAGGAG","ATTTGGTCCACCATATGCAT","561307.5.peg.1663"," 739"
"6843",192,442,250,"TCTGAATGATTGCGATCTAA","ATTTGGTCCACCATATGCAT","561307.5.peg.1663"," 739"
"6844",252,442,190,"CCAAATAAAGCGATTGTGAA","ATTTGGTCCACCATATGCAT","561307.5.peg.1663"," 739"
"6845",237,6,231,"TCCGCTAATAGTTGGTGTTC","GATAATGATATGAGAAGTGG","561307.5.peg.1664"," 740"
"6846",315,6,309,"AAATTGGCAGTTCCATCAAT","GATAATGATATGAGAAGTGG","561307.5.peg.1664"," 740"
"6847",6,237,231,"GATAATGATATGAGAAGTGG","TCCGCTAATAGTTGGTGTTC","561307.5.peg.1664"," 740"
"6848",6,315,309,"GATAATGATATGAGAAGTGG","AAATTGGCAGTTCCATCAAT","561307.5.peg.1664"," 740"
"6849",630,10,620,"AGAAACCAACAATACCATT","TTTAGTATCAATCAGAGATG","561307.5.peg.1670"," 747"
"6850",411,10,401,"ATAACACCAGGAATCCAAGT","TTTAGTATCAATCAGAGATG","561307.5.peg.1670"," 747"
"6851",338,10,328,"TCATACCAACTACAATCCAT","TTTAGTATCAATCAGAGATG","561307.5.peg.1670"," 747"
"6852",170,10,160,"AATATGCAAGGATAACTGAT","TTTAGTATCAATCAGAGATG","561307.5.peg.1670"," 747"
"6853",254,10,244,"TTGCAAATGATCCTGTTGTA","TTTAGTATCAATCAGAGATG","561307.5.peg.1670"," 747"
"6854",401,10,391,"GAATCCAAGTTGGCAATTCC","TTTAGTATCAATCAGAGATG","561307.5.peg.1670"," 747"
"6855",584,10,574,"GATTAGAAATACCTACCGCA","TTTAGTATCAATCAGAGATG","561307.5.peg.1670"," 747"
"6856",683,10,673,"TACCTATCAGTTCCACACCT","TTTAGTATCAATCAGAGATG","561307.5.peg.1670"," 747"
"6857",411,85,326,"ATAACACCAGGAATCCAAGT","TGCAATCATTTGAATTTGAC","561307.5.peg.1670"," 747"
"6858",338,85,253,"TCATACCAACTACAATCCAT","TGCAATCATTTGAATTTGAC","561307.5.peg.1670"," 747"
"6859",630,85,545,"AGAAACCAACAATACCATT","TGCAATCATTTGAATTTGAC","561307.5.peg.1670"," 747"
"6860",254,85,169,"TTGCAAATGATCCTGTTGTA","TGCAATCATTTGAATTTGAC","561307.5.peg.1670"," 747"
"6861",584,85,499,"GATTAGAAATACCTACCGCA","TGCAATCATTTGAATTTGAC","561307.5.peg.1670"," 747"
"6862",401,85,316,"GAATCCAAGTTGGCAATTCC","TGCAATCATTTGAATTTGAC","561307.5.peg.1670"," 747"
"6863",683,85,598,"TACCTATCAGTTCCACACCT","TGCAATCATTTGAATTTGAC","561307.5.peg.1670"," 747"
"6864",630,170,460,"AGAAACCAACAATACCATT","AATATGCAAGGATAACTGAT","561307.5.peg.1670"," 747"
"6865",10,170,160,"TTTAGTATCAATCAGAGATG","AATATGCAAGGATAACTGAT","561307.5.peg.1670"," 747"
"6866",584,170,414,"GATTAGAAATACCTACCGCA","AATATGCAAGGATAACTGAT","561307.5.peg.1670"," 747"
"6867",683,170,513,"TACCTATCAGTTCCACACCT","AATATGCAAGGATAACTGAT","561307.5.peg.1670"," 747"
"6868",401,170,231,"GAATCCAAGTTGGCAATTCC","AATATGCAAGGATAACTGAT","561307.5.peg.1670"," 747"
"6869",411,170,241,"ATAACACCAGGAATCCAAGT","AATATGCAAGGATAACTGAT","561307.5.peg.1670"," 747"
"6870",338,170,168,"TCATACCAACTACAATCCAT","AATATGCAAGGATAACTGAT","561307.5.peg.1670"," 747"
"6871",85,254,169,"TGCAATCATTTGAATTTGAC","TTGCAAATGATCCTGTTGTA","561307.5.peg.1670"," 747"
"6872",401,254,147,"GAATCCAAGTTGGCAATTCC","TTGCAAATGATCCTGTTGTA","561307.5.peg.1670"," 747"
"6873",10,254,244,"TTTAGTATCAATCAGAGATG","TTGCAAATGATCCTGTTGTA","561307.5.peg.1670"," 747"
"6874",584,254,330,"GATTAGAAATACCTACCGCA","TTGCAAATGATCCTGTTGTA","561307.5.peg.1670"," 747"
"6875",411,254,157,"ATAACACCAGGAATCCAAGT","TTGCAAATGATCCTGTTGTA","561307.5.peg.1670"," 747"
"6876",630,254,376,"AGAAACCAACAATACCATT","TTGCAAATGATCCTGTTGTA","561307.5.peg.1670"," 747"
"6877",683,254,429,"TACCTATCAGTTCCACACCT","TTGCAAATGATCCTGTTGTA","561307.5.peg.1670"," 747"
"6878",584,338,246,"GATTAGAAATACCTACCGCA","TCATACCAACTACAATCCAT","561307.5.peg.1670"," 747"
"6879",85,338,253,"TGCAATCATTTGAATTTGAC","TCATACCAACTACAATCCAT","561307.5.peg.1670"," 747"
"6880",683,338,345,"TACCTATCAGTTCCACACCT","TCATACCAACTACAATCCAT","561307.5.peg.1670"," 747"
"6881",630,338,292,"AGAAACCAACAATACCATT","TCATACCAACTACAATCCAT","561307.5.peg.1670"," 747"
"6882",10,338,328,"TTTAGTATCAATCAGAGATG","TCATACCAACTACAATCCAT","561307.5.peg.1670"," 747"
"6883",170,338,168,"AATATGCAAGGATAACTGAT","TCATACCAACTACAATCCAT","561307.5.peg.1670"," 747"
"6884",10,401,391,"TTTAGTATCAATCAGAGATG","GAATCCAAGTTGGCAATTCC","561307.5.peg.1670"," 747"
"6885",254,401,147,"TTGCAAATGATCCTGTTGTA","GAATCCAAGTTGGCAATTCC","561307.5.peg.1670"," 747"
"6886",630,401,229,"AGAAACCAACAATACCATT","GAATCCAAGTTGGCAATTCC","561307.5.peg.1670"," 747"
"6887",170,401,231,"AATATGCAAGGATAACTGAT","GAATCCAAGTTGGCAATTCC","561307.5.peg.1670"," 747"
"6888",683,401,282,"TACCTATCAGTTCCACACCT","GAATCCAAGTTGGCAATTCC","561307.5.peg.1670"," 747"
"6889",85,401,316,"TGCAATCATTTGAATTTGAC","GAATCCAAGTTGGCAATTCC","561307.5.peg.1670"," 747"
"6890",584,401,183,"GATTAGAAATACCTACCGCA","GAATCCAAGTTGGCAATTCC","561307.5.peg.1670"," 747"
"6891",85,411,326,"TGCAATCATTTGAATTTGAC","ATAACACCAGGAATCCAAGT","561307.5.peg.1670"," 747"
"6892",10,411,401,"TTTAGTATCAATCAGAGATG","ATAACACCAGGAATCCAAGT","561307.5.peg.1670"," 747"
"6893",170,411,241,"AATATGCAAGGATAACTGAT","ATAACACCAGGAATCCAAGT","561307.5.peg.1670"," 747"
"6894",683,411,272,"TACCTATCAGTTCCACACCT","ATAACACCAGGAATCCAAGT","561307.5.peg.1670"," 747"
"6895",584,411,173,"GATTAGAAATACCTACCGCA","ATAACACCAGGAATCCAAGT","561307.5.peg.1670"," 747"
"6896",630,411,219,"AGAAACCAACAATACCATT","ATAACACCAGGAATCCAAGT","561307.5.peg.1670"," 747"
"6897",254,411,157,"TTGCAAATGATCCTGTTGTA","ATAACACCAGGAATCCAAGT","561307.5.peg.1670"," 747"
"6898",10,584,574,"TTTAGTATCAATCAGAGATG","GATTAGAAATACCTACCGCA","561307.5.peg.1670"," 747"
"6899",411,584,173,"ATAACACCAGGAATCCAAGT","GATTAGAAATACCTACCGCA","561307.5.peg.1670"," 747"
"6900",254,584,330,"TTGCAAATGATCCTGTTGTA","GATTAGAAATACCTACCGCA","561307.5.peg.1670"," 747"
"6901",338,584,246,"TCATACCAACTACAATCCAT","GATTAGAAATACCTACCGCA","561307.5.peg.1670"," 747"
"6902",401,584,183,"GAATCCAAGTTGGCAATTCC","GATTAGAAATACCTACCGCA","561307.5.peg.1670"," 747"
"6903",170,584,414,"AATATGCAAGGATAACTGAT","GATTAGAAATACCTACCGCA","561307.5.peg.1670"," 747"
"6904",85,584,499,"TGCAATCATTTGAATTTGAC","GATTAGAAATACCTACCGCA","561307.5.peg.1670"," 747"
"6905",411,630,219,"ATAACACCAGGAATCCAAGT","AGAAACCAACAATACCATT","561307.5.peg.1670"," 747"
"6906",338,630,292,"TCATACCAACTACAATCCAT","AGAAACCAACAATACCATT","561307.5.peg.1670"," 747"
"6907",10,630,620,"TTTAGTATCAATCAGAGATG","AGAAACCAACAATACCATT","561307.5.peg.1670"," 747"
"6908",85,630,545,"TGCAATCATTTGAATTTGAC","AGAAACCAACAATACCATT","561307.5.peg.1670"," 747"
"6909",401,630,229,"GAATCCAAGTTGGCAATTCC","AGAAACCAACAATACCATT","561307.5.peg.1670"," 747"
"6910",170,630,460,"AATATGCAAGGATAACTGAT","AGAAACCAACAATACCATT","561307.5.peg.1670"," 747"
"6911",254,630,376,"TTGCAAATGATCCTGTTGTA","AGAAACCAACAATACCATT","561307.5.peg.1670"," 747"
"6912",254,683,429,"TTGCAAATGATCCTGTTGTA","TACCTATCAGTTCCACACCT","561307.5.peg.1670"," 747"
"6913",10,683,673,"TTTAGTATCAATCAGAGATG","TACCTATCAGTTCCACACCT","561307.5.peg.1670"," 747"
"6914",170,683,513,"AATATGCAAGGATAACTGAT","TACCTATCAGTTCCACACCT","561307.5.peg.1670"," 747"
"6915",411,683,272,"ATAACACCAGGAATCCAAGT","TACCTATCAGTTCCACACCT","561307.5.peg.1670"," 747"
"6916",338,683,345,"TCATACCAACTACAATCCAT","TACCTATCAGTTCCACACCT","561307.5.peg.1670"," 747"
"6917",85,683,598,"TGCAATCATTTGAATTTGAC","TACCTATCAGTTCCACACCT","561307.5.peg.1670"," 747"
"6918",401,683,282,"GAATCCAAGTTGGCAATTCC","TACCTATCAGTTCCACACCT","561307.5.peg.1670"," 747"
"6919",321,195,126,"ACATTACTTGATGTCCCACC","ACACCAATAATTACTGCTCT","561307.5.peg.1675"," 752"
"6920",358,195,163,"AGAAAGTGCTACGTTAGCTT","ACACCAATAATTACTGCTCT","561307.5.peg.1675"," 752"
"6921",414,195,219,"ATTAACGCAGGTGTAACGAA","ACACCAATAATTACTGCTCT","561307.5.peg.1675"," 752"
"6922",414,279,135,"ATTAACGCAGGTGTAACGAA","ACGCCAACAGCAATATCAGG","561307.5.peg.1675"," 752"
"6923",195,321,126,"ACACCAATAATTACTGCTCT","ACATTACTTGATGTCCCACC","561307.5.peg.1675"," 752"
"6924",195,358,163,"ACACCAATAATTACTGCTCT","AGAAAGTGCTACGTTAGCTT","561307.5.peg.1675"," 752"
"6925",195,414,219,"ACACCAATAATTACTGCTCT","ATTAACGCAGGTGTAACGAA","561307.5.peg.1675"," 752"
"6926",279,414,135,"ACGCCAACAGCAATATCAGG","ATTAACGCAGGTGTAACGAA","561307.5.peg.1675"," 752"
"6927",216,8,208,"AAGTATGGAAGTTGTTGCTT","AATGCCATGTATTCCTCGGG","561307.5.peg.1676"," 753"
"6928",216,11,205,"AAGTATGGAAGTTGTTGCTT","TTTAATGCCATGTATTCCTC","561307.5.peg.1676"," 753"
"6929",216,25,191,"AAGTATGGAAGTTGTTGCTT","AGGACCTCCCGAGGAATACA","561307.5.peg.1676"," 753"
"6930",216,34,182,"AAGTATGGAAGTTGTTGCTT","TAACATGTGAGGACCTCCCG","561307.5.peg.1676"," 753"
"6931",216,91,125,"AAGTATGGAAGTTGTTGCTT","AGTAGTACGGTCATTTAAAC","561307.5.peg.1676"," 753"
"6932",8,216,208,"AATGCCATGTATTCCTCGGG","AAGTATGGAAGTTGTTGCTT","561307.5.peg.1676"," 753"
"6933",11,216,205,"TTTAATGCCATGTATTCCTC","AAGTATGGAAGTTGTTGCTT","561307.5.peg.1676"," 753"
"6934",25,216,191,"AGGACCTCCCGAGGAATACA","AAGTATGGAAGTTGTTGCTT","561307.5.peg.1676"," 753"
"6935",34,216,182,"TAACATGTGAGGACCTCCCG","AAGTATGGAAGTTGTTGCTT","561307.5.peg.1676"," 753"
"6936",91,216,125,"AGTAGTACGGTCATTTAAAC","AAGTATGGAAGTTGTTGCTT","561307.5.peg.1676"," 753"
"6937",445,9,436,"AGAATATTCGTATCCAATG","GTTAGGAAAGATGATATGGA","561307.5.peg.1677"," 754"
"6938",372,9,363,"AAATTAGCGCCAAACGTATG","GTTAGGAAAGATGATATGGA","561307.5.peg.1677"," 754"
"6939",771,9,762,"AAGCCGTGATTGACTACTAC","GTTAGGAAAGATGATATGGA","561307.5.peg.1677"," 754"
"6940",294,9,285,"GCTGCAAGTGCTGCATGACC","GTTAGGAAAGATGATATGGA","561307.5.peg.1677"," 754"
"6941",627,9,618,"CCAATACCGTGCTGAACAGT","GTTAGGAAAGATGATATGGA","561307.5.peg.1677"," 754"
"6942",150,9,141,"GCTAAACTCCCCATGATTGT","GTTAGGAAAGATGATATGGA","561307.5.peg.1677"," 754"
"6943",531,9,522,"TGGAATACACCAACCATTTC","GTTAGGAAAGATGATATGGA","561307.5.peg.1677"," 754"
"6944",531,90,441,"TGGAATACACCAACCATTTC","AAGAAAGCGAACATTAATAC","561307.5.peg.1677"," 754"
"6945",771,90,681,"AAGCCGTGATTGACTACTAC","AAGAAAGCGAACATTAATAC","561307.5.peg.1677"," 754"
"6946",372,90,282,"AAATTAGCGCCAAACGTATG","AAGAAAGCGAACATTAATAC","561307.5.peg.1677"," 754"
"6947",445,90,355,"AGAATATTCGTATCCAATG","AAGAAAGCGAACATTAATAC","561307.5.peg.1677"," 754"
"6948",294,90,204,"GCTGCAAGTGCTGCATGACC","AAGAAAGCGAACATTAATAC","561307.5.peg.1677"," 754"
"6949",627,90,537,"CCAATACCGTGCTGAACAGT","AAGAAAGCGAACATTAATAC","561307.5.peg.1677"," 754"
"6950",9,150,141,"GTTAGGAAAGATGATATGGA","GCTAAACTCCCCATGATTGT","561307.5.peg.1677"," 754"
"6951",627,150,477,"CCAATACCGTGCTGAACAGT","GCTAAACTCCCCATGATTGT","561307.5.peg.1677"," 754"
"6952",372,150,222,"AAATTAGCGCCAAACGTATG","GCTAAACTCCCCATGATTGT","561307.5.peg.1677"," 754"
"6953",771,150,621,"AAGCCGTGATTGACTACTAC","GCTAAACTCCCCATGATTGT","561307.5.peg.1677"," 754"
"6954",531,150,381,"TGGAATACACCAACCATTTC","GCTAAACTCCCCATGATTGT","561307.5.peg.1677"," 754"
"6955",445,150,295,"AGAATATTCGTATCCAATG","GCTAAACTCCCCATGATTGT","561307.5.peg.1677"," 754"
"6956",294,150,144,"GCTGCAAGTGCTGCATGACC","GCTAAACTCCCCATGATTGT","561307.5.peg.1677"," 754"
"6957",531,294,237,"TGGAATACACCAACCATTTC","GCTGCAAGTGCTGCATGACC","561307.5.peg.1677"," 754"
"6958",90,294,204,"AAGAAAGCGAACATTAATAC","GCTGCAAGTGCTGCATGACC","561307.5.peg.1677"," 754"
"6959",9,294,285,"GTTAGGAAAGATGATATGGA","GCTGCAAGTGCTGCATGACC","561307.5.peg.1677"," 754"
"6960",627,294,333,"CCAATACCGTGCTGAACAGT","GCTGCAAGTGCTGCATGACC","561307.5.peg.1677"," 754"
"6961",771,294,477,"AAGCCGTGATTGACTACTAC","GCTGCAAGTGCTGCATGACC","561307.5.peg.1677"," 754"
"6962",150,294,144,"GCTAAACTCCCCATGATTGT","GCTGCAAGTGCTGCATGACC","561307.5.peg.1677"," 754"
"6963",445,294,151,"AGAATATTCGTATCCAATG","GCTGCAAGTGCTGCATGACC","561307.5.peg.1677"," 754"
"6964",150,372,222,"GCTAAACTCCCCATGATTGT","AAATTAGCGCCAAACGTATG","561307.5.peg.1677"," 754"
"6965",90,372,282,"AAGAAAGCGAACATTAATAC","AAATTAGCGCCAAACGTATG","561307.5.peg.1677"," 754"
"6966",9,372,363,"GTTAGGAAAGATGATATGGA","AAATTAGCGCCAAACGTATG","561307.5.peg.1677"," 754"
"6967",771,372,399,"AAGCCGTGATTGACTACTAC","AAATTAGCGCCAAACGTATG","561307.5.peg.1677"," 754"
"6968",531,372,159,"TGGAATACACCAACCATTTC","AAATTAGCGCCAAACGTATG","561307.5.peg.1677"," 754"
"6969",627,372,255,"CCAATACCGTGCTGAACAGT","AAATTAGCGCCAAACGTATG","561307.5.peg.1677"," 754"
"6970",294,445,151,"GCTGCAAGTGCTGCATGACC","AGAATATTCGTATCCAATG","561307.5.peg.1677"," 754"
"6971",9,445,436,"GTTAGGAAAGATGATATGGA","AGAATATTCGTATCCAATG","561307.5.peg.1677"," 754"
"6972",771,445,326,"AAGCCGTGATTGACTACTAC","AGAATATTCGTATCCAATG","561307.5.peg.1677"," 754"
"6973",90,445,355,"AAGAAAGCGAACATTAATAC","AGAATATTCGTATCCAATG","561307.5.peg.1677"," 754"
"6974",150,445,295,"GCTAAACTCCCCATGATTGT","AGAATATTCGTATCCAATG","561307.5.peg.1677"," 754"
"6975",627,445,182,"CCAATACCGTGCTGAACAGT","AGAATATTCGTATCCAATG","561307.5.peg.1677"," 754"
"6976",771,531,240,"AAGCCGTGATTGACTACTAC","TGGAATACACCAACCATTTC","561307.5.peg.1677"," 754"
"6977",150,531,381,"GCTAAACTCCCCATGATTGT","TGGAATACACCAACCATTTC","561307.5.peg.1677"," 754"
"6978",372,531,159,"AAATTAGCGCCAAACGTATG","TGGAATACACCAACCATTTC","561307.5.peg.1677"," 754"
"6979",294,531,237,"GCTGCAAGTGCTGCATGACC","TGGAATACACCAACCATTTC","561307.5.peg.1677"," 754"
"6980",90,531,441,"AAGAAAGCGAACATTAATAC","TGGAATACACCAACCATTTC","561307.5.peg.1677"," 754"
"6981",9,531,522,"GTTAGGAAAGATGATATGGA","TGGAATACACCAACCATTTC","561307.5.peg.1677"," 754"
"6982",9,627,618,"GTTAGGAAAGATGATATGGA","CCAATACCGTGCTGAACAGT","561307.5.peg.1677"," 754"
"6983",90,627,537,"AAGAAAGCGAACATTAATAC","CCAATACCGTGCTGAACAGT","561307.5.peg.1677"," 754"
"6984",372,627,255,"AAATTAGCGCCAAACGTATG","CCAATACCGTGCTGAACAGT","561307.5.peg.1677"," 754"
"6985",294,627,333,"GCTGCAAGTGCTGCATGACC","CCAATACCGTGCTGAACAGT","561307.5.peg.1677"," 754"
"6986",150,627,477,"GCTAAACTCCCCATGATTGT","CCAATACCGTGCTGAACAGT","561307.5.peg.1677"," 754"
"6987",445,627,182,"AGAATATTCGTATCCAATG","CCAATACCGTGCTGAACAGT","561307.5.peg.1677"," 754"
"6988",771,627,144,"AAGCCGTGATTGACTACTAC","CCAATACCGTGCTGAACAGT","561307.5.peg.1677"," 754"
"6989",445,771,326,"AGAATATTCGTATCCAATG","AAGCCGTGATTGACTACTAC","561307.5.peg.1677"," 754"
"6990",372,771,399,"AAATTAGCGCCAAACGTATG","AAGCCGTGATTGACTACTAC","561307.5.peg.1677"," 754"
"6991",627,771,144,"CCAATACCGTGCTGAACAGT","AAGCCGTGATTGACTACTAC","561307.5.peg.1677"," 754"
"6992",150,771,621,"GCTAAACTCCCCATGATTGT","AAGCCGTGATTGACTACTAC","561307.5.peg.1677"," 754"
"6993",9,771,762,"GTTAGGAAAGATGATATGGA","AAGCCGTGATTGACTACTAC","561307.5.peg.1677"," 754"
"6994",294,771,477,"GCTGCAAGTGCTGCATGACC","AAGCCGTGATTGACTACTAC","561307.5.peg.1677"," 754"
"6995",531,771,240,"TGGAATACACCAACCATTTC","AAGCCGTGATTGACTACTAC","561307.5.peg.1677"," 754"
"6996",90,771,681,"AAGAAAGCGAACATTAATAC","AAGCCGTGATTGACTACTAC","561307.5.peg.1677"," 754"
"6997",117,7,110,"CAAGCTTCGTATACTAACTC","AAAGTAAGAGCGAAAGTGGG","561307.5.peg.1679"," 756"
"6998",7,117,110,"AAAGTAAGAGCGAAAGTGGG","CAAGCTTCGTATACTAACTC","561307.5.peg.1679"," 756"
"6999",613,4,609,"CGTACTTTGTTCAAATTCAT","CGCATCATTATAACATGACA","561307.5.peg.168"," 757"
"7000",657,4,653,"TGCAATAAGCGACCACAGTT","CGCATCATTATAACATGACA","561307.5.peg.168"," 757"
"7001",657,7,650,"TGCAATAAGCGACCACAGTT","ATGCGAGTGGAAATTTGAGG","561307.5.peg.168"," 757"
"7002",613,7,606,"CGTACTTTGTTCAAATTCAT","ATGCGAGTGGAAATTTGAGG","561307.5.peg.168"," 757"
"7003",657,10,647,"TGCAATAAGCGACCACAGTT","ATGATGCGAGTGGAAATTTG","561307.5.peg.168"," 757"
"7004",613,10,603,"CGTACTTTGTTCAAATTCAT","ATGATGCGAGTGGAAATTTG","561307.5.peg.168"," 757"
"7005",657,20,637,"TGCAATAAGCGACCACAGTT","TCATGTTATAATGATGCGAG","561307.5.peg.168"," 757"
"7006",613,20,593,"CGTACTTTGTTCAAATTCAT","TCATGTTATAATGATGCGAG","561307.5.peg.168"," 757"
"7007",613,71,542,"CGTACTTTGTTCAAATTCAT","TACGCGCCAATTTCGCTAGA","561307.5.peg.168"," 757"
"7008",657,71,586,"TGCAATAAGCGACCACAGTT","TACGCGCCAATTTCGCTAGA","561307.5.peg.168"," 757"
"7009",4,613,609,"CGCATCATTATAACATGACA","CGTACTTTGTTCAAATTCAT","561307.5.peg.168"," 757"
"7010",10,613,603,"ATGATGCGAGTGGAAATTTG","CGTACTTTGTTCAAATTCAT","561307.5.peg.168"," 757"
"7011",7,613,606,"ATGCGAGTGGAAATTTGAGG","CGTACTTTGTTCAAATTCAT","561307.5.peg.168"," 757"
"7012",71,613,542,"TACGCGCCAATTTCGCTAGA","CGTACTTTGTTCAAATTCAT","561307.5.peg.168"," 757"
"7013",20,613,593,"TCATGTTATAATGATGCGAG","CGTACTTTGTTCAAATTCAT","561307.5.peg.168"," 757"
"7014",7,657,650,"ATGCGAGTGGAAATTTGAGG","TGCAATAAGCGACCACAGTT","561307.5.peg.168"," 757"
"7015",4,657,653,"CGCATCATTATAACATGACA","TGCAATAAGCGACCACAGTT","561307.5.peg.168"," 757"
"7016",20,657,637,"TCATGTTATAATGATGCGAG","TGCAATAAGCGACCACAGTT","561307.5.peg.168"," 757"
"7017",10,657,647,"ATGATGCGAGTGGAAATTTG","TGCAATAAGCGACCACAGTT","561307.5.peg.168"," 757"
"7018",71,657,586,"TACGCGCCAATTTCGCTAGA","TGCAATAAGCGACCACAGTT","561307.5.peg.168"," 757"
"7019",465,30,435,"TGTGCAAATCCGTAACCAAC","TCATCGTTTGTGAGAAAG","561307.5.peg.1680"," 758"
"7020",501,30,471,"GTAGCCATTGCTAGCGCAGT","TCATCGTTTGTGAGAAAG","561307.5.peg.1680"," 758"
"7021",465,89,376,"TGTGCAAATCCGTAACCAAC","ACGCCACAAATAATAACAAG","561307.5.peg.1680"," 758"
"7022",501,89,412,"GTAGCCATTGCTAGCGCAGT","ACGCCACAAATAATAACAAG","561307.5.peg.1680"," 758"
"7023",30,465,435,"TCATCGTTTGTGAGAAAG","TGTGCAAATCCGTAACCAAC","561307.5.peg.1680"," 758"
"7024",89,465,376,"ACGCCACAAATAATAACAAG","TGTGCAAATCCGTAACCAAC","561307.5.peg.1680"," 758"
"7025",30,501,471,"TCATCGTTTGTGAGAAAG","GTAGCCATTGCTAGCGCAGT","561307.5.peg.1680"," 758"
"7026",89,501,412,"ACGCCACAAATAATAACAAG","GTAGCCATTGCTAGCGCAGT","561307.5.peg.1680"," 758"
"7027",259,9,250,"GTAAAGTAACCCTGAGACAA","AACTCGATATTAAACAAAG","561307.5.peg.1682"," 760"
"7028",9,259,250,"AACTCGATATTAAACAAAG","GTAAAGTAACCCTGAGACAA","561307.5.peg.1682"," 760"
"7029",170,22,148,"CTTGTAAGCGTTGATGACCT","ACATCTCCTTATTCGCTTAA","561307.5.peg.1683"," 761"
"7030",141,22,119,"GTTTCGCCACAATCGGGTGC","ACATCTCCTTATTCGCTTAA","561307.5.peg.1683"," 761"
"7031",291,22,269,"TGTGCATCTTGTTCTTCACT","ACATCTCCTTATTCGCTTAA","561307.5.peg.1683"," 761"
"7032",147,22,125,"TAAGACGTTTCGCCACAATC","ACATCTCCTTATTCGCTTAA","561307.5.peg.1683"," 761"
"7033",398,22,376,"GTTGATATGCTTGTTCAACA","ACATCTCCTTATTCGCTTAA","561307.5.peg.1683"," 761"
"7034",291,117,174,"TGTGCATCTTGTTCTTCACT","GTCATTTCAGATTGTAAACC","561307.5.peg.1683"," 761"
"7035",398,117,281,"GTTGATATGCTTGTTCAACA","GTCATTTCAGATTGTAAACC","561307.5.peg.1683"," 761"
"7036",291,141,150,"TGTGCATCTTGTTCTTCACT","GTTTCGCCACAATCGGGTGC","561307.5.peg.1683"," 761"
"7037",22,141,119,"ACATCTCCTTATTCGCTTAA","GTTTCGCCACAATCGGGTGC","561307.5.peg.1683"," 761"
"7038",398,141,257,"GTTGATATGCTTGTTCAACA","GTTTCGCCACAATCGGGTGC","561307.5.peg.1683"," 761"
"7039",22,147,125,"ACATCTCCTTATTCGCTTAA","TAAGACGTTTCGCCACAATC","561307.5.peg.1683"," 761"
"7040",398,147,251,"GTTGATATGCTTGTTCAACA","TAAGACGTTTCGCCACAATC","561307.5.peg.1683"," 761"
"7041",291,147,144,"TGTGCATCTTGTTCTTCACT","TAAGACGTTTCGCCACAATC","561307.5.peg.1683"," 761"
"7042",22,170,148,"ACATCTCCTTATTCGCTTAA","CTTGTAAGCGTTGATGACCT","561307.5.peg.1683"," 761"
"7043",398,170,228,"GTTGATATGCTTGTTCAACA","CTTGTAAGCGTTGATGACCT","561307.5.peg.1683"," 761"
"7044",291,170,121,"TGTGCATCTTGTTCTTCACT","CTTGTAAGCGTTGATGACCT","561307.5.peg.1683"," 761"
"7045",117,291,174,"GTCATTTCAGATTGTAAACC","TGTGCATCTTGTTCTTCACT","561307.5.peg.1683"," 761"
"7046",141,291,150,"GTTTCGCCACAATCGGGTGC","TGTGCATCTTGTTCTTCACT","561307.5.peg.1683"," 761"
"7047",22,291,269,"ACATCTCCTTATTCGCTTAA","TGTGCATCTTGTTCTTCACT","561307.5.peg.1683"," 761"
"7048",398,291,107,"GTTGATATGCTTGTTCAACA","TGTGCATCTTGTTCTTCACT","561307.5.peg.1683"," 761"
"7049",147,291,144,"TAAGACGTTTCGCCACAATC","TGTGCATCTTGTTCTTCACT","561307.5.peg.1683"," 761"
"7050",170,291,121,"CTTGTAAGCGTTGATGACCT","TGTGCATCTTGTTCTTCACT","561307.5.peg.1683"," 761"
"7051",141,398,257,"GTTTCGCCACAATCGGGTGC","GTTGATATGCTTGTTCAACA","561307.5.peg.1683"," 761"
"7052",291,398,107,"TGTGCATCTTGTTCTTCACT","GTTGATATGCTTGTTCAACA","561307.5.peg.1683"," 761"
"7053",22,398,376,"ACATCTCCTTATTCGCTTAA","GTTGATATGCTTGTTCAACA","561307.5.peg.1683"," 761"
"7054",170,398,228,"CTTGTAAGCGTTGATGACCT","GTTGATATGCTTGTTCAACA","561307.5.peg.1683"," 761"
"7055",147,398,251,"TAAGACGTTTCGCCACAATC","GTTGATATGCTTGTTCAACA","561307.5.peg.1683"," 761"
"7056",117,398,281,"GTCATTTCAGATTGTAAACC","GTTGATATGCTTGTTCAACA","561307.5.peg.1683"," 761"
"7057",186,9,177,"GCAACAAGCCCAGTCGCAAG","ATATCATTGACTTAAGGAAG","561307.5.peg.1684"," 762"
"7058",512,9,503,"ATGTACCTACCGAACGCGAT","ATATCATTGACTTAAGGAAG","561307.5.peg.1684"," 762"
"7059",264,9,255,"TGTTCAACAAGCTCTTGAAT","ATATCATTGACTTAAGGAAG","561307.5.peg.1684"," 762"
"7060",264,11,253,"TGTTCAACAAGCTCTTGAAT","CATATCATTGACTTAAGGA","561307.5.peg.1684"," 762"
"7061",186,11,175,"GCAACAAGCCCAGTCGCAAG","CATATCATTGACTTAAGGA","561307.5.peg.1684"," 762"
"7062",512,11,501,"ATGTACCTACCGAACGCGAT","CATATCATTGACTTAAGGA","561307.5.peg.1684"," 762"
"7063",264,102,162,"TGTTCAACAAGCTCTTGAAT","ATTCTTTATCGGATAGTTC","561307.5.peg.1684"," 762"
"7064",512,102,410,"ATGTACCTACCGAACGCGAT","ATTCTTTATCGGATAGTTC","561307.5.peg.1684"," 762"
"7065",9,186,177,"ATATCATTGACTTAAGGAAG","GCAACAAGCCCAGTCGCAAG","561307.5.peg.1684"," 762"
"7066",512,186,326,"ATGTACCTACCGAACGCGAT","GCAACAAGCCCAGTCGCAAG","561307.5.peg.1684"," 762"
"7067",11,186,175,"CATATCATTGACTTAAGGA","GCAACAAGCCCAGTCGCAAG","561307.5.peg.1684"," 762"
"7068",9,264,255,"ATATCATTGACTTAAGGAAG","TGTTCAACAAGCTCTTGAAT","561307.5.peg.1684"," 762"
"7069",11,264,253,"CATATCATTGACTTAAGGA","TGTTCAACAAGCTCTTGAAT","561307.5.peg.1684"," 762"
"7070",102,264,162,"ATTCTTTATCGGATAGTTC","TGTTCAACAAGCTCTTGAAT","561307.5.peg.1684"," 762"
"7071",512,264,248,"ATGTACCTACCGAACGCGAT","TGTTCAACAAGCTCTTGAAT","561307.5.peg.1684"," 762"
"7072",11,512,501,"CATATCATTGACTTAAGGA","ATGTACCTACCGAACGCGAT","561307.5.peg.1684"," 762"
"7073",186,512,326,"GCAACAAGCCCAGTCGCAAG","ATGTACCTACCGAACGCGAT","561307.5.peg.1684"," 762"
"7074",9,512,503,"ATATCATTGACTTAAGGAAG","ATGTACCTACCGAACGCGAT","561307.5.peg.1684"," 762"
"7075",102,512,410,"ATTCTTTATCGGATAGTTC","ATGTACCTACCGAACGCGAT","561307.5.peg.1684"," 762"
"7076",264,512,248,"TGTTCAACAAGCTCTTGAAT","ATGTACCTACCGAACGCGAT","561307.5.peg.1684"," 762"
"7077",588,10,578,"GCCTCTTTAGGTACAGCATG","TTCCAATGATTGATAAAGC","561307.5.peg.1685"," 763"
"7078",581,10,571,"TAGGTACAGCATGAGGCCCT","TTCCAATGATTGATAAAGC","561307.5.peg.1685"," 763"
"7079",111,10,101,"TCTAATTCCTTACCCTTCAA","TTCCAATGATTGATAAAGC","561307.5.peg.1685"," 763"
"7080",382,10,372,"TGTTTCTCTAGTAGCATTAA","TTCCAATGATTGATAAAGC","561307.5.peg.1685"," 763"
"7081",280,10,270,"AGATCCACCAAATGTTAAAT","TTCCAATGATTGATAAAGC","561307.5.peg.1685"," 763"
"7082",600,10,590,"TCATTTGAACTTGCCTCTTT","TTCCAATGATTGATAAAGC","561307.5.peg.1685"," 763"
"7083",588,93,495,"GCCTCTTTAGGTACAGCATG","AAAGGTTTATCTGTTGATCT","561307.5.peg.1685"," 763"
"7084",600,93,507,"TCATTTGAACTTGCCTCTTT","AAAGGTTTATCTGTTGATCT","561307.5.peg.1685"," 763"
"7085",581,93,488,"TAGGTACAGCATGAGGCCCT","AAAGGTTTATCTGTTGATCT","561307.5.peg.1685"," 763"
"7086",382,93,289,"TGTTTCTCTAGTAGCATTAA","AAAGGTTTATCTGTTGATCT","561307.5.peg.1685"," 763"
"7087",280,93,187,"AGATCCACCAAATGTTAAAT","AAAGGTTTATCTGTTGATCT","561307.5.peg.1685"," 763"
"7088",10,111,101,"TTCCAATGATTGATAAAGC","TCTAATTCCTTACCCTTCAA","561307.5.peg.1685"," 763"
"7089",588,111,477,"GCCTCTTTAGGTACAGCATG","TCTAATTCCTTACCCTTCAA","561307.5.peg.1685"," 763"
"7090",280,111,169,"AGATCCACCAAATGTTAAAT","TCTAATTCCTTACCCTTCAA","561307.5.peg.1685"," 763"
"7091",581,111,470,"TAGGTACAGCATGAGGCCCT","TCTAATTCCTTACCCTTCAA","561307.5.peg.1685"," 763"
"7092",600,111,489,"TCATTTGAACTTGCCTCTTT","TCTAATTCCTTACCCTTCAA","561307.5.peg.1685"," 763"
"7093",382,111,271,"TGTTTCTCTAGTAGCATTAA","TCTAATTCCTTACCCTTCAA","561307.5.peg.1685"," 763"
"7094",93,280,187,"AAAGGTTTATCTGTTGATCT","AGATCCACCAAATGTTAAAT","561307.5.peg.1685"," 763"
"7095",588,280,308,"GCCTCTTTAGGTACAGCATG","AGATCCACCAAATGTTAAAT","561307.5.peg.1685"," 763"
"7096",111,280,169,"TCTAATTCCTTACCCTTCAA","AGATCCACCAAATGTTAAAT","561307.5.peg.1685"," 763"
"7097",10,280,270,"TTCCAATGATTGATAAAGC","AGATCCACCAAATGTTAAAT","561307.5.peg.1685"," 763"
"7098",581,280,301,"TAGGTACAGCATGAGGCCCT","AGATCCACCAAATGTTAAAT","561307.5.peg.1685"," 763"
"7099",382,280,102,"TGTTTCTCTAGTAGCATTAA","AGATCCACCAAATGTTAAAT","561307.5.peg.1685"," 763"
"7100",600,280,320,"TCATTTGAACTTGCCTCTTT","AGATCCACCAAATGTTAAAT","561307.5.peg.1685"," 763"
"7101",581,382,199,"TAGGTACAGCATGAGGCCCT","TGTTTCTCTAGTAGCATTAA","561307.5.peg.1685"," 763"
"7102",93,382,289,"AAAGGTTTATCTGTTGATCT","TGTTTCTCTAGTAGCATTAA","561307.5.peg.1685"," 763"
"7103",600,382,218,"TCATTTGAACTTGCCTCTTT","TGTTTCTCTAGTAGCATTAA","561307.5.peg.1685"," 763"
"7104",111,382,271,"TCTAATTCCTTACCCTTCAA","TGTTTCTCTAGTAGCATTAA","561307.5.peg.1685"," 763"
"7105",10,382,372,"TTCCAATGATTGATAAAGC","TGTTTCTCTAGTAGCATTAA","561307.5.peg.1685"," 763"
"7106",588,382,206,"GCCTCTTTAGGTACAGCATG","TGTTTCTCTAGTAGCATTAA","561307.5.peg.1685"," 763"
"7107",280,382,102,"AGATCCACCAAATGTTAAAT","TGTTTCTCTAGTAGCATTAA","561307.5.peg.1685"," 763"
"7108",10,581,571,"TTCCAATGATTGATAAAGC","TAGGTACAGCATGAGGCCCT","561307.5.peg.1685"," 763"
"7109",93,581,488,"AAAGGTTTATCTGTTGATCT","TAGGTACAGCATGAGGCCCT","561307.5.peg.1685"," 763"
"7110",382,581,199,"TGTTTCTCTAGTAGCATTAA","TAGGTACAGCATGAGGCCCT","561307.5.peg.1685"," 763"
"7111",280,581,301,"AGATCCACCAAATGTTAAAT","TAGGTACAGCATGAGGCCCT","561307.5.peg.1685"," 763"
"7112",111,581,470,"TCTAATTCCTTACCCTTCAA","TAGGTACAGCATGAGGCCCT","561307.5.peg.1685"," 763"
"7113",280,588,308,"AGATCCACCAAATGTTAAAT","GCCTCTTTAGGTACAGCATG","561307.5.peg.1685"," 763"
"7114",10,588,578,"TTCCAATGATTGATAAAGC","GCCTCTTTAGGTACAGCATG","561307.5.peg.1685"," 763"
"7115",111,588,477,"TCTAATTCCTTACCCTTCAA","GCCTCTTTAGGTACAGCATG","561307.5.peg.1685"," 763"
"7116",382,588,206,"TGTTTCTCTAGTAGCATTAA","GCCTCTTTAGGTACAGCATG","561307.5.peg.1685"," 763"
"7117",93,588,495,"AAAGGTTTATCTGTTGATCT","GCCTCTTTAGGTACAGCATG","561307.5.peg.1685"," 763"
"7118",382,600,218,"TGTTTCTCTAGTAGCATTAA","TCATTTGAACTTGCCTCTTT","561307.5.peg.1685"," 763"
"7119",280,600,320,"AGATCCACCAAATGTTAAAT","TCATTTGAACTTGCCTCTTT","561307.5.peg.1685"," 763"
"7120",111,600,489,"TCTAATTCCTTACCCTTCAA","TCATTTGAACTTGCCTCTTT","561307.5.peg.1685"," 763"
"7121",93,600,507,"AAAGGTTTATCTGTTGATCT","TCATTTGAACTTGCCTCTTT","561307.5.peg.1685"," 763"
"7122",10,600,590,"TTCCAATGATTGATAAAGC","TCATTTGAACTTGCCTCTTT","561307.5.peg.1685"," 763"
"7123",573,354,219,"GATTCATAGTAATTGCTAA","TGATCCCAGTTTGCCCATTC","561307.5.peg.1686"," 764"
"7124",487,354,133,"AAAGTGTTGATTACCTAGCT","TGATCCCAGTTTGCCCATTC","561307.5.peg.1686"," 764"
"7125",834,354,480,"TGTGGCACATATCCATTTAG","TGATCCCAGTTTGCCCATTC","561307.5.peg.1686"," 764"
"7126",852,354,498,"TCTTCTACAGAGTATCCTTG","TGATCCCAGTTTGCCCATTC","561307.5.peg.1686"," 764"
"7127",834,427,407,"TGTGGCACATATCCATTTAG","ACCAATATATATCCAACTAC","561307.5.peg.1686"," 764"
"7128",852,427,425,"TCTTCTACAGAGTATCCTTG","ACCAATATATATCCAACTAC","561307.5.peg.1686"," 764"
"7129",573,427,146,"GATTCATAGTAATTGCTAA","ACCAATATATATCCAACTAC","561307.5.peg.1686"," 764"
"7130",354,487,133,"TGATCCCAGTTTGCCCATTC","AAAGTGTTGATTACCTAGCT","561307.5.peg.1686"," 764"
"7131",834,487,347,"TGTGGCACATATCCATTTAG","AAAGTGTTGATTACCTAGCT","561307.5.peg.1686"," 764"
"7132",852,487,365,"TCTTCTACAGAGTATCCTTG","AAAGTGTTGATTACCTAGCT","561307.5.peg.1686"," 764"
"7133",354,573,219,"TGATCCCAGTTTGCCCATTC","GATTCATAGTAATTGCTAA","561307.5.peg.1686"," 764"
"7134",834,573,261,"TGTGGCACATATCCATTTAG","GATTCATAGTAATTGCTAA","561307.5.peg.1686"," 764"
"7135",852,573,279,"TCTTCTACAGAGTATCCTTG","GATTCATAGTAATTGCTAA","561307.5.peg.1686"," 764"
"7136",427,573,146,"ACCAATATATATCCAACTAC","GATTCATAGTAATTGCTAA","561307.5.peg.1686"," 764"
"7137",354,834,480,"TGATCCCAGTTTGCCCATTC","TGTGGCACATATCCATTTAG","561307.5.peg.1686"," 764"
"7138",573,834,261,"GATTCATAGTAATTGCTAA","TGTGGCACATATCCATTTAG","561307.5.peg.1686"," 764"
"7139",427,834,407,"ACCAATATATATCCAACTAC","TGTGGCACATATCCATTTAG","561307.5.peg.1686"," 764"
"7140",487,834,347,"AAAGTGTTGATTACCTAGCT","TGTGGCACATATCCATTTAG","561307.5.peg.1686"," 764"
"7141",427,852,425,"ACCAATATATATCCAACTAC","TCTTCTACAGAGTATCCTTG","561307.5.peg.1686"," 764"
"7142",354,852,498,"TGATCCCAGTTTGCCCATTC","TCTTCTACAGAGTATCCTTG","561307.5.peg.1686"," 764"
"7143",487,852,365,"AAAGTGTTGATTACCTAGCT","TCTTCTACAGAGTATCCTTG","561307.5.peg.1686"," 764"
"7144",573,852,279,"GATTCATAGTAATTGCTAA","TCTTCTACAGAGTATCCTTG","561307.5.peg.1686"," 764"
"7145",285,2,283,"TCTTCAATCGCTTCTTTAAG","CGGTTTAATTGTTCAAGCAT","561307.5.peg.169"," 768"
"7146",315,2,313,"CCTCCACAAATCGTTAATCC","CGGTTTAATTGTTCAAGCAT","561307.5.peg.169"," 768"
"7147",369,2,367,"CCTTCTAATTCTGTACCATC","CGGTTTAATTGTTCAAGCAT","561307.5.peg.169"," 768"
"7148",315,12,303,"CCTCCACAAATCGTTAATCC","TTAAACCGTTCGTTTGAAGG","561307.5.peg.169"," 768"
"7149",369,12,357,"CCTTCTAATTCTGTACCATC","TTAAACCGTTCGTTTGAAGG","561307.5.peg.169"," 768"
"7150",285,12,273,"TCTTCAATCGCTTCTTTAAG","TTAAACCGTTCGTTTGAAGG","561307.5.peg.169"," 768"
"7151",369,15,354,"CCTTCTAATTCTGTACCATC","CAATTAAACCGTTCGTTTGA","561307.5.peg.169"," 768"
"7152",315,15,300,"CCTCCACAAATCGTTAATCC","CAATTAAACCGTTCGTTTGA","561307.5.peg.169"," 768"
"7153",285,15,270,"TCTTCAATCGCTTCTTTAAG","CAATTAAACCGTTCGTTTGA","561307.5.peg.169"," 768"
"7154",369,22,347,"CCTTCTAATTCTGTACCATC","ATTGACCTCCTTCAAACGAA","561307.5.peg.169"," 768"
"7155",285,22,263,"TCTTCAATCGCTTCTTTAAG","ATTGACCTCCTTCAAACGAA","561307.5.peg.169"," 768"
"7156",315,22,293,"CCTCCACAAATCGTTAATCC","ATTGACCTCCTTCAAACGAA","561307.5.peg.169"," 768"
"7157",2,285,283,"CGGTTTAATTGTTCAAGCAT","TCTTCAATCGCTTCTTTAAG","561307.5.peg.169"," 768"
"7158",22,285,263,"ATTGACCTCCTTCAAACGAA","TCTTCAATCGCTTCTTTAAG","561307.5.peg.169"," 768"
"7159",15,285,270,"CAATTAAACCGTTCGTTTGA","TCTTCAATCGCTTCTTTAAG","561307.5.peg.169"," 768"
"7160",12,285,273,"TTAAACCGTTCGTTTGAAGG","TCTTCAATCGCTTCTTTAAG","561307.5.peg.169"," 768"
"7161",12,315,303,"TTAAACCGTTCGTTTGAAGG","CCTCCACAAATCGTTAATCC","561307.5.peg.169"," 768"
"7162",2,315,313,"CGGTTTAATTGTTCAAGCAT","CCTCCACAAATCGTTAATCC","561307.5.peg.169"," 768"
"7163",22,315,293,"ATTGACCTCCTTCAAACGAA","CCTCCACAAATCGTTAATCC","561307.5.peg.169"," 768"
"7164",15,315,300,"CAATTAAACCGTTCGTTTGA","CCTCCACAAATCGTTAATCC","561307.5.peg.169"," 768"
"7165",15,369,354,"CAATTAAACCGTTCGTTTGA","CCTTCTAATTCTGTACCATC","561307.5.peg.169"," 768"
"7166",12,369,357,"TTAAACCGTTCGTTTGAAGG","CCTTCTAATTCTGTACCATC","561307.5.peg.169"," 768"
"7167",2,369,367,"CGGTTTAATTGTTCAAGCAT","CCTTCTAATTCTGTACCATC","561307.5.peg.169"," 768"
"7168",22,369,347,"ATTGACCTCCTTCAAACGAA","CCTTCTAATTCTGTACCATC","561307.5.peg.169"," 768"
"7169",141,30,111,"AACTCTGTGACATATAAAGC","ACAAATATTACTCATGGTAG","561307.5.peg.1690"," 769"
"7170",264,30,234,"GGTCCTAACAAAGATGTTGT","ACAAATATTACTCATGGTAG","561307.5.peg.1690"," 769"
"7171",285,30,255,"TCCAATTTGTTGGAACATA","ACAAATATTACTCATGGTAG","561307.5.peg.1690"," 769"
"7172",264,141,123,"GGTCCTAACAAAGATGTTGT","AACTCTGTGACATATAAAGC","561307.5.peg.1690"," 769"
"7173",30,141,111,"ACAAATATTACTCATGGTAG","AACTCTGTGACATATAAAGC","561307.5.peg.1690"," 769"
"7174",285,141,144,"TCCAATTTGTTGGAACATA","AACTCTGTGACATATAAAGC","561307.5.peg.1690"," 769"
"7175",30,264,234,"ACAAATATTACTCATGGTAG","GGTCCTAACAAAGATGTTGT","561307.5.peg.1690"," 769"
"7176",141,264,123,"AACTCTGTGACATATAAAGC","GGTCCTAACAAAGATGTTGT","561307.5.peg.1690"," 769"
"7177",141,285,144,"AACTCTGTGACATATAAAGC","TCCAATTTGTTGGAACATA","561307.5.peg.1690"," 769"
"7178",30,285,255,"ACAAATATTACTCATGGTAG","TCCAATTTGTTGGAACATA","561307.5.peg.1690"," 769"
"7179",323,187,136,"ATGATTGCGCCCAACCTGAT","GCCTAGGAACCATACAAACA","561307.5.peg.1693"," 772"
"7180",603,187,416,"TTTCCTGAATTACCTGTAGT","GCCTAGGAACCATACAAACA","561307.5.peg.1693"," 772"
"7181",323,203,120,"ATGATTGCGCCCAACCTGAT","AAATGGTAATGATGCCGCCT","561307.5.peg.1693"," 772"
"7182",603,203,400,"TTTCCTGAATTACCTGTAGT","AAATGGTAATGATGCCGCCT","561307.5.peg.1693"," 772"
"7183",603,220,383,"TTTCCTGAATTACCTGTAGT","TGCTGTTAACCCCGCACAAA","561307.5.peg.1693"," 772"
"7184",323,220,103,"ATGATTGCGCCCAACCTGAT","TGCTGTTAACCCCGCACAAA","561307.5.peg.1693"," 772"
"7185",187,323,136,"GCCTAGGAACCATACAAACA","ATGATTGCGCCCAACCTGAT","561307.5.peg.1693"," 772"
"7186",603,323,280,"TTTCCTGAATTACCTGTAGT","ATGATTGCGCCCAACCTGAT","561307.5.peg.1693"," 772"
"7187",203,323,120,"AAATGGTAATGATGCCGCCT","ATGATTGCGCCCAACCTGAT","561307.5.peg.1693"," 772"
"7188",220,323,103,"TGCTGTTAACCCCGCACAAA","ATGATTGCGCCCAACCTGAT","561307.5.peg.1693"," 772"
"7189",203,603,400,"AAATGGTAATGATGCCGCCT","TTTCCTGAATTACCTGTAGT","561307.5.peg.1693"," 772"
"7190",187,603,416,"GCCTAGGAACCATACAAACA","TTTCCTGAATTACCTGTAGT","561307.5.peg.1693"," 772"
"7191",323,603,280,"ATGATTGCGCCCAACCTGAT","TTTCCTGAATTACCTGTAGT","561307.5.peg.1693"," 772"
"7192",220,603,383,"TGCTGTTAACCCCGCACAAA","TTTCCTGAATTACCTGTAGT","561307.5.peg.1693"," 772"
"7193",323,58,265,"TTAAAGCAACACCTTGTGCA","GTTTGTAATGTAACTGTGT","561307.5.peg.1694"," 773"
"7194",323,132,191,"TTAAAGCAACACCTTGTGCA","AGAGGTGTTCGACGAATAAA","561307.5.peg.1694"," 773"
"7195",58,323,265,"GTTTGTAATGTAACTGTGT","TTAAAGCAACACCTTGTGCA","561307.5.peg.1694"," 773"
"7196",132,323,191,"AGAGGTGTTCGACGAATAAA","TTAAAGCAACACCTTGTGCA","561307.5.peg.1694"," 773"
"7197",435,273,162,"TGACCTGCTATAGCACTCAT","ATTGATATTCGCTTTCATG","561307.5.peg.1695"," 774"
"7198",273,435,162,"ATTGATATTCGCTTTCATG","TGACCTGCTATAGCACTCAT","561307.5.peg.1695"," 774"
"7199",462,9,453,"GCAACATTTGAATCAACACC","TCTATGTGAACGAACCAAAG","561307.5.peg.1697"," 776"
"7200",258,9,249,"GTATTACTTGTCGTTGGTAC","TCTATGTGAACGAACCAAAG","561307.5.peg.1697"," 776"
"7201",1233,9,1224,"AATGACATATCTTCTCGCAT","TCTATGTGAACGAACCAAAG","561307.5.peg.1697"," 776"
"7202",249,9,240,"GTCGTTGGTACAGGTGAACT","TCTATGTGAACGAACCAAAG","561307.5.peg.1697"," 776"
"7203",554,9,545,"AGTTAAGTTCAGATTGAACG","TCTATGTGAACGAACCAAAG","561307.5.peg.1697"," 776"
"7204",1065,9,1056,"ACATTTCTCTCATATTATG","TCTATGTGAACGAACCAAAG","561307.5.peg.1697"," 776"
"7205",856,9,847,"AATGTAATCTAGCTGAGCTT","TCTATGTGAACGAACCAAAG","561307.5.peg.1697"," 776"
"7206",462,11,451,"GCAACATTTGAATCAACACC","TTTCTATGTGAACGAACCAA","561307.5.peg.1697"," 776"
"7207",856,11,845,"AATGTAATCTAGCTGAGCTT","TTTCTATGTGAACGAACCAA","561307.5.peg.1697"," 776"
"7208",1065,11,1054,"ACATTTCTCTCATATTATG","TTTCTATGTGAACGAACCAA","561307.5.peg.1697"," 776"
"7209",249,11,238,"GTCGTTGGTACAGGTGAACT","TTTCTATGTGAACGAACCAA","561307.5.peg.1697"," 776"
"7210",258,11,247,"GTATTACTTGTCGTTGGTAC","TTTCTATGTGAACGAACCAA","561307.5.peg.1697"," 776"
"7211",554,11,543,"AGTTAAGTTCAGATTGAACG","TTTCTATGTGAACGAACCAA","561307.5.peg.1697"," 776"
"7212",1233,11,1222,"AATGACATATCTTCTCGCAT","TTTCTATGTGAACGAACCAA","561307.5.peg.1697"," 776"
"7213",1065,34,1031,"ACATTTCTCTCATATTATG","AATCATGTTACTTTCCCCTT","561307.5.peg.1697"," 776"
"7214",462,34,428,"GCAACATTTGAATCAACACC","AATCATGTTACTTTCCCCTT","561307.5.peg.1697"," 776"
"7215",554,34,520,"AGTTAAGTTCAGATTGAACG","AATCATGTTACTTTCCCCTT","561307.5.peg.1697"," 776"
"7216",258,34,224,"GTATTACTTGTCGTTGGTAC","AATCATGTTACTTTCCCCTT","561307.5.peg.1697"," 776"
"7217",856,34,822,"AATGTAATCTAGCTGAGCTT","AATCATGTTACTTTCCCCTT","561307.5.peg.1697"," 776"
"7218",249,34,215,"GTCGTTGGTACAGGTGAACT","AATCATGTTACTTTCCCCTT","561307.5.peg.1697"," 776"
"7219",1233,34,1199,"AATGACATATCTTCTCGCAT","AATCATGTTACTTTCCCCTT","561307.5.peg.1697"," 776"
"7220",9,249,240,"TCTATGTGAACGAACCAAAG","GTCGTTGGTACAGGTGAACT","561307.5.peg.1697"," 776"
"7221",1065,249,816,"ACATTTCTCTCATATTATG","GTCGTTGGTACAGGTGAACT","561307.5.peg.1697"," 776"
"7222",856,249,607,"AATGTAATCTAGCTGAGCTT","GTCGTTGGTACAGGTGAACT","561307.5.peg.1697"," 776"
"7223",462,249,213,"GCAACATTTGAATCAACACC","GTCGTTGGTACAGGTGAACT","561307.5.peg.1697"," 776"
"7224",1233,249,984,"AATGACATATCTTCTCGCAT","GTCGTTGGTACAGGTGAACT","561307.5.peg.1697"," 776"
"7225",34,249,215,"AATCATGTTACTTTCCCCTT","GTCGTTGGTACAGGTGAACT","561307.5.peg.1697"," 776"
"7226",554,249,305,"AGTTAAGTTCAGATTGAACG","GTCGTTGGTACAGGTGAACT","561307.5.peg.1697"," 776"
"7227",11,249,238,"TTTCTATGTGAACGAACCAA","GTCGTTGGTACAGGTGAACT","561307.5.peg.1697"," 776"
"7228",462,258,204,"GCAACATTTGAATCAACACC","GTATTACTTGTCGTTGGTAC","561307.5.peg.1697"," 776"
"7229",856,258,598,"AATGTAATCTAGCTGAGCTT","GTATTACTTGTCGTTGGTAC","561307.5.peg.1697"," 776"
"7230",11,258,247,"TTTCTATGTGAACGAACCAA","GTATTACTTGTCGTTGGTAC","561307.5.peg.1697"," 776"
"7231",1233,258,975,"AATGACATATCTTCTCGCAT","GTATTACTTGTCGTTGGTAC","561307.5.peg.1697"," 776"
"7232",9,258,249,"TCTATGTGAACGAACCAAAG","GTATTACTTGTCGTTGGTAC","561307.5.peg.1697"," 776"
"7233",34,258,224,"AATCATGTTACTTTCCCCTT","GTATTACTTGTCGTTGGTAC","561307.5.peg.1697"," 776"
"7234",1065,258,807,"ACATTTCTCTCATATTATG","GTATTACTTGTCGTTGGTAC","561307.5.peg.1697"," 776"
"7235",554,258,296,"AGTTAAGTTCAGATTGAACG","GTATTACTTGTCGTTGGTAC","561307.5.peg.1697"," 776"
"7236",1065,462,603,"ACATTTCTCTCATATTATG","GCAACATTTGAATCAACACC","561307.5.peg.1697"," 776"
"7237",258,462,204,"GTATTACTTGTCGTTGGTAC","GCAACATTTGAATCAACACC","561307.5.peg.1697"," 776"
"7238",9,462,453,"TCTATGTGAACGAACCAAAG","GCAACATTTGAATCAACACC","561307.5.peg.1697"," 776"
"7239",11,462,451,"TTTCTATGTGAACGAACCAA","GCAACATTTGAATCAACACC","561307.5.peg.1697"," 776"
"7240",34,462,428,"AATCATGTTACTTTCCCCTT","GCAACATTTGAATCAACACC","561307.5.peg.1697"," 776"
"7241",1233,462,771,"AATGACATATCTTCTCGCAT","GCAACATTTGAATCAACACC","561307.5.peg.1697"," 776"
"7242",249,462,213,"GTCGTTGGTACAGGTGAACT","GCAACATTTGAATCAACACC","561307.5.peg.1697"," 776"
"7243",856,462,394,"AATGTAATCTAGCTGAGCTT","GCAACATTTGAATCAACACC","561307.5.peg.1697"," 776"
"7244",258,554,296,"GTATTACTTGTCGTTGGTAC","AGTTAAGTTCAGATTGAACG","561307.5.peg.1697"," 776"
"7245",11,554,543,"TTTCTATGTGAACGAACCAA","AGTTAAGTTCAGATTGAACG","561307.5.peg.1697"," 776"
"7246",9,554,545,"TCTATGTGAACGAACCAAAG","AGTTAAGTTCAGATTGAACG","561307.5.peg.1697"," 776"
"7247",34,554,520,"AATCATGTTACTTTCCCCTT","AGTTAAGTTCAGATTGAACG","561307.5.peg.1697"," 776"
"7248",1233,554,679,"AATGACATATCTTCTCGCAT","AGTTAAGTTCAGATTGAACG","561307.5.peg.1697"," 776"
"7249",249,554,305,"GTCGTTGGTACAGGTGAACT","AGTTAAGTTCAGATTGAACG","561307.5.peg.1697"," 776"
"7250",1065,554,511,"ACATTTCTCTCATATTATG","AGTTAAGTTCAGATTGAACG","561307.5.peg.1697"," 776"
"7251",856,554,302,"AATGTAATCTAGCTGAGCTT","AGTTAAGTTCAGATTGAACG","561307.5.peg.1697"," 776"
"7252",9,856,847,"TCTATGTGAACGAACCAAAG","AATGTAATCTAGCTGAGCTT","561307.5.peg.1697"," 776"
"7253",34,856,822,"AATCATGTTACTTTCCCCTT","AATGTAATCTAGCTGAGCTT","561307.5.peg.1697"," 776"
"7254",11,856,845,"TTTCTATGTGAACGAACCAA","AATGTAATCTAGCTGAGCTT","561307.5.peg.1697"," 776"
"7255",1233,856,377,"AATGACATATCTTCTCGCAT","AATGTAATCTAGCTGAGCTT","561307.5.peg.1697"," 776"
"7256",249,856,607,"GTCGTTGGTACAGGTGAACT","AATGTAATCTAGCTGAGCTT","561307.5.peg.1697"," 776"
"7257",462,856,394,"GCAACATTTGAATCAACACC","AATGTAATCTAGCTGAGCTT","561307.5.peg.1697"," 776"
"7258",1065,856,209,"ACATTTCTCTCATATTATG","AATGTAATCTAGCTGAGCTT","561307.5.peg.1697"," 776"
"7259",258,856,598,"GTATTACTTGTCGTTGGTAC","AATGTAATCTAGCTGAGCTT","561307.5.peg.1697"," 776"
"7260",554,856,302,"AGTTAAGTTCAGATTGAACG","AATGTAATCTAGCTGAGCTT","561307.5.peg.1697"," 776"
"7261",554,1065,511,"AGTTAAGTTCAGATTGAACG","ACATTTCTCTCATATTATG","561307.5.peg.1697"," 776"
"7262",11,1065,1054,"TTTCTATGTGAACGAACCAA","ACATTTCTCTCATATTATG","561307.5.peg.1697"," 776"
"7263",9,1065,1056,"TCTATGTGAACGAACCAAAG","ACATTTCTCTCATATTATG","561307.5.peg.1697"," 776"
"7264",34,1065,1031,"AATCATGTTACTTTCCCCTT","ACATTTCTCTCATATTATG","561307.5.peg.1697"," 776"
"7265",249,1065,816,"GTCGTTGGTACAGGTGAACT","ACATTTCTCTCATATTATG","561307.5.peg.1697"," 776"
"7266",462,1065,603,"GCAACATTTGAATCAACACC","ACATTTCTCTCATATTATG","561307.5.peg.1697"," 776"
"7267",856,1065,209,"AATGTAATCTAGCTGAGCTT","ACATTTCTCTCATATTATG","561307.5.peg.1697"," 776"
"7268",258,1065,807,"GTATTACTTGTCGTTGGTAC","ACATTTCTCTCATATTATG","561307.5.peg.1697"," 776"
"7269",1233,1065,168,"AATGACATATCTTCTCGCAT","ACATTTCTCTCATATTATG","561307.5.peg.1697"," 776"
"7270",856,1233,377,"AATGTAATCTAGCTGAGCTT","AATGACATATCTTCTCGCAT","561307.5.peg.1697"," 776"
"7271",1065,1233,168,"ACATTTCTCTCATATTATG","AATGACATATCTTCTCGCAT","561307.5.peg.1697"," 776"
"7272",34,1233,1199,"AATCATGTTACTTTCCCCTT","AATGACATATCTTCTCGCAT","561307.5.peg.1697"," 776"
"7273",11,1233,1222,"TTTCTATGTGAACGAACCAA","AATGACATATCTTCTCGCAT","561307.5.peg.1697"," 776"
"7274",9,1233,1224,"TCTATGTGAACGAACCAAAG","AATGACATATCTTCTCGCAT","561307.5.peg.1697"," 776"
"7275",258,1233,975,"GTATTACTTGTCGTTGGTAC","AATGACATATCTTCTCGCAT","561307.5.peg.1697"," 776"
"7276",462,1233,771,"GCAACATTTGAATCAACACC","AATGACATATCTTCTCGCAT","561307.5.peg.1697"," 776"
"7277",554,1233,679,"AGTTAAGTTCAGATTGAACG","AATGACATATCTTCTCGCAT","561307.5.peg.1697"," 776"
"7278",249,1233,984,"GTCGTTGGTACAGGTGAACT","AATGACATATCTTCTCGCAT","561307.5.peg.1697"," 776"
"7279",676,5,671,"ACCGTTTGTGTCCATCATAC","CGTATAATAGCCAATTGGGA","561307.5.peg.1698"," 777"
"7280",130,5,125,"CAAGTAACCAATGCCCGAAA","CGTATAATAGCCAATTGGGA","561307.5.peg.1698"," 777"
"7281",484,5,479,"CATGAATATCATCCAACATG","CGTATAATAGCCAATTGGGA","561307.5.peg.1698"," 777"
"7282",111,5,106,"TGGTTAAAGTGATTAACAG","CGTATAATAGCCAATTGGGA","561307.5.peg.1698"," 777"
"7283",130,9,121,"CAAGTAACCAATGCCCGAAA","ACACCGTATAATAGCCAATT","561307.5.peg.1698"," 777"
"7284",484,9,475,"CATGAATATCATCCAACATG","ACACCGTATAATAGCCAATT","561307.5.peg.1698"," 777"
"7285",111,9,102,"TGGTTAAAGTGATTAACAG","ACACCGTATAATAGCCAATT","561307.5.peg.1698"," 777"
"7286",676,9,667,"ACCGTTTGTGTCCATCATAC","ACACCGTATAATAGCCAATT","561307.5.peg.1698"," 777"
"7287",484,23,461,"CATGAATATCATCCAACATG","CCTCCCAATTGGCTATTATA","561307.5.peg.1698"," 777"
"7288",676,23,653,"ACCGTTTGTGTCCATCATAC","CCTCCCAATTGGCTATTATA","561307.5.peg.1698"," 777"
"7289",130,23,107,"CAAGTAACCAATGCCCGAAA","CCTCCCAATTGGCTATTATA","561307.5.peg.1698"," 777"
"7290",676,34,642,"ACCGTTTGTGTCCATCATAC","TTTCATATTTCCCTCCCAAT","561307.5.peg.1698"," 777"
"7291",484,34,450,"CATGAATATCATCCAACATG","TTTCATATTTCCCTCCCAAT","561307.5.peg.1698"," 777"
"7292",676,111,565,"ACCGTTTGTGTCCATCATAC","TGGTTAAAGTGATTAACAG","561307.5.peg.1698"," 777"
"7293",5,111,106,"CGTATAATAGCCAATTGGGA","TGGTTAAAGTGATTAACAG","561307.5.peg.1698"," 777"
"7294",9,111,102,"ACACCGTATAATAGCCAATT","TGGTTAAAGTGATTAACAG","561307.5.peg.1698"," 777"
"7295",484,111,373,"CATGAATATCATCCAACATG","TGGTTAAAGTGATTAACAG","561307.5.peg.1698"," 777"
"7296",9,130,121,"ACACCGTATAATAGCCAATT","CAAGTAACCAATGCCCGAAA","561307.5.peg.1698"," 777"
"7297",5,130,125,"CGTATAATAGCCAATTGGGA","CAAGTAACCAATGCCCGAAA","561307.5.peg.1698"," 777"
"7298",23,130,107,"CCTCCCAATTGGCTATTATA","CAAGTAACCAATGCCCGAAA","561307.5.peg.1698"," 777"
"7299",484,130,354,"CATGAATATCATCCAACATG","CAAGTAACCAATGCCCGAAA","561307.5.peg.1698"," 777"
"7300",676,130,546,"ACCGTTTGTGTCCATCATAC","CAAGTAACCAATGCCCGAAA","561307.5.peg.1698"," 777"
"7301",5,484,479,"CGTATAATAGCCAATTGGGA","CATGAATATCATCCAACATG","561307.5.peg.1698"," 777"
"7302",111,484,373,"TGGTTAAAGTGATTAACAG","CATGAATATCATCCAACATG","561307.5.peg.1698"," 777"
"7303",9,484,475,"ACACCGTATAATAGCCAATT","CATGAATATCATCCAACATG","561307.5.peg.1698"," 777"
"7304",676,484,192,"ACCGTTTGTGTCCATCATAC","CATGAATATCATCCAACATG","561307.5.peg.1698"," 777"
"7305",23,484,461,"CCTCCCAATTGGCTATTATA","CATGAATATCATCCAACATG","561307.5.peg.1698"," 777"
"7306",130,484,354,"CAAGTAACCAATGCCCGAAA","CATGAATATCATCCAACATG","561307.5.peg.1698"," 777"
"7307",34,484,450,"TTTCATATTTCCCTCCCAAT","CATGAATATCATCCAACATG","561307.5.peg.1698"," 777"
"7308",5,676,671,"CGTATAATAGCCAATTGGGA","ACCGTTTGTGTCCATCATAC","561307.5.peg.1698"," 777"
"7309",9,676,667,"ACACCGTATAATAGCCAATT","ACCGTTTGTGTCCATCATAC","561307.5.peg.1698"," 777"
"7310",34,676,642,"TTTCATATTTCCCTCCCAAT","ACCGTTTGTGTCCATCATAC","561307.5.peg.1698"," 777"
"7311",23,676,653,"CCTCCCAATTGGCTATTATA","ACCGTTTGTGTCCATCATAC","561307.5.peg.1698"," 777"
"7312",111,676,565,"TGGTTAAAGTGATTAACAG","ACCGTTTGTGTCCATCATAC","561307.5.peg.1698"," 777"
"7313",130,676,546,"CAAGTAACCAATGCCCGAAA","ACCGTTTGTGTCCATCATAC","561307.5.peg.1698"," 777"
"7314",484,676,192,"CATGAATATCATCCAACATG","ACCGTTTGTGTCCATCATAC","561307.5.peg.1698"," 777"
"7315",471,91,380,"ACTTGCCCAGTTGCCATATC","ATCATTACCGATTGGAGAAA","561307.5.peg.17"," 779"
"7316",633,91,542,"GCAATTGCCATATGAGTAAT","ATCATTACCGATTGGAGAAA","561307.5.peg.17"," 779"
"7317",471,186,285,"ACTTGCCCAGTTGCCATATC","CCTGCTAAGTGAACGCTATA","561307.5.peg.17"," 779"
"7318",633,186,447,"GCAATTGCCATATGAGTAAT","CCTGCTAAGTGAACGCTATA","561307.5.peg.17"," 779"
"7319",91,471,380,"ATCATTACCGATTGGAGAAA","ACTTGCCCAGTTGCCATATC","561307.5.peg.17"," 779"
"7320",633,471,162,"GCAATTGCCATATGAGTAAT","ACTTGCCCAGTTGCCATATC","561307.5.peg.17"," 779"
"7321",186,471,285,"CCTGCTAAGTGAACGCTATA","ACTTGCCCAGTTGCCATATC","561307.5.peg.17"," 779"
"7322",186,633,447,"CCTGCTAAGTGAACGCTATA","GCAATTGCCATATGAGTAAT","561307.5.peg.17"," 779"
"7323",91,633,542,"ATCATTACCGATTGGAGAAA","GCAATTGCCATATGAGTAAT","561307.5.peg.17"," 779"
"7324",471,633,162,"ACTTGCCCAGTTGCCATATC","GCAATTGCCATATGAGTAAT","561307.5.peg.17"," 779"
"7325",274,75,199,"AGATTCCCAAGGGAGCGCTT","ACAACAGCTTCTAATCCCAT","561307.5.peg.1700"," 781"
"7326",284,75,209,"ATCAATTATAGATTCCCAA","ACAACAGCTTCTAATCCCAT","561307.5.peg.1700"," 781"
"7327",451,75,376,"GGCAACTTCAACAGGGTATT","ACAACAGCTTCTAATCCCAT","561307.5.peg.1700"," 781"
"7328",363,75,288,"TTAGTTATCGCCTGACAATC","ACAACAGCTTCTAATCCCAT","561307.5.peg.1700"," 781"
"7329",320,75,245,"TAACGCTTCTACCTTGAACT","ACAACAGCTTCTAATCCCAT","561307.5.peg.1700"," 781"
"7330",593,75,518,"CACCTTTCCAGTTTGCAAGA","ACAACAGCTTCTAATCCCAT","561307.5.peg.1700"," 781"
"7331",75,274,199,"ACAACAGCTTCTAATCCCAT","AGATTCCCAAGGGAGCGCTT","561307.5.peg.1700"," 781"
"7332",451,274,177,"GGCAACTTCAACAGGGTATT","AGATTCCCAAGGGAGCGCTT","561307.5.peg.1700"," 781"
"7333",593,274,319,"CACCTTTCCAGTTTGCAAGA","AGATTCCCAAGGGAGCGCTT","561307.5.peg.1700"," 781"
"7334",75,284,209,"ACAACAGCTTCTAATCCCAT","ATCAATTATAGATTCCCAA","561307.5.peg.1700"," 781"
"7335",451,284,167,"GGCAACTTCAACAGGGTATT","ATCAATTATAGATTCCCAA","561307.5.peg.1700"," 781"
"7336",593,284,309,"CACCTTTCCAGTTTGCAAGA","ATCAATTATAGATTCCCAA","561307.5.peg.1700"," 781"
"7337",75,320,245,"ACAACAGCTTCTAATCCCAT","TAACGCTTCTACCTTGAACT","561307.5.peg.1700"," 781"
"7338",451,320,131,"GGCAACTTCAACAGGGTATT","TAACGCTTCTACCTTGAACT","561307.5.peg.1700"," 781"
"7339",593,320,273,"CACCTTTCCAGTTTGCAAGA","TAACGCTTCTACCTTGAACT","561307.5.peg.1700"," 781"
"7340",593,363,230,"CACCTTTCCAGTTTGCAAGA","TTAGTTATCGCCTGACAATC","561307.5.peg.1700"," 781"
"7341",75,363,288,"ACAACAGCTTCTAATCCCAT","TTAGTTATCGCCTGACAATC","561307.5.peg.1700"," 781"
"7342",320,451,131,"TAACGCTTCTACCTTGAACT","GGCAACTTCAACAGGGTATT","561307.5.peg.1700"," 781"
"7343",593,451,142,"CACCTTTCCAGTTTGCAAGA","GGCAACTTCAACAGGGTATT","561307.5.peg.1700"," 781"
"7344",75,451,376,"ACAACAGCTTCTAATCCCAT","GGCAACTTCAACAGGGTATT","561307.5.peg.1700"," 781"
"7345",274,451,177,"AGATTCCCAAGGGAGCGCTT","GGCAACTTCAACAGGGTATT","561307.5.peg.1700"," 781"
"7346",284,451,167,"ATCAATTATAGATTCCCAA","GGCAACTTCAACAGGGTATT","561307.5.peg.1700"," 781"
"7347",284,593,309,"ATCAATTATAGATTCCCAA","CACCTTTCCAGTTTGCAAGA","561307.5.peg.1700"," 781"
"7348",75,593,518,"ACAACAGCTTCTAATCCCAT","CACCTTTCCAGTTTGCAAGA","561307.5.peg.1700"," 781"
"7349",451,593,142,"GGCAACTTCAACAGGGTATT","CACCTTTCCAGTTTGCAAGA","561307.5.peg.1700"," 781"
"7350",274,593,319,"AGATTCCCAAGGGAGCGCTT","CACCTTTCCAGTTTGCAAGA","561307.5.peg.1700"," 781"
"7351",320,593,273,"TAACGCTTCTACCTTGAACT","CACCTTTCCAGTTTGCAAGA","561307.5.peg.1700"," 781"
"7352",363,593,230,"TTAGTTATCGCCTGACAATC","CACCTTTCCAGTTTGCAAGA","561307.5.peg.1700"," 781"
"7353",112,9,103,"CTCAATATTACTAAAGGCAG","CGTTTACTACCAAACTTGTG","561307.5.peg.1705"," 786"
"7354",225,9,216,"TTAACTATTTGTACTGGCGT","CGTTTACTACCAAACTTGTG","561307.5.peg.1705"," 786"
"7355",258,9,249,"ATCACAGCTTTACTCCGCTT","CGTTTACTACCAAACTTGTG","561307.5.peg.1705"," 786"
"7356",258,29,229,"ATCACAGCTTTACTCCGCTT","AAATTTCACCACACAAGTT","561307.5.peg.1705"," 786"
"7357",225,29,196,"TTAACTATTTGTACTGGCGT","AAATTTCACCACACAAGTT","561307.5.peg.1705"," 786"
"7358",9,112,103,"CGTTTACTACCAAACTTGTG","CTCAATATTACTAAAGGCAG","561307.5.peg.1705"," 786"
"7359",225,112,113,"TTAACTATTTGTACTGGCGT","CTCAATATTACTAAAGGCAG","561307.5.peg.1705"," 786"
"7360",258,112,146,"ATCACAGCTTTACTCCGCTT","CTCAATATTACTAAAGGCAG","561307.5.peg.1705"," 786"
"7361",9,225,216,"CGTTTACTACCAAACTTGTG","TTAACTATTTGTACTGGCGT","561307.5.peg.1705"," 786"
"7362",112,225,113,"CTCAATATTACTAAAGGCAG","TTAACTATTTGTACTGGCGT","561307.5.peg.1705"," 786"
"7363",29,225,196,"AAATTTCACCACACAAGTT","TTAACTATTTGTACTGGCGT","561307.5.peg.1705"," 786"
"7364",9,258,249,"CGTTTACTACCAAACTTGTG","ATCACAGCTTTACTCCGCTT","561307.5.peg.1705"," 786"
"7365",29,258,229,"AAATTTCACCACACAAGTT","ATCACAGCTTTACTCCGCTT","561307.5.peg.1705"," 786"
"7366",112,258,146,"CTCAATATTACTAAAGGCAG","ATCACAGCTTTACTCCGCTT","561307.5.peg.1705"," 786"
"7367",741,244,497,"TTATAGTTGTTTGGAACCTG","CGGATCTTGTAATTTAGCTT","561307.5.peg.1706"," 787"
"7368",733,244,489,"GTTTGGAACCTGAGGTAAAC","CGGATCTTGTAATTTAGCTT","561307.5.peg.1706"," 787"
"7369",487,244,243,"ACTTGTTGTGTTAATGTTG","CGGATCTTGTAATTTAGCTT","561307.5.peg.1706"," 787"
"7370",487,264,223,"ACTTGTTGTGTTAATGTTG","TCATATATCTTTGCAGGAAT","561307.5.peg.1706"," 787"
"7371",733,264,469,"GTTTGGAACCTGAGGTAAAC","TCATATATCTTTGCAGGAAT","561307.5.peg.1706"," 787"
"7372",741,264,477,"TTATAGTTGTTTGGAACCTG","TCATATATCTTTGCAGGAAT","561307.5.peg.1706"," 787"
"7373",487,270,217,"ACTTGTTGTGTTAATGTTG","TCTTGTCATATATCTTTGC","561307.5.peg.1706"," 787"
"7374",733,270,463,"GTTTGGAACCTGAGGTAAAC","TCTTGTCATATATCTTTGC","561307.5.peg.1706"," 787"
"7375",741,270,471,"TTATAGTTGTTTGGAACCTG","TCTTGTCATATATCTTTGC","561307.5.peg.1706"," 787"
"7376",741,323,418,"TTATAGTTGTTTGGAACCTG","ATTTACATGCTCATGTCTT","561307.5.peg.1706"," 787"
"7377",487,323,164,"ACTTGTTGTGTTAATGTTG","ATTTACATGCTCATGTCTT","561307.5.peg.1706"," 787"
"7378",733,323,410,"GTTTGGAACCTGAGGTAAAC","ATTTACATGCTCATGTCTT","561307.5.peg.1706"," 787"
"7379",244,487,243,"CGGATCTTGTAATTTAGCTT","ACTTGTTGTGTTAATGTTG","561307.5.peg.1706"," 787"
"7380",741,487,254,"TTATAGTTGTTTGGAACCTG","ACTTGTTGTGTTAATGTTG","561307.5.peg.1706"," 787"
"7381",264,487,223,"TCATATATCTTTGCAGGAAT","ACTTGTTGTGTTAATGTTG","561307.5.peg.1706"," 787"
"7382",733,487,246,"GTTTGGAACCTGAGGTAAAC","ACTTGTTGTGTTAATGTTG","561307.5.peg.1706"," 787"
"7383",270,487,217,"TCTTGTCATATATCTTTGC","ACTTGTTGTGTTAATGTTG","561307.5.peg.1706"," 787"
"7384",323,487,164,"ATTTACATGCTCATGTCTT","ACTTGTTGTGTTAATGTTG","561307.5.peg.1706"," 787"
"7385",244,733,489,"CGGATCTTGTAATTTAGCTT","GTTTGGAACCTGAGGTAAAC","561307.5.peg.1706"," 787"
"7386",270,733,463,"TCTTGTCATATATCTTTGC","GTTTGGAACCTGAGGTAAAC","561307.5.peg.1706"," 787"
"7387",264,733,469,"TCATATATCTTTGCAGGAAT","GTTTGGAACCTGAGGTAAAC","561307.5.peg.1706"," 787"
"7388",487,733,246,"ACTTGTTGTGTTAATGTTG","GTTTGGAACCTGAGGTAAAC","561307.5.peg.1706"," 787"
"7389",323,733,410,"ATTTACATGCTCATGTCTT","GTTTGGAACCTGAGGTAAAC","561307.5.peg.1706"," 787"
"7390",244,741,497,"CGGATCTTGTAATTTAGCTT","TTATAGTTGTTTGGAACCTG","561307.5.peg.1706"," 787"
"7391",270,741,471,"TCTTGTCATATATCTTTGC","TTATAGTTGTTTGGAACCTG","561307.5.peg.1706"," 787"
"7392",323,741,418,"ATTTACATGCTCATGTCTT","TTATAGTTGTTTGGAACCTG","561307.5.peg.1706"," 787"
"7393",264,741,477,"TCATATATCTTTGCAGGAAT","TTATAGTTGTTTGGAACCTG","561307.5.peg.1706"," 787"
"7394",487,741,254,"ACTTGTTGTGTTAATGTTG","TTATAGTTGTTTGGAACCTG","561307.5.peg.1706"," 787"
"7395",234,10,224,"CTGACTGCCAAATAATCTTC","AAATTTGATTGGTTAAACG","561307.5.peg.1708"," 789"
"7396",234,20,214,"CTGACTGCCAAATAATCTTC","AACGGTACCTAAATTTGAT","561307.5.peg.1708"," 789"
"7397",234,105,129,"CTGACTGCCAAATAATCTTC","TTTAATTCACATTCTGCATC","561307.5.peg.1708"," 789"
"7398",10,234,224,"AAATTTGATTGGTTAAACG","CTGACTGCCAAATAATCTTC","561307.5.peg.1708"," 789"
"7399",20,234,214,"AACGGTACCTAAATTTGAT","CTGACTGCCAAATAATCTTC","561307.5.peg.1708"," 789"
"7400",105,234,129,"TTTAATTCACATTCTGCATC","CTGACTGCCAAATAATCTTC","561307.5.peg.1708"," 789"
"7401",192,78,114,"TCTGAAGCAATTCAATTGA","AATTCTCTTCGTATCACTAC","561307.5.peg.1709"," 790"
"7402",319,78,241,"GGATCTAGATTCATATATT","AATTCTCTTCGTATCACTAC","561307.5.peg.1709"," 790"
"7403",231,78,153,"TAACCATTGTAATATCACG","AATTCTCTTCGTATCACTAC","561307.5.peg.1709"," 790"
"7404",231,107,124,"TAACCATTGTAATATCACG","CTAAACCTAAGTCACTGTAA","561307.5.peg.1709"," 790"
"7405",319,107,212,"GGATCTAGATTCATATATT","CTAAACCTAAGTCACTGTAA","561307.5.peg.1709"," 790"
"7406",78,192,114,"AATTCTCTTCGTATCACTAC","TCTGAAGCAATTCAATTGA","561307.5.peg.1709"," 790"
"7407",319,192,127,"GGATCTAGATTCATATATT","TCTGAAGCAATTCAATTGA","561307.5.peg.1709"," 790"
"7408",78,231,153,"AATTCTCTTCGTATCACTAC","TAACCATTGTAATATCACG","561307.5.peg.1709"," 790"
"7409",107,231,124,"CTAAACCTAAGTCACTGTAA","TAACCATTGTAATATCACG","561307.5.peg.1709"," 790"
"7410",78,319,241,"AATTCTCTTCGTATCACTAC","GGATCTAGATTCATATATT","561307.5.peg.1709"," 790"
"7411",192,319,127,"TCTGAAGCAATTCAATTGA","GGATCTAGATTCATATATT","561307.5.peg.1709"," 790"
"7412",107,319,212,"CTAAACCTAAGTCACTGTAA","GGATCTAGATTCATATATT","561307.5.peg.1709"," 790"
"7413",534,89,445,"ATAATTCACTTGTACCTTC","AAGCACCAATTGTAACGTCT","561307.5.peg.1710"," 792"
"7414",89,534,445,"AAGCACCAATTGTAACGTCT","ATAATTCACTTGTACCTTC","561307.5.peg.1710"," 792"
"7415",732,64,668,"CTGCCATTATAATTTGTTGT","TTCCAAATCCACAACGGCAT","561307.5.peg.1711"," 793"
"7416",1008,64,944,"TTCAACGCTTCATTCATTGC","TTCCAAATCCACAACGGCAT","561307.5.peg.1711"," 793"
"7417",201,64,137,"GTTAACGCTTGAATGAACGG","TTCCAAATCCACAACGGCAT","561307.5.peg.1711"," 793"
"7418",481,64,417,"AGCTCGATGGGCATTTGCTA","TTCCAAATCCACAACGGCAT","561307.5.peg.1711"," 793"
"7419",1173,64,1109,"AATTCCTGTATATCTCCGGA","TTCCAAATCCACAACGGCAT","561307.5.peg.1711"," 793"
"7420",567,64,503,"ATTGCTTCAAAGTATCTAA","TTCCAAATCCACAACGGCAT","561307.5.peg.1711"," 793"
"7421",807,64,743,"TCCGCTAAATATAATTGTTG","TTCCAAATCCACAACGGCAT","561307.5.peg.1711"," 793"
"7422",1251,64,1187,"TAATGAACATCGTGACGTGC","TTCCAAATCCACAACGGCAT","561307.5.peg.1711"," 793"
"7423",1177,64,1113,"TTTAATTCCTGTATATCTC","TTCCAAATCCACAACGGCAT","561307.5.peg.1711"," 793"
"7424",514,64,450,"CATCAATTTAGCAGTAGTAG","TTCCAAATCCACAACGGCAT","561307.5.peg.1711"," 793"
"7425",204,64,140,"GATGTTAACGCTTGAATGAA","TTCCAAATCCACAACGGCAT","561307.5.peg.1711"," 793"
"7426",493,64,429,"GGCATCTTCGTCAGCTCGAT","TTCCAAATCCACAACGGCAT","561307.5.peg.1711"," 793"
"7427",201,70,131,"GTTAACGCTTGAATGAACGG","TGTTGTTTCCAAATCCACAA","561307.5.peg.1711"," 793"
"7428",1173,70,1103,"AATTCCTGTATATCTCCGGA","TGTTGTTTCCAAATCCACAA","561307.5.peg.1711"," 793"
"7429",732,70,662,"CTGCCATTATAATTTGTTGT","TGTTGTTTCCAAATCCACAA","561307.5.peg.1711"," 793"
"7430",514,70,444,"CATCAATTTAGCAGTAGTAG","TGTTGTTTCCAAATCCACAA","561307.5.peg.1711"," 793"
"7431",481,70,411,"AGCTCGATGGGCATTTGCTA","TGTTGTTTCCAAATCCACAA","561307.5.peg.1711"," 793"
"7432",567,70,497,"ATTGCTTCAAAGTATCTAA","TGTTGTTTCCAAATCCACAA","561307.5.peg.1711"," 793"
"7433",493,70,423,"GGCATCTTCGTCAGCTCGAT","TGTTGTTTCCAAATCCACAA","561307.5.peg.1711"," 793"
"7434",807,70,737,"TCCGCTAAATATAATTGTTG","TGTTGTTTCCAAATCCACAA","561307.5.peg.1711"," 793"
"7435",1251,70,1181,"TAATGAACATCGTGACGTGC","TGTTGTTTCCAAATCCACAA","561307.5.peg.1711"," 793"
"7436",1008,70,938,"TTCAACGCTTCATTCATTGC","TGTTGTTTCCAAATCCACAA","561307.5.peg.1711"," 793"
"7437",204,70,134,"GATGTTAACGCTTGAATGAA","TGTTGTTTCCAAATCCACAA","561307.5.peg.1711"," 793"
"7438",1177,70,1107,"TTTAATTCCTGTATATCTC","TGTTGTTTCCAAATCCACAA","561307.5.peg.1711"," 793"
"7439",1008,201,807,"TTCAACGCTTCATTCATTGC","GTTAACGCTTGAATGAACGG","561307.5.peg.1711"," 793"
"7440",807,201,606,"TCCGCTAAATATAATTGTTG","GTTAACGCTTGAATGAACGG","561307.5.peg.1711"," 793"
"7441",1251,201,1050,"TAATGAACATCGTGACGTGC","GTTAACGCTTGAATGAACGG","561307.5.peg.1711"," 793"
"7442",732,201,531,"CTGCCATTATAATTTGTTGT","GTTAACGCTTGAATGAACGG","561307.5.peg.1711"," 793"
"7443",493,201,292,"GGCATCTTCGTCAGCTCGAT","GTTAACGCTTGAATGAACGG","561307.5.peg.1711"," 793"
"7444",567,201,366,"ATTGCTTCAAAGTATCTAA","GTTAACGCTTGAATGAACGG","561307.5.peg.1711"," 793"
"7445",64,201,137,"TTCCAAATCCACAACGGCAT","GTTAACGCTTGAATGAACGG","561307.5.peg.1711"," 793"
"7446",1173,201,972,"AATTCCTGTATATCTCCGGA","GTTAACGCTTGAATGAACGG","561307.5.peg.1711"," 793"
"7447",1177,201,976,"TTTAATTCCTGTATATCTC","GTTAACGCTTGAATGAACGG","561307.5.peg.1711"," 793"
"7448",514,201,313,"CATCAATTTAGCAGTAGTAG","GTTAACGCTTGAATGAACGG","561307.5.peg.1711"," 793"
"7449",481,201,280,"AGCTCGATGGGCATTTGCTA","GTTAACGCTTGAATGAACGG","561307.5.peg.1711"," 793"
"7450",70,201,131,"TGTTGTTTCCAAATCCACAA","GTTAACGCTTGAATGAACGG","561307.5.peg.1711"," 793"
"7451",64,204,140,"TTCCAAATCCACAACGGCAT","GATGTTAACGCTTGAATGAA","561307.5.peg.1711"," 793"
"7452",514,204,310,"CATCAATTTAGCAGTAGTAG","GATGTTAACGCTTGAATGAA","561307.5.peg.1711"," 793"
"7453",1177,204,973,"TTTAATTCCTGTATATCTC","GATGTTAACGCTTGAATGAA","561307.5.peg.1711"," 793"
"7454",1008,204,804,"TTCAACGCTTCATTCATTGC","GATGTTAACGCTTGAATGAA","561307.5.peg.1711"," 793"
"7455",807,204,603,"TCCGCTAAATATAATTGTTG","GATGTTAACGCTTGAATGAA","561307.5.peg.1711"," 793"
"7456",493,204,289,"GGCATCTTCGTCAGCTCGAT","GATGTTAACGCTTGAATGAA","561307.5.peg.1711"," 793"
"7457",70,204,134,"TGTTGTTTCCAAATCCACAA","GATGTTAACGCTTGAATGAA","561307.5.peg.1711"," 793"
"7458",1251,204,1047,"TAATGAACATCGTGACGTGC","GATGTTAACGCTTGAATGAA","561307.5.peg.1711"," 793"
"7459",567,204,363,"ATTGCTTCAAAGTATCTAA","GATGTTAACGCTTGAATGAA","561307.5.peg.1711"," 793"
"7460",732,204,528,"CTGCCATTATAATTTGTTGT","GATGTTAACGCTTGAATGAA","561307.5.peg.1711"," 793"
"7461",481,204,277,"AGCTCGATGGGCATTTGCTA","GATGTTAACGCTTGAATGAA","561307.5.peg.1711"," 793"
"7462",1173,204,969,"AATTCCTGTATATCTCCGGA","GATGTTAACGCTTGAATGAA","561307.5.peg.1711"," 793"
"7463",807,481,326,"TCCGCTAAATATAATTGTTG","AGCTCGATGGGCATTTGCTA","561307.5.peg.1711"," 793"
"7464",70,481,411,"TGTTGTTTCCAAATCCACAA","AGCTCGATGGGCATTTGCTA","561307.5.peg.1711"," 793"
"7465",1177,481,696,"TTTAATTCCTGTATATCTC","AGCTCGATGGGCATTTGCTA","561307.5.peg.1711"," 793"
"7466",201,481,280,"GTTAACGCTTGAATGAACGG","AGCTCGATGGGCATTTGCTA","561307.5.peg.1711"," 793"
"7467",732,481,251,"CTGCCATTATAATTTGTTGT","AGCTCGATGGGCATTTGCTA","561307.5.peg.1711"," 793"
"7468",1251,481,770,"TAATGAACATCGTGACGTGC","AGCTCGATGGGCATTTGCTA","561307.5.peg.1711"," 793"
"7469",64,481,417,"TTCCAAATCCACAACGGCAT","AGCTCGATGGGCATTTGCTA","561307.5.peg.1711"," 793"
"7470",1008,481,527,"TTCAACGCTTCATTCATTGC","AGCTCGATGGGCATTTGCTA","561307.5.peg.1711"," 793"
"7471",204,481,277,"GATGTTAACGCTTGAATGAA","AGCTCGATGGGCATTTGCTA","561307.5.peg.1711"," 793"
"7472",1173,481,692,"AATTCCTGTATATCTCCGGA","AGCTCGATGGGCATTTGCTA","561307.5.peg.1711"," 793"
"7473",70,493,423,"TGTTGTTTCCAAATCCACAA","GGCATCTTCGTCAGCTCGAT","561307.5.peg.1711"," 793"
"7474",201,493,292,"GTTAACGCTTGAATGAACGG","GGCATCTTCGTCAGCTCGAT","561307.5.peg.1711"," 793"
"7475",1177,493,684,"TTTAATTCCTGTATATCTC","GGCATCTTCGTCAGCTCGAT","561307.5.peg.1711"," 793"
"7476",1173,493,680,"AATTCCTGTATATCTCCGGA","GGCATCTTCGTCAGCTCGAT","561307.5.peg.1711"," 793"
"7477",807,493,314,"TCCGCTAAATATAATTGTTG","GGCATCTTCGTCAGCTCGAT","561307.5.peg.1711"," 793"
"7478",64,493,429,"TTCCAAATCCACAACGGCAT","GGCATCTTCGTCAGCTCGAT","561307.5.peg.1711"," 793"
"7479",1008,493,515,"TTCAACGCTTCATTCATTGC","GGCATCTTCGTCAGCTCGAT","561307.5.peg.1711"," 793"
"7480",204,493,289,"GATGTTAACGCTTGAATGAA","GGCATCTTCGTCAGCTCGAT","561307.5.peg.1711"," 793"
"7481",732,493,239,"CTGCCATTATAATTTGTTGT","GGCATCTTCGTCAGCTCGAT","561307.5.peg.1711"," 793"
"7482",1251,493,758,"TAATGAACATCGTGACGTGC","GGCATCTTCGTCAGCTCGAT","561307.5.peg.1711"," 793"
"7483",1251,514,737,"TAATGAACATCGTGACGTGC","CATCAATTTAGCAGTAGTAG","561307.5.peg.1711"," 793"
"7484",807,514,293,"TCCGCTAAATATAATTGTTG","CATCAATTTAGCAGTAGTAG","561307.5.peg.1711"," 793"
"7485",64,514,450,"TTCCAAATCCACAACGGCAT","CATCAATTTAGCAGTAGTAG","561307.5.peg.1711"," 793"
"7486",1173,514,659,"AATTCCTGTATATCTCCGGA","CATCAATTTAGCAGTAGTAG","561307.5.peg.1711"," 793"
"7487",732,514,218,"CTGCCATTATAATTTGTTGT","CATCAATTTAGCAGTAGTAG","561307.5.peg.1711"," 793"
"7488",204,514,310,"GATGTTAACGCTTGAATGAA","CATCAATTTAGCAGTAGTAG","561307.5.peg.1711"," 793"
"7489",70,514,444,"TGTTGTTTCCAAATCCACAA","CATCAATTTAGCAGTAGTAG","561307.5.peg.1711"," 793"
"7490",201,514,313,"GTTAACGCTTGAATGAACGG","CATCAATTTAGCAGTAGTAG","561307.5.peg.1711"," 793"
"7491",1177,514,663,"TTTAATTCCTGTATATCTC","CATCAATTTAGCAGTAGTAG","561307.5.peg.1711"," 793"
"7492",1008,514,494,"TTCAACGCTTCATTCATTGC","CATCAATTTAGCAGTAGTAG","561307.5.peg.1711"," 793"
"7493",204,567,363,"GATGTTAACGCTTGAATGAA","ATTGCTTCAAAGTATCTAA","561307.5.peg.1711"," 793"
"7494",70,567,497,"TGTTGTTTCCAAATCCACAA","ATTGCTTCAAAGTATCTAA","561307.5.peg.1711"," 793"
"7495",1177,567,610,"TTTAATTCCTGTATATCTC","ATTGCTTCAAAGTATCTAA","561307.5.peg.1711"," 793"
"7496",1251,567,684,"TAATGAACATCGTGACGTGC","ATTGCTTCAAAGTATCTAA","561307.5.peg.1711"," 793"
"7497",1008,567,441,"TTCAACGCTTCATTCATTGC","ATTGCTTCAAAGTATCTAA","561307.5.peg.1711"," 793"
"7498",732,567,165,"CTGCCATTATAATTTGTTGT","ATTGCTTCAAAGTATCTAA","561307.5.peg.1711"," 793"
"7499",807,567,240,"TCCGCTAAATATAATTGTTG","ATTGCTTCAAAGTATCTAA","561307.5.peg.1711"," 793"
"7500",64,567,503,"TTCCAAATCCACAACGGCAT","ATTGCTTCAAAGTATCTAA","561307.5.peg.1711"," 793"
"7501",201,567,366,"GTTAACGCTTGAATGAACGG","ATTGCTTCAAAGTATCTAA","561307.5.peg.1711"," 793"
"7502",1173,567,606,"AATTCCTGTATATCTCCGGA","ATTGCTTCAAAGTATCTAA","561307.5.peg.1711"," 793"
"7503",64,732,668,"TTCCAAATCCACAACGGCAT","CTGCCATTATAATTTGTTGT","561307.5.peg.1711"," 793"
"7504",204,732,528,"GATGTTAACGCTTGAATGAA","CTGCCATTATAATTTGTTGT","561307.5.peg.1711"," 793"
"7505",567,732,165,"ATTGCTTCAAAGTATCTAA","CTGCCATTATAATTTGTTGT","561307.5.peg.1711"," 793"
"7506",481,732,251,"AGCTCGATGGGCATTTGCTA","CTGCCATTATAATTTGTTGT","561307.5.peg.1711"," 793"
"7507",70,732,662,"TGTTGTTTCCAAATCCACAA","CTGCCATTATAATTTGTTGT","561307.5.peg.1711"," 793"
"7508",1008,732,276,"TTCAACGCTTCATTCATTGC","CTGCCATTATAATTTGTTGT","561307.5.peg.1711"," 793"
"7509",493,732,239,"GGCATCTTCGTCAGCTCGAT","CTGCCATTATAATTTGTTGT","561307.5.peg.1711"," 793"
"7510",201,732,531,"GTTAACGCTTGAATGAACGG","CTGCCATTATAATTTGTTGT","561307.5.peg.1711"," 793"
"7511",1251,732,519,"TAATGAACATCGTGACGTGC","CTGCCATTATAATTTGTTGT","561307.5.peg.1711"," 793"
"7512",514,732,218,"CATCAATTTAGCAGTAGTAG","CTGCCATTATAATTTGTTGT","561307.5.peg.1711"," 793"
"7513",1173,732,441,"AATTCCTGTATATCTCCGGA","CTGCCATTATAATTTGTTGT","561307.5.peg.1711"," 793"
"7514",1177,732,445,"TTTAATTCCTGTATATCTC","CTGCCATTATAATTTGTTGT","561307.5.peg.1711"," 793"
"7515",204,807,603,"GATGTTAACGCTTGAATGAA","TCCGCTAAATATAATTGTTG","561307.5.peg.1711"," 793"
"7516",1251,807,444,"TAATGAACATCGTGACGTGC","TCCGCTAAATATAATTGTTG","561307.5.peg.1711"," 793"
"7517",1173,807,366,"AATTCCTGTATATCTCCGGA","TCCGCTAAATATAATTGTTG","561307.5.peg.1711"," 793"
"7518",493,807,314,"GGCATCTTCGTCAGCTCGAT","TCCGCTAAATATAATTGTTG","561307.5.peg.1711"," 793"
"7519",70,807,737,"TGTTGTTTCCAAATCCACAA","TCCGCTAAATATAATTGTTG","561307.5.peg.1711"," 793"
"7520",514,807,293,"CATCAATTTAGCAGTAGTAG","TCCGCTAAATATAATTGTTG","561307.5.peg.1711"," 793"
"7521",481,807,326,"AGCTCGATGGGCATTTGCTA","TCCGCTAAATATAATTGTTG","561307.5.peg.1711"," 793"
"7522",1008,807,201,"TTCAACGCTTCATTCATTGC","TCCGCTAAATATAATTGTTG","561307.5.peg.1711"," 793"
"7523",201,807,606,"GTTAACGCTTGAATGAACGG","TCCGCTAAATATAATTGTTG","561307.5.peg.1711"," 793"
"7524",64,807,743,"TTCCAAATCCACAACGGCAT","TCCGCTAAATATAATTGTTG","561307.5.peg.1711"," 793"
"7525",1177,807,370,"TTTAATTCCTGTATATCTC","TCCGCTAAATATAATTGTTG","561307.5.peg.1711"," 793"
"7526",567,807,240,"ATTGCTTCAAAGTATCTAA","TCCGCTAAATATAATTGTTG","561307.5.peg.1711"," 793"
"7527",807,1008,201,"TCCGCTAAATATAATTGTTG","TTCAACGCTTCATTCATTGC","561307.5.peg.1711"," 793"
"7528",732,1008,276,"CTGCCATTATAATTTGTTGT","TTCAACGCTTCATTCATTGC","561307.5.peg.1711"," 793"
"7529",1173,1008,165,"AATTCCTGTATATCTCCGGA","TTCAACGCTTCATTCATTGC","561307.5.peg.1711"," 793"
"7530",1251,1008,243,"TAATGAACATCGTGACGTGC","TTCAACGCTTCATTCATTGC","561307.5.peg.1711"," 793"
"7531",481,1008,527,"AGCTCGATGGGCATTTGCTA","TTCAACGCTTCATTCATTGC","561307.5.peg.1711"," 793"
"7532",493,1008,515,"GGCATCTTCGTCAGCTCGAT","TTCAACGCTTCATTCATTGC","561307.5.peg.1711"," 793"
"7533",64,1008,944,"TTCCAAATCCACAACGGCAT","TTCAACGCTTCATTCATTGC","561307.5.peg.1711"," 793"
"7534",567,1008,441,"ATTGCTTCAAAGTATCTAA","TTCAACGCTTCATTCATTGC","561307.5.peg.1711"," 793"
"7535",70,1008,938,"TGTTGTTTCCAAATCCACAA","TTCAACGCTTCATTCATTGC","561307.5.peg.1711"," 793"
"7536",1177,1008,169,"TTTAATTCCTGTATATCTC","TTCAACGCTTCATTCATTGC","561307.5.peg.1711"," 793"
"7537",514,1008,494,"CATCAATTTAGCAGTAGTAG","TTCAACGCTTCATTCATTGC","561307.5.peg.1711"," 793"
"7538",201,1008,807,"GTTAACGCTTGAATGAACGG","TTCAACGCTTCATTCATTGC","561307.5.peg.1711"," 793"
"7539",204,1008,804,"GATGTTAACGCTTGAATGAA","TTCAACGCTTCATTCATTGC","561307.5.peg.1711"," 793"
"7540",70,1173,1103,"TGTTGTTTCCAAATCCACAA","AATTCCTGTATATCTCCGGA","561307.5.peg.1711"," 793"
"7541",514,1173,659,"CATCAATTTAGCAGTAGTAG","AATTCCTGTATATCTCCGGA","561307.5.peg.1711"," 793"
"7542",481,1173,692,"AGCTCGATGGGCATTTGCTA","AATTCCTGTATATCTCCGGA","561307.5.peg.1711"," 793"
"7543",64,1173,1109,"TTCCAAATCCACAACGGCAT","AATTCCTGTATATCTCCGGA","561307.5.peg.1711"," 793"
"7544",567,1173,606,"ATTGCTTCAAAGTATCTAA","AATTCCTGTATATCTCCGGA","561307.5.peg.1711"," 793"
"7545",1008,1173,165,"TTCAACGCTTCATTCATTGC","AATTCCTGTATATCTCCGGA","561307.5.peg.1711"," 793"
"7546",201,1173,972,"GTTAACGCTTGAATGAACGG","AATTCCTGTATATCTCCGGA","561307.5.peg.1711"," 793"
"7547",204,1173,969,"GATGTTAACGCTTGAATGAA","AATTCCTGTATATCTCCGGA","561307.5.peg.1711"," 793"
"7548",493,1173,680,"GGCATCTTCGTCAGCTCGAT","AATTCCTGTATATCTCCGGA","561307.5.peg.1711"," 793"
"7549",732,1173,441,"CTGCCATTATAATTTGTTGT","AATTCCTGTATATCTCCGGA","561307.5.peg.1711"," 793"
"7550",807,1173,366,"TCCGCTAAATATAATTGTTG","AATTCCTGTATATCTCCGGA","561307.5.peg.1711"," 793"
"7551",64,1177,1113,"TTCCAAATCCACAACGGCAT","TTTAATTCCTGTATATCTC","561307.5.peg.1711"," 793"
"7552",481,1177,696,"AGCTCGATGGGCATTTGCTA","TTTAATTCCTGTATATCTC","561307.5.peg.1711"," 793"
"7553",732,1177,445,"CTGCCATTATAATTTGTTGT","TTTAATTCCTGTATATCTC","561307.5.peg.1711"," 793"
"7554",567,1177,610,"ATTGCTTCAAAGTATCTAA","TTTAATTCCTGTATATCTC","561307.5.peg.1711"," 793"
"7555",1008,1177,169,"TTCAACGCTTCATTCATTGC","TTTAATTCCTGTATATCTC","561307.5.peg.1711"," 793"
"7556",514,1177,663,"CATCAATTTAGCAGTAGTAG","TTTAATTCCTGTATATCTC","561307.5.peg.1711"," 793"
"7557",70,1177,1107,"TGTTGTTTCCAAATCCACAA","TTTAATTCCTGTATATCTC","561307.5.peg.1711"," 793"
"7558",807,1177,370,"TCCGCTAAATATAATTGTTG","TTTAATTCCTGTATATCTC","561307.5.peg.1711"," 793"
"7559",493,1177,684,"GGCATCTTCGTCAGCTCGAT","TTTAATTCCTGTATATCTC","561307.5.peg.1711"," 793"
"7560",204,1177,973,"GATGTTAACGCTTGAATGAA","TTTAATTCCTGTATATCTC","561307.5.peg.1711"," 793"
"7561",201,1177,976,"GTTAACGCTTGAATGAACGG","TTTAATTCCTGTATATCTC","561307.5.peg.1711"," 793"
"7562",481,1251,770,"AGCTCGATGGGCATTTGCTA","TAATGAACATCGTGACGTGC","561307.5.peg.1711"," 793"
"7563",567,1251,684,"ATTGCTTCAAAGTATCTAA","TAATGAACATCGTGACGTGC","561307.5.peg.1711"," 793"
"7564",493,1251,758,"GGCATCTTCGTCAGCTCGAT","TAATGAACATCGTGACGTGC","561307.5.peg.1711"," 793"
"7565",1008,1251,243,"TTCAACGCTTCATTCATTGC","TAATGAACATCGTGACGTGC","561307.5.peg.1711"," 793"
"7566",732,1251,519,"CTGCCATTATAATTTGTTGT","TAATGAACATCGTGACGTGC","561307.5.peg.1711"," 793"
"7567",514,1251,737,"CATCAATTTAGCAGTAGTAG","TAATGAACATCGTGACGTGC","561307.5.peg.1711"," 793"
"7568",204,1251,1047,"GATGTTAACGCTTGAATGAA","TAATGAACATCGTGACGTGC","561307.5.peg.1711"," 793"
"7569",807,1251,444,"TCCGCTAAATATAATTGTTG","TAATGAACATCGTGACGTGC","561307.5.peg.1711"," 793"
"7570",201,1251,1050,"GTTAACGCTTGAATGAACGG","TAATGAACATCGTGACGTGC","561307.5.peg.1711"," 793"
"7571",64,1251,1187,"TTCCAAATCCACAACGGCAT","TAATGAACATCGTGACGTGC","561307.5.peg.1711"," 793"
"7572",70,1251,1181,"TGTTGTTTCCAAATCCACAA","TAATGAACATCGTGACGTGC","561307.5.peg.1711"," 793"
"7573",477,173,304,"ATCATTGAGAATGCAACGTT","ACATCCCTCTAACTTTAAT","561307.5.peg.1712"," 794"
"7574",173,477,304,"ACATCCCTCTAACTTTAAT","ATCATTGAGAATGCAACGTT","561307.5.peg.1712"," 794"
"7575",302,198,104,"CGACATAATCTTCTTCAGCC","AGATAGATTCTATTTCATC","561307.5.peg.1713"," 795"
"7576",329,198,131,"ATGTAACACCACTTGGTCTA","AGATAGATTCTATTTCATC","561307.5.peg.1713"," 795"
"7577",336,198,138,"CGAACAAATGTAACACCACT","AGATAGATTCTATTTCATC","561307.5.peg.1713"," 795"
"7578",336,234,102,"CGAACAAATGTAACACCACT","GTGCCATGTTCTTTACCTAC","561307.5.peg.1713"," 795"
"7579",198,302,104,"AGATAGATTCTATTTCATC","CGACATAATCTTCTTCAGCC","561307.5.peg.1713"," 795"
"7580",198,329,131,"AGATAGATTCTATTTCATC","ATGTAACACCACTTGGTCTA","561307.5.peg.1713"," 795"
"7581",198,336,138,"AGATAGATTCTATTTCATC","CGAACAAATGTAACACCACT","561307.5.peg.1713"," 795"
"7582",234,336,102,"GTGCCATGTTCTTTACCTAC","CGAACAAATGTAACACCACT","561307.5.peg.1713"," 795"
"7583",216,44,172,"CTTAACGTAATATCATACGG","TTCCAGAACCACCCATGGAC","561307.5.peg.1714"," 796"
"7584",555,44,511,"ATGCTGTGTTATGTTTAGT","TTCCAGAACCACCCATGGAC","561307.5.peg.1714"," 796"
"7585",216,49,167,"CTTAACGTAATATCATACGG","AATAATTCCAGAACCACCCA","561307.5.peg.1714"," 796"
"7586",555,49,506,"ATGCTGTGTTATGTTTAGT","AATAATTCCAGAACCACCCA","561307.5.peg.1714"," 796"
"7587",44,216,172,"TTCCAGAACCACCCATGGAC","CTTAACGTAATATCATACGG","561307.5.peg.1714"," 796"
"7588",555,216,339,"ATGCTGTGTTATGTTTAGT","CTTAACGTAATATCATACGG","561307.5.peg.1714"," 796"
"7589",49,216,167,"AATAATTCCAGAACCACCCA","CTTAACGTAATATCATACGG","561307.5.peg.1714"," 796"
"7590",49,555,506,"AATAATTCCAGAACCACCCA","ATGCTGTGTTATGTTTAGT","561307.5.peg.1714"," 796"
"7591",44,555,511,"TTCCAGAACCACCCATGGAC","ATGCTGTGTTATGTTTAGT","561307.5.peg.1714"," 796"
"7592",216,555,339,"CTTAACGTAATATCATACGG","ATGCTGTGTTATGTTTAGT","561307.5.peg.1714"," 796"
"7593",297,102,195,"GATGGTCTGTCATAGTTTGC","ACTTTGTGTTGTGCCCATAA","561307.5.peg.1716"," 798"
"7594",315,102,213,"ATTGCAGTTCCAGCAACTGA","ACTTTGTGTTGTGCCCATAA","561307.5.peg.1716"," 798"
"7595",343,102,241,"AATGGCATGACCAACTTCGT","ACTTTGTGTTGTGCCCATAA","561307.5.peg.1716"," 798"
"7596",374,102,272,"TCTTAAGAACCAATATCCT","ACTTTGTGTTGTGCCCATAA","561307.5.peg.1716"," 798"
"7597",102,297,195,"ACTTTGTGTTGTGCCCATAA","GATGGTCTGTCATAGTTTGC","561307.5.peg.1716"," 798"
"7598",102,315,213,"ACTTTGTGTTGTGCCCATAA","ATTGCAGTTCCAGCAACTGA","561307.5.peg.1716"," 798"
"7599",102,343,241,"ACTTTGTGTTGTGCCCATAA","AATGGCATGACCAACTTCGT","561307.5.peg.1716"," 798"
"7600",102,374,272,"ACTTTGTGTTGTGCCCATAA","TCTTAAGAACCAATATCCT","561307.5.peg.1716"," 798"
"7601",285,159,126,"ACGTTCATACCGGGCTCGAC","CCCATACCGATCGCAAATTC","561307.5.peg.172"," 802"
"7602",282,159,123,"TTCATACCGGGCTCGACTGG","CCCATACCGATCGCAAATTC","561307.5.peg.172"," 802"
"7603",522,159,363,"TGTGCAAATTGTCTGTCTCT","CCCATACCGATCGCAAATTC","561307.5.peg.172"," 802"
"7604",648,159,489,"ACTTGTTCTACAGTAGACGT","CCCATACCGATCGCAAATTC","561307.5.peg.172"," 802"
"7605",522,237,285,"TGTGCAAATTGTCTGTCTCT","ATACGAACATATCCACCAAC","561307.5.peg.172"," 802"
"7606",648,237,411,"ACTTGTTCTACAGTAGACGT","ATACGAACATATCCACCAAC","561307.5.peg.172"," 802"
"7607",648,282,366,"ACTTGTTCTACAGTAGACGT","TTCATACCGGGCTCGACTGG","561307.5.peg.172"," 802"
"7608",522,282,240,"TGTGCAAATTGTCTGTCTCT","TTCATACCGGGCTCGACTGG","561307.5.peg.172"," 802"
"7609",159,282,123,"CCCATACCGATCGCAAATTC","TTCATACCGGGCTCGACTGG","561307.5.peg.172"," 802"
"7610",159,285,126,"CCCATACCGATCGCAAATTC","ACGTTCATACCGGGCTCGAC","561307.5.peg.172"," 802"
"7611",648,285,363,"ACTTGTTCTACAGTAGACGT","ACGTTCATACCGGGCTCGAC","561307.5.peg.172"," 802"
"7612",522,285,237,"TGTGCAAATTGTCTGTCTCT","ACGTTCATACCGGGCTCGAC","561307.5.peg.172"," 802"
"7613",159,522,363,"CCCATACCGATCGCAAATTC","TGTGCAAATTGTCTGTCTCT","561307.5.peg.172"," 802"
"7614",237,522,285,"ATACGAACATATCCACCAAC","TGTGCAAATTGTCTGTCTCT","561307.5.peg.172"," 802"
"7615",282,522,240,"TTCATACCGGGCTCGACTGG","TGTGCAAATTGTCTGTCTCT","561307.5.peg.172"," 802"
"7616",285,522,237,"ACGTTCATACCGGGCTCGAC","TGTGCAAATTGTCTGTCTCT","561307.5.peg.172"," 802"
"7617",648,522,126,"ACTTGTTCTACAGTAGACGT","TGTGCAAATTGTCTGTCTCT","561307.5.peg.172"," 802"
"7618",159,648,489,"CCCATACCGATCGCAAATTC","ACTTGTTCTACAGTAGACGT","561307.5.peg.172"," 802"
"7619",237,648,411,"ATACGAACATATCCACCAAC","ACTTGTTCTACAGTAGACGT","561307.5.peg.172"," 802"
"7620",285,648,363,"ACGTTCATACCGGGCTCGAC","ACTTGTTCTACAGTAGACGT","561307.5.peg.172"," 802"
"7621",282,648,366,"TTCATACCGGGCTCGACTGG","ACTTGTTCTACAGTAGACGT","561307.5.peg.172"," 802"
"7622",522,648,126,"TGTGCAAATTGTCTGTCTCT","ACTTGTTCTACAGTAGACGT","561307.5.peg.172"," 802"
"7623",224,84,140,"TGATTTCTACACCTAACAGT","ACTTCTATTTCGCCCTTTAA","561307.5.peg.1720"," 803"
"7624",600,84,516,"CTAATTCTTTAATGATGGT","ACTTCTATTTCGCCCTTTAA","561307.5.peg.1720"," 803"
"7625",420,84,336,"GGTCTCAAGACACGATCCAT","ACTTCTATTTCGCCCTTTAA","561307.5.peg.1720"," 803"
"7626",303,84,219,"CCTGTATACAATACTTGATG","ACTTCTATTTCGCCCTTTAA","561307.5.peg.1720"," 803"
"7627",303,108,195,"CCTGTATACAATACTTGATG","TGTGTCATTGACTTATCGCC","561307.5.peg.1720"," 803"
"7628",224,108,116,"TGATTTCTACACCTAACAGT","TGTGTCATTGACTTATCGCC","561307.5.peg.1720"," 803"
"7629",600,108,492,"CTAATTCTTTAATGATGGT","TGTGTCATTGACTTATCGCC","561307.5.peg.1720"," 803"
"7630",420,108,312,"GGTCTCAAGACACGATCCAT","TGTGTCATTGACTTATCGCC","561307.5.peg.1720"," 803"
"7631",420,131,289,"GGTCTCAAGACACGATCCAT","GCGACGCCAACATGATTGCA","561307.5.peg.1720"," 803"
"7632",303,131,172,"CCTGTATACAATACTTGATG","GCGACGCCAACATGATTGCA","561307.5.peg.1720"," 803"
"7633",600,131,469,"CTAATTCTTTAATGATGGT","GCGACGCCAACATGATTGCA","561307.5.peg.1720"," 803"
"7634",600,183,417,"CTAATTCTTTAATGATGGT","CGACAATCTTCGCCAAGTAG","561307.5.peg.1720"," 803"
"7635",420,183,237,"GGTCTCAAGACACGATCCAT","CGACAATCTTCGCCAAGTAG","561307.5.peg.1720"," 803"
"7636",303,183,120,"CCTGTATACAATACTTGATG","CGACAATCTTCGCCAAGTAG","561307.5.peg.1720"," 803"
"7637",84,224,140,"ACTTCTATTTCGCCCTTTAA","TGATTTCTACACCTAACAGT","561307.5.peg.1720"," 803"
"7638",600,224,376,"CTAATTCTTTAATGATGGT","TGATTTCTACACCTAACAGT","561307.5.peg.1720"," 803"
"7639",420,224,196,"GGTCTCAAGACACGATCCAT","TGATTTCTACACCTAACAGT","561307.5.peg.1720"," 803"
"7640",108,224,116,"TGTGTCATTGACTTATCGCC","TGATTTCTACACCTAACAGT","561307.5.peg.1720"," 803"
"7641",183,303,120,"CGACAATCTTCGCCAAGTAG","CCTGTATACAATACTTGATG","561307.5.peg.1720"," 803"
"7642",84,303,219,"ACTTCTATTTCGCCCTTTAA","CCTGTATACAATACTTGATG","561307.5.peg.1720"," 803"
"7643",600,303,297,"CTAATTCTTTAATGATGGT","CCTGTATACAATACTTGATG","561307.5.peg.1720"," 803"
"7644",131,303,172,"GCGACGCCAACATGATTGCA","CCTGTATACAATACTTGATG","561307.5.peg.1720"," 803"
"7645",420,303,117,"GGTCTCAAGACACGATCCAT","CCTGTATACAATACTTGATG","561307.5.peg.1720"," 803"
"7646",108,303,195,"TGTGTCATTGACTTATCGCC","CCTGTATACAATACTTGATG","561307.5.peg.1720"," 803"
"7647",84,420,336,"ACTTCTATTTCGCCCTTTAA","GGTCTCAAGACACGATCCAT","561307.5.peg.1720"," 803"
"7648",108,420,312,"TGTGTCATTGACTTATCGCC","GGTCTCAAGACACGATCCAT","561307.5.peg.1720"," 803"
"7649",303,420,117,"CCTGTATACAATACTTGATG","GGTCTCAAGACACGATCCAT","561307.5.peg.1720"," 803"
"7650",600,420,180,"CTAATTCTTTAATGATGGT","GGTCTCAAGACACGATCCAT","561307.5.peg.1720"," 803"
"7651",131,420,289,"GCGACGCCAACATGATTGCA","GGTCTCAAGACACGATCCAT","561307.5.peg.1720"," 803"
"7652",183,420,237,"CGACAATCTTCGCCAAGTAG","GGTCTCAAGACACGATCCAT","561307.5.peg.1720"," 803"
"7653",224,420,196,"TGATTTCTACACCTAACAGT","GGTCTCAAGACACGATCCAT","561307.5.peg.1720"," 803"
"7654",131,600,469,"GCGACGCCAACATGATTGCA","CTAATTCTTTAATGATGGT","561307.5.peg.1720"," 803"
"7655",420,600,180,"GGTCTCAAGACACGATCCAT","CTAATTCTTTAATGATGGT","561307.5.peg.1720"," 803"
"7656",108,600,492,"TGTGTCATTGACTTATCGCC","CTAATTCTTTAATGATGGT","561307.5.peg.1720"," 803"
"7657",84,600,516,"ACTTCTATTTCGCCCTTTAA","CTAATTCTTTAATGATGGT","561307.5.peg.1720"," 803"
"7658",183,600,417,"CGACAATCTTCGCCAAGTAG","CTAATTCTTTAATGATGGT","561307.5.peg.1720"," 803"
"7659",303,600,297,"CCTGTATACAATACTTGATG","CTAATTCTTTAATGATGGT","561307.5.peg.1720"," 803"
"7660",224,600,376,"TGATTTCTACACCTAACAGT","CTAATTCTTTAATGATGGT","561307.5.peg.1720"," 803"
"7661",304,87,217,"TGTATTACGAGTTACATGAT","GCACCGTGTTCAACATATAT","561307.5.peg.1721"," 804"
"7662",417,87,330,"TCATGCGCTAGTATAGTCGT","GCACCGTGTTCAACATATAT","561307.5.peg.1721"," 804"
"7663",510,87,423,"AATCATAAATCACAGCAGT","GCACCGTGTTCAACATATAT","561307.5.peg.1721"," 804"
"7664",417,304,113,"TCATGCGCTAGTATAGTCGT","TGTATTACGAGTTACATGAT","561307.5.peg.1721"," 804"
"7665",87,304,217,"GCACCGTGTTCAACATATAT","TGTATTACGAGTTACATGAT","561307.5.peg.1721"," 804"
"7666",510,304,206,"AATCATAAATCACAGCAGT","TGTATTACGAGTTACATGAT","561307.5.peg.1721"," 804"
"7667",87,417,330,"GCACCGTGTTCAACATATAT","TCATGCGCTAGTATAGTCGT","561307.5.peg.1721"," 804"
"7668",304,417,113,"TGTATTACGAGTTACATGAT","TCATGCGCTAGTATAGTCGT","561307.5.peg.1721"," 804"
"7669",304,510,206,"TGTATTACGAGTTACATGAT","AATCATAAATCACAGCAGT","561307.5.peg.1721"," 804"
"7670",87,510,423,"GCACCGTGTTCAACATATAT","AATCATAAATCACAGCAGT","561307.5.peg.1721"," 804"
"7671",261,12,249,"TGGTTACAACCATAGTAAT","TGTTATCGTGGAAGTATGAA","561307.5.peg.1722"," 805"
"7672",372,12,360,"AAATCTGCATGACCAGGTCT","TGTTATCGTGGAAGTATGAA","561307.5.peg.1722"," 805"
"7673",378,12,366,"CCAACCAAATCTGCATGACC","TGTTATCGTGGAAGTATGAA","561307.5.peg.1722"," 805"
"7674",261,59,202,"TGGTTACAACCATAGTAAT","CATGTGATTCTCCTGATGTT","561307.5.peg.1722"," 805"
"7675",378,59,319,"CCAACCAAATCTGCATGACC","CATGTGATTCTCCTGATGTT","561307.5.peg.1722"," 805"
"7676",372,59,313,"AAATCTGCATGACCAGGTCT","CATGTGATTCTCCTGATGTT","561307.5.peg.1722"," 805"
"7677",12,261,249,"TGTTATCGTGGAAGTATGAA","TGGTTACAACCATAGTAAT","561307.5.peg.1722"," 805"
"7678",59,261,202,"CATGTGATTCTCCTGATGTT","TGGTTACAACCATAGTAAT","561307.5.peg.1722"," 805"
"7679",372,261,111,"AAATCTGCATGACCAGGTCT","TGGTTACAACCATAGTAAT","561307.5.peg.1722"," 805"
"7680",378,261,117,"CCAACCAAATCTGCATGACC","TGGTTACAACCATAGTAAT","561307.5.peg.1722"," 805"
"7681",12,372,360,"TGTTATCGTGGAAGTATGAA","AAATCTGCATGACCAGGTCT","561307.5.peg.1722"," 805"
"7682",59,372,313,"CATGTGATTCTCCTGATGTT","AAATCTGCATGACCAGGTCT","561307.5.peg.1722"," 805"
"7683",261,372,111,"TGGTTACAACCATAGTAAT","AAATCTGCATGACCAGGTCT","561307.5.peg.1722"," 805"
"7684",12,378,366,"TGTTATCGTGGAAGTATGAA","CCAACCAAATCTGCATGACC","561307.5.peg.1722"," 805"
"7685",261,378,117,"TGGTTACAACCATAGTAAT","CCAACCAAATCTGCATGACC","561307.5.peg.1722"," 805"
"7686",59,378,319,"CATGTGATTCTCCTGATGTT","CCAACCAAATCTGCATGACC","561307.5.peg.1722"," 805"
"7687",171,10,161,"TGTGTTTCAGCAAGTTCCAT","ATAAACCTATTAAACACAGG","561307.5.peg.1723"," 806"
"7688",171,12,159,"TGTGTTTCAGCAAGTTCCAT","CATAAACCTATTAAACACA","561307.5.peg.1723"," 806"
"7689",171,24,147,"TGTGTTTCAGCAAGTTCCAT","TGTATCCCCCTGTGTTTAAT","561307.5.peg.1723"," 806"
"7690",10,171,161,"ATAAACCTATTAAACACAGG","TGTGTTTCAGCAAGTTCCAT","561307.5.peg.1723"," 806"
"7691",12,171,159,"CATAAACCTATTAAACACA","TGTGTTTCAGCAAGTTCCAT","561307.5.peg.1723"," 806"
"7692",24,171,147,"TGTATCCCCCTGTGTTTAAT","TGTGTTTCAGCAAGTTCCAT","561307.5.peg.1723"," 806"
"7693",182,36,146,"TACTCAGAATAACAAATGCT","TTTGCCACGTTAATCACCTT","561307.5.peg.1724"," 807"
"7694",418,36,382,"TGTACACGATTATCTTTAA","TTTGCCACGTTAATCACCTT","561307.5.peg.1724"," 807"
"7695",500,36,464,"TGTCTGTTGACTGTTAAAT","TTTGCCACGTTAATCACCTT","561307.5.peg.1724"," 807"
"7696",418,182,236,"TGTACACGATTATCTTTAA","TACTCAGAATAACAAATGCT","561307.5.peg.1724"," 807"
"7697",36,182,146,"TTTGCCACGTTAATCACCTT","TACTCAGAATAACAAATGCT","561307.5.peg.1724"," 807"
"7698",500,182,318,"TGTCTGTTGACTGTTAAAT","TACTCAGAATAACAAATGCT","561307.5.peg.1724"," 807"
"7699",36,418,382,"TTTGCCACGTTAATCACCTT","TGTACACGATTATCTTTAA","561307.5.peg.1724"," 807"
"7700",182,418,236,"TACTCAGAATAACAAATGCT","TGTACACGATTATCTTTAA","561307.5.peg.1724"," 807"
"7701",182,500,318,"TACTCAGAATAACAAATGCT","TGTCTGTTGACTGTTAAAT","561307.5.peg.1724"," 807"
"7702",36,500,464,"TTTGCCACGTTAATCACCTT","TGTCTGTTGACTGTTAAAT","561307.5.peg.1724"," 807"
"7703",171,8,163,"CATGCCACTTTGGCAACATC","GAATAGTGATAATATCGTG","561307.5.peg.1726"," 809"
"7704",181,8,173,"AATTGTGAGGCATGCCACTT","GAATAGTGATAATATCGTG","561307.5.peg.1726"," 809"
"7705",194,8,186,"TCATTGATGTGTCAATTGTG","GAATAGTGATAATATCGTG","561307.5.peg.1726"," 809"
"7706",8,171,163,"GAATAGTGATAATATCGTG","CATGCCACTTTGGCAACATC","561307.5.peg.1726"," 809"
"7707",8,181,173,"GAATAGTGATAATATCGTG","AATTGTGAGGCATGCCACTT","561307.5.peg.1726"," 809"
"7708",8,194,186,"GAATAGTGATAATATCGTG","TCATTGATGTGTCAATTGTG","561307.5.peg.1726"," 809"
"7709",426,7,419,"CCAATACCTGCATTATATTC","AAAGAGAAATTAACGATTGG","561307.5.peg.1728"," 811"
"7710",462,7,455,"ACAACTTCTTCCGCATGACT","AAAGAGAAATTAACGATTGG","561307.5.peg.1728"," 811"
"7711",495,7,488,"GATGAAGCAGCAACTGTAGT","AAAGAGAAATTAACGATTGG","561307.5.peg.1728"," 811"
"7712",426,94,332,"CCAATACCTGCATTATATTC","TTCTGCAAGAACATTGGCAA","561307.5.peg.1728"," 811"
"7713",462,94,368,"ACAACTTCTTCCGCATGACT","TTCTGCAAGAACATTGGCAA","561307.5.peg.1728"," 811"
"7714",495,94,401,"GATGAAGCAGCAACTGTAGT","TTCTGCAAGAACATTGGCAA","561307.5.peg.1728"," 811"
"7715",7,426,419,"AAAGAGAAATTAACGATTGG","CCAATACCTGCATTATATTC","561307.5.peg.1728"," 811"
"7716",94,426,332,"TTCTGCAAGAACATTGGCAA","CCAATACCTGCATTATATTC","561307.5.peg.1728"," 811"
"7717",7,462,455,"AAAGAGAAATTAACGATTGG","ACAACTTCTTCCGCATGACT","561307.5.peg.1728"," 811"
"7718",94,462,368,"TTCTGCAAGAACATTGGCAA","ACAACTTCTTCCGCATGACT","561307.5.peg.1728"," 811"
"7719",7,495,488,"AAAGAGAAATTAACGATTGG","GATGAAGCAGCAACTGTAGT","561307.5.peg.1728"," 811"
"7720",94,495,401,"TTCTGCAAGAACATTGGCAA","GATGAAGCAGCAACTGTAGT","561307.5.peg.1728"," 811"
"7721",286,153,133,"AATAACATCCGCTTCATCTA","ATACGATCTCGTGTTACACC","561307.5.peg.1729"," 812"
"7722",471,153,318,"TGTGACCCTGATATCGGATA","ATACGATCTCGTGTTACACC","561307.5.peg.1729"," 812"
"7723",387,153,234,"TTGTTAACCGCTAATACGAC","ATACGATCTCGTGTTACACC","561307.5.peg.1729"," 812"
"7724",477,153,324,"AAACCATGTGACCCTGATAT","ATACGATCTCGTGTTACACC","561307.5.peg.1729"," 812"
"7725",387,249,138,"TTGTTAACCGCTAATACGAC","GCTCTAATTTGTGTTTGGAA","561307.5.peg.1729"," 812"
"7726",477,249,228,"AAACCATGTGACCCTGATAT","GCTCTAATTTGTGTTTGGAA","561307.5.peg.1729"," 812"
"7727",471,249,222,"TGTGACCCTGATATCGGATA","GCTCTAATTTGTGTTTGGAA","561307.5.peg.1729"," 812"
"7728",153,286,133,"ATACGATCTCGTGTTACACC","AATAACATCCGCTTCATCTA","561307.5.peg.1729"," 812"
"7729",387,286,101,"TTGTTAACCGCTAATACGAC","AATAACATCCGCTTCATCTA","561307.5.peg.1729"," 812"
"7730",477,286,191,"AAACCATGTGACCCTGATAT","AATAACATCCGCTTCATCTA","561307.5.peg.1729"," 812"
"7731",471,286,185,"TGTGACCCTGATATCGGATA","AATAACATCCGCTTCATCTA","561307.5.peg.1729"," 812"
"7732",249,387,138,"GCTCTAATTTGTGTTTGGAA","TTGTTAACCGCTAATACGAC","561307.5.peg.1729"," 812"
"7733",153,387,234,"ATACGATCTCGTGTTACACC","TTGTTAACCGCTAATACGAC","561307.5.peg.1729"," 812"
"7734",286,387,101,"AATAACATCCGCTTCATCTA","TTGTTAACCGCTAATACGAC","561307.5.peg.1729"," 812"
"7735",249,471,222,"GCTCTAATTTGTGTTTGGAA","TGTGACCCTGATATCGGATA","561307.5.peg.1729"," 812"
"7736",153,471,318,"ATACGATCTCGTGTTACACC","TGTGACCCTGATATCGGATA","561307.5.peg.1729"," 812"
"7737",286,471,185,"AATAACATCCGCTTCATCTA","TGTGACCCTGATATCGGATA","561307.5.peg.1729"," 812"
"7738",153,477,324,"ATACGATCTCGTGTTACACC","AAACCATGTGACCCTGATAT","561307.5.peg.1729"," 812"
"7739",249,477,228,"GCTCTAATTTGTGTTTGGAA","AAACCATGTGACCCTGATAT","561307.5.peg.1729"," 812"
"7740",286,477,191,"AATAACATCCGCTTCATCTA","AAACCATGTGACCCTGATAT","561307.5.peg.1729"," 812"
"7741",207,12,195,"CCAACTGCACTAATTAAACC","ACGCTTTGGCGGATTGAGTG","561307.5.peg.173"," 813"
"7742",249,12,237,"ACCCATGGCCCTGCATGTTG","ACGCTTTGGCGGATTGAGTG","561307.5.peg.173"," 813"
"7743",264,12,252,"ATTGAATTACTTGTACCCA","ACGCTTTGGCGGATTGAGTG","561307.5.peg.173"," 813"
"7744",207,23,184,"CCAACTGCACTAATTAAACC","TCACGTCAAAGACGCTTTGG","561307.5.peg.173"," 813"
"7745",264,23,241,"ATTGAATTACTTGTACCCA","TCACGTCAAAGACGCTTTGG","561307.5.peg.173"," 813"
"7746",249,23,226,"ACCCATGGCCCTGCATGTTG","TCACGTCAAAGACGCTTTGG","561307.5.peg.173"," 813"
"7747",207,26,181,"CCAACTGCACTAATTAAACC","CAGTCACGTCAAAGACGCTT","561307.5.peg.173"," 813"
"7748",264,26,238,"ATTGAATTACTTGTACCCA","CAGTCACGTCAAAGACGCTT","561307.5.peg.173"," 813"
"7749",249,26,223,"ACCCATGGCCCTGCATGTTG","CAGTCACGTCAAAGACGCTT","561307.5.peg.173"," 813"
"7750",12,207,195,"ACGCTTTGGCGGATTGAGTG","CCAACTGCACTAATTAAACC","561307.5.peg.173"," 813"
"7751",23,207,184,"TCACGTCAAAGACGCTTTGG","CCAACTGCACTAATTAAACC","561307.5.peg.173"," 813"
"7752",26,207,181,"CAGTCACGTCAAAGACGCTT","CCAACTGCACTAATTAAACC","561307.5.peg.173"," 813"
"7753",12,249,237,"ACGCTTTGGCGGATTGAGTG","ACCCATGGCCCTGCATGTTG","561307.5.peg.173"," 813"
"7754",26,249,223,"CAGTCACGTCAAAGACGCTT","ACCCATGGCCCTGCATGTTG","561307.5.peg.173"," 813"
"7755",23,249,226,"TCACGTCAAAGACGCTTTGG","ACCCATGGCCCTGCATGTTG","561307.5.peg.173"," 813"
"7756",12,264,252,"ACGCTTTGGCGGATTGAGTG","ATTGAATTACTTGTACCCA","561307.5.peg.173"," 813"
"7757",26,264,238,"CAGTCACGTCAAAGACGCTT","ATTGAATTACTTGTACCCA","561307.5.peg.173"," 813"
"7758",23,264,241,"TCACGTCAAAGACGCTTTGG","ATTGAATTACTTGTACCCA","561307.5.peg.173"," 813"
"7759",450,183,267,"TCTGTTGAAATTAGTGAAGC","TGCGTAGATAGTTGACTAAT","561307.5.peg.1730"," 814"
"7760",563,183,380,"CTTCTTGTTCAACTGCTTTA","TGCGTAGATAGTTGACTAAT","561307.5.peg.1730"," 814"
"7761",183,450,267,"TGCGTAGATAGTTGACTAAT","TCTGTTGAAATTAGTGAAGC","561307.5.peg.1730"," 814"
"7762",563,450,113,"CTTCTTGTTCAACTGCTTTA","TCTGTTGAAATTAGTGAAGC","561307.5.peg.1730"," 814"
"7763",183,563,380,"TGCGTAGATAGTTGACTAAT","CTTCTTGTTCAACTGCTTTA","561307.5.peg.1730"," 814"
"7764",450,563,113,"TCTGTTGAAATTAGTGAAGC","CTTCTTGTTCAACTGCTTTA","561307.5.peg.1730"," 814"
"7765",213,85,128,"ACATGTTGGATTGTCATATG","TTGGTCTTGTGACATACTAA","561307.5.peg.1733"," 817"
"7766",436,85,351,"ATCAGAGGCAACGCGAATAG","TTGGTCTTGTGACATACTAA","561307.5.peg.1733"," 817"
"7767",207,85,122,"TGGATTGTCATATGAGGTGA","TTGGTCTTGTGACATACTAA","561307.5.peg.1733"," 817"
"7768",466,85,381,"AACCATCACGCCTTTATGAC","TTGGTCTTGTGACATACTAA","561307.5.peg.1733"," 817"
"7769",310,85,225,"GGCAGTTTCTTCTAACGTAT","TTGGTCTTGTGACATACTAA","561307.5.peg.1733"," 817"
"7770",466,137,329,"AACCATCACGCCTTTATGAC","CATCTTGATGCATTGAAATA","561307.5.peg.1733"," 817"
"7771",436,137,299,"ATCAGAGGCAACGCGAATAG","CATCTTGATGCATTGAAATA","561307.5.peg.1733"," 817"
"7772",310,137,173,"GGCAGTTTCTTCTAACGTAT","CATCTTGATGCATTGAAATA","561307.5.peg.1733"," 817"
"7773",85,207,122,"TTGGTCTTGTGACATACTAA","TGGATTGTCATATGAGGTGA","561307.5.peg.1733"," 817"
"7774",310,207,103,"GGCAGTTTCTTCTAACGTAT","TGGATTGTCATATGAGGTGA","561307.5.peg.1733"," 817"
"7775",466,207,259,"AACCATCACGCCTTTATGAC","TGGATTGTCATATGAGGTGA","561307.5.peg.1733"," 817"
"7776",436,207,229,"ATCAGAGGCAACGCGAATAG","TGGATTGTCATATGAGGTGA","561307.5.peg.1733"," 817"
"7777",85,213,128,"TTGGTCTTGTGACATACTAA","ACATGTTGGATTGTCATATG","561307.5.peg.1733"," 817"
"7778",436,213,223,"ATCAGAGGCAACGCGAATAG","ACATGTTGGATTGTCATATG","561307.5.peg.1733"," 817"
"7779",466,213,253,"AACCATCACGCCTTTATGAC","ACATGTTGGATTGTCATATG","561307.5.peg.1733"," 817"
"7780",207,310,103,"TGGATTGTCATATGAGGTGA","GGCAGTTTCTTCTAACGTAT","561307.5.peg.1733"," 817"
"7781",466,310,156,"AACCATCACGCCTTTATGAC","GGCAGTTTCTTCTAACGTAT","561307.5.peg.1733"," 817"
"7782",85,310,225,"TTGGTCTTGTGACATACTAA","GGCAGTTTCTTCTAACGTAT","561307.5.peg.1733"," 817"
"7783",137,310,173,"CATCTTGATGCATTGAAATA","GGCAGTTTCTTCTAACGTAT","561307.5.peg.1733"," 817"
"7784",436,310,126,"ATCAGAGGCAACGCGAATAG","GGCAGTTTCTTCTAACGTAT","561307.5.peg.1733"," 817"
"7785",137,436,299,"CATCTTGATGCATTGAAATA","ATCAGAGGCAACGCGAATAG","561307.5.peg.1733"," 817"
"7786",85,436,351,"TTGGTCTTGTGACATACTAA","ATCAGAGGCAACGCGAATAG","561307.5.peg.1733"," 817"
"7787",310,436,126,"GGCAGTTTCTTCTAACGTAT","ATCAGAGGCAACGCGAATAG","561307.5.peg.1733"," 817"
"7788",207,436,229,"TGGATTGTCATATGAGGTGA","ATCAGAGGCAACGCGAATAG","561307.5.peg.1733"," 817"
"7789",213,436,223,"ACATGTTGGATTGTCATATG","ATCAGAGGCAACGCGAATAG","561307.5.peg.1733"," 817"
"7790",137,466,329,"CATCTTGATGCATTGAAATA","AACCATCACGCCTTTATGAC","561307.5.peg.1733"," 817"
"7791",85,466,381,"TTGGTCTTGTGACATACTAA","AACCATCACGCCTTTATGAC","561307.5.peg.1733"," 817"
"7792",207,466,259,"TGGATTGTCATATGAGGTGA","AACCATCACGCCTTTATGAC","561307.5.peg.1733"," 817"
"7793",213,466,253,"ACATGTTGGATTGTCATATG","AACCATCACGCCTTTATGAC","561307.5.peg.1733"," 817"
"7794",310,466,156,"GGCAGTTTCTTCTAACGTAT","AACCATCACGCCTTTATGAC","561307.5.peg.1733"," 817"
"7795",237,9,228,"TACTTTCTTCAACGATAAA","AATAGTTTGGGATTAAAGG","561307.5.peg.1734"," 818"
"7796",261,9,252,"ACTAGCGCTTGATTACGTCT","AATAGTTTGGGATTAAAGG","561307.5.peg.1734"," 818"
"7797",237,87,150,"TACTTTCTTCAACGATAAA","ATAGCCGCACTTAATCCGCA","561307.5.peg.1734"," 818"
"7798",261,87,174,"ACTAGCGCTTGATTACGTCT","ATAGCCGCACTTAATCCGCA","561307.5.peg.1734"," 818"
"7799",9,237,228,"AATAGTTTGGGATTAAAGG","TACTTTCTTCAACGATAAA","561307.5.peg.1734"," 818"
"7800",87,237,150,"ATAGCCGCACTTAATCCGCA","TACTTTCTTCAACGATAAA","561307.5.peg.1734"," 818"
"7801",9,261,252,"AATAGTTTGGGATTAAAGG","ACTAGCGCTTGATTACGTCT","561307.5.peg.1734"," 818"
"7802",87,261,174,"ATAGCCGCACTTAATCCGCA","ACTAGCGCTTGATTACGTCT","561307.5.peg.1734"," 818"
"7803",360,143,217,"GGTGTACTGTCTTGATGGCT","CCTGATGTTCTAATTCTGAT","561307.5.peg.1735"," 819"
"7804",438,143,295,"TCATTGTCTTCGATTGGTTC","CCTGATGTTCTAATTCTGAT","561307.5.peg.1735"," 819"
"7805",365,143,222,"GTTGAGGTGTACTGTCTTGA","CCTGATGTTCTAATTCTGAT","561307.5.peg.1735"," 819"
"7806",381,143,238,"AATATTCCTCTTCATGTTG","CCTGATGTTCTAATTCTGAT","561307.5.peg.1735"," 819"
"7807",444,143,301,"GTTTATCATTGTCTTCGAT","CCTGATGTTCTAATTCTGAT","561307.5.peg.1735"," 819"
"7808",360,198,162,"GGTGTACTGTCTTGATGGCT","TTTCTTCTTTGGGCATTTCT","561307.5.peg.1735"," 819"
"7809",365,198,167,"GTTGAGGTGTACTGTCTTGA","TTTCTTCTTTGGGCATTTCT","561307.5.peg.1735"," 819"
"7810",381,198,183,"AATATTCCTCTTCATGTTG","TTTCTTCTTTGGGCATTTCT","561307.5.peg.1735"," 819"
"7811",438,198,240,"TCATTGTCTTCGATTGGTTC","TTTCTTCTTTGGGCATTTCT","561307.5.peg.1735"," 819"
"7812",444,198,246,"GTTTATCATTGTCTTCGAT","TTTCTTCTTTGGGCATTTCT","561307.5.peg.1735"," 819"
"7813",360,227,133,"GGTGTACTGTCTTGATGGCT","TATGATTCGTTGCTAAATCA","561307.5.peg.1735"," 819"
"7814",381,227,154,"AATATTCCTCTTCATGTTG","TATGATTCGTTGCTAAATCA","561307.5.peg.1735"," 819"
"7815",438,227,211,"TCATTGTCTTCGATTGGTTC","TATGATTCGTTGCTAAATCA","561307.5.peg.1735"," 819"
"7816",365,227,138,"GTTGAGGTGTACTGTCTTGA","TATGATTCGTTGCTAAATCA","561307.5.peg.1735"," 819"
"7817",444,227,217,"GTTTATCATTGTCTTCGAT","TATGATTCGTTGCTAAATCA","561307.5.peg.1735"," 819"
"7818",143,360,217,"CCTGATGTTCTAATTCTGAT","GGTGTACTGTCTTGATGGCT","561307.5.peg.1735"," 819"
"7819",198,360,162,"TTTCTTCTTTGGGCATTTCT","GGTGTACTGTCTTGATGGCT","561307.5.peg.1735"," 819"
"7820",227,360,133,"TATGATTCGTTGCTAAATCA","GGTGTACTGTCTTGATGGCT","561307.5.peg.1735"," 819"
"7821",198,365,167,"TTTCTTCTTTGGGCATTTCT","GTTGAGGTGTACTGTCTTGA","561307.5.peg.1735"," 819"
"7822",227,365,138,"TATGATTCGTTGCTAAATCA","GTTGAGGTGTACTGTCTTGA","561307.5.peg.1735"," 819"
"7823",143,365,222,"CCTGATGTTCTAATTCTGAT","GTTGAGGTGTACTGTCTTGA","561307.5.peg.1735"," 819"
"7824",227,381,154,"TATGATTCGTTGCTAAATCA","AATATTCCTCTTCATGTTG","561307.5.peg.1735"," 819"
"7825",198,381,183,"TTTCTTCTTTGGGCATTTCT","AATATTCCTCTTCATGTTG","561307.5.peg.1735"," 819"
"7826",143,381,238,"CCTGATGTTCTAATTCTGAT","AATATTCCTCTTCATGTTG","561307.5.peg.1735"," 819"
"7827",227,438,211,"TATGATTCGTTGCTAAATCA","TCATTGTCTTCGATTGGTTC","561307.5.peg.1735"," 819"
"7828",143,438,295,"CCTGATGTTCTAATTCTGAT","TCATTGTCTTCGATTGGTTC","561307.5.peg.1735"," 819"
"7829",198,438,240,"TTTCTTCTTTGGGCATTTCT","TCATTGTCTTCGATTGGTTC","561307.5.peg.1735"," 819"
"7830",143,444,301,"CCTGATGTTCTAATTCTGAT","GTTTATCATTGTCTTCGAT","561307.5.peg.1735"," 819"
"7831",198,444,246,"TTTCTTCTTTGGGCATTTCT","GTTTATCATTGTCTTCGAT","561307.5.peg.1735"," 819"
"7832",227,444,217,"TATGATTCGTTGCTAAATCA","GTTTATCATTGTCTTCGAT","561307.5.peg.1735"," 819"
"7833",492,9,483,"TTCCTATTAGAGCATAATG","TAATCGTTGGATTTGAAAG","561307.5.peg.1736"," 820"
"7834",216,9,207,"AACGGTGAGATAATTAATGT","TAATCGTTGGATTTGAAAG","561307.5.peg.1736"," 820"
"7835",381,9,372,"GACGGTTGCAGGAGAAATTC","TAATCGTTGGATTTGAAAG","561307.5.peg.1736"," 820"
"7836",705,9,696,"GGTCCCGACTGTTGTAGAAA","TAATCGTTGGATTTGAAAG","561307.5.peg.1736"," 820"
"7837",362,9,353,"CTGGACTTAGAAAGATGAAG","TAATCGTTGGATTTGAAAG","561307.5.peg.1736"," 820"
"7838",464,9,455,"AATCATATCCCCATTCAGAT","TAATCGTTGGATTTGAAAG","561307.5.peg.1736"," 820"
"7839",159,9,150,"AAACTCTTTCCACTTCCAGT","TAATCGTTGGATTTGAAAG","561307.5.peg.1736"," 820"
"7840",464,99,365,"AATCATATCCCCATTCAGAT","TCTATAATTTCCTGTTGTCC","561307.5.peg.1736"," 820"
"7841",216,99,117,"AACGGTGAGATAATTAATGT","TCTATAATTTCCTGTTGTCC","561307.5.peg.1736"," 820"
"7842",362,99,263,"CTGGACTTAGAAAGATGAAG","TCTATAATTTCCTGTTGTCC","561307.5.peg.1736"," 820"
"7843",381,99,282,"GACGGTTGCAGGAGAAATTC","TCTATAATTTCCTGTTGTCC","561307.5.peg.1736"," 820"
"7844",705,99,606,"GGTCCCGACTGTTGTAGAAA","TCTATAATTTCCTGTTGTCC","561307.5.peg.1736"," 820"
"7845",492,99,393,"TTCCTATTAGAGCATAATG","TCTATAATTTCCTGTTGTCC","561307.5.peg.1736"," 820"
"7846",9,159,150,"TAATCGTTGGATTTGAAAG","AAACTCTTTCCACTTCCAGT","561307.5.peg.1736"," 820"
"7847",362,159,203,"CTGGACTTAGAAAGATGAAG","AAACTCTTTCCACTTCCAGT","561307.5.peg.1736"," 820"
"7848",492,159,333,"TTCCTATTAGAGCATAATG","AAACTCTTTCCACTTCCAGT","561307.5.peg.1736"," 820"
"7849",705,159,546,"GGTCCCGACTGTTGTAGAAA","AAACTCTTTCCACTTCCAGT","561307.5.peg.1736"," 820"
"7850",464,159,305,"AATCATATCCCCATTCAGAT","AAACTCTTTCCACTTCCAGT","561307.5.peg.1736"," 820"
"7851",381,159,222,"GACGGTTGCAGGAGAAATTC","AAACTCTTTCCACTTCCAGT","561307.5.peg.1736"," 820"
"7852",99,216,117,"TCTATAATTTCCTGTTGTCC","AACGGTGAGATAATTAATGT","561307.5.peg.1736"," 820"
"7853",464,216,248,"AATCATATCCCCATTCAGAT","AACGGTGAGATAATTAATGT","561307.5.peg.1736"," 820"
"7854",705,216,489,"GGTCCCGACTGTTGTAGAAA","AACGGTGAGATAATTAATGT","561307.5.peg.1736"," 820"
"7855",362,216,146,"CTGGACTTAGAAAGATGAAG","AACGGTGAGATAATTAATGT","561307.5.peg.1736"," 820"
"7856",381,216,165,"GACGGTTGCAGGAGAAATTC","AACGGTGAGATAATTAATGT","561307.5.peg.1736"," 820"
"7857",9,216,207,"TAATCGTTGGATTTGAAAG","AACGGTGAGATAATTAATGT","561307.5.peg.1736"," 820"
"7858",492,216,276,"TTCCTATTAGAGCATAATG","AACGGTGAGATAATTAATGT","561307.5.peg.1736"," 820"
"7859",159,362,203,"AAACTCTTTCCACTTCCAGT","CTGGACTTAGAAAGATGAAG","561307.5.peg.1736"," 820"
"7860",705,362,343,"GGTCCCGACTGTTGTAGAAA","CTGGACTTAGAAAGATGAAG","561307.5.peg.1736"," 820"
"7861",216,362,146,"AACGGTGAGATAATTAATGT","CTGGACTTAGAAAGATGAAG","561307.5.peg.1736"," 820"
"7862",492,362,130,"TTCCTATTAGAGCATAATG","CTGGACTTAGAAAGATGAAG","561307.5.peg.1736"," 820"
"7863",464,362,102,"AATCATATCCCCATTCAGAT","CTGGACTTAGAAAGATGAAG","561307.5.peg.1736"," 820"
"7864",99,362,263,"TCTATAATTTCCTGTTGTCC","CTGGACTTAGAAAGATGAAG","561307.5.peg.1736"," 820"
"7865",9,362,353,"TAATCGTTGGATTTGAAAG","CTGGACTTAGAAAGATGAAG","561307.5.peg.1736"," 820"
"7866",9,381,372,"TAATCGTTGGATTTGAAAG","GACGGTTGCAGGAGAAATTC","561307.5.peg.1736"," 820"
"7867",159,381,222,"AAACTCTTTCCACTTCCAGT","GACGGTTGCAGGAGAAATTC","561307.5.peg.1736"," 820"
"7868",705,381,324,"GGTCCCGACTGTTGTAGAAA","GACGGTTGCAGGAGAAATTC","561307.5.peg.1736"," 820"
"7869",99,381,282,"TCTATAATTTCCTGTTGTCC","GACGGTTGCAGGAGAAATTC","561307.5.peg.1736"," 820"
"7870",492,381,111,"TTCCTATTAGAGCATAATG","GACGGTTGCAGGAGAAATTC","561307.5.peg.1736"," 820"
"7871",216,381,165,"AACGGTGAGATAATTAATGT","GACGGTTGCAGGAGAAATTC","561307.5.peg.1736"," 820"
"7872",99,464,365,"TCTATAATTTCCTGTTGTCC","AATCATATCCCCATTCAGAT","561307.5.peg.1736"," 820"
"7873",9,464,455,"TAATCGTTGGATTTGAAAG","AATCATATCCCCATTCAGAT","561307.5.peg.1736"," 820"
"7874",159,464,305,"AAACTCTTTCCACTTCCAGT","AATCATATCCCCATTCAGAT","561307.5.peg.1736"," 820"
"7875",216,464,248,"AACGGTGAGATAATTAATGT","AATCATATCCCCATTCAGAT","561307.5.peg.1736"," 820"
"7876",362,464,102,"CTGGACTTAGAAAGATGAAG","AATCATATCCCCATTCAGAT","561307.5.peg.1736"," 820"
"7877",705,464,241,"GGTCCCGACTGTTGTAGAAA","AATCATATCCCCATTCAGAT","561307.5.peg.1736"," 820"
"7878",362,492,130,"CTGGACTTAGAAAGATGAAG","TTCCTATTAGAGCATAATG","561307.5.peg.1736"," 820"
"7879",9,492,483,"TAATCGTTGGATTTGAAAG","TTCCTATTAGAGCATAATG","561307.5.peg.1736"," 820"
"7880",159,492,333,"AAACTCTTTCCACTTCCAGT","TTCCTATTAGAGCATAATG","561307.5.peg.1736"," 820"
"7881",216,492,276,"AACGGTGAGATAATTAATGT","TTCCTATTAGAGCATAATG","561307.5.peg.1736"," 820"
"7882",381,492,111,"GACGGTTGCAGGAGAAATTC","TTCCTATTAGAGCATAATG","561307.5.peg.1736"," 820"
"7883",705,492,213,"GGTCCCGACTGTTGTAGAAA","TTCCTATTAGAGCATAATG","561307.5.peg.1736"," 820"
"7884",99,492,393,"TCTATAATTTCCTGTTGTCC","TTCCTATTAGAGCATAATG","561307.5.peg.1736"," 820"
"7885",381,705,324,"GACGGTTGCAGGAGAAATTC","GGTCCCGACTGTTGTAGAAA","561307.5.peg.1736"," 820"
"7886",492,705,213,"TTCCTATTAGAGCATAATG","GGTCCCGACTGTTGTAGAAA","561307.5.peg.1736"," 820"
"7887",99,705,606,"TCTATAATTTCCTGTTGTCC","GGTCCCGACTGTTGTAGAAA","561307.5.peg.1736"," 820"
"7888",362,705,343,"CTGGACTTAGAAAGATGAAG","GGTCCCGACTGTTGTAGAAA","561307.5.peg.1736"," 820"
"7889",159,705,546,"AAACTCTTTCCACTTCCAGT","GGTCCCGACTGTTGTAGAAA","561307.5.peg.1736"," 820"
"7890",216,705,489,"AACGGTGAGATAATTAATGT","GGTCCCGACTGTTGTAGAAA","561307.5.peg.1736"," 820"
"7891",9,705,696,"TAATCGTTGGATTTGAAAG","GGTCCCGACTGTTGTAGAAA","561307.5.peg.1736"," 820"
"7892",464,705,241,"AATCATATCCCCATTCAGAT","GGTCCCGACTGTTGTAGAAA","561307.5.peg.1736"," 820"
"7893",174,10,164,"GTAAATGTAGCTAGTAGTGA","ATTCATCTCGTAAGAATAGG","561307.5.peg.1739"," 823"
"7894",204,10,194,"GCAACTACGATACCGGCAAC","ATTCATCTCGTAAGAATAGG","561307.5.peg.1739"," 823"
"7895",211,10,201,"AACCAGTGCAACTACGATAC","ATTCATCTCGTAAGAATAGG","561307.5.peg.1739"," 823"
"7896",204,13,191,"GCAACTACGATACCGGCAAC","TCCATTCATCTCGTAAGAAT","561307.5.peg.1739"," 823"
"7897",204,13,191,"GCAACTACGATACCGGCAAC","ATTCTTACGAGATGAATGGA","561307.5.peg.1739"," 823"
"7898",174,13,161,"GTAAATGTAGCTAGTAGTGA","TCCATTCATCTCGTAAGAAT","561307.5.peg.1739"," 823"
"7899",174,13,161,"GTAAATGTAGCTAGTAGTGA","ATTCTTACGAGATGAATGGA","561307.5.peg.1739"," 823"
"7900",211,13,198,"AACCAGTGCAACTACGATAC","TCCATTCATCTCGTAAGAAT","561307.5.peg.1739"," 823"
"7901",211,13,198,"AACCAGTGCAACTACGATAC","ATTCTTACGAGATGAATGGA","561307.5.peg.1739"," 823"
"7902",211,13,198,"AACCAGTGCAACTACGATAC","TCCATTCATCTCGTAAGAAT","561307.5.peg.1739"," 823"
"7903",211,13,198,"AACCAGTGCAACTACGATAC","ATTCTTACGAGATGAATGGA","561307.5.peg.1739"," 823"
"7904",174,13,161,"GTAAATGTAGCTAGTAGTGA","TCCATTCATCTCGTAAGAAT","561307.5.peg.1739"," 823"
"7905",174,13,161,"GTAAATGTAGCTAGTAGTGA","ATTCTTACGAGATGAATGGA","561307.5.peg.1739"," 823"
"7906",204,13,191,"GCAACTACGATACCGGCAAC","TCCATTCATCTCGTAAGAAT","561307.5.peg.1739"," 823"
"7907",204,13,191,"GCAACTACGATACCGGCAAC","ATTCTTACGAGATGAATGGA","561307.5.peg.1739"," 823"
"7908",211,17,194,"AACCAGTGCAACTACGATAC","TCCTATTCTTACGAGATGAA","561307.5.peg.1739"," 823"
"7909",174,17,157,"GTAAATGTAGCTAGTAGTGA","TCCTATTCTTACGAGATGAA","561307.5.peg.1739"," 823"
"7910",204,17,187,"GCAACTACGATACCGGCAAC","TCCTATTCTTACGAGATGAA","561307.5.peg.1739"," 823"
"7911",10,174,164,"ATTCATCTCGTAAGAATAGG","GTAAATGTAGCTAGTAGTGA","561307.5.peg.1739"," 823"
"7912",13,174,161,"TCCATTCATCTCGTAAGAAT","GTAAATGTAGCTAGTAGTGA","561307.5.peg.1739"," 823"
"7913",13,174,161,"ATTCTTACGAGATGAATGGA","GTAAATGTAGCTAGTAGTGA","561307.5.peg.1739"," 823"
"7914",13,174,161,"TCCATTCATCTCGTAAGAAT","GTAAATGTAGCTAGTAGTGA","561307.5.peg.1739"," 823"
"7915",13,174,161,"ATTCTTACGAGATGAATGGA","GTAAATGTAGCTAGTAGTGA","561307.5.peg.1739"," 823"
"7916",17,174,157,"TCCTATTCTTACGAGATGAA","GTAAATGTAGCTAGTAGTGA","561307.5.peg.1739"," 823"
"7917",10,204,194,"ATTCATCTCGTAAGAATAGG","GCAACTACGATACCGGCAAC","561307.5.peg.1739"," 823"
"7918",13,204,191,"ATTCTTACGAGATGAATGGA","GCAACTACGATACCGGCAAC","561307.5.peg.1739"," 823"
"7919",13,204,191,"ATTCTTACGAGATGAATGGA","GCAACTACGATACCGGCAAC","561307.5.peg.1739"," 823"
"7920",13,204,191,"TCCATTCATCTCGTAAGAAT","GCAACTACGATACCGGCAAC","561307.5.peg.1739"," 823"
"7921",13,204,191,"TCCATTCATCTCGTAAGAAT","GCAACTACGATACCGGCAAC","561307.5.peg.1739"," 823"
"7922",17,204,187,"TCCTATTCTTACGAGATGAA","GCAACTACGATACCGGCAAC","561307.5.peg.1739"," 823"
"7923",10,211,201,"ATTCATCTCGTAAGAATAGG","AACCAGTGCAACTACGATAC","561307.5.peg.1739"," 823"
"7924",13,211,198,"TCCATTCATCTCGTAAGAAT","AACCAGTGCAACTACGATAC","561307.5.peg.1739"," 823"
"7925",13,211,198,"ATTCTTACGAGATGAATGGA","AACCAGTGCAACTACGATAC","561307.5.peg.1739"," 823"
"7926",13,211,198,"TCCATTCATCTCGTAAGAAT","AACCAGTGCAACTACGATAC","561307.5.peg.1739"," 823"
"7927",13,211,198,"ATTCTTACGAGATGAATGGA","AACCAGTGCAACTACGATAC","561307.5.peg.1739"," 823"
"7928",17,211,194,"TCCTATTCTTACGAGATGAA","AACCAGTGCAACTACGATAC","561307.5.peg.1739"," 823"
"7929",183,8,175,"CGTAATGACCTTTAATTCT","ACAGAGATGATCAGGCTCGG","561307.5.peg.174"," 824"
"7930",183,11,172,"CGTAATGACCTTTAATTCT","ATGACAGAGATGATCAGGCT","561307.5.peg.174"," 824"
"7931",183,16,167,"CGTAATGACCTTTAATTCT","ACTATATGACAGAGATGATC","561307.5.peg.174"," 824"
"7932",8,183,175,"ACAGAGATGATCAGGCTCGG","CGTAATGACCTTTAATTCT","561307.5.peg.174"," 824"
"7933",11,183,172,"ATGACAGAGATGATCAGGCT","CGTAATGACCTTTAATTCT","561307.5.peg.174"," 824"
"7934",16,183,167,"ACTATATGACAGAGATGATC","CGTAATGACCTTTAATTCT","561307.5.peg.174"," 824"
"7935",231,8,223,"CAGAAACATTATACTCCTT","AAGATGAAGCTGAAATATAG","561307.5.peg.1745"," 830"
"7936",231,10,221,"CAGAAACATTATACTCCTT","GCAAGATGAAGCTGAAATAT","561307.5.peg.1745"," 830"
"7937",8,231,223,"AAGATGAAGCTGAAATATAG","CAGAAACATTATACTCCTT","561307.5.peg.1745"," 830"
"7938",10,231,221,"GCAAGATGAAGCTGAAATAT","CAGAAACATTATACTCCTT","561307.5.peg.1745"," 830"
"7939",655,106,549,"ATAGCCATTGACAATGACTA","GGGCGGGAATATTAAATTTC","561307.5.peg.1751"," 837"
"7940",591,106,485,"TCCAAACTTCCTGAAATGAA","GGGCGGGAATATTAAATTTC","561307.5.peg.1751"," 837"
"7941",545,106,439,"GTGCACTTAGTGCAGATTCA","GGGCGGGAATATTAAATTTC","561307.5.peg.1751"," 837"
"7942",430,106,324,"AAACTAATCCAGTAAACGA","GGGCGGGAATATTAAATTTC","561307.5.peg.1751"," 837"
"7943",381,106,275,"AAAGTCCATTGGTTATGCAC","GGGCGGGAATATTAAATTTC","561307.5.peg.1751"," 837"
"7944",655,122,533,"ATAGCCATTGACAATGACTA","CTGTATGGCCAAGCATGGGC","561307.5.peg.1751"," 837"
"7945",545,122,423,"GTGCACTTAGTGCAGATTCA","CTGTATGGCCAAGCATGGGC","561307.5.peg.1751"," 837"
"7946",430,122,308,"AAACTAATCCAGTAAACGA","CTGTATGGCCAAGCATGGGC","561307.5.peg.1751"," 837"
"7947",381,122,259,"AAAGTCCATTGGTTATGCAC","CTGTATGGCCAAGCATGGGC","561307.5.peg.1751"," 837"
"7948",591,122,469,"TCCAAACTTCCTGAAATGAA","CTGTATGGCCAAGCATGGGC","561307.5.peg.1751"," 837"
"7949",381,126,255,"AAAGTCCATTGGTTATGCAC","CCCGCTGTATGGCCAAGCAT","561307.5.peg.1751"," 837"
"7950",591,126,465,"TCCAAACTTCCTGAAATGAA","CCCGCTGTATGGCCAAGCAT","561307.5.peg.1751"," 837"
"7951",430,126,304,"AAACTAATCCAGTAAACGA","CCCGCTGTATGGCCAAGCAT","561307.5.peg.1751"," 837"
"7952",655,126,529,"ATAGCCATTGACAATGACTA","CCCGCTGTATGGCCAAGCAT","561307.5.peg.1751"," 837"
"7953",545,126,419,"GTGCACTTAGTGCAGATTCA","CCCGCTGTATGGCCAAGCAT","561307.5.peg.1751"," 837"
"7954",430,181,249,"AAACTAATCCAGTAAACGA","GGGGAGTAATATGCCTGTAA","561307.5.peg.1751"," 837"
"7955",545,181,364,"GTGCACTTAGTGCAGATTCA","GGGGAGTAATATGCCTGTAA","561307.5.peg.1751"," 837"
"7956",381,181,200,"AAAGTCCATTGGTTATGCAC","GGGGAGTAATATGCCTGTAA","561307.5.peg.1751"," 837"
"7957",591,181,410,"TCCAAACTTCCTGAAATGAA","GGGGAGTAATATGCCTGTAA","561307.5.peg.1751"," 837"
"7958",655,181,474,"ATAGCCATTGACAATGACTA","GGGGAGTAATATGCCTGTAA","561307.5.peg.1751"," 837"
"7959",122,381,259,"CTGTATGGCCAAGCATGGGC","AAAGTCCATTGGTTATGCAC","561307.5.peg.1751"," 837"
"7960",591,381,210,"TCCAAACTTCCTGAAATGAA","AAAGTCCATTGGTTATGCAC","561307.5.peg.1751"," 837"
"7961",181,381,200,"GGGGAGTAATATGCCTGTAA","AAAGTCCATTGGTTATGCAC","561307.5.peg.1751"," 837"
"7962",126,381,255,"CCCGCTGTATGGCCAAGCAT","AAAGTCCATTGGTTATGCAC","561307.5.peg.1751"," 837"
"7963",106,381,275,"GGGCGGGAATATTAAATTTC","AAAGTCCATTGGTTATGCAC","561307.5.peg.1751"," 837"
"7964",545,381,164,"GTGCACTTAGTGCAGATTCA","AAAGTCCATTGGTTATGCAC","561307.5.peg.1751"," 837"
"7965",655,381,274,"ATAGCCATTGACAATGACTA","AAAGTCCATTGGTTATGCAC","561307.5.peg.1751"," 837"
"7966",122,430,308,"CTGTATGGCCAAGCATGGGC","AAACTAATCCAGTAAACGA","561307.5.peg.1751"," 837"
"7967",181,430,249,"GGGGAGTAATATGCCTGTAA","AAACTAATCCAGTAAACGA","561307.5.peg.1751"," 837"
"7968",126,430,304,"CCCGCTGTATGGCCAAGCAT","AAACTAATCCAGTAAACGA","561307.5.peg.1751"," 837"
"7969",545,430,115,"GTGCACTTAGTGCAGATTCA","AAACTAATCCAGTAAACGA","561307.5.peg.1751"," 837"
"7970",106,430,324,"GGGCGGGAATATTAAATTTC","AAACTAATCCAGTAAACGA","561307.5.peg.1751"," 837"
"7971",591,430,161,"TCCAAACTTCCTGAAATGAA","AAACTAATCCAGTAAACGA","561307.5.peg.1751"," 837"
"7972",655,430,225,"ATAGCCATTGACAATGACTA","AAACTAATCCAGTAAACGA","561307.5.peg.1751"," 837"
"7973",106,545,439,"GGGCGGGAATATTAAATTTC","GTGCACTTAGTGCAGATTCA","561307.5.peg.1751"," 837"
"7974",181,545,364,"GGGGAGTAATATGCCTGTAA","GTGCACTTAGTGCAGATTCA","561307.5.peg.1751"," 837"
"7975",655,545,110,"ATAGCCATTGACAATGACTA","GTGCACTTAGTGCAGATTCA","561307.5.peg.1751"," 837"
"7976",122,545,423,"CTGTATGGCCAAGCATGGGC","GTGCACTTAGTGCAGATTCA","561307.5.peg.1751"," 837"
"7977",381,545,164,"AAAGTCCATTGGTTATGCAC","GTGCACTTAGTGCAGATTCA","561307.5.peg.1751"," 837"
"7978",126,545,419,"CCCGCTGTATGGCCAAGCAT","GTGCACTTAGTGCAGATTCA","561307.5.peg.1751"," 837"
"7979",430,545,115,"AAACTAATCCAGTAAACGA","GTGCACTTAGTGCAGATTCA","561307.5.peg.1751"," 837"
"7980",381,591,210,"AAAGTCCATTGGTTATGCAC","TCCAAACTTCCTGAAATGAA","561307.5.peg.1751"," 837"
"7981",106,591,485,"GGGCGGGAATATTAAATTTC","TCCAAACTTCCTGAAATGAA","561307.5.peg.1751"," 837"
"7982",181,591,410,"GGGGAGTAATATGCCTGTAA","TCCAAACTTCCTGAAATGAA","561307.5.peg.1751"," 837"
"7983",122,591,469,"CTGTATGGCCAAGCATGGGC","TCCAAACTTCCTGAAATGAA","561307.5.peg.1751"," 837"
"7984",126,591,465,"CCCGCTGTATGGCCAAGCAT","TCCAAACTTCCTGAAATGAA","561307.5.peg.1751"," 837"
"7985",430,591,161,"AAACTAATCCAGTAAACGA","TCCAAACTTCCTGAAATGAA","561307.5.peg.1751"," 837"
"7986",106,655,549,"GGGCGGGAATATTAAATTTC","ATAGCCATTGACAATGACTA","561307.5.peg.1751"," 837"
"7987",545,655,110,"GTGCACTTAGTGCAGATTCA","ATAGCCATTGACAATGACTA","561307.5.peg.1751"," 837"
"7988",122,655,533,"CTGTATGGCCAAGCATGGGC","ATAGCCATTGACAATGACTA","561307.5.peg.1751"," 837"
"7989",181,655,474,"GGGGAGTAATATGCCTGTAA","ATAGCCATTGACAATGACTA","561307.5.peg.1751"," 837"
"7990",381,655,274,"AAAGTCCATTGGTTATGCAC","ATAGCCATTGACAATGACTA","561307.5.peg.1751"," 837"
"7991",126,655,529,"CCCGCTGTATGGCCAAGCAT","ATAGCCATTGACAATGACTA","561307.5.peg.1751"," 837"
"7992",430,655,225,"AAACTAATCCAGTAAACGA","ATAGCCATTGACAATGACTA","561307.5.peg.1751"," 837"
"7993",390,232,158,"TTATGCCCTTCTATTAAACT","AGATTGTTGCACAGTTTGAT","561307.5.peg.1753"," 839"
"7994",232,390,158,"AGATTGTTGCACAGTTTGAT","TTATGCCCTTCTATTAAACT","561307.5.peg.1753"," 839"
"7995",123,3,120,"CCCATGGCACGCATACCATT","ATTATCGTAATGGGGGTCAA","561307.5.peg.1755"," 841"
"7996",363,3,360,"ATATAACCCGCAAAGAAACC","ATTATCGTAATGGGGGTCAA","561307.5.peg.1755"," 841"
"7997",139,3,136,"TGCATTAGCTAATGCTCCCA","ATTATCGTAATGGGGGTCAA","561307.5.peg.1755"," 841"
"7998",498,3,495,"TCAATGTACTATTCACTAC","ATTATCGTAATGGGGGTCAA","561307.5.peg.1755"," 841"
"7999",423,3,420,"CCAATTAAGTCGACACCATC","ATTATCGTAATGGGGGTCAA","561307.5.peg.1755"," 841"
"8000",539,3,536,"GATTCGTATTCGTACTACTT","ATTATCGTAATGGGGGTCAA","561307.5.peg.1755"," 841"
"8001",337,3,334,"TAAATCCATACCACCGCACG","ATTATCGTAATGGGGGTCAA","561307.5.peg.1755"," 841"
"8002",465,3,462,"ACTGCAATAAGACGAGCTAA","ATTATCGTAATGGGGGTCAA","561307.5.peg.1755"," 841"
"8003",498,123,375,"TCAATGTACTATTCACTAC","CCCATGGCACGCATACCATT","561307.5.peg.1755"," 841"
"8004",539,123,416,"GATTCGTATTCGTACTACTT","CCCATGGCACGCATACCATT","561307.5.peg.1755"," 841"
"8005",465,123,342,"ACTGCAATAAGACGAGCTAA","CCCATGGCACGCATACCATT","561307.5.peg.1755"," 841"
"8006",3,123,120,"ATTATCGTAATGGGGGTCAA","CCCATGGCACGCATACCATT","561307.5.peg.1755"," 841"
"8007",337,123,214,"TAAATCCATACCACCGCACG","CCCATGGCACGCATACCATT","561307.5.peg.1755"," 841"
"8008",363,123,240,"ATATAACCCGCAAAGAAACC","CCCATGGCACGCATACCATT","561307.5.peg.1755"," 841"
"8009",423,123,300,"CCAATTAAGTCGACACCATC","CCCATGGCACGCATACCATT","561307.5.peg.1755"," 841"
"8010",363,139,224,"ATATAACCCGCAAAGAAACC","TGCATTAGCTAATGCTCCCA","561307.5.peg.1755"," 841"
"8011",498,139,359,"TCAATGTACTATTCACTAC","TGCATTAGCTAATGCTCCCA","561307.5.peg.1755"," 841"
"8012",465,139,326,"ACTGCAATAAGACGAGCTAA","TGCATTAGCTAATGCTCCCA","561307.5.peg.1755"," 841"
"8013",539,139,400,"GATTCGTATTCGTACTACTT","TGCATTAGCTAATGCTCCCA","561307.5.peg.1755"," 841"
"8014",337,139,198,"TAAATCCATACCACCGCACG","TGCATTAGCTAATGCTCCCA","561307.5.peg.1755"," 841"
"8015",423,139,284,"CCAATTAAGTCGACACCATC","TGCATTAGCTAATGCTCCCA","561307.5.peg.1755"," 841"
"8016",3,139,136,"ATTATCGTAATGGGGGTCAA","TGCATTAGCTAATGCTCCCA","561307.5.peg.1755"," 841"
"8017",3,337,334,"ATTATCGTAATGGGGGTCAA","TAAATCCATACCACCGCACG","561307.5.peg.1755"," 841"
"8018",539,337,202,"GATTCGTATTCGTACTACTT","TAAATCCATACCACCGCACG","561307.5.peg.1755"," 841"
"8019",139,337,198,"TGCATTAGCTAATGCTCCCA","TAAATCCATACCACCGCACG","561307.5.peg.1755"," 841"
"8020",465,337,128,"ACTGCAATAAGACGAGCTAA","TAAATCCATACCACCGCACG","561307.5.peg.1755"," 841"
"8021",498,337,161,"TCAATGTACTATTCACTAC","TAAATCCATACCACCGCACG","561307.5.peg.1755"," 841"
"8022",123,337,214,"CCCATGGCACGCATACCATT","TAAATCCATACCACCGCACG","561307.5.peg.1755"," 841"
"8023",3,363,360,"ATTATCGTAATGGGGGTCAA","ATATAACCCGCAAAGAAACC","561307.5.peg.1755"," 841"
"8024",123,363,240,"CCCATGGCACGCATACCATT","ATATAACCCGCAAAGAAACC","561307.5.peg.1755"," 841"
"8025",498,363,135,"TCAATGTACTATTCACTAC","ATATAACCCGCAAAGAAACC","561307.5.peg.1755"," 841"
"8026",139,363,224,"TGCATTAGCTAATGCTCCCA","ATATAACCCGCAAAGAAACC","561307.5.peg.1755"," 841"
"8027",539,363,176,"GATTCGTATTCGTACTACTT","ATATAACCCGCAAAGAAACC","561307.5.peg.1755"," 841"
"8028",465,363,102,"ACTGCAATAAGACGAGCTAA","ATATAACCCGCAAAGAAACC","561307.5.peg.1755"," 841"
"8029",139,423,284,"TGCATTAGCTAATGCTCCCA","CCAATTAAGTCGACACCATC","561307.5.peg.1755"," 841"
"8030",123,423,300,"CCCATGGCACGCATACCATT","CCAATTAAGTCGACACCATC","561307.5.peg.1755"," 841"
"8031",539,423,116,"GATTCGTATTCGTACTACTT","CCAATTAAGTCGACACCATC","561307.5.peg.1755"," 841"
"8032",3,423,420,"ATTATCGTAATGGGGGTCAA","CCAATTAAGTCGACACCATC","561307.5.peg.1755"," 841"
"8033",363,465,102,"ATATAACCCGCAAAGAAACC","ACTGCAATAAGACGAGCTAA","561307.5.peg.1755"," 841"
"8034",337,465,128,"TAAATCCATACCACCGCACG","ACTGCAATAAGACGAGCTAA","561307.5.peg.1755"," 841"
"8035",123,465,342,"CCCATGGCACGCATACCATT","ACTGCAATAAGACGAGCTAA","561307.5.peg.1755"," 841"
"8036",3,465,462,"ATTATCGTAATGGGGGTCAA","ACTGCAATAAGACGAGCTAA","561307.5.peg.1755"," 841"
"8037",139,465,326,"TGCATTAGCTAATGCTCCCA","ACTGCAATAAGACGAGCTAA","561307.5.peg.1755"," 841"
"8038",363,498,135,"ATATAACCCGCAAAGAAACC","TCAATGTACTATTCACTAC","561307.5.peg.1755"," 841"
"8039",337,498,161,"TAAATCCATACCACCGCACG","TCAATGTACTATTCACTAC","561307.5.peg.1755"," 841"
"8040",139,498,359,"TGCATTAGCTAATGCTCCCA","TCAATGTACTATTCACTAC","561307.5.peg.1755"," 841"
"8041",123,498,375,"CCCATGGCACGCATACCATT","TCAATGTACTATTCACTAC","561307.5.peg.1755"," 841"
"8042",3,498,495,"ATTATCGTAATGGGGGTCAA","TCAATGTACTATTCACTAC","561307.5.peg.1755"," 841"
"8043",423,539,116,"CCAATTAAGTCGACACCATC","GATTCGTATTCGTACTACTT","561307.5.peg.1755"," 841"
"8044",139,539,400,"TGCATTAGCTAATGCTCCCA","GATTCGTATTCGTACTACTT","561307.5.peg.1755"," 841"
"8045",123,539,416,"CCCATGGCACGCATACCATT","GATTCGTATTCGTACTACTT","561307.5.peg.1755"," 841"
"8046",337,539,202,"TAAATCCATACCACCGCACG","GATTCGTATTCGTACTACTT","561307.5.peg.1755"," 841"
"8047",363,539,176,"ATATAACCCGCAAAGAAACC","GATTCGTATTCGTACTACTT","561307.5.peg.1755"," 841"
"8048",3,539,536,"ATTATCGTAATGGGGGTCAA","GATTCGTATTCGTACTACTT","561307.5.peg.1755"," 841"
"8049",436,96,340,"TCCAAATTCATAAATGGTG","AGTTCACGTTGTGAAATAAA","561307.5.peg.1756"," 842"
"8050",303,96,207,"ATAGAGCGTGTTGACGTTAC","AGTTCACGTTGTGAAATAAA","561307.5.peg.1756"," 842"
"8051",225,96,129,"GCTGCGCCAATACAAACAAT","AGTTCACGTTGTGAAATAAA","561307.5.peg.1756"," 842"
"8052",303,144,159,"ATAGAGCGTGTTGACGTTAC","GAAATAATGTTTGCTACGCT","561307.5.peg.1756"," 842"
"8053",436,144,292,"TCCAAATTCATAAATGGTG","GAAATAATGTTTGCTACGCT","561307.5.peg.1756"," 842"
"8054",96,225,129,"AGTTCACGTTGTGAAATAAA","GCTGCGCCAATACAAACAAT","561307.5.peg.1756"," 842"
"8055",436,225,211,"TCCAAATTCATAAATGGTG","GCTGCGCCAATACAAACAAT","561307.5.peg.1756"," 842"
"8056",96,303,207,"AGTTCACGTTGTGAAATAAA","ATAGAGCGTGTTGACGTTAC","561307.5.peg.1756"," 842"
"8057",436,303,133,"TCCAAATTCATAAATGGTG","ATAGAGCGTGTTGACGTTAC","561307.5.peg.1756"," 842"
"8058",144,303,159,"GAAATAATGTTTGCTACGCT","ATAGAGCGTGTTGACGTTAC","561307.5.peg.1756"," 842"
"8059",225,436,211,"GCTGCGCCAATACAAACAAT","TCCAAATTCATAAATGGTG","561307.5.peg.1756"," 842"
"8060",144,436,292,"GAAATAATGTTTGCTACGCT","TCCAAATTCATAAATGGTG","561307.5.peg.1756"," 842"
"8061",96,436,340,"AGTTCACGTTGTGAAATAAA","TCCAAATTCATAAATGGTG","561307.5.peg.1756"," 842"
"8062",303,436,133,"ATAGAGCGTGTTGACGTTAC","TCCAAATTCATAAATGGTG","561307.5.peg.1756"," 842"
"8063",117,7,110,"GTTGATTCTAATGCTACAAT","GATAAAGTTGCTGTTGATCT","561307.5.peg.1757"," 843"
"8064",220,7,213,"AATGGCTATGGTTGCTGGAA","GATAAAGTTGCTGTTGATCT","561307.5.peg.1757"," 843"
"8065",232,7,225,"TTTGCCATCTATAATGGCTA","GATAAAGTTGCTGTTGATCT","561307.5.peg.1757"," 843"
"8066",225,7,218,"TCTATAATGGCTATGGTTGC","GATAAAGTTGCTGTTGATCT","561307.5.peg.1757"," 843"
"8067",225,10,215,"TCTATAATGGCTATGGTTGC","GCAACTTTATCACGATATGG","561307.5.peg.1757"," 843"
"8068",220,10,210,"AATGGCTATGGTTGCTGGAA","GCAACTTTATCACGATATGG","561307.5.peg.1757"," 843"
"8069",117,10,107,"GTTGATTCTAATGCTACAAT","GCAACTTTATCACGATATGG","561307.5.peg.1757"," 843"
"8070",232,10,222,"TTTGCCATCTATAATGGCTA","GCAACTTTATCACGATATGG","561307.5.peg.1757"," 843"
"8071",7,117,110,"GATAAAGTTGCTGTTGATCT","GTTGATTCTAATGCTACAAT","561307.5.peg.1757"," 843"
"8072",220,117,103,"AATGGCTATGGTTGCTGGAA","GTTGATTCTAATGCTACAAT","561307.5.peg.1757"," 843"
"8073",232,117,115,"TTTGCCATCTATAATGGCTA","GTTGATTCTAATGCTACAAT","561307.5.peg.1757"," 843"
"8074",10,117,107,"GCAACTTTATCACGATATGG","GTTGATTCTAATGCTACAAT","561307.5.peg.1757"," 843"
"8075",225,117,108,"TCTATAATGGCTATGGTTGC","GTTGATTCTAATGCTACAAT","561307.5.peg.1757"," 843"
"8076",7,220,213,"GATAAAGTTGCTGTTGATCT","AATGGCTATGGTTGCTGGAA","561307.5.peg.1757"," 843"
"8077",10,220,210,"GCAACTTTATCACGATATGG","AATGGCTATGGTTGCTGGAA","561307.5.peg.1757"," 843"
"8078",117,220,103,"GTTGATTCTAATGCTACAAT","AATGGCTATGGTTGCTGGAA","561307.5.peg.1757"," 843"
"8079",7,225,218,"GATAAAGTTGCTGTTGATCT","TCTATAATGGCTATGGTTGC","561307.5.peg.1757"," 843"
"8080",117,225,108,"GTTGATTCTAATGCTACAAT","TCTATAATGGCTATGGTTGC","561307.5.peg.1757"," 843"
"8081",10,225,215,"GCAACTTTATCACGATATGG","TCTATAATGGCTATGGTTGC","561307.5.peg.1757"," 843"
"8082",117,232,115,"GTTGATTCTAATGCTACAAT","TTTGCCATCTATAATGGCTA","561307.5.peg.1757"," 843"
"8083",10,232,222,"GCAACTTTATCACGATATGG","TTTGCCATCTATAATGGCTA","561307.5.peg.1757"," 843"
"8084",7,232,225,"GATAAAGTTGCTGTTGATCT","TTTGCCATCTATAATGGCTA","561307.5.peg.1757"," 843"
"8085",157,10,147,"ACTTGCGGTAAAGAAACTAT","GAATCAATACATTGTAAAG","561307.5.peg.1759"," 845"
"8086",515,10,505,"CGAGTGATGCAACGATATAA","GAATCAATACATTGTAAAG","561307.5.peg.1759"," 845"
"8087",172,10,162,"AGATGGCAAGCGACCACTTG","GAATCAATACATTGTAAAG","561307.5.peg.1759"," 845"
"8088",136,10,126,"GGTACTTTGGCTCGCGCGCT","GAATCAATACATTGTAAAG","561307.5.peg.1759"," 845"
"8089",404,10,394,"AGCCAATGACACGTATGCTA","GAATCAATACATTGTAAAG","561307.5.peg.1759"," 845"
"8090",446,10,436,"CAATTGCAACACGCCCTAAA","GAATCAATACATTGTAAAG","561307.5.peg.1759"," 845"
"8091",172,48,124,"AGATGGCAAGCGACCACTTG","CCAAATCCAACTTCTTTCAT","561307.5.peg.1759"," 845"
"8092",446,48,398,"CAATTGCAACACGCCCTAAA","CCAAATCCAACTTCTTTCAT","561307.5.peg.1759"," 845"
"8093",157,48,109,"ACTTGCGGTAAAGAAACTAT","CCAAATCCAACTTCTTTCAT","561307.5.peg.1759"," 845"
"8094",515,48,467,"CGAGTGATGCAACGATATAA","CCAAATCCAACTTCTTTCAT","561307.5.peg.1759"," 845"
"8095",404,48,356,"AGCCAATGACACGTATGCTA","CCAAATCCAACTTCTTTCAT","561307.5.peg.1759"," 845"
"8096",446,88,358,"CAATTGCAACACGCCCTAAA","GCTAGTAGATAAATGATAA","561307.5.peg.1759"," 845"
"8097",515,88,427,"CGAGTGATGCAACGATATAA","GCTAGTAGATAAATGATAA","561307.5.peg.1759"," 845"
"8098",404,88,316,"AGCCAATGACACGTATGCTA","GCTAGTAGATAAATGATAA","561307.5.peg.1759"," 845"
"8099",446,136,310,"CAATTGCAACACGCCCTAAA","GGTACTTTGGCTCGCGCGCT","561307.5.peg.1759"," 845"
"8100",515,136,379,"CGAGTGATGCAACGATATAA","GGTACTTTGGCTCGCGCGCT","561307.5.peg.1759"," 845"
"8101",10,136,126,"GAATCAATACATTGTAAAG","GGTACTTTGGCTCGCGCGCT","561307.5.peg.1759"," 845"
"8102",404,136,268,"AGCCAATGACACGTATGCTA","GGTACTTTGGCTCGCGCGCT","561307.5.peg.1759"," 845"
"8103",515,157,358,"CGAGTGATGCAACGATATAA","ACTTGCGGTAAAGAAACTAT","561307.5.peg.1759"," 845"
"8104",404,157,247,"AGCCAATGACACGTATGCTA","ACTTGCGGTAAAGAAACTAT","561307.5.peg.1759"," 845"
"8105",10,157,147,"GAATCAATACATTGTAAAG","ACTTGCGGTAAAGAAACTAT","561307.5.peg.1759"," 845"
"8106",48,157,109,"CCAAATCCAACTTCTTTCAT","ACTTGCGGTAAAGAAACTAT","561307.5.peg.1759"," 845"
"8107",446,157,289,"CAATTGCAACACGCCCTAAA","ACTTGCGGTAAAGAAACTAT","561307.5.peg.1759"," 845"
"8108",446,172,274,"CAATTGCAACACGCCCTAAA","AGATGGCAAGCGACCACTTG","561307.5.peg.1759"," 845"
"8109",515,172,343,"CGAGTGATGCAACGATATAA","AGATGGCAAGCGACCACTTG","561307.5.peg.1759"," 845"
"8110",10,172,162,"GAATCAATACATTGTAAAG","AGATGGCAAGCGACCACTTG","561307.5.peg.1759"," 845"
"8111",404,172,232,"AGCCAATGACACGTATGCTA","AGATGGCAAGCGACCACTTG","561307.5.peg.1759"," 845"
"8112",48,172,124,"CCAAATCCAACTTCTTTCAT","AGATGGCAAGCGACCACTTG","561307.5.peg.1759"," 845"
"8113",10,404,394,"GAATCAATACATTGTAAAG","AGCCAATGACACGTATGCTA","561307.5.peg.1759"," 845"
"8114",157,404,247,"ACTTGCGGTAAAGAAACTAT","AGCCAATGACACGTATGCTA","561307.5.peg.1759"," 845"
"8115",136,404,268,"GGTACTTTGGCTCGCGCGCT","AGCCAATGACACGTATGCTA","561307.5.peg.1759"," 845"
"8116",515,404,111,"CGAGTGATGCAACGATATAA","AGCCAATGACACGTATGCTA","561307.5.peg.1759"," 845"
"8117",88,404,316,"GCTAGTAGATAAATGATAA","AGCCAATGACACGTATGCTA","561307.5.peg.1759"," 845"
"8118",172,404,232,"AGATGGCAAGCGACCACTTG","AGCCAATGACACGTATGCTA","561307.5.peg.1759"," 845"
"8119",48,404,356,"CCAAATCCAACTTCTTTCAT","AGCCAATGACACGTATGCTA","561307.5.peg.1759"," 845"
"8120",172,446,274,"AGATGGCAAGCGACCACTTG","CAATTGCAACACGCCCTAAA","561307.5.peg.1759"," 845"
"8121",88,446,358,"GCTAGTAGATAAATGATAA","CAATTGCAACACGCCCTAAA","561307.5.peg.1759"," 845"
"8122",157,446,289,"ACTTGCGGTAAAGAAACTAT","CAATTGCAACACGCCCTAAA","561307.5.peg.1759"," 845"
"8123",48,446,398,"CCAAATCCAACTTCTTTCAT","CAATTGCAACACGCCCTAAA","561307.5.peg.1759"," 845"
"8124",136,446,310,"GGTACTTTGGCTCGCGCGCT","CAATTGCAACACGCCCTAAA","561307.5.peg.1759"," 845"
"8125",10,446,436,"GAATCAATACATTGTAAAG","CAATTGCAACACGCCCTAAA","561307.5.peg.1759"," 845"
"8126",404,515,111,"AGCCAATGACACGTATGCTA","CGAGTGATGCAACGATATAA","561307.5.peg.1759"," 845"
"8127",136,515,379,"GGTACTTTGGCTCGCGCGCT","CGAGTGATGCAACGATATAA","561307.5.peg.1759"," 845"
"8128",48,515,467,"CCAAATCCAACTTCTTTCAT","CGAGTGATGCAACGATATAA","561307.5.peg.1759"," 845"
"8129",172,515,343,"AGATGGCAAGCGACCACTTG","CGAGTGATGCAACGATATAA","561307.5.peg.1759"," 845"
"8130",10,515,505,"GAATCAATACATTGTAAAG","CGAGTGATGCAACGATATAA","561307.5.peg.1759"," 845"
"8131",157,515,358,"ACTTGCGGTAAAGAAACTAT","CGAGTGATGCAACGATATAA","561307.5.peg.1759"," 845"
"8132",88,515,427,"GCTAGTAGATAAATGATAA","CGAGTGATGCAACGATATAA","561307.5.peg.1759"," 845"
"8133",260,9,251,"CCATGTAATCAGCAGTTCCA","ACATATATTCACGATAGAG","561307.5.peg.176"," 846"
"8134",9,260,251,"ACATATATTCACGATAGAG","CCATGTAATCAGCAGTTCCA","561307.5.peg.176"," 846"
"8135",367,250,117,"TGGATAGTAGAATGGTGTTA","TTTATCCCCAACTGCCTCTT","561307.5.peg.1760"," 847"
"8136",250,367,117,"TTTATCCCCAACTGCCTCTT","TGGATAGTAGAATGGTGTTA","561307.5.peg.1760"," 847"
"8137",192,8,184,"CTAAAGCGTGTCATCGTTGC","AGTAATCATTAAGATGAAG","561307.5.peg.1762"," 849"
"8138",172,8,164,"TGGTGATGTACCAATCGCAT","AGTAATCATTAAGATGAAG","561307.5.peg.1762"," 849"
"8139",374,8,366,"GAAGTTTGTCGATAAAGGTT","AGTAATCATTAAGATGAAG","561307.5.peg.1762"," 849"
"8140",379,8,371,"GATTGAAGTTTGTCGATAA","AGTAATCATTAAGATGAAG","561307.5.peg.1762"," 849"
"8141",166,8,158,"TGTACCAATCGCATGGGCTA","AGTAATCATTAAGATGAAG","561307.5.peg.1762"," 849"
"8142",379,166,213,"GATTGAAGTTTGTCGATAA","TGTACCAATCGCATGGGCTA","561307.5.peg.1762"," 849"
"8143",8,166,158,"AGTAATCATTAAGATGAAG","TGTACCAATCGCATGGGCTA","561307.5.peg.1762"," 849"
"8144",374,166,208,"GAAGTTTGTCGATAAAGGTT","TGTACCAATCGCATGGGCTA","561307.5.peg.1762"," 849"
"8145",8,172,164,"AGTAATCATTAAGATGAAG","TGGTGATGTACCAATCGCAT","561307.5.peg.1762"," 849"
"8146",379,172,207,"GATTGAAGTTTGTCGATAA","TGGTGATGTACCAATCGCAT","561307.5.peg.1762"," 849"
"8147",374,172,202,"GAAGTTTGTCGATAAAGGTT","TGGTGATGTACCAATCGCAT","561307.5.peg.1762"," 849"
"8148",374,192,182,"GAAGTTTGTCGATAAAGGTT","CTAAAGCGTGTCATCGTTGC","561307.5.peg.1762"," 849"
"8149",8,192,184,"AGTAATCATTAAGATGAAG","CTAAAGCGTGTCATCGTTGC","561307.5.peg.1762"," 849"
"8150",379,192,187,"GATTGAAGTTTGTCGATAA","CTAAAGCGTGTCATCGTTGC","561307.5.peg.1762"," 849"
"8151",8,374,366,"AGTAATCATTAAGATGAAG","GAAGTTTGTCGATAAAGGTT","561307.5.peg.1762"," 849"
"8152",172,374,202,"TGGTGATGTACCAATCGCAT","GAAGTTTGTCGATAAAGGTT","561307.5.peg.1762"," 849"
"8153",166,374,208,"TGTACCAATCGCATGGGCTA","GAAGTTTGTCGATAAAGGTT","561307.5.peg.1762"," 849"
"8154",192,374,182,"CTAAAGCGTGTCATCGTTGC","GAAGTTTGTCGATAAAGGTT","561307.5.peg.1762"," 849"
"8155",166,379,213,"TGTACCAATCGCATGGGCTA","GATTGAAGTTTGTCGATAA","561307.5.peg.1762"," 849"
"8156",8,379,371,"AGTAATCATTAAGATGAAG","GATTGAAGTTTGTCGATAA","561307.5.peg.1762"," 849"
"8157",172,379,207,"TGGTGATGTACCAATCGCAT","GATTGAAGTTTGTCGATAA","561307.5.peg.1762"," 849"
"8158",192,379,187,"CTAAAGCGTGTCATCGTTGC","GATTGAAGTTTGTCGATAA","561307.5.peg.1762"," 849"
"8159",219,90,129,"CGTTTCACAATGCCAATAAC","GATGAATGCAATGGTTCATC","561307.5.peg.1763"," 850"
"8160",90,219,129,"GATGAATGCAATGGTTCATC","CGTTTCACAATGCCAATAAC","561307.5.peg.1763"," 850"
"8161",267,4,263,"ATCATAATCAGTGCAACATA","AATGATTCATCTCATTAAG","561307.5.peg.1764"," 851"
"8162",258,4,254,"AGTGCAACATAGGGCATAAG","AATGATTCATCTCATTAAG","561307.5.peg.1764"," 851"
"8163",598,4,594,"CGAAGCCACTGCATCGACAG","AATGATTCATCTCATTAAG","561307.5.peg.1764"," 851"
"8164",697,4,693,"AAAGCCAGTCGCAATAATCG","AATGATTCATCTCATTAAG","561307.5.peg.1764"," 851"
"8165",238,4,234,"TGGACCTATGATTGAGCGAA","AATGATTCATCTCATTAAG","561307.5.peg.1764"," 851"
"8166",697,238,459,"AAAGCCAGTCGCAATAATCG","TGGACCTATGATTGAGCGAA","561307.5.peg.1764"," 851"
"8167",4,238,234,"AATGATTCATCTCATTAAG","TGGACCTATGATTGAGCGAA","561307.5.peg.1764"," 851"
"8168",598,238,360,"CGAAGCCACTGCATCGACAG","TGGACCTATGATTGAGCGAA","561307.5.peg.1764"," 851"
"8169",4,258,254,"AATGATTCATCTCATTAAG","AGTGCAACATAGGGCATAAG","561307.5.peg.1764"," 851"
"8170",697,258,439,"AAAGCCAGTCGCAATAATCG","AGTGCAACATAGGGCATAAG","561307.5.peg.1764"," 851"
"8171",598,258,340,"CGAAGCCACTGCATCGACAG","AGTGCAACATAGGGCATAAG","561307.5.peg.1764"," 851"
"8172",598,267,331,"CGAAGCCACTGCATCGACAG","ATCATAATCAGTGCAACATA","561307.5.peg.1764"," 851"
"8173",4,267,263,"AATGATTCATCTCATTAAG","ATCATAATCAGTGCAACATA","561307.5.peg.1764"," 851"
"8174",697,267,430,"AAAGCCAGTCGCAATAATCG","ATCATAATCAGTGCAACATA","561307.5.peg.1764"," 851"
"8175",4,598,594,"AATGATTCATCTCATTAAG","CGAAGCCACTGCATCGACAG","561307.5.peg.1764"," 851"
"8176",258,598,340,"AGTGCAACATAGGGCATAAG","CGAAGCCACTGCATCGACAG","561307.5.peg.1764"," 851"
"8177",238,598,360,"TGGACCTATGATTGAGCGAA","CGAAGCCACTGCATCGACAG","561307.5.peg.1764"," 851"
"8178",267,598,331,"ATCATAATCAGTGCAACATA","CGAAGCCACTGCATCGACAG","561307.5.peg.1764"," 851"
"8179",238,697,459,"TGGACCTATGATTGAGCGAA","AAAGCCAGTCGCAATAATCG","561307.5.peg.1764"," 851"
"8180",4,697,693,"AATGATTCATCTCATTAAG","AAAGCCAGTCGCAATAATCG","561307.5.peg.1764"," 851"
"8181",258,697,439,"AGTGCAACATAGGGCATAAG","AAAGCCAGTCGCAATAATCG","561307.5.peg.1764"," 851"
"8182",267,697,430,"ATCATAATCAGTGCAACATA","AAAGCCAGTCGCAATAATCG","561307.5.peg.1764"," 851"
"8183",487,213,274,"TCCATTACGTTCAGCATGAT","ATCGCATTCCCTTGTTCTCC","561307.5.peg.1765"," 852"
"8184",708,213,495,"GCATCTATGATTTGATGCGC","ATCGCATTCCCTTGTTCTCC","561307.5.peg.1765"," 852"
"8185",752,213,539,"CTTGTGGTTTCTGTTCACTT","ATCGCATTCCCTTGTTCTCC","561307.5.peg.1765"," 852"
"8186",927,213,714,"TGTACTTGATTCGCTTTAAG","ATCGCATTCCCTTGTTCTCC","561307.5.peg.1765"," 852"
"8187",1026,213,813,"TATTTCCACCCCAATAATT","ATCGCATTCCCTTGTTCTCC","561307.5.peg.1765"," 852"
"8188",582,213,369,"GGTGCTGCTTTATCATGATT","ATCGCATTCCCTTGTTCTCC","561307.5.peg.1765"," 852"
"8189",684,213,471,"GATGTGTATCTTGTTGATT","ATCGCATTCCCTTGTTCTCC","561307.5.peg.1765"," 852"
"8190",670,213,457,"TTGATTTGGATGTTTGTCCG","ATCGCATTCCCTTGTTCTCC","561307.5.peg.1765"," 852"
"8191",951,213,738,"CAACTGGATATTTGTTAAG","ATCGCATTCCCTTGTTCTCC","561307.5.peg.1765"," 852"
"8192",811,213,598,"TTTATCTGTCGGTTTCTCTG","ATCGCATTCCCTTGTTCTCC","561307.5.peg.1765"," 852"
"8193",213,487,274,"ATCGCATTCCCTTGTTCTCC","TCCATTACGTTCAGCATGAT","561307.5.peg.1765"," 852"
"8194",752,487,265,"CTTGTGGTTTCTGTTCACTT","TCCATTACGTTCAGCATGAT","561307.5.peg.1765"," 852"
"8195",927,487,440,"TGTACTTGATTCGCTTTAAG","TCCATTACGTTCAGCATGAT","561307.5.peg.1765"," 852"
"8196",708,487,221,"GCATCTATGATTTGATGCGC","TCCATTACGTTCAGCATGAT","561307.5.peg.1765"," 852"
"8197",684,487,197,"GATGTGTATCTTGTTGATT","TCCATTACGTTCAGCATGAT","561307.5.peg.1765"," 852"
"8198",670,487,183,"TTGATTTGGATGTTTGTCCG","TCCATTACGTTCAGCATGAT","561307.5.peg.1765"," 852"
"8199",951,487,464,"CAACTGGATATTTGTTAAG","TCCATTACGTTCAGCATGAT","561307.5.peg.1765"," 852"
"8200",811,487,324,"TTTATCTGTCGGTTTCTCTG","TCCATTACGTTCAGCATGAT","561307.5.peg.1765"," 852"
"8201",1026,487,539,"TATTTCCACCCCAATAATT","TCCATTACGTTCAGCATGAT","561307.5.peg.1765"," 852"
"8202",1026,582,444,"TATTTCCACCCCAATAATT","GGTGCTGCTTTATCATGATT","561307.5.peg.1765"," 852"
"8203",951,582,369,"CAACTGGATATTTGTTAAG","GGTGCTGCTTTATCATGATT","561307.5.peg.1765"," 852"
"8204",684,582,102,"GATGTGTATCTTGTTGATT","GGTGCTGCTTTATCATGATT","561307.5.peg.1765"," 852"
"8205",752,582,170,"CTTGTGGTTTCTGTTCACTT","GGTGCTGCTTTATCATGATT","561307.5.peg.1765"," 852"
"8206",927,582,345,"TGTACTTGATTCGCTTTAAG","GGTGCTGCTTTATCATGATT","561307.5.peg.1765"," 852"
"8207",811,582,229,"TTTATCTGTCGGTTTCTCTG","GGTGCTGCTTTATCATGATT","561307.5.peg.1765"," 852"
"8208",708,582,126,"GCATCTATGATTTGATGCGC","GGTGCTGCTTTATCATGATT","561307.5.peg.1765"," 852"
"8209",213,582,369,"ATCGCATTCCCTTGTTCTCC","GGTGCTGCTTTATCATGATT","561307.5.peg.1765"," 852"
"8210",487,670,183,"TCCATTACGTTCAGCATGAT","TTGATTTGGATGTTTGTCCG","561307.5.peg.1765"," 852"
"8211",1026,670,356,"TATTTCCACCCCAATAATT","TTGATTTGGATGTTTGTCCG","561307.5.peg.1765"," 852"
"8212",213,670,457,"ATCGCATTCCCTTGTTCTCC","TTGATTTGGATGTTTGTCCG","561307.5.peg.1765"," 852"
"8213",951,670,281,"CAACTGGATATTTGTTAAG","TTGATTTGGATGTTTGTCCG","561307.5.peg.1765"," 852"
"8214",811,670,141,"TTTATCTGTCGGTTTCTCTG","TTGATTTGGATGTTTGTCCG","561307.5.peg.1765"," 852"
"8215",927,670,257,"TGTACTTGATTCGCTTTAAG","TTGATTTGGATGTTTGTCCG","561307.5.peg.1765"," 852"
"8216",1026,684,342,"TATTTCCACCCCAATAATT","GATGTGTATCTTGTTGATT","561307.5.peg.1765"," 852"
"8217",487,684,197,"TCCATTACGTTCAGCATGAT","GATGTGTATCTTGTTGATT","561307.5.peg.1765"," 852"
"8218",927,684,243,"TGTACTTGATTCGCTTTAAG","GATGTGTATCTTGTTGATT","561307.5.peg.1765"," 852"
"8219",951,684,267,"CAACTGGATATTTGTTAAG","GATGTGTATCTTGTTGATT","561307.5.peg.1765"," 852"
"8220",213,684,471,"ATCGCATTCCCTTGTTCTCC","GATGTGTATCTTGTTGATT","561307.5.peg.1765"," 852"
"8221",811,684,127,"TTTATCTGTCGGTTTCTCTG","GATGTGTATCTTGTTGATT","561307.5.peg.1765"," 852"
"8222",582,684,102,"GGTGCTGCTTTATCATGATT","GATGTGTATCTTGTTGATT","561307.5.peg.1765"," 852"
"8223",811,708,103,"TTTATCTGTCGGTTTCTCTG","GCATCTATGATTTGATGCGC","561307.5.peg.1765"," 852"
"8224",213,708,495,"ATCGCATTCCCTTGTTCTCC","GCATCTATGATTTGATGCGC","561307.5.peg.1765"," 852"
"8225",927,708,219,"TGTACTTGATTCGCTTTAAG","GCATCTATGATTTGATGCGC","561307.5.peg.1765"," 852"
"8226",487,708,221,"TCCATTACGTTCAGCATGAT","GCATCTATGATTTGATGCGC","561307.5.peg.1765"," 852"
"8227",951,708,243,"CAACTGGATATTTGTTAAG","GCATCTATGATTTGATGCGC","561307.5.peg.1765"," 852"
"8228",1026,708,318,"TATTTCCACCCCAATAATT","GCATCTATGATTTGATGCGC","561307.5.peg.1765"," 852"
"8229",582,708,126,"GGTGCTGCTTTATCATGATT","GCATCTATGATTTGATGCGC","561307.5.peg.1765"," 852"
"8230",213,752,539,"ATCGCATTCCCTTGTTCTCC","CTTGTGGTTTCTGTTCACTT","561307.5.peg.1765"," 852"
"8231",487,752,265,"TCCATTACGTTCAGCATGAT","CTTGTGGTTTCTGTTCACTT","561307.5.peg.1765"," 852"
"8232",951,752,199,"CAACTGGATATTTGTTAAG","CTTGTGGTTTCTGTTCACTT","561307.5.peg.1765"," 852"
"8233",927,752,175,"TGTACTTGATTCGCTTTAAG","CTTGTGGTTTCTGTTCACTT","561307.5.peg.1765"," 852"
"8234",582,752,170,"GGTGCTGCTTTATCATGATT","CTTGTGGTTTCTGTTCACTT","561307.5.peg.1765"," 852"
"8235",1026,752,274,"TATTTCCACCCCAATAATT","CTTGTGGTTTCTGTTCACTT","561307.5.peg.1765"," 852"
"8236",951,811,140,"CAACTGGATATTTGTTAAG","TTTATCTGTCGGTTTCTCTG","561307.5.peg.1765"," 852"
"8237",927,811,116,"TGTACTTGATTCGCTTTAAG","TTTATCTGTCGGTTTCTCTG","561307.5.peg.1765"," 852"
"8238",487,811,324,"TCCATTACGTTCAGCATGAT","TTTATCTGTCGGTTTCTCTG","561307.5.peg.1765"," 852"
"8239",670,811,141,"TTGATTTGGATGTTTGTCCG","TTTATCTGTCGGTTTCTCTG","561307.5.peg.1765"," 852"
"8240",582,811,229,"GGTGCTGCTTTATCATGATT","TTTATCTGTCGGTTTCTCTG","561307.5.peg.1765"," 852"
"8241",708,811,103,"GCATCTATGATTTGATGCGC","TTTATCTGTCGGTTTCTCTG","561307.5.peg.1765"," 852"
"8242",684,811,127,"GATGTGTATCTTGTTGATT","TTTATCTGTCGGTTTCTCTG","561307.5.peg.1765"," 852"
"8243",1026,811,215,"TATTTCCACCCCAATAATT","TTTATCTGTCGGTTTCTCTG","561307.5.peg.1765"," 852"
"8244",213,811,598,"ATCGCATTCCCTTGTTCTCC","TTTATCTGTCGGTTTCTCTG","561307.5.peg.1765"," 852"
"8245",684,927,243,"GATGTGTATCTTGTTGATT","TGTACTTGATTCGCTTTAAG","561307.5.peg.1765"," 852"
"8246",811,927,116,"TTTATCTGTCGGTTTCTCTG","TGTACTTGATTCGCTTTAAG","561307.5.peg.1765"," 852"
"8247",213,927,714,"ATCGCATTCCCTTGTTCTCC","TGTACTTGATTCGCTTTAAG","561307.5.peg.1765"," 852"
"8248",582,927,345,"GGTGCTGCTTTATCATGATT","TGTACTTGATTCGCTTTAAG","561307.5.peg.1765"," 852"
"8249",752,927,175,"CTTGTGGTTTCTGTTCACTT","TGTACTTGATTCGCTTTAAG","561307.5.peg.1765"," 852"
"8250",708,927,219,"GCATCTATGATTTGATGCGC","TGTACTTGATTCGCTTTAAG","561307.5.peg.1765"," 852"
"8251",487,927,440,"TCCATTACGTTCAGCATGAT","TGTACTTGATTCGCTTTAAG","561307.5.peg.1765"," 852"
"8252",670,927,257,"TTGATTTGGATGTTTGTCCG","TGTACTTGATTCGCTTTAAG","561307.5.peg.1765"," 852"
"8253",752,951,199,"CTTGTGGTTTCTGTTCACTT","CAACTGGATATTTGTTAAG","561307.5.peg.1765"," 852"
"8254",582,951,369,"GGTGCTGCTTTATCATGATT","CAACTGGATATTTGTTAAG","561307.5.peg.1765"," 852"
"8255",487,951,464,"TCCATTACGTTCAGCATGAT","CAACTGGATATTTGTTAAG","561307.5.peg.1765"," 852"
"8256",684,951,267,"GATGTGTATCTTGTTGATT","CAACTGGATATTTGTTAAG","561307.5.peg.1765"," 852"
"8257",670,951,281,"TTGATTTGGATGTTTGTCCG","CAACTGGATATTTGTTAAG","561307.5.peg.1765"," 852"
"8258",213,951,738,"ATCGCATTCCCTTGTTCTCC","CAACTGGATATTTGTTAAG","561307.5.peg.1765"," 852"
"8259",708,951,243,"GCATCTATGATTTGATGCGC","CAACTGGATATTTGTTAAG","561307.5.peg.1765"," 852"
"8260",811,951,140,"TTTATCTGTCGGTTTCTCTG","CAACTGGATATTTGTTAAG","561307.5.peg.1765"," 852"
"8261",487,1026,539,"TCCATTACGTTCAGCATGAT","TATTTCCACCCCAATAATT","561307.5.peg.1765"," 852"
"8262",752,1026,274,"CTTGTGGTTTCTGTTCACTT","TATTTCCACCCCAATAATT","561307.5.peg.1765"," 852"
"8263",708,1026,318,"GCATCTATGATTTGATGCGC","TATTTCCACCCCAATAATT","561307.5.peg.1765"," 852"
"8264",684,1026,342,"GATGTGTATCTTGTTGATT","TATTTCCACCCCAATAATT","561307.5.peg.1765"," 852"
"8265",213,1026,813,"ATCGCATTCCCTTGTTCTCC","TATTTCCACCCCAATAATT","561307.5.peg.1765"," 852"
"8266",582,1026,444,"GGTGCTGCTTTATCATGATT","TATTTCCACCCCAATAATT","561307.5.peg.1765"," 852"
"8267",811,1026,215,"TTTATCTGTCGGTTTCTCTG","TATTTCCACCCCAATAATT","561307.5.peg.1765"," 852"
"8268",670,1026,356,"TTGATTTGGATGTTTGTCCG","TATTTCCACCCCAATAATT","561307.5.peg.1765"," 852"
"8269",261,155,106,"ATGCAATCGAGACTTACTTC","CGAACATTAATCCACCACCG","561307.5.peg.1766"," 853"
"8270",349,155,194,"TGCACCTGATGATCTGCCAA","CGAACATTAATCCACCACCG","561307.5.peg.1766"," 853"
"8271",349,196,153,"TGCACCTGATGATCTGCCAA","AAGGATATCGATATACTGTG","561307.5.peg.1766"," 853"
"8272",349,198,151,"TGCACCTGATGATCTGCCAA","GTAAGGATATCGATATACTG","561307.5.peg.1766"," 853"
"8273",349,215,134,"TGCACCTGATGATCTGCCAA","TAAATCGTAATGTTCCGTA","561307.5.peg.1766"," 853"
"8274",155,261,106,"CGAACATTAATCCACCACCG","ATGCAATCGAGACTTACTTC","561307.5.peg.1766"," 853"
"8275",155,349,194,"CGAACATTAATCCACCACCG","TGCACCTGATGATCTGCCAA","561307.5.peg.1766"," 853"
"8276",196,349,153,"AAGGATATCGATATACTGTG","TGCACCTGATGATCTGCCAA","561307.5.peg.1766"," 853"
"8277",198,349,151,"GTAAGGATATCGATATACTG","TGCACCTGATGATCTGCCAA","561307.5.peg.1766"," 853"
"8278",215,349,134,"TAAATCGTAATGTTCCGTA","TGCACCTGATGATCTGCCAA","561307.5.peg.1766"," 853"
"8279",620,129,491,"TTAATGAGTCGGCACCGTAA","GTTGATGTGTTTACGGTCAT","561307.5.peg.1767"," 854"
"8280",356,129,227,"AACGACCAGCATGCGCTAGC","GTTGATGTGTTTACGGTCAT","561307.5.peg.1767"," 854"
"8281",420,129,291,"GAATGCAATGTCATAGGGCT","GTTGATGTGTTTACGGTCAT","561307.5.peg.1767"," 854"
"8282",425,129,296,"TCGGTGAATGCAATGTCATA","GTTGATGTGTTTACGGTCAT","561307.5.peg.1767"," 854"
"8283",344,129,215,"GCGCTAGCTGGATAATAGCG","GTTGATGTGTTTACGGTCAT","561307.5.peg.1767"," 854"
"8284",444,129,315,"GCGATAACATCGTGTTCAAT","GTTGATGTGTTTACGGTCAT","561307.5.peg.1767"," 854"
"8285",444,226,218,"GCGATAACATCGTGTTCAAT","AGGTTCAATGTAAGCAGCGC","561307.5.peg.1767"," 854"
"8286",344,226,118,"GCGCTAGCTGGATAATAGCG","AGGTTCAATGTAAGCAGCGC","561307.5.peg.1767"," 854"
"8287",420,226,194,"GAATGCAATGTCATAGGGCT","AGGTTCAATGTAAGCAGCGC","561307.5.peg.1767"," 854"
"8288",356,226,130,"AACGACCAGCATGCGCTAGC","AGGTTCAATGTAAGCAGCGC","561307.5.peg.1767"," 854"
"8289",620,226,394,"TTAATGAGTCGGCACCGTAA","AGGTTCAATGTAAGCAGCGC","561307.5.peg.1767"," 854"
"8290",425,226,199,"TCGGTGAATGCAATGTCATA","AGGTTCAATGTAAGCAGCGC","561307.5.peg.1767"," 854"
"8291",620,344,276,"TTAATGAGTCGGCACCGTAA","GCGCTAGCTGGATAATAGCG","561307.5.peg.1767"," 854"
"8292",129,344,215,"GTTGATGTGTTTACGGTCAT","GCGCTAGCTGGATAATAGCG","561307.5.peg.1767"," 854"
"8293",226,344,118,"AGGTTCAATGTAAGCAGCGC","GCGCTAGCTGGATAATAGCG","561307.5.peg.1767"," 854"
"8294",444,344,100,"GCGATAACATCGTGTTCAAT","GCGCTAGCTGGATAATAGCG","561307.5.peg.1767"," 854"
"8295",620,356,264,"TTAATGAGTCGGCACCGTAA","AACGACCAGCATGCGCTAGC","561307.5.peg.1767"," 854"
"8296",129,356,227,"GTTGATGTGTTTACGGTCAT","AACGACCAGCATGCGCTAGC","561307.5.peg.1767"," 854"
"8297",226,356,130,"AGGTTCAATGTAAGCAGCGC","AACGACCAGCATGCGCTAGC","561307.5.peg.1767"," 854"
"8298",129,420,291,"GTTGATGTGTTTACGGTCAT","GAATGCAATGTCATAGGGCT","561307.5.peg.1767"," 854"
"8299",620,420,200,"TTAATGAGTCGGCACCGTAA","GAATGCAATGTCATAGGGCT","561307.5.peg.1767"," 854"
"8300",226,420,194,"AGGTTCAATGTAAGCAGCGC","GAATGCAATGTCATAGGGCT","561307.5.peg.1767"," 854"
"8301",129,425,296,"GTTGATGTGTTTACGGTCAT","TCGGTGAATGCAATGTCATA","561307.5.peg.1767"," 854"
"8302",620,425,195,"TTAATGAGTCGGCACCGTAA","TCGGTGAATGCAATGTCATA","561307.5.peg.1767"," 854"
"8303",226,425,199,"AGGTTCAATGTAAGCAGCGC","TCGGTGAATGCAATGTCATA","561307.5.peg.1767"," 854"
"8304",129,444,315,"GTTGATGTGTTTACGGTCAT","GCGATAACATCGTGTTCAAT","561307.5.peg.1767"," 854"
"8305",620,444,176,"TTAATGAGTCGGCACCGTAA","GCGATAACATCGTGTTCAAT","561307.5.peg.1767"," 854"
"8306",226,444,218,"AGGTTCAATGTAAGCAGCGC","GCGATAACATCGTGTTCAAT","561307.5.peg.1767"," 854"
"8307",344,444,100,"GCGCTAGCTGGATAATAGCG","GCGATAACATCGTGTTCAAT","561307.5.peg.1767"," 854"
"8308",344,620,276,"GCGCTAGCTGGATAATAGCG","TTAATGAGTCGGCACCGTAA","561307.5.peg.1767"," 854"
"8309",420,620,200,"GAATGCAATGTCATAGGGCT","TTAATGAGTCGGCACCGTAA","561307.5.peg.1767"," 854"
"8310",226,620,394,"AGGTTCAATGTAAGCAGCGC","TTAATGAGTCGGCACCGTAA","561307.5.peg.1767"," 854"
"8311",425,620,195,"TCGGTGAATGCAATGTCATA","TTAATGAGTCGGCACCGTAA","561307.5.peg.1767"," 854"
"8312",129,620,491,"GTTGATGTGTTTACGGTCAT","TTAATGAGTCGGCACCGTAA","561307.5.peg.1767"," 854"
"8313",356,620,264,"AACGACCAGCATGCGCTAGC","TTAATGAGTCGGCACCGTAA","561307.5.peg.1767"," 854"
"8314",444,620,176,"GCGATAACATCGTGTTCAAT","TTAATGAGTCGGCACCGTAA","561307.5.peg.1767"," 854"
"8315",378,2,376,"TGCTTTACCATAGTAGTACC","CAGGATAAGTTTGGAGATGA","561307.5.peg.1768"," 855"
"8316",420,2,418,"CATCGTAACTATCATATGT","CAGGATAAGTTTGGAGATGA","561307.5.peg.1768"," 855"
"8317",195,2,193,"GGACTACTACACGCAAACGC","CAGGATAAGTTTGGAGATGA","561307.5.peg.1768"," 855"
"8318",486,2,484,"ACACCTAACGTATGCGCACT","CAGGATAAGTTTGGAGATGA","561307.5.peg.1768"," 855"
"8319",378,11,367,"TGCTTTACCATAGTAGTACC","TTGACATGACAGGATAAGTT","561307.5.peg.1768"," 855"
"8320",420,11,409,"CATCGTAACTATCATATGT","TTGACATGACAGGATAAGTT","561307.5.peg.1768"," 855"
"8321",486,11,475,"ACACCTAACGTATGCGCACT","TTGACATGACAGGATAAGTT","561307.5.peg.1768"," 855"
"8322",195,11,184,"GGACTACTACACGCAAACGC","TTGACATGACAGGATAAGTT","561307.5.peg.1768"," 855"
"8323",378,21,357,"TGCTTTACCATAGTAGTACC","TTATGTCGGTTTGACATGAC","561307.5.peg.1768"," 855"
"8324",420,21,399,"CATCGTAACTATCATATGT","TTATGTCGGTTTGACATGAC","561307.5.peg.1768"," 855"
"8325",195,21,174,"GGACTACTACACGCAAACGC","TTATGTCGGTTTGACATGAC","561307.5.peg.1768"," 855"
"8326",486,21,465,"ACACCTAACGTATGCGCACT","TTATGTCGGTTTGACATGAC","561307.5.peg.1768"," 855"
"8327",2,195,193,"CAGGATAAGTTTGGAGATGA","GGACTACTACACGCAAACGC","561307.5.peg.1768"," 855"
"8328",11,195,184,"TTGACATGACAGGATAAGTT","GGACTACTACACGCAAACGC","561307.5.peg.1768"," 855"
"8329",378,195,183,"TGCTTTACCATAGTAGTACC","GGACTACTACACGCAAACGC","561307.5.peg.1768"," 855"
"8330",21,195,174,"TTATGTCGGTTTGACATGAC","GGACTACTACACGCAAACGC","561307.5.peg.1768"," 855"
"8331",420,195,225,"CATCGTAACTATCATATGT","GGACTACTACACGCAAACGC","561307.5.peg.1768"," 855"
"8332",486,195,291,"ACACCTAACGTATGCGCACT","GGACTACTACACGCAAACGC","561307.5.peg.1768"," 855"
"8333",11,378,367,"TTGACATGACAGGATAAGTT","TGCTTTACCATAGTAGTACC","561307.5.peg.1768"," 855"
"8334",2,378,376,"CAGGATAAGTTTGGAGATGA","TGCTTTACCATAGTAGTACC","561307.5.peg.1768"," 855"
"8335",486,378,108,"ACACCTAACGTATGCGCACT","TGCTTTACCATAGTAGTACC","561307.5.peg.1768"," 855"
"8336",21,378,357,"TTATGTCGGTTTGACATGAC","TGCTTTACCATAGTAGTACC","561307.5.peg.1768"," 855"
"8337",195,378,183,"GGACTACTACACGCAAACGC","TGCTTTACCATAGTAGTACC","561307.5.peg.1768"," 855"
"8338",195,420,225,"GGACTACTACACGCAAACGC","CATCGTAACTATCATATGT","561307.5.peg.1768"," 855"
"8339",11,420,409,"TTGACATGACAGGATAAGTT","CATCGTAACTATCATATGT","561307.5.peg.1768"," 855"
"8340",2,420,418,"CAGGATAAGTTTGGAGATGA","CATCGTAACTATCATATGT","561307.5.peg.1768"," 855"
"8341",21,420,399,"TTATGTCGGTTTGACATGAC","CATCGTAACTATCATATGT","561307.5.peg.1768"," 855"
"8342",11,486,475,"TTGACATGACAGGATAAGTT","ACACCTAACGTATGCGCACT","561307.5.peg.1768"," 855"
"8343",2,486,484,"CAGGATAAGTTTGGAGATGA","ACACCTAACGTATGCGCACT","561307.5.peg.1768"," 855"
"8344",195,486,291,"GGACTACTACACGCAAACGC","ACACCTAACGTATGCGCACT","561307.5.peg.1768"," 855"
"8345",21,486,465,"TTATGTCGGTTTGACATGAC","ACACCTAACGTATGCGCACT","561307.5.peg.1768"," 855"
"8346",378,486,108,"TGCTTTACCATAGTAGTACC","ACACCTAACGTATGCGCACT","561307.5.peg.1768"," 855"
"8347",195,6,189,"TCATCACTTACAGGTAATGC","AGCATTCCTAGCATTACCGG","561307.5.peg.1770"," 858"
"8348",195,9,186,"TCATCACTTACAGGTAATGC","AGAAGCATTCCTAGCATTAC","561307.5.peg.1770"," 858"
"8349",195,29,166,"TCATCACTTACAGGTAATGC","TTTAAGCCTCCGGTAATGCT","561307.5.peg.1770"," 858"
"8350",195,39,156,"TCATCACTTACAGGTAATGC","AACGTTTCCATTTAAGCCTC","561307.5.peg.1770"," 858"
"8351",6,195,189,"AGCATTCCTAGCATTACCGG","TCATCACTTACAGGTAATGC","561307.5.peg.1770"," 858"
"8352",9,195,186,"AGAAGCATTCCTAGCATTAC","TCATCACTTACAGGTAATGC","561307.5.peg.1770"," 858"
"8353",29,195,166,"TTTAAGCCTCCGGTAATGCT","TCATCACTTACAGGTAATGC","561307.5.peg.1770"," 858"
"8354",39,195,156,"AACGTTTCCATTTAAGCCTC","TCATCACTTACAGGTAATGC","561307.5.peg.1770"," 858"
"8355",282,10,272,"TACTCTTGCCAACTGCCATA","GGATTTACAACTGTATAAGG","561307.5.peg.1771"," 859"
"8356",382,10,372,"GTACTGTTTACCTTCCACCA","GGATTTACAACTGTATAAGG","561307.5.peg.1771"," 859"
"8357",404,10,394,"CTGCATTCGTAGTTATAATG","GGATTTACAACTGTATAAGG","561307.5.peg.1771"," 859"
"8358",282,49,233,"TACTCTTGCCAACTGCCATA","CCACTTACTACTCTGCATCA","561307.5.peg.1771"," 859"
"8359",404,49,355,"CTGCATTCGTAGTTATAATG","CCACTTACTACTCTGCATCA","561307.5.peg.1771"," 859"
"8360",382,49,333,"GTACTGTTTACCTTCCACCA","CCACTTACTACTCTGCATCA","561307.5.peg.1771"," 859"
"8361",10,282,272,"GGATTTACAACTGTATAAGG","TACTCTTGCCAACTGCCATA","561307.5.peg.1771"," 859"
"8362",49,282,233,"CCACTTACTACTCTGCATCA","TACTCTTGCCAACTGCCATA","561307.5.peg.1771"," 859"
"8363",382,282,100,"GTACTGTTTACCTTCCACCA","TACTCTTGCCAACTGCCATA","561307.5.peg.1771"," 859"
"8364",404,282,122,"CTGCATTCGTAGTTATAATG","TACTCTTGCCAACTGCCATA","561307.5.peg.1771"," 859"
"8365",10,382,372,"GGATTTACAACTGTATAAGG","GTACTGTTTACCTTCCACCA","561307.5.peg.1771"," 859"
"8366",49,382,333,"CCACTTACTACTCTGCATCA","GTACTGTTTACCTTCCACCA","561307.5.peg.1771"," 859"
"8367",282,382,100,"TACTCTTGCCAACTGCCATA","GTACTGTTTACCTTCCACCA","561307.5.peg.1771"," 859"
"8368",10,404,394,"GGATTTACAACTGTATAAGG","CTGCATTCGTAGTTATAATG","561307.5.peg.1771"," 859"
"8369",282,404,122,"TACTCTTGCCAACTGCCATA","CTGCATTCGTAGTTATAATG","561307.5.peg.1771"," 859"
"8370",49,404,355,"CCACTTACTACTCTGCATCA","CTGCATTCGTAGTTATAATG","561307.5.peg.1771"," 859"
"8371",375,266,109,"GTATGCAACGCCTTTATAGC","CAGCGCCACCACCAGTATCT","561307.5.peg.1772"," 860"
"8372",266,375,109,"CAGCGCCACCACCAGTATCT","GTATGCAACGCCTTTATAGC","561307.5.peg.1772"," 860"
"8373",205,11,194,"GACAAACATTAATCGCTCTG","GTAATCAATAGACACAAAG","561307.5.peg.1773"," 861"
"8374",348,11,337,"CGTTGTATACCTTCAATTGC","GTAATCAATAGACACAAAG","561307.5.peg.1773"," 861"
"8375",205,73,132,"GACAAACATTAATCGCTCTG","GCCAACAAACCCTGTACCAC","561307.5.peg.1773"," 861"
"8376",348,73,275,"CGTTGTATACCTTCAATTGC","GCCAACAAACCCTGTACCAC","561307.5.peg.1773"," 861"
"8377",11,205,194,"GTAATCAATAGACACAAAG","GACAAACATTAATCGCTCTG","561307.5.peg.1773"," 861"
"8378",348,205,143,"CGTTGTATACCTTCAATTGC","GACAAACATTAATCGCTCTG","561307.5.peg.1773"," 861"
"8379",73,205,132,"GCCAACAAACCCTGTACCAC","GACAAACATTAATCGCTCTG","561307.5.peg.1773"," 861"
"8380",73,348,275,"GCCAACAAACCCTGTACCAC","CGTTGTATACCTTCAATTGC","561307.5.peg.1773"," 861"
"8381",11,348,337,"GTAATCAATAGACACAAAG","CGTTGTATACCTTCAATTGC","561307.5.peg.1773"," 861"
"8382",205,348,143,"GACAAACATTAATCGCTCTG","CGTTGTATACCTTCAATTGC","561307.5.peg.1773"," 861"
"8383",288,48,240,"GAGACGATAGCTTCGTTGTT","AATTAAGGATTGCTTGCAT","561307.5.peg.1774"," 862"
"8384",540,48,492,"ATCGTAGGTTGGAGTAATGC","AATTAAGGATTGCTTGCAT","561307.5.peg.1774"," 862"
"8385",257,48,209,"CTTGCACACCAAATGCGTGT","AATTAAGGATTGCTTGCAT","561307.5.peg.1774"," 862"
"8386",625,48,577,"TAATTGACCTACAGCACCTG","AATTAAGGATTGCTTGCAT","561307.5.peg.1774"," 862"
"8387",151,48,103,"GGTTCCTGAAGTGATCGTTG","AATTAAGGATTGCTTGCAT","561307.5.peg.1774"," 862"
"8388",625,97,528,"TAATTGACCTACAGCACCTG","GGCAATCAGTGCAACAAGAA","561307.5.peg.1774"," 862"
"8389",257,97,160,"CTTGCACACCAAATGCGTGT","GGCAATCAGTGCAACAAGAA","561307.5.peg.1774"," 862"
"8390",540,97,443,"ATCGTAGGTTGGAGTAATGC","GGCAATCAGTGCAACAAGAA","561307.5.peg.1774"," 862"
"8391",288,97,191,"GAGACGATAGCTTCGTTGTT","GGCAATCAGTGCAACAAGAA","561307.5.peg.1774"," 862"
"8392",540,147,393,"ATCGTAGGTTGGAGTAATGC","CCTGAAGTGATCGTTGCGGC","561307.5.peg.1774"," 862"
"8393",257,147,110,"CTTGCACACCAAATGCGTGT","CCTGAAGTGATCGTTGCGGC","561307.5.peg.1774"," 862"
"8394",625,147,478,"TAATTGACCTACAGCACCTG","CCTGAAGTGATCGTTGCGGC","561307.5.peg.1774"," 862"
"8395",288,147,141,"GAGACGATAGCTTCGTTGTT","CCTGAAGTGATCGTTGCGGC","561307.5.peg.1774"," 862"
"8396",257,151,106,"CTTGCACACCAAATGCGTGT","GGTTCCTGAAGTGATCGTTG","561307.5.peg.1774"," 862"
"8397",540,151,389,"ATCGTAGGTTGGAGTAATGC","GGTTCCTGAAGTGATCGTTG","561307.5.peg.1774"," 862"
"8398",288,151,137,"GAGACGATAGCTTCGTTGTT","GGTTCCTGAAGTGATCGTTG","561307.5.peg.1774"," 862"
"8399",48,151,103,"AATTAAGGATTGCTTGCAT","GGTTCCTGAAGTGATCGTTG","561307.5.peg.1774"," 862"
"8400",625,151,474,"TAATTGACCTACAGCACCTG","GGTTCCTGAAGTGATCGTTG","561307.5.peg.1774"," 862"
"8401",48,257,209,"AATTAAGGATTGCTTGCAT","CTTGCACACCAAATGCGTGT","561307.5.peg.1774"," 862"
"8402",97,257,160,"GGCAATCAGTGCAACAAGAA","CTTGCACACCAAATGCGTGT","561307.5.peg.1774"," 862"
"8403",151,257,106,"GGTTCCTGAAGTGATCGTTG","CTTGCACACCAAATGCGTGT","561307.5.peg.1774"," 862"
"8404",147,257,110,"CCTGAAGTGATCGTTGCGGC","CTTGCACACCAAATGCGTGT","561307.5.peg.1774"," 862"
"8405",540,257,283,"ATCGTAGGTTGGAGTAATGC","CTTGCACACCAAATGCGTGT","561307.5.peg.1774"," 862"
"8406",625,257,368,"TAATTGACCTACAGCACCTG","CTTGCACACCAAATGCGTGT","561307.5.peg.1774"," 862"
"8407",625,288,337,"TAATTGACCTACAGCACCTG","GAGACGATAGCTTCGTTGTT","561307.5.peg.1774"," 862"
"8408",540,288,252,"ATCGTAGGTTGGAGTAATGC","GAGACGATAGCTTCGTTGTT","561307.5.peg.1774"," 862"
"8409",97,288,191,"GGCAATCAGTGCAACAAGAA","GAGACGATAGCTTCGTTGTT","561307.5.peg.1774"," 862"
"8410",48,288,240,"AATTAAGGATTGCTTGCAT","GAGACGATAGCTTCGTTGTT","561307.5.peg.1774"," 862"
"8411",147,288,141,"CCTGAAGTGATCGTTGCGGC","GAGACGATAGCTTCGTTGTT","561307.5.peg.1774"," 862"
"8412",151,288,137,"GGTTCCTGAAGTGATCGTTG","GAGACGATAGCTTCGTTGTT","561307.5.peg.1774"," 862"
"8413",48,540,492,"AATTAAGGATTGCTTGCAT","ATCGTAGGTTGGAGTAATGC","561307.5.peg.1774"," 862"
"8414",97,540,443,"GGCAATCAGTGCAACAAGAA","ATCGTAGGTTGGAGTAATGC","561307.5.peg.1774"," 862"
"8415",151,540,389,"GGTTCCTGAAGTGATCGTTG","ATCGTAGGTTGGAGTAATGC","561307.5.peg.1774"," 862"
"8416",147,540,393,"CCTGAAGTGATCGTTGCGGC","ATCGTAGGTTGGAGTAATGC","561307.5.peg.1774"," 862"
"8417",288,540,252,"GAGACGATAGCTTCGTTGTT","ATCGTAGGTTGGAGTAATGC","561307.5.peg.1774"," 862"
"8418",257,540,283,"CTTGCACACCAAATGCGTGT","ATCGTAGGTTGGAGTAATGC","561307.5.peg.1774"," 862"
"8419",48,625,577,"AATTAAGGATTGCTTGCAT","TAATTGACCTACAGCACCTG","561307.5.peg.1774"," 862"
"8420",257,625,368,"CTTGCACACCAAATGCGTGT","TAATTGACCTACAGCACCTG","561307.5.peg.1774"," 862"
"8421",151,625,474,"GGTTCCTGAAGTGATCGTTG","TAATTGACCTACAGCACCTG","561307.5.peg.1774"," 862"
"8422",147,625,478,"CCTGAAGTGATCGTTGCGGC","TAATTGACCTACAGCACCTG","561307.5.peg.1774"," 862"
"8423",288,625,337,"GAGACGATAGCTTCGTTGTT","TAATTGACCTACAGCACCTG","561307.5.peg.1774"," 862"
"8424",97,625,528,"GGCAATCAGTGCAACAAGAA","TAATTGACCTACAGCACCTG","561307.5.peg.1774"," 862"
"8425",147,9,138,"TATCATATTGAATGGTACG","CGCTTACAATTACAAATAGG","561307.5.peg.1777"," 865"
"8426",215,9,206,"TGATGCCTGCAGCTTTATTA","CGCTTACAATTACAAATAGG","561307.5.peg.1777"," 865"
"8427",206,9,197,"CAGCTTTATTACGGCTGACT","CGCTTACAATTACAAATAGG","561307.5.peg.1777"," 865"
"8428",355,9,346,"TTGCTTTGTTGAAACAGGAT","CGCTTACAATTACAAATAGG","561307.5.peg.1777"," 865"
"8429",439,9,430,"AAATGGTATTGATCTAGTT","CGCTTACAATTACAAATAGG","561307.5.peg.1777"," 865"
"8430",617,9,608,"TAATGTCTTAATAATGGCA","CGCTTACAATTACAAATAGG","561307.5.peg.1777"," 865"
"8431",9,147,138,"CGCTTACAATTACAAATAGG","TATCATATTGAATGGTACG","561307.5.peg.1777"," 865"
"8432",439,147,292,"AAATGGTATTGATCTAGTT","TATCATATTGAATGGTACG","561307.5.peg.1777"," 865"
"8433",617,147,470,"TAATGTCTTAATAATGGCA","TATCATATTGAATGGTACG","561307.5.peg.1777"," 865"
"8434",355,147,208,"TTGCTTTGTTGAAACAGGAT","TATCATATTGAATGGTACG","561307.5.peg.1777"," 865"
"8435",9,206,197,"CGCTTACAATTACAAATAGG","CAGCTTTATTACGGCTGACT","561307.5.peg.1777"," 865"
"8436",439,206,233,"AAATGGTATTGATCTAGTT","CAGCTTTATTACGGCTGACT","561307.5.peg.1777"," 865"
"8437",617,206,411,"TAATGTCTTAATAATGGCA","CAGCTTTATTACGGCTGACT","561307.5.peg.1777"," 865"
"8438",355,206,149,"TTGCTTTGTTGAAACAGGAT","CAGCTTTATTACGGCTGACT","561307.5.peg.1777"," 865"
"8439",439,215,224,"AAATGGTATTGATCTAGTT","TGATGCCTGCAGCTTTATTA","561307.5.peg.1777"," 865"
"8440",9,215,206,"CGCTTACAATTACAAATAGG","TGATGCCTGCAGCTTTATTA","561307.5.peg.1777"," 865"
"8441",617,215,402,"TAATGTCTTAATAATGGCA","TGATGCCTGCAGCTTTATTA","561307.5.peg.1777"," 865"
"8442",355,215,140,"TTGCTTTGTTGAAACAGGAT","TGATGCCTGCAGCTTTATTA","561307.5.peg.1777"," 865"
"8443",9,355,346,"CGCTTACAATTACAAATAGG","TTGCTTTGTTGAAACAGGAT","561307.5.peg.1777"," 865"
"8444",147,355,208,"TATCATATTGAATGGTACG","TTGCTTTGTTGAAACAGGAT","561307.5.peg.1777"," 865"
"8445",206,355,149,"CAGCTTTATTACGGCTGACT","TTGCTTTGTTGAAACAGGAT","561307.5.peg.1777"," 865"
"8446",215,355,140,"TGATGCCTGCAGCTTTATTA","TTGCTTTGTTGAAACAGGAT","561307.5.peg.1777"," 865"
"8447",617,355,262,"TAATGTCTTAATAATGGCA","TTGCTTTGTTGAAACAGGAT","561307.5.peg.1777"," 865"
"8448",617,439,178,"TAATGTCTTAATAATGGCA","AAATGGTATTGATCTAGTT","561307.5.peg.1777"," 865"
"8449",147,439,292,"TATCATATTGAATGGTACG","AAATGGTATTGATCTAGTT","561307.5.peg.1777"," 865"
"8450",9,439,430,"CGCTTACAATTACAAATAGG","AAATGGTATTGATCTAGTT","561307.5.peg.1777"," 865"
"8451",206,439,233,"CAGCTTTATTACGGCTGACT","AAATGGTATTGATCTAGTT","561307.5.peg.1777"," 865"
"8452",215,439,224,"TGATGCCTGCAGCTTTATTA","AAATGGTATTGATCTAGTT","561307.5.peg.1777"," 865"
"8453",147,617,470,"TATCATATTGAATGGTACG","TAATGTCTTAATAATGGCA","561307.5.peg.1777"," 865"
"8454",206,617,411,"CAGCTTTATTACGGCTGACT","TAATGTCTTAATAATGGCA","561307.5.peg.1777"," 865"
"8455",215,617,402,"TGATGCCTGCAGCTTTATTA","TAATGTCTTAATAATGGCA","561307.5.peg.1777"," 865"
"8456",355,617,262,"TTGCTTTGTTGAAACAGGAT","TAATGTCTTAATAATGGCA","561307.5.peg.1777"," 865"
"8457",9,617,608,"CGCTTACAATTACAAATAGG","TAATGTCTTAATAATGGCA","561307.5.peg.1777"," 865"
"8458",439,617,178,"AAATGGTATTGATCTAGTT","TAATGTCTTAATAATGGCA","561307.5.peg.1777"," 865"
"8459",228,87,141,"CCCATTAAGATAGCAAATAC","TGCATCATCGCTTTAAATAC","561307.5.peg.1779"," 867"
"8460",396,87,309,"GCTGCGATTTGATCACTGAA","TGCATCATCGCTTTAAATAC","561307.5.peg.1779"," 867"
"8461",543,87,456,"TACCAATCATAGAAACCAT","TGCATCATCGCTTTAAATAC","561307.5.peg.1779"," 867"
"8462",228,120,108,"CCCATTAAGATAGCAAATAC","ATAAAGTCCCTATCATCAT","561307.5.peg.1779"," 867"
"8463",543,120,423,"TACCAATCATAGAAACCAT","ATAAAGTCCCTATCATCAT","561307.5.peg.1779"," 867"
"8464",396,120,276,"GCTGCGATTTGATCACTGAA","ATAAAGTCCCTATCATCAT","561307.5.peg.1779"," 867"
"8465",87,228,141,"TGCATCATCGCTTTAAATAC","CCCATTAAGATAGCAAATAC","561307.5.peg.1779"," 867"
"8466",396,228,168,"GCTGCGATTTGATCACTGAA","CCCATTAAGATAGCAAATAC","561307.5.peg.1779"," 867"
"8467",120,228,108,"ATAAAGTCCCTATCATCAT","CCCATTAAGATAGCAAATAC","561307.5.peg.1779"," 867"
"8468",543,228,315,"TACCAATCATAGAAACCAT","CCCATTAAGATAGCAAATAC","561307.5.peg.1779"," 867"
"8469",87,396,309,"TGCATCATCGCTTTAAATAC","GCTGCGATTTGATCACTGAA","561307.5.peg.1779"," 867"
"8470",120,396,276,"ATAAAGTCCCTATCATCAT","GCTGCGATTTGATCACTGAA","561307.5.peg.1779"," 867"
"8471",543,396,147,"TACCAATCATAGAAACCAT","GCTGCGATTTGATCACTGAA","561307.5.peg.1779"," 867"
"8472",228,396,168,"CCCATTAAGATAGCAAATAC","GCTGCGATTTGATCACTGAA","561307.5.peg.1779"," 867"
"8473",87,543,456,"TGCATCATCGCTTTAAATAC","TACCAATCATAGAAACCAT","561307.5.peg.1779"," 867"
"8474",396,543,147,"GCTGCGATTTGATCACTGAA","TACCAATCATAGAAACCAT","561307.5.peg.1779"," 867"
"8475",120,543,423,"ATAAAGTCCCTATCATCAT","TACCAATCATAGAAACCAT","561307.5.peg.1779"," 867"
"8476",228,543,315,"CCCATTAAGATAGCAAATAC","TACCAATCATAGAAACCAT","561307.5.peg.1779"," 867"
"8477",265,66,199,"CTTACTAAATCCATATGCGA","AAAGGCTTAATATGCTTTGC","561307.5.peg.1781"," 870"
"8478",473,66,407,"TAAACCAGTGAACGAGAACA","AAAGGCTTAATATGCTTTGC","561307.5.peg.1781"," 870"
"8479",204,66,138,"AAACCTTGCTCTTGCAATGC","AAAGGCTTAATATGCTTTGC","561307.5.peg.1781"," 870"
"8480",673,66,607,"ATCAATACGTATGAAATTG","AAAGGCTTAATATGCTTTGC","561307.5.peg.1781"," 870"
"8481",462,66,396,"ACGAGAACACGGCCTGAAGG","AAAGGCTTAATATGCTTTGC","561307.5.peg.1781"," 870"
"8482",465,66,399,"TGAACGAGAACACGGCCTGA","AAAGGCTTAATATGCTTTGC","561307.5.peg.1781"," 870"
"8483",387,66,321,"CCGATACCTGATGTAAAGAA","AAAGGCTTAATATGCTTTGC","561307.5.peg.1781"," 870"
"8484",523,66,457,"ATTATGCGCAACGTTCCAAA","AAAGGCTTAATATGCTTTGC","561307.5.peg.1781"," 870"
"8485",647,66,581,"TGATAAGTGCTAAGAGTGCA","AAAGGCTTAATATGCTTTGC","561307.5.peg.1781"," 870"
"8486",465,112,353,"TGAACGAGAACACGGCCTGA","TTGGAGACGTAATCGTTTAT","561307.5.peg.1781"," 870"
"8487",523,112,411,"ATTATGCGCAACGTTCCAAA","TTGGAGACGTAATCGTTTAT","561307.5.peg.1781"," 870"
"8488",265,112,153,"CTTACTAAATCCATATGCGA","TTGGAGACGTAATCGTTTAT","561307.5.peg.1781"," 870"
"8489",387,112,275,"CCGATACCTGATGTAAAGAA","TTGGAGACGTAATCGTTTAT","561307.5.peg.1781"," 870"
"8490",462,112,350,"ACGAGAACACGGCCTGAAGG","TTGGAGACGTAATCGTTTAT","561307.5.peg.1781"," 870"
"8491",673,112,561,"ATCAATACGTATGAAATTG","TTGGAGACGTAATCGTTTAT","561307.5.peg.1781"," 870"
"8492",473,112,361,"TAAACCAGTGAACGAGAACA","TTGGAGACGTAATCGTTTAT","561307.5.peg.1781"," 870"
"8493",647,112,535,"TGATAAGTGCTAAGAGTGCA","TTGGAGACGTAATCGTTTAT","561307.5.peg.1781"," 870"
"8494",462,204,258,"ACGAGAACACGGCCTGAAGG","AAACCTTGCTCTTGCAATGC","561307.5.peg.1781"," 870"
"8495",66,204,138,"AAAGGCTTAATATGCTTTGC","AAACCTTGCTCTTGCAATGC","561307.5.peg.1781"," 870"
"8496",387,204,183,"CCGATACCTGATGTAAAGAA","AAACCTTGCTCTTGCAATGC","561307.5.peg.1781"," 870"
"8497",465,204,261,"TGAACGAGAACACGGCCTGA","AAACCTTGCTCTTGCAATGC","561307.5.peg.1781"," 870"
"8498",523,204,319,"ATTATGCGCAACGTTCCAAA","AAACCTTGCTCTTGCAATGC","561307.5.peg.1781"," 870"
"8499",673,204,469,"ATCAATACGTATGAAATTG","AAACCTTGCTCTTGCAATGC","561307.5.peg.1781"," 870"
"8500",473,204,269,"TAAACCAGTGAACGAGAACA","AAACCTTGCTCTTGCAATGC","561307.5.peg.1781"," 870"
"8501",647,204,443,"TGATAAGTGCTAAGAGTGCA","AAACCTTGCTCTTGCAATGC","561307.5.peg.1781"," 870"
"8502",66,265,199,"AAAGGCTTAATATGCTTTGC","CTTACTAAATCCATATGCGA","561307.5.peg.1781"," 870"
"8503",387,265,122,"CCGATACCTGATGTAAAGAA","CTTACTAAATCCATATGCGA","561307.5.peg.1781"," 870"
"8504",473,265,208,"TAAACCAGTGAACGAGAACA","CTTACTAAATCCATATGCGA","561307.5.peg.1781"," 870"
"8505",112,265,153,"TTGGAGACGTAATCGTTTAT","CTTACTAAATCCATATGCGA","561307.5.peg.1781"," 870"
"8506",465,265,200,"TGAACGAGAACACGGCCTGA","CTTACTAAATCCATATGCGA","561307.5.peg.1781"," 870"
"8507",647,265,382,"TGATAAGTGCTAAGAGTGCA","CTTACTAAATCCATATGCGA","561307.5.peg.1781"," 870"
"8508",523,265,258,"ATTATGCGCAACGTTCCAAA","CTTACTAAATCCATATGCGA","561307.5.peg.1781"," 870"
"8509",462,265,197,"ACGAGAACACGGCCTGAAGG","CTTACTAAATCCATATGCGA","561307.5.peg.1781"," 870"
"8510",673,265,408,"ATCAATACGTATGAAATTG","CTTACTAAATCCATATGCGA","561307.5.peg.1781"," 870"
"8511",673,387,286,"ATCAATACGTATGAAATTG","CCGATACCTGATGTAAAGAA","561307.5.peg.1781"," 870"
"8512",66,387,321,"AAAGGCTTAATATGCTTTGC","CCGATACCTGATGTAAAGAA","561307.5.peg.1781"," 870"
"8513",265,387,122,"CTTACTAAATCCATATGCGA","CCGATACCTGATGTAAAGAA","561307.5.peg.1781"," 870"
"8514",523,387,136,"ATTATGCGCAACGTTCCAAA","CCGATACCTGATGTAAAGAA","561307.5.peg.1781"," 870"
"8515",204,387,183,"AAACCTTGCTCTTGCAATGC","CCGATACCTGATGTAAAGAA","561307.5.peg.1781"," 870"
"8516",647,387,260,"TGATAAGTGCTAAGAGTGCA","CCGATACCTGATGTAAAGAA","561307.5.peg.1781"," 870"
"8517",112,387,275,"TTGGAGACGTAATCGTTTAT","CCGATACCTGATGTAAAGAA","561307.5.peg.1781"," 870"
"8518",66,462,396,"AAAGGCTTAATATGCTTTGC","ACGAGAACACGGCCTGAAGG","561307.5.peg.1781"," 870"
"8519",112,462,350,"TTGGAGACGTAATCGTTTAT","ACGAGAACACGGCCTGAAGG","561307.5.peg.1781"," 870"
"8520",265,462,197,"CTTACTAAATCCATATGCGA","ACGAGAACACGGCCTGAAGG","561307.5.peg.1781"," 870"
"8521",647,462,185,"TGATAAGTGCTAAGAGTGCA","ACGAGAACACGGCCTGAAGG","561307.5.peg.1781"," 870"
"8522",204,462,258,"AAACCTTGCTCTTGCAATGC","ACGAGAACACGGCCTGAAGG","561307.5.peg.1781"," 870"
"8523",673,462,211,"ATCAATACGTATGAAATTG","ACGAGAACACGGCCTGAAGG","561307.5.peg.1781"," 870"
"8524",265,465,200,"CTTACTAAATCCATATGCGA","TGAACGAGAACACGGCCTGA","561307.5.peg.1781"," 870"
"8525",647,465,182,"TGATAAGTGCTAAGAGTGCA","TGAACGAGAACACGGCCTGA","561307.5.peg.1781"," 870"
"8526",204,465,261,"AAACCTTGCTCTTGCAATGC","TGAACGAGAACACGGCCTGA","561307.5.peg.1781"," 870"
"8527",66,465,399,"AAAGGCTTAATATGCTTTGC","TGAACGAGAACACGGCCTGA","561307.5.peg.1781"," 870"
"8528",112,465,353,"TTGGAGACGTAATCGTTTAT","TGAACGAGAACACGGCCTGA","561307.5.peg.1781"," 870"
"8529",673,465,208,"ATCAATACGTATGAAATTG","TGAACGAGAACACGGCCTGA","561307.5.peg.1781"," 870"
"8530",112,473,361,"TTGGAGACGTAATCGTTTAT","TAAACCAGTGAACGAGAACA","561307.5.peg.1781"," 870"
"8531",265,473,208,"CTTACTAAATCCATATGCGA","TAAACCAGTGAACGAGAACA","561307.5.peg.1781"," 870"
"8532",204,473,269,"AAACCTTGCTCTTGCAATGC","TAAACCAGTGAACGAGAACA","561307.5.peg.1781"," 870"
"8533",673,473,200,"ATCAATACGTATGAAATTG","TAAACCAGTGAACGAGAACA","561307.5.peg.1781"," 870"
"8534",66,473,407,"AAAGGCTTAATATGCTTTGC","TAAACCAGTGAACGAGAACA","561307.5.peg.1781"," 870"
"8535",647,473,174,"TGATAAGTGCTAAGAGTGCA","TAAACCAGTGAACGAGAACA","561307.5.peg.1781"," 870"
"8536",673,523,150,"ATCAATACGTATGAAATTG","ATTATGCGCAACGTTCCAAA","561307.5.peg.1781"," 870"
"8537",387,523,136,"CCGATACCTGATGTAAAGAA","ATTATGCGCAACGTTCCAAA","561307.5.peg.1781"," 870"
"8538",66,523,457,"AAAGGCTTAATATGCTTTGC","ATTATGCGCAACGTTCCAAA","561307.5.peg.1781"," 870"
"8539",647,523,124,"TGATAAGTGCTAAGAGTGCA","ATTATGCGCAACGTTCCAAA","561307.5.peg.1781"," 870"
"8540",265,523,258,"CTTACTAAATCCATATGCGA","ATTATGCGCAACGTTCCAAA","561307.5.peg.1781"," 870"
"8541",112,523,411,"TTGGAGACGTAATCGTTTAT","ATTATGCGCAACGTTCCAAA","561307.5.peg.1781"," 870"
"8542",204,523,319,"AAACCTTGCTCTTGCAATGC","ATTATGCGCAACGTTCCAAA","561307.5.peg.1781"," 870"
"8543",66,647,581,"AAAGGCTTAATATGCTTTGC","TGATAAGTGCTAAGAGTGCA","561307.5.peg.1781"," 870"
"8544",112,647,535,"TTGGAGACGTAATCGTTTAT","TGATAAGTGCTAAGAGTGCA","561307.5.peg.1781"," 870"
"8545",204,647,443,"AAACCTTGCTCTTGCAATGC","TGATAAGTGCTAAGAGTGCA","561307.5.peg.1781"," 870"
"8546",465,647,182,"TGAACGAGAACACGGCCTGA","TGATAAGTGCTAAGAGTGCA","561307.5.peg.1781"," 870"
"8547",265,647,382,"CTTACTAAATCCATATGCGA","TGATAAGTGCTAAGAGTGCA","561307.5.peg.1781"," 870"
"8548",473,647,174,"TAAACCAGTGAACGAGAACA","TGATAAGTGCTAAGAGTGCA","561307.5.peg.1781"," 870"
"8549",523,647,124,"ATTATGCGCAACGTTCCAAA","TGATAAGTGCTAAGAGTGCA","561307.5.peg.1781"," 870"
"8550",462,647,185,"ACGAGAACACGGCCTGAAGG","TGATAAGTGCTAAGAGTGCA","561307.5.peg.1781"," 870"
"8551",387,647,260,"CCGATACCTGATGTAAAGAA","TGATAAGTGCTAAGAGTGCA","561307.5.peg.1781"," 870"
"8552",465,673,208,"TGAACGAGAACACGGCCTGA","ATCAATACGTATGAAATTG","561307.5.peg.1781"," 870"
"8553",462,673,211,"ACGAGAACACGGCCTGAAGG","ATCAATACGTATGAAATTG","561307.5.peg.1781"," 870"
"8554",112,673,561,"TTGGAGACGTAATCGTTTAT","ATCAATACGTATGAAATTG","561307.5.peg.1781"," 870"
"8555",66,673,607,"AAAGGCTTAATATGCTTTGC","ATCAATACGTATGAAATTG","561307.5.peg.1781"," 870"
"8556",265,673,408,"CTTACTAAATCCATATGCGA","ATCAATACGTATGAAATTG","561307.5.peg.1781"," 870"
"8557",523,673,150,"ATTATGCGCAACGTTCCAAA","ATCAATACGTATGAAATTG","561307.5.peg.1781"," 870"
"8558",204,673,469,"AAACCTTGCTCTTGCAATGC","ATCAATACGTATGAAATTG","561307.5.peg.1781"," 870"
"8559",473,673,200,"TAAACCAGTGAACGAGAACA","ATCAATACGTATGAAATTG","561307.5.peg.1781"," 870"
"8560",387,673,286,"CCGATACCTGATGTAAAGAA","ATCAATACGTATGAAATTG","561307.5.peg.1781"," 870"
"8561",264,128,136,"CGATAAATCGTTTCAGTACC","TTCAACTAATCGTAATCCA","561307.5.peg.1782"," 871"
"8562",243,128,115,"GGCTGCTTATGACCCGCATT","TTCAACTAATCGTAATCCA","561307.5.peg.1782"," 871"
"8563",456,128,328,"GCGTTATGTTGCCATTGATG","TTCAACTAATCGTAATCCA","561307.5.peg.1782"," 871"
"8564",303,128,175,"TAATGAAGTGCCGCTTGATT","TTCAACTAATCGTAATCCA","561307.5.peg.1782"," 871"
"8565",128,243,115,"TTCAACTAATCGTAATCCA","GGCTGCTTATGACCCGCATT","561307.5.peg.1782"," 871"
"8566",456,243,213,"GCGTTATGTTGCCATTGATG","GGCTGCTTATGACCCGCATT","561307.5.peg.1782"," 871"
"8567",128,264,136,"TTCAACTAATCGTAATCCA","CGATAAATCGTTTCAGTACC","561307.5.peg.1782"," 871"
"8568",456,264,192,"GCGTTATGTTGCCATTGATG","CGATAAATCGTTTCAGTACC","561307.5.peg.1782"," 871"
"8569",128,303,175,"TTCAACTAATCGTAATCCA","TAATGAAGTGCCGCTTGATT","561307.5.peg.1782"," 871"
"8570",456,303,153,"GCGTTATGTTGCCATTGATG","TAATGAAGTGCCGCTTGATT","561307.5.peg.1782"," 871"
"8571",128,456,328,"TTCAACTAATCGTAATCCA","GCGTTATGTTGCCATTGATG","561307.5.peg.1782"," 871"
"8572",243,456,213,"GGCTGCTTATGACCCGCATT","GCGTTATGTTGCCATTGATG","561307.5.peg.1782"," 871"
"8573",264,456,192,"CGATAAATCGTTTCAGTACC","GCGTTATGTTGCCATTGATG","561307.5.peg.1782"," 871"
"8574",303,456,153,"TAATGAAGTGCCGCTTGATT","GCGTTATGTTGCCATTGATG","561307.5.peg.1782"," 871"
"8575",286,81,205,"TTTAATATGCTTTGTCGCTT","GAATACAAACCAAACTCAAG","561307.5.peg.1783"," 872"
"8576",345,81,264,"AGTCTTCAAATACTCTTAC","GAATACAAACCAAACTCAAG","561307.5.peg.1783"," 872"
"8577",400,81,319,"TGCTCTGCCAGCTACAATTT","GAATACAAACCAAACTCAAG","561307.5.peg.1783"," 872"
"8578",81,286,205,"GAATACAAACCAAACTCAAG","TTTAATATGCTTTGTCGCTT","561307.5.peg.1783"," 872"
"8579",400,286,114,"TGCTCTGCCAGCTACAATTT","TTTAATATGCTTTGTCGCTT","561307.5.peg.1783"," 872"
"8580",81,345,264,"GAATACAAACCAAACTCAAG","AGTCTTCAAATACTCTTAC","561307.5.peg.1783"," 872"
"8581",81,400,319,"GAATACAAACCAAACTCAAG","TGCTCTGCCAGCTACAATTT","561307.5.peg.1783"," 872"
"8582",286,400,114,"TTTAATATGCTTTGTCGCTT","TGCTCTGCCAGCTACAATTT","561307.5.peg.1783"," 872"
"8583",334,138,196,"AATAACGACACCTACATCGA","GCGCCAACCTTATCTAGGAT","561307.5.peg.1785"," 874"
"8584",463,138,325,"TTTGAATATTGGAGCGACTG","GCGCCAACCTTATCTAGGAT","561307.5.peg.1785"," 874"
"8585",334,143,191,"AATAACGACACCTACATCGA","TTAATGCGCCAACCTTATCT","561307.5.peg.1785"," 874"
"8586",463,143,320,"TTTGAATATTGGAGCGACTG","TTAATGCGCCAACCTTATCT","561307.5.peg.1785"," 874"
"8587",463,213,250,"TTTGAATATTGGAGCGACTG","ATACCTGAGCTATATTGTTC","561307.5.peg.1785"," 874"
"8588",334,213,121,"AATAACGACACCTACATCGA","ATACCTGAGCTATATTGTTC","561307.5.peg.1785"," 874"
"8589",138,334,196,"GCGCCAACCTTATCTAGGAT","AATAACGACACCTACATCGA","561307.5.peg.1785"," 874"
"8590",463,334,129,"TTTGAATATTGGAGCGACTG","AATAACGACACCTACATCGA","561307.5.peg.1785"," 874"
"8591",143,334,191,"TTAATGCGCCAACCTTATCT","AATAACGACACCTACATCGA","561307.5.peg.1785"," 874"
"8592",213,334,121,"ATACCTGAGCTATATTGTTC","AATAACGACACCTACATCGA","561307.5.peg.1785"," 874"
"8593",143,463,320,"TTAATGCGCCAACCTTATCT","TTTGAATATTGGAGCGACTG","561307.5.peg.1785"," 874"
"8594",138,463,325,"GCGCCAACCTTATCTAGGAT","TTTGAATATTGGAGCGACTG","561307.5.peg.1785"," 874"
"8595",334,463,129,"AATAACGACACCTACATCGA","TTTGAATATTGGAGCGACTG","561307.5.peg.1785"," 874"
"8596",213,463,250,"ATACCTGAGCTATATTGTTC","TTTGAATATTGGAGCGACTG","561307.5.peg.1785"," 874"
"8597",330,31,299,"TCTCCAAATGCTTCTGCAAC","ATAAGAACACATCTATG","561307.5.peg.1788"," 877"
"8598",31,330,299,"ATAAGAACACATCTATG","TCTCCAAATGCTTCTGCAAC","561307.5.peg.1788"," 877"
"8599",421,130,291,"ACCTAATCCTATCGATTCAC","ACTTGCGCCAATTGCAACAC","561307.5.peg.1789"," 878"
"8600",516,130,386,"GGTAAATCTTTAAAGGCATC","ACTTGCGCCAATTGCAACAC","561307.5.peg.1789"," 878"
"8601",243,130,113,"TGCGTGGGTGTGGTAATGCC","ACTTGCGCCAATTGCAACAC","561307.5.peg.1789"," 878"
"8602",408,130,278,"GATTCACCGGTATCTACTGG","ACTTGCGCCAATTGCAACAC","561307.5.peg.1789"," 878"
"8603",463,130,333,"CAAAGACTTACTAATCCCAA","ACTTGCGCCAATTGCAACAC","561307.5.peg.1789"," 878"
"8604",546,130,416,"TCGTCTATTAACTGATCATT","ACTTGCGCCAATTGCAACAC","561307.5.peg.1789"," 878"
"8605",411,130,281,"ATCGATTCACCGGTATCTAC","ACTTGCGCCAATTGCAACAC","561307.5.peg.1789"," 878"
"8606",387,130,257,"GGCATTAAAGGATTGTTACT","ACTTGCGCCAATTGCAACAC","561307.5.peg.1789"," 878"
"8607",387,243,144,"GGCATTAAAGGATTGTTACT","TGCGTGGGTGTGGTAATGCC","561307.5.peg.1789"," 878"
"8608",411,243,168,"ATCGATTCACCGGTATCTAC","TGCGTGGGTGTGGTAATGCC","561307.5.peg.1789"," 878"
"8609",408,243,165,"GATTCACCGGTATCTACTGG","TGCGTGGGTGTGGTAATGCC","561307.5.peg.1789"," 878"
"8610",421,243,178,"ACCTAATCCTATCGATTCAC","TGCGTGGGTGTGGTAATGCC","561307.5.peg.1789"," 878"
"8611",130,243,113,"ACTTGCGCCAATTGCAACAC","TGCGTGGGTGTGGTAATGCC","561307.5.peg.1789"," 878"
"8612",546,243,303,"TCGTCTATTAACTGATCATT","TGCGTGGGTGTGGTAATGCC","561307.5.peg.1789"," 878"
"8613",516,243,273,"GGTAAATCTTTAAAGGCATC","TGCGTGGGTGTGGTAATGCC","561307.5.peg.1789"," 878"
"8614",463,243,220,"CAAAGACTTACTAATCCCAA","TGCGTGGGTGTGGTAATGCC","561307.5.peg.1789"," 878"
"8615",130,387,257,"ACTTGCGCCAATTGCAACAC","GGCATTAAAGGATTGTTACT","561307.5.peg.1789"," 878"
"8616",516,387,129,"GGTAAATCTTTAAAGGCATC","GGCATTAAAGGATTGTTACT","561307.5.peg.1789"," 878"
"8617",243,387,144,"TGCGTGGGTGTGGTAATGCC","GGCATTAAAGGATTGTTACT","561307.5.peg.1789"," 878"
"8618",546,387,159,"TCGTCTATTAACTGATCATT","GGCATTAAAGGATTGTTACT","561307.5.peg.1789"," 878"
"8619",243,408,165,"TGCGTGGGTGTGGTAATGCC","GATTCACCGGTATCTACTGG","561307.5.peg.1789"," 878"
"8620",546,408,138,"TCGTCTATTAACTGATCATT","GATTCACCGGTATCTACTGG","561307.5.peg.1789"," 878"
"8621",130,408,278,"ACTTGCGCCAATTGCAACAC","GATTCACCGGTATCTACTGG","561307.5.peg.1789"," 878"
"8622",516,408,108,"GGTAAATCTTTAAAGGCATC","GATTCACCGGTATCTACTGG","561307.5.peg.1789"," 878"
"8623",546,411,135,"TCGTCTATTAACTGATCATT","ATCGATTCACCGGTATCTAC","561307.5.peg.1789"," 878"
"8624",243,411,168,"TGCGTGGGTGTGGTAATGCC","ATCGATTCACCGGTATCTAC","561307.5.peg.1789"," 878"
"8625",516,411,105,"GGTAAATCTTTAAAGGCATC","ATCGATTCACCGGTATCTAC","561307.5.peg.1789"," 878"
"8626",130,411,281,"ACTTGCGCCAATTGCAACAC","ATCGATTCACCGGTATCTAC","561307.5.peg.1789"," 878"
"8627",130,421,291,"ACTTGCGCCAATTGCAACAC","ACCTAATCCTATCGATTCAC","561307.5.peg.1789"," 878"
"8628",243,421,178,"TGCGTGGGTGTGGTAATGCC","ACCTAATCCTATCGATTCAC","561307.5.peg.1789"," 878"
"8629",546,421,125,"TCGTCTATTAACTGATCATT","ACCTAATCCTATCGATTCAC","561307.5.peg.1789"," 878"
"8630",130,463,333,"ACTTGCGCCAATTGCAACAC","CAAAGACTTACTAATCCCAA","561307.5.peg.1789"," 878"
"8631",243,463,220,"TGCGTGGGTGTGGTAATGCC","CAAAGACTTACTAATCCCAA","561307.5.peg.1789"," 878"
"8632",130,516,386,"ACTTGCGCCAATTGCAACAC","GGTAAATCTTTAAAGGCATC","561307.5.peg.1789"," 878"
"8633",411,516,105,"ATCGATTCACCGGTATCTAC","GGTAAATCTTTAAAGGCATC","561307.5.peg.1789"," 878"
"8634",408,516,108,"GATTCACCGGTATCTACTGG","GGTAAATCTTTAAAGGCATC","561307.5.peg.1789"," 878"
"8635",387,516,129,"GGCATTAAAGGATTGTTACT","GGTAAATCTTTAAAGGCATC","561307.5.peg.1789"," 878"
"8636",243,516,273,"TGCGTGGGTGTGGTAATGCC","GGTAAATCTTTAAAGGCATC","561307.5.peg.1789"," 878"
"8637",408,546,138,"GATTCACCGGTATCTACTGG","TCGTCTATTAACTGATCATT","561307.5.peg.1789"," 878"
"8638",243,546,303,"TGCGTGGGTGTGGTAATGCC","TCGTCTATTAACTGATCATT","561307.5.peg.1789"," 878"
"8639",130,546,416,"ACTTGCGCCAATTGCAACAC","TCGTCTATTAACTGATCATT","561307.5.peg.1789"," 878"
"8640",387,546,159,"GGCATTAAAGGATTGTTACT","TCGTCTATTAACTGATCATT","561307.5.peg.1789"," 878"
"8641",411,546,135,"ATCGATTCACCGGTATCTAC","TCGTCTATTAACTGATCATT","561307.5.peg.1789"," 878"
"8642",421,546,125,"ACCTAATCCTATCGATTCAC","TCGTCTATTAACTGATCATT","561307.5.peg.1789"," 878"
"8643",329,9,320,"ATAATCCACCTAACCATCTT","GGAGGTAATTAACCAATAGG","561307.5.peg.179"," 879"
"8644",329,12,317,"ATAATCCACCTAACCATCTT","ATGGAGGTAATTAACCAAT","561307.5.peg.179"," 879"
"8645",329,27,302,"ATAATCCACCTAACCATCTT","TTACAATAGTTTGCTATGG","561307.5.peg.179"," 879"
"8646",329,104,225,"ATAATCCACCTAACCATCTT","TTGGGTTCCAACGACGTGTT","561307.5.peg.179"," 879"
"8647",9,329,320,"GGAGGTAATTAACCAATAGG","ATAATCCACCTAACCATCTT","561307.5.peg.179"," 879"
"8648",12,329,317,"ATGGAGGTAATTAACCAAT","ATAATCCACCTAACCATCTT","561307.5.peg.179"," 879"
"8649",27,329,302,"TTACAATAGTTTGCTATGG","ATAATCCACCTAACCATCTT","561307.5.peg.179"," 879"
"8650",104,329,225,"TTGGGTTCCAACGACGTGTT","ATAATCCACCTAACCATCTT","561307.5.peg.179"," 879"
"8651",840,9,831,"TGAATTTGACCTTCAACATA","TTACCAGGTGTTAGTAAGGG","561307.5.peg.1790"," 880"
"8652",840,12,828,"TGAATTTGACCTTCAACATA","GTATTACCAGGTGTTAGTAA","561307.5.peg.1790"," 880"
"8653",840,23,817,"TGAATTTGACCTTCAACATA","TATCCTCCCTTACTAACACC","561307.5.peg.1790"," 880"
"8654",840,46,794,"TGAATTTGACCTTCAACATA","GTCAAATAATGTTTCACCA","561307.5.peg.1790"," 880"
"8655",9,840,831,"TTACCAGGTGTTAGTAAGGG","TGAATTTGACCTTCAACATA","561307.5.peg.1790"," 880"
"8656",12,840,828,"GTATTACCAGGTGTTAGTAA","TGAATTTGACCTTCAACATA","561307.5.peg.1790"," 880"
"8657",23,840,817,"TATCCTCCCTTACTAACACC","TGAATTTGACCTTCAACATA","561307.5.peg.1790"," 880"
"8658",46,840,794,"GTCAAATAATGTTTCACCA","TGAATTTGACCTTCAACATA","561307.5.peg.1790"," 880"
"8659",259,3,256,"TTTATATTCGACATCATCCA","AATTAAACAAAGAGGAGCA","561307.5.peg.1796"," 886"
"8660",3,259,256,"AATTAAACAAAGAGGAGCA","TTTATATTCGACATCATCCA","561307.5.peg.1796"," 886"
"8661",258,153,105,"TATAATCACTACGTTTAAC","GCCATTGCCGAACTCATCAA","561307.5.peg.1797"," 887"
"8662",153,258,105,"GCCATTGCCGAACTCATCAA","TATAATCACTACGTTTAAC","561307.5.peg.1797"," 887"
"8663",243,123,120,"TTCATAGCAGCAATTCGTGC","GTCGCACCTAAATCATAGGC","561307.5.peg.1799"," 889"
"8664",288,123,165,"ACTTTATTCACCGTAAATGC","GTCGCACCTAAATCATAGGC","561307.5.peg.1799"," 889"
"8665",276,123,153,"GTAAATGCAGGTACTGTTTC","GTCGCACCTAAATCATAGGC","561307.5.peg.1799"," 889"
"8666",414,123,291,"CGACTGTTGTTGACAAGCAT","GTCGCACCTAAATCATAGGC","561307.5.peg.1799"," 889"
"8667",414,183,231,"CGACTGTTGTTGACAAGCAT","TAACTTCATCAATCTCACT","561307.5.peg.1799"," 889"
"8668",288,183,105,"ACTTTATTCACCGTAAATGC","TAACTTCATCAATCTCACT","561307.5.peg.1799"," 889"
"8669",123,243,120,"GTCGCACCTAAATCATAGGC","TTCATAGCAGCAATTCGTGC","561307.5.peg.1799"," 889"
"8670",414,243,171,"CGACTGTTGTTGACAAGCAT","TTCATAGCAGCAATTCGTGC","561307.5.peg.1799"," 889"
"8671",123,276,153,"GTCGCACCTAAATCATAGGC","GTAAATGCAGGTACTGTTTC","561307.5.peg.1799"," 889"
"8672",414,276,138,"CGACTGTTGTTGACAAGCAT","GTAAATGCAGGTACTGTTTC","561307.5.peg.1799"," 889"
"8673",123,288,165,"GTCGCACCTAAATCATAGGC","ACTTTATTCACCGTAAATGC","561307.5.peg.1799"," 889"
"8674",414,288,126,"CGACTGTTGTTGACAAGCAT","ACTTTATTCACCGTAAATGC","561307.5.peg.1799"," 889"
"8675",183,288,105,"TAACTTCATCAATCTCACT","ACTTTATTCACCGTAAATGC","561307.5.peg.1799"," 889"
"8676",123,414,291,"GTCGCACCTAAATCATAGGC","CGACTGTTGTTGACAAGCAT","561307.5.peg.1799"," 889"
"8677",183,414,231,"TAACTTCATCAATCTCACT","CGACTGTTGTTGACAAGCAT","561307.5.peg.1799"," 889"
"8678",243,414,171,"TTCATAGCAGCAATTCGTGC","CGACTGTTGTTGACAAGCAT","561307.5.peg.1799"," 889"
"8679",276,414,138,"GTAAATGCAGGTACTGTTTC","CGACTGTTGTTGACAAGCAT","561307.5.peg.1799"," 889"
"8680",288,414,126,"ACTTTATTCACCGTAAATGC","CGACTGTTGTTGACAAGCAT","561307.5.peg.1799"," 889"
"8681",305,8,297,"CATCATCAATAGTTCTTCCT","ATCTATTACTGCTCACAAGG","561307.5.peg.1801"," 893"
"8682",657,8,649,"CTGTCGTCTGTAACTAAGAT","ATCTATTACTGCTCACAAGG","561307.5.peg.1801"," 893"
"8683",506,8,498,"TAATCGGACCAACAATGACA","ATCTATTACTGCTCACAAGG","561307.5.peg.1801"," 893"
"8684",362,8,354,"TTATAAGTGCACTTGCAACA","ATCTATTACTGCTCACAAGG","561307.5.peg.1801"," 893"
"8685",230,8,222,"ATAAAGAGAAATCACCAACT","ATCTATTACTGCTCACAAGG","561307.5.peg.1801"," 893"
"8686",801,8,793,"TCTAAACCTATACCACCAAC","ATCTATTACTGCTCACAAGG","561307.5.peg.1801"," 893"
"8687",417,8,409,"GGCTCAACATTGTCCCATTC","ATCTATTACTGCTCACAAGG","561307.5.peg.1801"," 893"
"8688",481,8,473,"AGCGTTAACGTTTAAAGATT","ATCTATTACTGCTCACAAGG","561307.5.peg.1801"," 893"
"8689",438,8,430,"AATACATTGCGACTCACTTT","ATCTATTACTGCTCACAAGG","561307.5.peg.1801"," 893"
"8690",293,8,285,"TTCTTCCTTGGAAACGTTCA","ATCTATTACTGCTCACAAGG","561307.5.peg.1801"," 893"
"8691",8,230,222,"ATCTATTACTGCTCACAAGG","ATAAAGAGAAATCACCAACT","561307.5.peg.1801"," 893"
"8692",481,230,251,"AGCGTTAACGTTTAAAGATT","ATAAAGAGAAATCACCAACT","561307.5.peg.1801"," 893"
"8693",362,230,132,"TTATAAGTGCACTTGCAACA","ATAAAGAGAAATCACCAACT","561307.5.peg.1801"," 893"
"8694",657,230,427,"CTGTCGTCTGTAACTAAGAT","ATAAAGAGAAATCACCAACT","561307.5.peg.1801"," 893"
"8695",417,230,187,"GGCTCAACATTGTCCCATTC","ATAAAGAGAAATCACCAACT","561307.5.peg.1801"," 893"
"8696",506,230,276,"TAATCGGACCAACAATGACA","ATAAAGAGAAATCACCAACT","561307.5.peg.1801"," 893"
"8697",438,230,208,"AATACATTGCGACTCACTTT","ATAAAGAGAAATCACCAACT","561307.5.peg.1801"," 893"
"8698",801,230,571,"TCTAAACCTATACCACCAAC","ATAAAGAGAAATCACCAACT","561307.5.peg.1801"," 893"
"8699",417,293,124,"GGCTCAACATTGTCCCATTC","TTCTTCCTTGGAAACGTTCA","561307.5.peg.1801"," 893"
"8700",481,293,188,"AGCGTTAACGTTTAAAGATT","TTCTTCCTTGGAAACGTTCA","561307.5.peg.1801"," 893"
"8701",8,293,285,"ATCTATTACTGCTCACAAGG","TTCTTCCTTGGAAACGTTCA","561307.5.peg.1801"," 893"
"8702",438,293,145,"AATACATTGCGACTCACTTT","TTCTTCCTTGGAAACGTTCA","561307.5.peg.1801"," 893"
"8703",801,293,508,"TCTAAACCTATACCACCAAC","TTCTTCCTTGGAAACGTTCA","561307.5.peg.1801"," 893"
"8704",657,293,364,"CTGTCGTCTGTAACTAAGAT","TTCTTCCTTGGAAACGTTCA","561307.5.peg.1801"," 893"
"8705",506,293,213,"TAATCGGACCAACAATGACA","TTCTTCCTTGGAAACGTTCA","561307.5.peg.1801"," 893"
"8706",8,305,297,"ATCTATTACTGCTCACAAGG","CATCATCAATAGTTCTTCCT","561307.5.peg.1801"," 893"
"8707",657,305,352,"CTGTCGTCTGTAACTAAGAT","CATCATCAATAGTTCTTCCT","561307.5.peg.1801"," 893"
"8708",417,305,112,"GGCTCAACATTGTCCCATTC","CATCATCAATAGTTCTTCCT","561307.5.peg.1801"," 893"
"8709",438,305,133,"AATACATTGCGACTCACTTT","CATCATCAATAGTTCTTCCT","561307.5.peg.1801"," 893"
"8710",801,305,496,"TCTAAACCTATACCACCAAC","CATCATCAATAGTTCTTCCT","561307.5.peg.1801"," 893"
"8711",506,305,201,"TAATCGGACCAACAATGACA","CATCATCAATAGTTCTTCCT","561307.5.peg.1801"," 893"
"8712",481,305,176,"AGCGTTAACGTTTAAAGATT","CATCATCAATAGTTCTTCCT","561307.5.peg.1801"," 893"
"8713",506,362,144,"TAATCGGACCAACAATGACA","TTATAAGTGCACTTGCAACA","561307.5.peg.1801"," 893"
"8714",230,362,132,"ATAAAGAGAAATCACCAACT","TTATAAGTGCACTTGCAACA","561307.5.peg.1801"," 893"
"8715",8,362,354,"ATCTATTACTGCTCACAAGG","TTATAAGTGCACTTGCAACA","561307.5.peg.1801"," 893"
"8716",657,362,295,"CTGTCGTCTGTAACTAAGAT","TTATAAGTGCACTTGCAACA","561307.5.peg.1801"," 893"
"8717",481,362,119,"AGCGTTAACGTTTAAAGATT","TTATAAGTGCACTTGCAACA","561307.5.peg.1801"," 893"
"8718",801,362,439,"TCTAAACCTATACCACCAAC","TTATAAGTGCACTTGCAACA","561307.5.peg.1801"," 893"
"8719",8,417,409,"ATCTATTACTGCTCACAAGG","GGCTCAACATTGTCCCATTC","561307.5.peg.1801"," 893"
"8720",801,417,384,"TCTAAACCTATACCACCAAC","GGCTCAACATTGTCCCATTC","561307.5.peg.1801"," 893"
"8721",305,417,112,"CATCATCAATAGTTCTTCCT","GGCTCAACATTGTCCCATTC","561307.5.peg.1801"," 893"
"8722",293,417,124,"TTCTTCCTTGGAAACGTTCA","GGCTCAACATTGTCCCATTC","561307.5.peg.1801"," 893"
"8723",230,417,187,"ATAAAGAGAAATCACCAACT","GGCTCAACATTGTCCCATTC","561307.5.peg.1801"," 893"
"8724",657,417,240,"CTGTCGTCTGTAACTAAGAT","GGCTCAACATTGTCCCATTC","561307.5.peg.1801"," 893"
"8725",801,438,363,"TCTAAACCTATACCACCAAC","AATACATTGCGACTCACTTT","561307.5.peg.1801"," 893"
"8726",293,438,145,"TTCTTCCTTGGAAACGTTCA","AATACATTGCGACTCACTTT","561307.5.peg.1801"," 893"
"8727",8,438,430,"ATCTATTACTGCTCACAAGG","AATACATTGCGACTCACTTT","561307.5.peg.1801"," 893"
"8728",230,438,208,"ATAAAGAGAAATCACCAACT","AATACATTGCGACTCACTTT","561307.5.peg.1801"," 893"
"8729",305,438,133,"CATCATCAATAGTTCTTCCT","AATACATTGCGACTCACTTT","561307.5.peg.1801"," 893"
"8730",657,438,219,"CTGTCGTCTGTAACTAAGAT","AATACATTGCGACTCACTTT","561307.5.peg.1801"," 893"
"8731",801,481,320,"TCTAAACCTATACCACCAAC","AGCGTTAACGTTTAAAGATT","561307.5.peg.1801"," 893"
"8732",8,481,473,"ATCTATTACTGCTCACAAGG","AGCGTTAACGTTTAAAGATT","561307.5.peg.1801"," 893"
"8733",230,481,251,"ATAAAGAGAAATCACCAACT","AGCGTTAACGTTTAAAGATT","561307.5.peg.1801"," 893"
"8734",305,481,176,"CATCATCAATAGTTCTTCCT","AGCGTTAACGTTTAAAGATT","561307.5.peg.1801"," 893"
"8735",657,481,176,"CTGTCGTCTGTAACTAAGAT","AGCGTTAACGTTTAAAGATT","561307.5.peg.1801"," 893"
"8736",362,481,119,"TTATAAGTGCACTTGCAACA","AGCGTTAACGTTTAAAGATT","561307.5.peg.1801"," 893"
"8737",293,481,188,"TTCTTCCTTGGAAACGTTCA","AGCGTTAACGTTTAAAGATT","561307.5.peg.1801"," 893"
"8738",230,506,276,"ATAAAGAGAAATCACCAACT","TAATCGGACCAACAATGACA","561307.5.peg.1801"," 893"
"8739",293,506,213,"TTCTTCCTTGGAAACGTTCA","TAATCGGACCAACAATGACA","561307.5.peg.1801"," 893"
"8740",8,506,498,"ATCTATTACTGCTCACAAGG","TAATCGGACCAACAATGACA","561307.5.peg.1801"," 893"
"8741",362,506,144,"TTATAAGTGCACTTGCAACA","TAATCGGACCAACAATGACA","561307.5.peg.1801"," 893"
"8742",657,506,151,"CTGTCGTCTGTAACTAAGAT","TAATCGGACCAACAATGACA","561307.5.peg.1801"," 893"
"8743",801,506,295,"TCTAAACCTATACCACCAAC","TAATCGGACCAACAATGACA","561307.5.peg.1801"," 893"
"8744",305,506,201,"CATCATCAATAGTTCTTCCT","TAATCGGACCAACAATGACA","561307.5.peg.1801"," 893"
"8745",362,657,295,"TTATAAGTGCACTTGCAACA","CTGTCGTCTGTAACTAAGAT","561307.5.peg.1801"," 893"
"8746",8,657,649,"ATCTATTACTGCTCACAAGG","CTGTCGTCTGTAACTAAGAT","561307.5.peg.1801"," 893"
"8747",506,657,151,"TAATCGGACCAACAATGACA","CTGTCGTCTGTAACTAAGAT","561307.5.peg.1801"," 893"
"8748",293,657,364,"TTCTTCCTTGGAAACGTTCA","CTGTCGTCTGTAACTAAGAT","561307.5.peg.1801"," 893"
"8749",417,657,240,"GGCTCAACATTGTCCCATTC","CTGTCGTCTGTAACTAAGAT","561307.5.peg.1801"," 893"
"8750",438,657,219,"AATACATTGCGACTCACTTT","CTGTCGTCTGTAACTAAGAT","561307.5.peg.1801"," 893"
"8751",305,657,352,"CATCATCAATAGTTCTTCCT","CTGTCGTCTGTAACTAAGAT","561307.5.peg.1801"," 893"
"8752",481,657,176,"AGCGTTAACGTTTAAAGATT","CTGTCGTCTGTAACTAAGAT","561307.5.peg.1801"," 893"
"8753",801,657,144,"TCTAAACCTATACCACCAAC","CTGTCGTCTGTAACTAAGAT","561307.5.peg.1801"," 893"
"8754",230,657,427,"ATAAAGAGAAATCACCAACT","CTGTCGTCTGTAACTAAGAT","561307.5.peg.1801"," 893"
"8755",230,801,571,"ATAAAGAGAAATCACCAACT","TCTAAACCTATACCACCAAC","561307.5.peg.1801"," 893"
"8756",438,801,363,"AATACATTGCGACTCACTTT","TCTAAACCTATACCACCAAC","561307.5.peg.1801"," 893"
"8757",657,801,144,"CTGTCGTCTGTAACTAAGAT","TCTAAACCTATACCACCAAC","561307.5.peg.1801"," 893"
"8758",8,801,793,"ATCTATTACTGCTCACAAGG","TCTAAACCTATACCACCAAC","561307.5.peg.1801"," 893"
"8759",506,801,295,"TAATCGGACCAACAATGACA","TCTAAACCTATACCACCAAC","561307.5.peg.1801"," 893"
"8760",305,801,496,"CATCATCAATAGTTCTTCCT","TCTAAACCTATACCACCAAC","561307.5.peg.1801"," 893"
"8761",362,801,439,"TTATAAGTGCACTTGCAACA","TCTAAACCTATACCACCAAC","561307.5.peg.1801"," 893"
"8762",417,801,384,"GGCTCAACATTGTCCCATTC","TCTAAACCTATACCACCAAC","561307.5.peg.1801"," 893"
"8763",481,801,320,"AGCGTTAACGTTTAAAGATT","TCTAAACCTATACCACCAAC","561307.5.peg.1801"," 893"
"8764",293,801,508,"TTCTTCCTTGGAAACGTTCA","TCTAAACCTATACCACCAAC","561307.5.peg.1801"," 893"
"8765",559,2,557,"AAGTAATTTGTGTTTGAAG","ATGTCTGCAATGAGTTCATC","561307.5.peg.1802"," 894"
"8766",732,2,730,"TATCTAATAAGCTGGCATT","ATGTCTGCAATGAGTTCATC","561307.5.peg.1802"," 894"
"8767",208,2,206,"GGTTTGAATGACATCAGCAC","ATGTCTGCAATGAGTTCATC","561307.5.peg.1802"," 894"
"8768",705,2,703,"CAAGATAAGAATGCGTGCTC","ATGTCTGCAATGAGTTCATC","561307.5.peg.1802"," 894"
"8769",671,2,669,"GTGTGAAAGACTCTTGCATA","ATGTCTGCAATGAGTTCATC","561307.5.peg.1802"," 894"
"8770",488,2,486,"GACATTTGTTAACTCTTCT","ATGTCTGCAATGAGTTCATC","561307.5.peg.1802"," 894"
"8771",540,2,538,"GCGGTTAATTGAGCAATGAT","ATGTCTGCAATGAGTTCATC","561307.5.peg.1802"," 894"
"8772",139,2,137,"AAGATTATATGCTTCTGGAC","ATGTCTGCAATGAGTTCATC","561307.5.peg.1802"," 894"
"8773",665,2,663,"AAGACTCTTGCATATGGTGC","ATGTCTGCAATGAGTTCATC","561307.5.peg.1802"," 894"
"8774",671,7,664,"GTGTGAAAGACTCTTGCATA","CATCAAATACGCATTAAAGG","561307.5.peg.1802"," 894"
"8775",488,7,481,"GACATTTGTTAACTCTTCT","CATCAAATACGCATTAAAGG","561307.5.peg.1802"," 894"
"8776",732,7,725,"TATCTAATAAGCTGGCATT","CATCAAATACGCATTAAAGG","561307.5.peg.1802"," 894"
"8777",208,7,201,"GGTTTGAATGACATCAGCAC","CATCAAATACGCATTAAAGG","561307.5.peg.1802"," 894"
"8778",705,7,698,"CAAGATAAGAATGCGTGCTC","CATCAAATACGCATTAAAGG","561307.5.peg.1802"," 894"
"8779",540,7,533,"GCGGTTAATTGAGCAATGAT","CATCAAATACGCATTAAAGG","561307.5.peg.1802"," 894"
"8780",665,7,658,"AAGACTCTTGCATATGGTGC","CATCAAATACGCATTAAAGG","561307.5.peg.1802"," 894"
"8781",559,7,552,"AAGTAATTTGTGTTTGAAG","CATCAAATACGCATTAAAGG","561307.5.peg.1802"," 894"
"8782",139,7,132,"AAGATTATATGCTTCTGGAC","CATCAAATACGCATTAAAGG","561307.5.peg.1802"," 894"
"8783",488,10,478,"GACATTTGTTAACTCTTCT","GACATCAAATACGCATTAA","561307.5.peg.1802"," 894"
"8784",139,10,129,"AAGATTATATGCTTCTGGAC","GACATCAAATACGCATTAA","561307.5.peg.1802"," 894"
"8785",671,10,661,"GTGTGAAAGACTCTTGCATA","GACATCAAATACGCATTAA","561307.5.peg.1802"," 894"
"8786",208,10,198,"GGTTTGAATGACATCAGCAC","GACATCAAATACGCATTAA","561307.5.peg.1802"," 894"
"8787",705,10,695,"CAAGATAAGAATGCGTGCTC","GACATCAAATACGCATTAA","561307.5.peg.1802"," 894"
"8788",559,10,549,"AAGTAATTTGTGTTTGAAG","GACATCAAATACGCATTAA","561307.5.peg.1802"," 894"
"8789",732,10,722,"TATCTAATAAGCTGGCATT","GACATCAAATACGCATTAA","561307.5.peg.1802"," 894"
"8790",540,10,530,"GCGGTTAATTGAGCAATGAT","GACATCAAATACGCATTAA","561307.5.peg.1802"," 894"
"8791",665,10,655,"AAGACTCTTGCATATGGTGC","GACATCAAATACGCATTAA","561307.5.peg.1802"," 894"
"8792",2,139,137,"ATGTCTGCAATGAGTTCATC","AAGATTATATGCTTCTGGAC","561307.5.peg.1802"," 894"
"8793",732,139,593,"TATCTAATAAGCTGGCATT","AAGATTATATGCTTCTGGAC","561307.5.peg.1802"," 894"
"8794",665,139,526,"AAGACTCTTGCATATGGTGC","AAGATTATATGCTTCTGGAC","561307.5.peg.1802"," 894"
"8795",671,139,532,"GTGTGAAAGACTCTTGCATA","AAGATTATATGCTTCTGGAC","561307.5.peg.1802"," 894"
"8796",540,139,401,"GCGGTTAATTGAGCAATGAT","AAGATTATATGCTTCTGGAC","561307.5.peg.1802"," 894"
"8797",559,139,420,"AAGTAATTTGTGTTTGAAG","AAGATTATATGCTTCTGGAC","561307.5.peg.1802"," 894"
"8798",10,139,129,"GACATCAAATACGCATTAA","AAGATTATATGCTTCTGGAC","561307.5.peg.1802"," 894"
"8799",7,139,132,"CATCAAATACGCATTAAAGG","AAGATTATATGCTTCTGGAC","561307.5.peg.1802"," 894"
"8800",705,139,566,"CAAGATAAGAATGCGTGCTC","AAGATTATATGCTTCTGGAC","561307.5.peg.1802"," 894"
"8801",488,139,349,"GACATTTGTTAACTCTTCT","AAGATTATATGCTTCTGGAC","561307.5.peg.1802"," 894"
"8802",7,208,201,"CATCAAATACGCATTAAAGG","GGTTTGAATGACATCAGCAC","561307.5.peg.1802"," 894"
"8803",732,208,524,"TATCTAATAAGCTGGCATT","GGTTTGAATGACATCAGCAC","561307.5.peg.1802"," 894"
"8804",665,208,457,"AAGACTCTTGCATATGGTGC","GGTTTGAATGACATCAGCAC","561307.5.peg.1802"," 894"
"8805",488,208,280,"GACATTTGTTAACTCTTCT","GGTTTGAATGACATCAGCAC","561307.5.peg.1802"," 894"
"8806",540,208,332,"GCGGTTAATTGAGCAATGAT","GGTTTGAATGACATCAGCAC","561307.5.peg.1802"," 894"
"8807",671,208,463,"GTGTGAAAGACTCTTGCATA","GGTTTGAATGACATCAGCAC","561307.5.peg.1802"," 894"
"8808",2,208,206,"ATGTCTGCAATGAGTTCATC","GGTTTGAATGACATCAGCAC","561307.5.peg.1802"," 894"
"8809",10,208,198,"GACATCAAATACGCATTAA","GGTTTGAATGACATCAGCAC","561307.5.peg.1802"," 894"
"8810",559,208,351,"AAGTAATTTGTGTTTGAAG","GGTTTGAATGACATCAGCAC","561307.5.peg.1802"," 894"
"8811",705,208,497,"CAAGATAAGAATGCGTGCTC","GGTTTGAATGACATCAGCAC","561307.5.peg.1802"," 894"
"8812",10,488,478,"GACATCAAATACGCATTAA","GACATTTGTTAACTCTTCT","561307.5.peg.1802"," 894"
"8813",208,488,280,"GGTTTGAATGACATCAGCAC","GACATTTGTTAACTCTTCT","561307.5.peg.1802"," 894"
"8814",665,488,177,"AAGACTCTTGCATATGGTGC","GACATTTGTTAACTCTTCT","561307.5.peg.1802"," 894"
"8815",705,488,217,"CAAGATAAGAATGCGTGCTC","GACATTTGTTAACTCTTCT","561307.5.peg.1802"," 894"
"8816",671,488,183,"GTGTGAAAGACTCTTGCATA","GACATTTGTTAACTCTTCT","561307.5.peg.1802"," 894"
"8817",2,488,486,"ATGTCTGCAATGAGTTCATC","GACATTTGTTAACTCTTCT","561307.5.peg.1802"," 894"
"8818",139,488,349,"AAGATTATATGCTTCTGGAC","GACATTTGTTAACTCTTCT","561307.5.peg.1802"," 894"
"8819",7,488,481,"CATCAAATACGCATTAAAGG","GACATTTGTTAACTCTTCT","561307.5.peg.1802"," 894"
"8820",732,488,244,"TATCTAATAAGCTGGCATT","GACATTTGTTAACTCTTCT","561307.5.peg.1802"," 894"
"8821",208,540,332,"GGTTTGAATGACATCAGCAC","GCGGTTAATTGAGCAATGAT","561307.5.peg.1802"," 894"
"8822",7,540,533,"CATCAAATACGCATTAAAGG","GCGGTTAATTGAGCAATGAT","561307.5.peg.1802"," 894"
"8823",2,540,538,"ATGTCTGCAATGAGTTCATC","GCGGTTAATTGAGCAATGAT","561307.5.peg.1802"," 894"
"8824",705,540,165,"CAAGATAAGAATGCGTGCTC","GCGGTTAATTGAGCAATGAT","561307.5.peg.1802"," 894"
"8825",10,540,530,"GACATCAAATACGCATTAA","GCGGTTAATTGAGCAATGAT","561307.5.peg.1802"," 894"
"8826",665,540,125,"AAGACTCTTGCATATGGTGC","GCGGTTAATTGAGCAATGAT","561307.5.peg.1802"," 894"
"8827",139,540,401,"AAGATTATATGCTTCTGGAC","GCGGTTAATTGAGCAATGAT","561307.5.peg.1802"," 894"
"8828",671,540,131,"GTGTGAAAGACTCTTGCATA","GCGGTTAATTGAGCAATGAT","561307.5.peg.1802"," 894"
"8829",732,540,192,"TATCTAATAAGCTGGCATT","GCGGTTAATTGAGCAATGAT","561307.5.peg.1802"," 894"
"8830",665,559,106,"AAGACTCTTGCATATGGTGC","AAGTAATTTGTGTTTGAAG","561307.5.peg.1802"," 894"
"8831",671,559,112,"GTGTGAAAGACTCTTGCATA","AAGTAATTTGTGTTTGAAG","561307.5.peg.1802"," 894"
"8832",2,559,557,"ATGTCTGCAATGAGTTCATC","AAGTAATTTGTGTTTGAAG","561307.5.peg.1802"," 894"
"8833",139,559,420,"AAGATTATATGCTTCTGGAC","AAGTAATTTGTGTTTGAAG","561307.5.peg.1802"," 894"
"8834",732,559,173,"TATCTAATAAGCTGGCATT","AAGTAATTTGTGTTTGAAG","561307.5.peg.1802"," 894"
"8835",10,559,549,"GACATCAAATACGCATTAA","AAGTAATTTGTGTTTGAAG","561307.5.peg.1802"," 894"
"8836",208,559,351,"GGTTTGAATGACATCAGCAC","AAGTAATTTGTGTTTGAAG","561307.5.peg.1802"," 894"
"8837",7,559,552,"CATCAAATACGCATTAAAGG","AAGTAATTTGTGTTTGAAG","561307.5.peg.1802"," 894"
"8838",705,559,146,"CAAGATAAGAATGCGTGCTC","AAGTAATTTGTGTTTGAAG","561307.5.peg.1802"," 894"
"8839",2,665,663,"ATGTCTGCAATGAGTTCATC","AAGACTCTTGCATATGGTGC","561307.5.peg.1802"," 894"
"8840",208,665,457,"GGTTTGAATGACATCAGCAC","AAGACTCTTGCATATGGTGC","561307.5.peg.1802"," 894"
"8841",7,665,658,"CATCAAATACGCATTAAAGG","AAGACTCTTGCATATGGTGC","561307.5.peg.1802"," 894"
"8842",10,665,655,"GACATCAAATACGCATTAA","AAGACTCTTGCATATGGTGC","561307.5.peg.1802"," 894"
"8843",559,665,106,"AAGTAATTTGTGTTTGAAG","AAGACTCTTGCATATGGTGC","561307.5.peg.1802"," 894"
"8844",139,665,526,"AAGATTATATGCTTCTGGAC","AAGACTCTTGCATATGGTGC","561307.5.peg.1802"," 894"
"8845",488,665,177,"GACATTTGTTAACTCTTCT","AAGACTCTTGCATATGGTGC","561307.5.peg.1802"," 894"
"8846",540,665,125,"GCGGTTAATTGAGCAATGAT","AAGACTCTTGCATATGGTGC","561307.5.peg.1802"," 894"
"8847",10,671,661,"GACATCAAATACGCATTAA","GTGTGAAAGACTCTTGCATA","561307.5.peg.1802"," 894"
"8848",139,671,532,"AAGATTATATGCTTCTGGAC","GTGTGAAAGACTCTTGCATA","561307.5.peg.1802"," 894"
"8849",559,671,112,"AAGTAATTTGTGTTTGAAG","GTGTGAAAGACTCTTGCATA","561307.5.peg.1802"," 894"
"8850",2,671,669,"ATGTCTGCAATGAGTTCATC","GTGTGAAAGACTCTTGCATA","561307.5.peg.1802"," 894"
"8851",488,671,183,"GACATTTGTTAACTCTTCT","GTGTGAAAGACTCTTGCATA","561307.5.peg.1802"," 894"
"8852",7,671,664,"CATCAAATACGCATTAAAGG","GTGTGAAAGACTCTTGCATA","561307.5.peg.1802"," 894"
"8853",208,671,463,"GGTTTGAATGACATCAGCAC","GTGTGAAAGACTCTTGCATA","561307.5.peg.1802"," 894"
"8854",540,671,131,"GCGGTTAATTGAGCAATGAT","GTGTGAAAGACTCTTGCATA","561307.5.peg.1802"," 894"
"8855",139,705,566,"AAGATTATATGCTTCTGGAC","CAAGATAAGAATGCGTGCTC","561307.5.peg.1802"," 894"
"8856",7,705,698,"CATCAAATACGCATTAAAGG","CAAGATAAGAATGCGTGCTC","561307.5.peg.1802"," 894"
"8857",2,705,703,"ATGTCTGCAATGAGTTCATC","CAAGATAAGAATGCGTGCTC","561307.5.peg.1802"," 894"
"8858",559,705,146,"AAGTAATTTGTGTTTGAAG","CAAGATAAGAATGCGTGCTC","561307.5.peg.1802"," 894"
"8859",488,705,217,"GACATTTGTTAACTCTTCT","CAAGATAAGAATGCGTGCTC","561307.5.peg.1802"," 894"
"8860",10,705,695,"GACATCAAATACGCATTAA","CAAGATAAGAATGCGTGCTC","561307.5.peg.1802"," 894"
"8861",540,705,165,"GCGGTTAATTGAGCAATGAT","CAAGATAAGAATGCGTGCTC","561307.5.peg.1802"," 894"
"8862",208,705,497,"GGTTTGAATGACATCAGCAC","CAAGATAAGAATGCGTGCTC","561307.5.peg.1802"," 894"
"8863",2,732,730,"ATGTCTGCAATGAGTTCATC","TATCTAATAAGCTGGCATT","561307.5.peg.1802"," 894"
"8864",7,732,725,"CATCAAATACGCATTAAAGG","TATCTAATAAGCTGGCATT","561307.5.peg.1802"," 894"
"8865",559,732,173,"AAGTAATTTGTGTTTGAAG","TATCTAATAAGCTGGCATT","561307.5.peg.1802"," 894"
"8866",139,732,593,"AAGATTATATGCTTCTGGAC","TATCTAATAAGCTGGCATT","561307.5.peg.1802"," 894"
"8867",208,732,524,"GGTTTGAATGACATCAGCAC","TATCTAATAAGCTGGCATT","561307.5.peg.1802"," 894"
"8868",10,732,722,"GACATCAAATACGCATTAA","TATCTAATAAGCTGGCATT","561307.5.peg.1802"," 894"
"8869",488,732,244,"GACATTTGTTAACTCTTCT","TATCTAATAAGCTGGCATT","561307.5.peg.1802"," 894"
"8870",540,732,192,"GCGGTTAATTGAGCAATGAT","TATCTAATAAGCTGGCATT","561307.5.peg.1802"," 894"
"8871",146,10,136,"CGCCACCAAGACTTGTTTGA","GCATTAGATAAAGCTCAGAT","561307.5.peg.1803"," 895"
"8872",119,10,109,"TTGAAGAATCATAGAGTGGT","GCATTAGATAAAGCTCAGAT","561307.5.peg.1803"," 895"
"8873",333,10,323,"GTACCGCCATATACATCATC","GCATTAGATAAAGCTCAGAT","561307.5.peg.1803"," 895"
"8874",123,10,113,"ATGTTGAAGAATCATAGAG","GCATTAGATAAAGCTCAGAT","561307.5.peg.1803"," 895"
"8875",579,10,569,"AATAAAGGTGATTGACCTAA","GCATTAGATAAAGCTCAGAT","561307.5.peg.1803"," 895"
"8876",594,10,584,"ATATCAGCGCCAAGTAATAA","GCATTAGATAAAGCTCAGAT","561307.5.peg.1803"," 895"
"8877",406,10,396,"TTCGAGCTTTGTAGTATCTA","GCATTAGATAAAGCTCAGAT","561307.5.peg.1803"," 895"
"8878",10,119,109,"GCATTAGATAAAGCTCAGAT","TTGAAGAATCATAGAGTGGT","561307.5.peg.1803"," 895"
"8879",594,119,475,"ATATCAGCGCCAAGTAATAA","TTGAAGAATCATAGAGTGGT","561307.5.peg.1803"," 895"
"8880",333,119,214,"GTACCGCCATATACATCATC","TTGAAGAATCATAGAGTGGT","561307.5.peg.1803"," 895"
"8881",406,119,287,"TTCGAGCTTTGTAGTATCTA","TTGAAGAATCATAGAGTGGT","561307.5.peg.1803"," 895"
"8882",579,119,460,"AATAAAGGTGATTGACCTAA","TTGAAGAATCATAGAGTGGT","561307.5.peg.1803"," 895"
"8883",333,123,210,"GTACCGCCATATACATCATC","ATGTTGAAGAATCATAGAG","561307.5.peg.1803"," 895"
"8884",579,123,456,"AATAAAGGTGATTGACCTAA","ATGTTGAAGAATCATAGAG","561307.5.peg.1803"," 895"
"8885",10,123,113,"GCATTAGATAAAGCTCAGAT","ATGTTGAAGAATCATAGAG","561307.5.peg.1803"," 895"
"8886",594,123,471,"ATATCAGCGCCAAGTAATAA","ATGTTGAAGAATCATAGAG","561307.5.peg.1803"," 895"
"8887",406,123,283,"TTCGAGCTTTGTAGTATCTA","ATGTTGAAGAATCATAGAG","561307.5.peg.1803"," 895"
"8888",594,146,448,"ATATCAGCGCCAAGTAATAA","CGCCACCAAGACTTGTTTGA","561307.5.peg.1803"," 895"
"8889",406,146,260,"TTCGAGCTTTGTAGTATCTA","CGCCACCAAGACTTGTTTGA","561307.5.peg.1803"," 895"
"8890",579,146,433,"AATAAAGGTGATTGACCTAA","CGCCACCAAGACTTGTTTGA","561307.5.peg.1803"," 895"
"8891",333,146,187,"GTACCGCCATATACATCATC","CGCCACCAAGACTTGTTTGA","561307.5.peg.1803"," 895"
"8892",10,146,136,"GCATTAGATAAAGCTCAGAT","CGCCACCAAGACTTGTTTGA","561307.5.peg.1803"," 895"
"8893",123,333,210,"ATGTTGAAGAATCATAGAG","GTACCGCCATATACATCATC","561307.5.peg.1803"," 895"
"8894",119,333,214,"TTGAAGAATCATAGAGTGGT","GTACCGCCATATACATCATC","561307.5.peg.1803"," 895"
"8895",594,333,261,"ATATCAGCGCCAAGTAATAA","GTACCGCCATATACATCATC","561307.5.peg.1803"," 895"
"8896",10,333,323,"GCATTAGATAAAGCTCAGAT","GTACCGCCATATACATCATC","561307.5.peg.1803"," 895"
"8897",579,333,246,"AATAAAGGTGATTGACCTAA","GTACCGCCATATACATCATC","561307.5.peg.1803"," 895"
"8898",146,333,187,"CGCCACCAAGACTTGTTTGA","GTACCGCCATATACATCATC","561307.5.peg.1803"," 895"
"8899",10,406,396,"GCATTAGATAAAGCTCAGAT","TTCGAGCTTTGTAGTATCTA","561307.5.peg.1803"," 895"
"8900",119,406,287,"TTGAAGAATCATAGAGTGGT","TTCGAGCTTTGTAGTATCTA","561307.5.peg.1803"," 895"
"8901",579,406,173,"AATAAAGGTGATTGACCTAA","TTCGAGCTTTGTAGTATCTA","561307.5.peg.1803"," 895"
"8902",146,406,260,"CGCCACCAAGACTTGTTTGA","TTCGAGCTTTGTAGTATCTA","561307.5.peg.1803"," 895"
"8903",123,406,283,"ATGTTGAAGAATCATAGAG","TTCGAGCTTTGTAGTATCTA","561307.5.peg.1803"," 895"
"8904",594,406,188,"ATATCAGCGCCAAGTAATAA","TTCGAGCTTTGTAGTATCTA","561307.5.peg.1803"," 895"
"8905",10,579,569,"GCATTAGATAAAGCTCAGAT","AATAAAGGTGATTGACCTAA","561307.5.peg.1803"," 895"
"8906",333,579,246,"GTACCGCCATATACATCATC","AATAAAGGTGATTGACCTAA","561307.5.peg.1803"," 895"
"8907",406,579,173,"TTCGAGCTTTGTAGTATCTA","AATAAAGGTGATTGACCTAA","561307.5.peg.1803"," 895"
"8908",123,579,456,"ATGTTGAAGAATCATAGAG","AATAAAGGTGATTGACCTAA","561307.5.peg.1803"," 895"
"8909",119,579,460,"TTGAAGAATCATAGAGTGGT","AATAAAGGTGATTGACCTAA","561307.5.peg.1803"," 895"
"8910",146,579,433,"CGCCACCAAGACTTGTTTGA","AATAAAGGTGATTGACCTAA","561307.5.peg.1803"," 895"
"8911",146,594,448,"CGCCACCAAGACTTGTTTGA","ATATCAGCGCCAAGTAATAA","561307.5.peg.1803"," 895"
"8912",406,594,188,"TTCGAGCTTTGTAGTATCTA","ATATCAGCGCCAAGTAATAA","561307.5.peg.1803"," 895"
"8913",119,594,475,"TTGAAGAATCATAGAGTGGT","ATATCAGCGCCAAGTAATAA","561307.5.peg.1803"," 895"
"8914",333,594,261,"GTACCGCCATATACATCATC","ATATCAGCGCCAAGTAATAA","561307.5.peg.1803"," 895"
"8915",10,594,584,"GCATTAGATAAAGCTCAGAT","ATATCAGCGCCAAGTAATAA","561307.5.peg.1803"," 895"
"8916",123,594,471,"ATGTTGAAGAATCATAGAG","ATATCAGCGCCAAGTAATAA","561307.5.peg.1803"," 895"
"8917",223,85,138,"TGCAATACCATGCTCAAGTT","TATAGCACCGGTTGAATCAT","561307.5.peg.1804"," 896"
"8918",192,85,107,"GTTTCAAATGTTGAGCGTGT","TATAGCACCGGTTGAATCAT","561307.5.peg.1804"," 896"
"8919",468,85,383,"TCATTTGTGGGTTAGATAT","TATAGCACCGGTTGAATCAT","561307.5.peg.1804"," 896"
"8920",479,85,394,"CATCAATAGCAATCATTTGT","TATAGCACCGGTTGAATCAT","561307.5.peg.1804"," 896"
"8921",468,97,371,"TCATTTGTGGGTTAGATAT","GATTGGATTCGCTATAGCAC","561307.5.peg.1804"," 896"
"8922",479,97,382,"CATCAATAGCAATCATTTGT","GATTGGATTCGCTATAGCAC","561307.5.peg.1804"," 896"
"8923",223,97,126,"TGCAATACCATGCTCAAGTT","GATTGGATTCGCTATAGCAC","561307.5.peg.1804"," 896"
"8924",85,192,107,"TATAGCACCGGTTGAATCAT","GTTTCAAATGTTGAGCGTGT","561307.5.peg.1804"," 896"
"8925",468,192,276,"TCATTTGTGGGTTAGATAT","GTTTCAAATGTTGAGCGTGT","561307.5.peg.1804"," 896"
"8926",479,192,287,"CATCAATAGCAATCATTTGT","GTTTCAAATGTTGAGCGTGT","561307.5.peg.1804"," 896"
"8927",85,223,138,"TATAGCACCGGTTGAATCAT","TGCAATACCATGCTCAAGTT","561307.5.peg.1804"," 896"
"8928",468,223,245,"TCATTTGTGGGTTAGATAT","TGCAATACCATGCTCAAGTT","561307.5.peg.1804"," 896"
"8929",479,223,256,"CATCAATAGCAATCATTTGT","TGCAATACCATGCTCAAGTT","561307.5.peg.1804"," 896"
"8930",97,223,126,"GATTGGATTCGCTATAGCAC","TGCAATACCATGCTCAAGTT","561307.5.peg.1804"," 896"
"8931",85,468,383,"TATAGCACCGGTTGAATCAT","TCATTTGTGGGTTAGATAT","561307.5.peg.1804"," 896"
"8932",223,468,245,"TGCAATACCATGCTCAAGTT","TCATTTGTGGGTTAGATAT","561307.5.peg.1804"," 896"
"8933",97,468,371,"GATTGGATTCGCTATAGCAC","TCATTTGTGGGTTAGATAT","561307.5.peg.1804"," 896"
"8934",192,468,276,"GTTTCAAATGTTGAGCGTGT","TCATTTGTGGGTTAGATAT","561307.5.peg.1804"," 896"
"8935",97,479,382,"GATTGGATTCGCTATAGCAC","CATCAATAGCAATCATTTGT","561307.5.peg.1804"," 896"
"8936",85,479,394,"TATAGCACCGGTTGAATCAT","CATCAATAGCAATCATTTGT","561307.5.peg.1804"," 896"
"8937",192,479,287,"GTTTCAAATGTTGAGCGTGT","CATCAATAGCAATCATTTGT","561307.5.peg.1804"," 896"
"8938",223,479,256,"TGCAATACCATGCTCAAGTT","CATCAATAGCAATCATTTGT","561307.5.peg.1804"," 896"
"8939",243,81,162,"CTGTAAATTCAAATGTAGT","ATGTTGATTTACCAACGTT","561307.5.peg.1808"," 900"
"8940",81,243,162,"ATGTTGATTTACCAACGTT","CTGTAAATTCAAATGTAGT","561307.5.peg.1808"," 900"
"8941",120,2,118,"TTTGCACAATAAAGCCATTC","ATAATAGTTGTGAGGTGGTA","561307.5.peg.1809"," 901"
"8942",120,7,113,"TTTGCACAATAAAGCCATTC","GTTCTATAATAGTTGTGAGG","561307.5.peg.1809"," 901"
"8943",2,120,118,"ATAATAGTTGTGAGGTGGTA","TTTGCACAATAAAGCCATTC","561307.5.peg.1809"," 901"
"8944",7,120,113,"GTTCTATAATAGTTGTGAGG","TTTGCACAATAAAGCCATTC","561307.5.peg.1809"," 901"
"8945",675,151,524,"CCTAGCATACCTAAAGCACC","TCTTCTGTATCGATTACGTA","561307.5.peg.181"," 902"
"8946",151,675,524,"TCTTCTGTATCGATTACGTA","CCTAGCATACCTAAAGCACC","561307.5.peg.181"," 902"
"8947",111,8,103,"GTCGCTACACTCACACCTGA","AGACAAGTAATAATTAGAGG","561307.5.peg.1811"," 904"
"8948",8,111,103,"AGACAAGTAATAATTAGAGG","GTCGCTACACTCACACCTGA","561307.5.peg.1811"," 904"
"8949",169,10,159,"TGTTTATCTTGTACACTTG","ATAAAGCTTTACATCAAGG","561307.5.peg.1816"," 909"
"8950",10,169,159,"ATAAAGCTTTACATCAAGG","TGTTTATCTTGTACACTTG","561307.5.peg.1816"," 909"
"8951",264,141,123,"GTCGTTGATGCAATGTCATA","TTTGTGCCAGTATCCGTTAA","561307.5.peg.1821"," 915"
"8952",289,141,148,"TGAACGTTCTCTTAATAGAG","TTTGTGCCAGTATCCGTTAA","561307.5.peg.1821"," 915"
"8953",291,141,150,"AGTGAACGTTCTCTTAATAG","TTTGTGCCAGTATCCGTTAA","561307.5.peg.1821"," 915"
"8954",141,264,123,"TTTGTGCCAGTATCCGTTAA","GTCGTTGATGCAATGTCATA","561307.5.peg.1821"," 915"
"8955",141,289,148,"TTTGTGCCAGTATCCGTTAA","TGAACGTTCTCTTAATAGAG","561307.5.peg.1821"," 915"
"8956",141,291,150,"TTTGTGCCAGTATCCGTTAA","AGTGAACGTTCTCTTAATAG","561307.5.peg.1821"," 915"
"8957",288,124,164,"GAGTTAAACTCGTGACCTAA","TTTATCATCTGAACCAAGGC","561307.5.peg.1825"," 919"
"8958",231,124,107,"GGACGATTGACTGAGAAACT","TTTATCATCTGAACCAAGGC","561307.5.peg.1825"," 919"
"8959",441,124,317,"TTAAGTGCTTGAACGACATC","TTTATCATCTGAACCAAGGC","561307.5.peg.1825"," 919"
"8960",252,124,128,"GTTACACCTGTTTCTTCGCC","TTTATCATCTGAACCAAGGC","561307.5.peg.1825"," 919"
"8961",693,124,569,"ATCGCTGCACTACCACTAGC","TTTATCATCTGAACCAAGGC","561307.5.peg.1825"," 919"
"8962",770,124,646,"TACCAGCAGTATCATTAACT","TTTATCATCTGAACCAAGGC","561307.5.peg.1825"," 919"
"8963",482,124,358,"TCATAGAATGCGTGATGTTA","TTTATCATCTGAACCAAGGC","561307.5.peg.1825"," 919"
"8964",124,231,107,"TTTATCATCTGAACCAAGGC","GGACGATTGACTGAGAAACT","561307.5.peg.1825"," 919"
"8965",770,231,539,"TACCAGCAGTATCATTAACT","GGACGATTGACTGAGAAACT","561307.5.peg.1825"," 919"
"8966",441,231,210,"TTAAGTGCTTGAACGACATC","GGACGATTGACTGAGAAACT","561307.5.peg.1825"," 919"
"8967",482,231,251,"TCATAGAATGCGTGATGTTA","GGACGATTGACTGAGAAACT","561307.5.peg.1825"," 919"
"8968",693,231,462,"ATCGCTGCACTACCACTAGC","GGACGATTGACTGAGAAACT","561307.5.peg.1825"," 919"
"8969",441,252,189,"TTAAGTGCTTGAACGACATC","GTTACACCTGTTTCTTCGCC","561307.5.peg.1825"," 919"
"8970",693,252,441,"ATCGCTGCACTACCACTAGC","GTTACACCTGTTTCTTCGCC","561307.5.peg.1825"," 919"
"8971",124,252,128,"TTTATCATCTGAACCAAGGC","GTTACACCTGTTTCTTCGCC","561307.5.peg.1825"," 919"
"8972",770,252,518,"TACCAGCAGTATCATTAACT","GTTACACCTGTTTCTTCGCC","561307.5.peg.1825"," 919"
"8973",482,252,230,"TCATAGAATGCGTGATGTTA","GTTACACCTGTTTCTTCGCC","561307.5.peg.1825"," 919"
"8974",770,288,482,"TACCAGCAGTATCATTAACT","GAGTTAAACTCGTGACCTAA","561307.5.peg.1825"," 919"
"8975",482,288,194,"TCATAGAATGCGTGATGTTA","GAGTTAAACTCGTGACCTAA","561307.5.peg.1825"," 919"
"8976",693,288,405,"ATCGCTGCACTACCACTAGC","GAGTTAAACTCGTGACCTAA","561307.5.peg.1825"," 919"
"8977",441,288,153,"TTAAGTGCTTGAACGACATC","GAGTTAAACTCGTGACCTAA","561307.5.peg.1825"," 919"
"8978",124,288,164,"TTTATCATCTGAACCAAGGC","GAGTTAAACTCGTGACCTAA","561307.5.peg.1825"," 919"
"8979",252,441,189,"GTTACACCTGTTTCTTCGCC","TTAAGTGCTTGAACGACATC","561307.5.peg.1825"," 919"
"8980",231,441,210,"GGACGATTGACTGAGAAACT","TTAAGTGCTTGAACGACATC","561307.5.peg.1825"," 919"
"8981",770,441,329,"TACCAGCAGTATCATTAACT","TTAAGTGCTTGAACGACATC","561307.5.peg.1825"," 919"
"8982",124,441,317,"TTTATCATCTGAACCAAGGC","TTAAGTGCTTGAACGACATC","561307.5.peg.1825"," 919"
"8983",693,441,252,"ATCGCTGCACTACCACTAGC","TTAAGTGCTTGAACGACATC","561307.5.peg.1825"," 919"
"8984",288,441,153,"GAGTTAAACTCGTGACCTAA","TTAAGTGCTTGAACGACATC","561307.5.peg.1825"," 919"
"8985",124,482,358,"TTTATCATCTGAACCAAGGC","TCATAGAATGCGTGATGTTA","561307.5.peg.1825"," 919"
"8986",231,482,251,"GGACGATTGACTGAGAAACT","TCATAGAATGCGTGATGTTA","561307.5.peg.1825"," 919"
"8987",693,482,211,"ATCGCTGCACTACCACTAGC","TCATAGAATGCGTGATGTTA","561307.5.peg.1825"," 919"
"8988",288,482,194,"GAGTTAAACTCGTGACCTAA","TCATAGAATGCGTGATGTTA","561307.5.peg.1825"," 919"
"8989",252,482,230,"GTTACACCTGTTTCTTCGCC","TCATAGAATGCGTGATGTTA","561307.5.peg.1825"," 919"
"8990",770,482,288,"TACCAGCAGTATCATTAACT","TCATAGAATGCGTGATGTTA","561307.5.peg.1825"," 919"
"8991",124,693,569,"TTTATCATCTGAACCAAGGC","ATCGCTGCACTACCACTAGC","561307.5.peg.1825"," 919"
"8992",441,693,252,"TTAAGTGCTTGAACGACATC","ATCGCTGCACTACCACTAGC","561307.5.peg.1825"," 919"
"8993",482,693,211,"TCATAGAATGCGTGATGTTA","ATCGCTGCACTACCACTAGC","561307.5.peg.1825"," 919"
"8994",252,693,441,"GTTACACCTGTTTCTTCGCC","ATCGCTGCACTACCACTAGC","561307.5.peg.1825"," 919"
"8995",231,693,462,"GGACGATTGACTGAGAAACT","ATCGCTGCACTACCACTAGC","561307.5.peg.1825"," 919"
"8996",288,693,405,"GAGTTAAACTCGTGACCTAA","ATCGCTGCACTACCACTAGC","561307.5.peg.1825"," 919"
"8997",288,770,482,"GAGTTAAACTCGTGACCTAA","TACCAGCAGTATCATTAACT","561307.5.peg.1825"," 919"
"8998",482,770,288,"TCATAGAATGCGTGATGTTA","TACCAGCAGTATCATTAACT","561307.5.peg.1825"," 919"
"8999",231,770,539,"GGACGATTGACTGAGAAACT","TACCAGCAGTATCATTAACT","561307.5.peg.1825"," 919"
"9000",441,770,329,"TTAAGTGCTTGAACGACATC","TACCAGCAGTATCATTAACT","561307.5.peg.1825"," 919"
"9001",124,770,646,"TTTATCATCTGAACCAAGGC","TACCAGCAGTATCATTAACT","561307.5.peg.1825"," 919"
"9002",252,770,518,"GTTACACCTGTTTCTTCGCC","TACCAGCAGTATCATTAACT","561307.5.peg.1825"," 919"
"9003",114,5,109,"TAACAACGTCTTCACTTAA","ATTGTAAAGTATCGAGGAGT","561307.5.peg.1827"," 921"
"9004",179,5,174,"CAATAATTGAGTATGCTTGC","ATTGTAAAGTATCGAGGAGT","561307.5.peg.1827"," 921"
"9005",5,114,109,"ATTGTAAAGTATCGAGGAGT","TAACAACGTCTTCACTTAA","561307.5.peg.1827"," 921"
"9006",5,179,174,"ATTGTAAAGTATCGAGGAGT","CAATAATTGAGTATGCTTGC","561307.5.peg.1827"," 921"
"9007",300,9,291,"CTGTCAGCAATCCATCCGCC","GTATTAGGGGAAGAAAGGAT","561307.5.peg.1830"," 925"
"9008",608,9,599,"CTGCAATCAAGAATCCGCCG","GTATTAGGGGAAGAAAGGAT","561307.5.peg.1830"," 925"
"9009",117,9,108,"AAGAGTACGCCTAGTCCTCG","GTATTAGGGGAAGAAAGGAT","561307.5.peg.1830"," 925"
"9010",396,9,387,"ATAAGCCGATTAATGCAAA","GTATTAGGGGAAGAAAGGAT","561307.5.peg.1830"," 925"
"9011",705,9,696,"GCTGGTGTCAATGGGTTAGT","GTATTAGGGGAAGAAAGGAT","561307.5.peg.1830"," 925"
"9012",300,14,286,"CTGTCAGCAATCCATCCGCC","CTATTGTATTAGGGGAAGAA","561307.5.peg.1830"," 925"
"9013",608,14,594,"CTGCAATCAAGAATCCGCCG","CTATTGTATTAGGGGAAGAA","561307.5.peg.1830"," 925"
"9014",117,14,103,"AAGAGTACGCCTAGTCCTCG","CTATTGTATTAGGGGAAGAA","561307.5.peg.1830"," 925"
"9015",396,14,382,"ATAAGCCGATTAATGCAAA","CTATTGTATTAGGGGAAGAA","561307.5.peg.1830"," 925"
"9016",705,14,691,"GCTGGTGTCAATGGGTTAGT","CTATTGTATTAGGGGAAGAA","561307.5.peg.1830"," 925"
"9017",608,67,541,"CTGCAATCAAGAATCCGCCG","GTCTTGAATTTGATTTCCAT","561307.5.peg.1830"," 925"
"9018",396,67,329,"ATAAGCCGATTAATGCAAA","GTCTTGAATTTGATTTCCAT","561307.5.peg.1830"," 925"
"9019",300,67,233,"CTGTCAGCAATCCATCCGCC","GTCTTGAATTTGATTTCCAT","561307.5.peg.1830"," 925"
"9020",705,67,638,"GCTGGTGTCAATGGGTTAGT","GTCTTGAATTTGATTTCCAT","561307.5.peg.1830"," 925"
"9021",705,117,588,"GCTGGTGTCAATGGGTTAGT","AAGAGTACGCCTAGTCCTCG","561307.5.peg.1830"," 925"
"9022",396,117,279,"ATAAGCCGATTAATGCAAA","AAGAGTACGCCTAGTCCTCG","561307.5.peg.1830"," 925"
"9023",14,117,103,"CTATTGTATTAGGGGAAGAA","AAGAGTACGCCTAGTCCTCG","561307.5.peg.1830"," 925"
"9024",300,117,183,"CTGTCAGCAATCCATCCGCC","AAGAGTACGCCTAGTCCTCG","561307.5.peg.1830"," 925"
"9025",608,117,491,"CTGCAATCAAGAATCCGCCG","AAGAGTACGCCTAGTCCTCG","561307.5.peg.1830"," 925"
"9026",9,117,108,"GTATTAGGGGAAGAAAGGAT","AAGAGTACGCCTAGTCCTCG","561307.5.peg.1830"," 925"
"9027",9,300,291,"GTATTAGGGGAAGAAAGGAT","CTGTCAGCAATCCATCCGCC","561307.5.peg.1830"," 925"
"9028",14,300,286,"CTATTGTATTAGGGGAAGAA","CTGTCAGCAATCCATCCGCC","561307.5.peg.1830"," 925"
"9029",117,300,183,"AAGAGTACGCCTAGTCCTCG","CTGTCAGCAATCCATCCGCC","561307.5.peg.1830"," 925"
"9030",705,300,405,"GCTGGTGTCAATGGGTTAGT","CTGTCAGCAATCCATCCGCC","561307.5.peg.1830"," 925"
"9031",608,300,308,"CTGCAATCAAGAATCCGCCG","CTGTCAGCAATCCATCCGCC","561307.5.peg.1830"," 925"
"9032",67,300,233,"GTCTTGAATTTGATTTCCAT","CTGTCAGCAATCCATCCGCC","561307.5.peg.1830"," 925"
"9033",67,396,329,"GTCTTGAATTTGATTTCCAT","ATAAGCCGATTAATGCAAA","561307.5.peg.1830"," 925"
"9034",705,396,309,"GCTGGTGTCAATGGGTTAGT","ATAAGCCGATTAATGCAAA","561307.5.peg.1830"," 925"
"9035",117,396,279,"AAGAGTACGCCTAGTCCTCG","ATAAGCCGATTAATGCAAA","561307.5.peg.1830"," 925"
"9036",9,396,387,"GTATTAGGGGAAGAAAGGAT","ATAAGCCGATTAATGCAAA","561307.5.peg.1830"," 925"
"9037",14,396,382,"CTATTGTATTAGGGGAAGAA","ATAAGCCGATTAATGCAAA","561307.5.peg.1830"," 925"
"9038",608,396,212,"CTGCAATCAAGAATCCGCCG","ATAAGCCGATTAATGCAAA","561307.5.peg.1830"," 925"
"9039",9,608,599,"GTATTAGGGGAAGAAAGGAT","CTGCAATCAAGAATCCGCCG","561307.5.peg.1830"," 925"
"9040",14,608,594,"CTATTGTATTAGGGGAAGAA","CTGCAATCAAGAATCCGCCG","561307.5.peg.1830"," 925"
"9041",117,608,491,"AAGAGTACGCCTAGTCCTCG","CTGCAATCAAGAATCCGCCG","561307.5.peg.1830"," 925"
"9042",396,608,212,"ATAAGCCGATTAATGCAAA","CTGCAATCAAGAATCCGCCG","561307.5.peg.1830"," 925"
"9043",67,608,541,"GTCTTGAATTTGATTTCCAT","CTGCAATCAAGAATCCGCCG","561307.5.peg.1830"," 925"
"9044",300,608,308,"CTGTCAGCAATCCATCCGCC","CTGCAATCAAGAATCCGCCG","561307.5.peg.1830"," 925"
"9045",67,705,638,"GTCTTGAATTTGATTTCCAT","GCTGGTGTCAATGGGTTAGT","561307.5.peg.1830"," 925"
"9046",14,705,691,"CTATTGTATTAGGGGAAGAA","GCTGGTGTCAATGGGTTAGT","561307.5.peg.1830"," 925"
"9047",396,705,309,"ATAAGCCGATTAATGCAAA","GCTGGTGTCAATGGGTTAGT","561307.5.peg.1830"," 925"
"9048",9,705,696,"GTATTAGGGGAAGAAAGGAT","GCTGGTGTCAATGGGTTAGT","561307.5.peg.1830"," 925"
"9049",300,705,405,"CTGTCAGCAATCCATCCGCC","GCTGGTGTCAATGGGTTAGT","561307.5.peg.1830"," 925"
"9050",117,705,588,"AAGAGTACGCCTAGTCCTCG","GCTGGTGTCAATGGGTTAGT","561307.5.peg.1830"," 925"
"9051",222,62,160,"AAATCTGGTTGCCCAGTAAT","CTTGTAATTCATCTTGTTGA","561307.5.peg.1831"," 926"
"9052",62,222,160,"CTTGTAATTCATCTTGTTGA","AAATCTGGTTGCCCAGTAAT","561307.5.peg.1831"," 926"
"9053",146,9,137,"ATAAGCTACTAAAGCTTCT","TTGAATTTAAGAACAAGGT","561307.5.peg.1834"," 929"
"9054",533,9,524,"CTAGCTCACCACGACGCGCA","TTGAATTTAAGAACAAGGT","561307.5.peg.1834"," 929"
"9055",726,9,717,"CCTTCAAGTGACTTAGCAAT","TTGAATTTAAGAACAAGGT","561307.5.peg.1834"," 929"
"9056",437,9,428,"GTGCTTTATTACCATTTGCT","TTGAATTTAAGAACAAGGT","561307.5.peg.1834"," 929"
"9057",421,9,412,"TGCTAGGTATAAAGCAACAA","TTGAATTTAAGAACAAGGT","561307.5.peg.1834"," 929"
"9058",782,9,773,"AGTACACAGCACCAGCACCA","TTGAATTTAAGAACAAGGT","561307.5.peg.1834"," 929"
"9059",437,146,291,"GTGCTTTATTACCATTTGCT","ATAAGCTACTAAAGCTTCT","561307.5.peg.1834"," 929"
"9060",9,146,137,"TTGAATTTAAGAACAAGGT","ATAAGCTACTAAAGCTTCT","561307.5.peg.1834"," 929"
"9061",533,146,387,"CTAGCTCACCACGACGCGCA","ATAAGCTACTAAAGCTTCT","561307.5.peg.1834"," 929"
"9062",421,146,275,"TGCTAGGTATAAAGCAACAA","ATAAGCTACTAAAGCTTCT","561307.5.peg.1834"," 929"
"9063",726,146,580,"CCTTCAAGTGACTTAGCAAT","ATAAGCTACTAAAGCTTCT","561307.5.peg.1834"," 929"
"9064",782,146,636,"AGTACACAGCACCAGCACCA","ATAAGCTACTAAAGCTTCT","561307.5.peg.1834"," 929"
"9065",533,421,112,"CTAGCTCACCACGACGCGCA","TGCTAGGTATAAAGCAACAA","561307.5.peg.1834"," 929"
"9066",9,421,412,"TTGAATTTAAGAACAAGGT","TGCTAGGTATAAAGCAACAA","561307.5.peg.1834"," 929"
"9067",782,421,361,"AGTACACAGCACCAGCACCA","TGCTAGGTATAAAGCAACAA","561307.5.peg.1834"," 929"
"9068",726,421,305,"CCTTCAAGTGACTTAGCAAT","TGCTAGGTATAAAGCAACAA","561307.5.peg.1834"," 929"
"9069",146,421,275,"ATAAGCTACTAAAGCTTCT","TGCTAGGTATAAAGCAACAA","561307.5.peg.1834"," 929"
"9070",9,437,428,"TTGAATTTAAGAACAAGGT","GTGCTTTATTACCATTTGCT","561307.5.peg.1834"," 929"
"9071",146,437,291,"ATAAGCTACTAAAGCTTCT","GTGCTTTATTACCATTTGCT","561307.5.peg.1834"," 929"
"9072",782,437,345,"AGTACACAGCACCAGCACCA","GTGCTTTATTACCATTTGCT","561307.5.peg.1834"," 929"
"9073",726,437,289,"CCTTCAAGTGACTTAGCAAT","GTGCTTTATTACCATTTGCT","561307.5.peg.1834"," 929"
"9074",782,533,249,"AGTACACAGCACCAGCACCA","CTAGCTCACCACGACGCGCA","561307.5.peg.1834"," 929"
"9075",146,533,387,"ATAAGCTACTAAAGCTTCT","CTAGCTCACCACGACGCGCA","561307.5.peg.1834"," 929"
"9076",421,533,112,"TGCTAGGTATAAAGCAACAA","CTAGCTCACCACGACGCGCA","561307.5.peg.1834"," 929"
"9077",9,533,524,"TTGAATTTAAGAACAAGGT","CTAGCTCACCACGACGCGCA","561307.5.peg.1834"," 929"
"9078",726,533,193,"CCTTCAAGTGACTTAGCAAT","CTAGCTCACCACGACGCGCA","561307.5.peg.1834"," 929"
"9079",9,726,717,"TTGAATTTAAGAACAAGGT","CCTTCAAGTGACTTAGCAAT","561307.5.peg.1834"," 929"
"9080",421,726,305,"TGCTAGGTATAAAGCAACAA","CCTTCAAGTGACTTAGCAAT","561307.5.peg.1834"," 929"
"9081",146,726,580,"ATAAGCTACTAAAGCTTCT","CCTTCAAGTGACTTAGCAAT","561307.5.peg.1834"," 929"
"9082",437,726,289,"GTGCTTTATTACCATTTGCT","CCTTCAAGTGACTTAGCAAT","561307.5.peg.1834"," 929"
"9083",533,726,193,"CTAGCTCACCACGACGCGCA","CCTTCAAGTGACTTAGCAAT","561307.5.peg.1834"," 929"
"9084",533,782,249,"CTAGCTCACCACGACGCGCA","AGTACACAGCACCAGCACCA","561307.5.peg.1834"," 929"
"9085",9,782,773,"TTGAATTTAAGAACAAGGT","AGTACACAGCACCAGCACCA","561307.5.peg.1834"," 929"
"9086",437,782,345,"GTGCTTTATTACCATTTGCT","AGTACACAGCACCAGCACCA","561307.5.peg.1834"," 929"
"9087",421,782,361,"TGCTAGGTATAAAGCAACAA","AGTACACAGCACCAGCACCA","561307.5.peg.1834"," 929"
"9088",146,782,636,"ATAAGCTACTAAAGCTTCT","AGTACACAGCACCAGCACCA","561307.5.peg.1834"," 929"
"9089",372,12,360,"AGGTAGTTTGTTTCACTAGA","TATTGAGTAACATTACAGG","561307.5.peg.1835"," 930"
"9090",497,12,485,"TCGTAACTCTGGCCATATAT","TATTGAGTAACATTACAGG","561307.5.peg.1835"," 930"
"9091",258,12,246,"GTCGTATGTAGCATAACTAA","TATTGAGTAACATTACAGG","561307.5.peg.1835"," 930"
"9092",12,258,246,"TATTGAGTAACATTACAGG","GTCGTATGTAGCATAACTAA","561307.5.peg.1835"," 930"
"9093",372,258,114,"AGGTAGTTTGTTTCACTAGA","GTCGTATGTAGCATAACTAA","561307.5.peg.1835"," 930"
"9094",497,258,239,"TCGTAACTCTGGCCATATAT","GTCGTATGTAGCATAACTAA","561307.5.peg.1835"," 930"
"9095",12,372,360,"TATTGAGTAACATTACAGG","AGGTAGTTTGTTTCACTAGA","561307.5.peg.1835"," 930"
"9096",497,372,125,"TCGTAACTCTGGCCATATAT","AGGTAGTTTGTTTCACTAGA","561307.5.peg.1835"," 930"
"9097",258,372,114,"GTCGTATGTAGCATAACTAA","AGGTAGTTTGTTTCACTAGA","561307.5.peg.1835"," 930"
"9098",12,497,485,"TATTGAGTAACATTACAGG","TCGTAACTCTGGCCATATAT","561307.5.peg.1835"," 930"
"9099",258,497,239,"GTCGTATGTAGCATAACTAA","TCGTAACTCTGGCCATATAT","561307.5.peg.1835"," 930"
"9100",372,497,125,"AGGTAGTTTGTTTCACTAGA","TCGTAACTCTGGCCATATAT","561307.5.peg.1835"," 930"
"9101",205,8,197,"AATCACCACTGAAGTTGCAA","TATCTTGCTTATGAAAGGT","561307.5.peg.1837"," 932"
"9102",248,8,240,"TTATTGATGGTGTCAATAGA","TATCTTGCTTATGAAAGGT","561307.5.peg.1837"," 932"
"9103",261,8,253,"GCATCTAACCCCATTATTGA","TATCTTGCTTATGAAAGGT","561307.5.peg.1837"," 932"
"9104",8,205,197,"TATCTTGCTTATGAAAGGT","AATCACCACTGAAGTTGCAA","561307.5.peg.1837"," 932"
"9105",8,248,240,"TATCTTGCTTATGAAAGGT","TTATTGATGGTGTCAATAGA","561307.5.peg.1837"," 932"
"9106",8,261,253,"TATCTTGCTTATGAAAGGT","GCATCTAACCCCATTATTGA","561307.5.peg.1837"," 932"
"9107",353,153,200,"TCAAACGACCTTTAGAATAA","GTACTCTTACCCGCACCATT","561307.5.peg.1838"," 933"
"9108",153,353,200,"GTACTCTTACCCGCACCATT","TCAAACGACCTTTAGAATAA","561307.5.peg.1838"," 933"
"9109",208,88,120,"AGCATTTCCGCGTAATGAAT","TTGATATGCCGCTTCTGAAC","561307.5.peg.184"," 935"
"9110",426,88,338,"GCGATAATTGTGTATCCATC","TTGATATGCCGCTTCTGAAC","561307.5.peg.184"," 935"
"9111",472,88,384,"GTCCACTATTTCTTGCGCAA","TTGATATGCCGCTTCTGAAC","561307.5.peg.184"," 935"
"9112",586,88,498,"AGCTTCACCTTTATCATAAC","TTGATATGCCGCTTCTGAAC","561307.5.peg.184"," 935"
"9113",456,88,368,"GCAAGGGTTTCTGTAGTAAG","TTGATATGCCGCTTCTGAAC","561307.5.peg.184"," 935"
"9114",421,88,333,"AATTGTGTATCCATCTGGAA","TTGATATGCCGCTTCTGAAC","561307.5.peg.184"," 935"
"9115",624,88,536,"TAAATTCATCCTCAGTCAT","TTGATATGCCGCTTCTGAAC","561307.5.peg.184"," 935"
"9116",315,88,227,"ACTGCTAATGCACCACCAGC","TTGATATGCCGCTTCTGAAC","561307.5.peg.184"," 935"
"9117",421,168,253,"AATTGTGTATCCATCTGGAA","AATTTATCAGTATGGTGCGC","561307.5.peg.184"," 935"
"9118",624,168,456,"TAAATTCATCCTCAGTCAT","AATTTATCAGTATGGTGCGC","561307.5.peg.184"," 935"
"9119",315,168,147,"ACTGCTAATGCACCACCAGC","AATTTATCAGTATGGTGCGC","561307.5.peg.184"," 935"
"9120",426,168,258,"GCGATAATTGTGTATCCATC","AATTTATCAGTATGGTGCGC","561307.5.peg.184"," 935"
"9121",472,168,304,"GTCCACTATTTCTTGCGCAA","AATTTATCAGTATGGTGCGC","561307.5.peg.184"," 935"
"9122",456,168,288,"GCAAGGGTTTCTGTAGTAAG","AATTTATCAGTATGGTGCGC","561307.5.peg.184"," 935"
"9123",586,168,418,"AGCTTCACCTTTATCATAAC","AATTTATCAGTATGGTGCGC","561307.5.peg.184"," 935"
"9124",315,208,107,"ACTGCTAATGCACCACCAGC","AGCATTTCCGCGTAATGAAT","561307.5.peg.184"," 935"
"9125",88,208,120,"TTGATATGCCGCTTCTGAAC","AGCATTTCCGCGTAATGAAT","561307.5.peg.184"," 935"
"9126",421,208,213,"AATTGTGTATCCATCTGGAA","AGCATTTCCGCGTAATGAAT","561307.5.peg.184"," 935"
"9127",624,208,416,"TAAATTCATCCTCAGTCAT","AGCATTTCCGCGTAATGAAT","561307.5.peg.184"," 935"
"9128",456,208,248,"GCAAGGGTTTCTGTAGTAAG","AGCATTTCCGCGTAATGAAT","561307.5.peg.184"," 935"
"9129",472,208,264,"GTCCACTATTTCTTGCGCAA","AGCATTTCCGCGTAATGAAT","561307.5.peg.184"," 935"
"9130",426,208,218,"GCGATAATTGTGTATCCATC","AGCATTTCCGCGTAATGAAT","561307.5.peg.184"," 935"
"9131",586,208,378,"AGCTTCACCTTTATCATAAC","AGCATTTCCGCGTAATGAAT","561307.5.peg.184"," 935"
"9132",624,315,309,"TAAATTCATCCTCAGTCAT","ACTGCTAATGCACCACCAGC","561307.5.peg.184"," 935"
"9133",586,315,271,"AGCTTCACCTTTATCATAAC","ACTGCTAATGCACCACCAGC","561307.5.peg.184"," 935"
"9134",208,315,107,"AGCATTTCCGCGTAATGAAT","ACTGCTAATGCACCACCAGC","561307.5.peg.184"," 935"
"9135",421,315,106,"AATTGTGTATCCATCTGGAA","ACTGCTAATGCACCACCAGC","561307.5.peg.184"," 935"
"9136",426,315,111,"GCGATAATTGTGTATCCATC","ACTGCTAATGCACCACCAGC","561307.5.peg.184"," 935"
"9137",472,315,157,"GTCCACTATTTCTTGCGCAA","ACTGCTAATGCACCACCAGC","561307.5.peg.184"," 935"
"9138",168,315,147,"AATTTATCAGTATGGTGCGC","ACTGCTAATGCACCACCAGC","561307.5.peg.184"," 935"
"9139",456,315,141,"GCAAGGGTTTCTGTAGTAAG","ACTGCTAATGCACCACCAGC","561307.5.peg.184"," 935"
"9140",88,315,227,"TTGATATGCCGCTTCTGAAC","ACTGCTAATGCACCACCAGC","561307.5.peg.184"," 935"
"9141",586,421,165,"AGCTTCACCTTTATCATAAC","AATTGTGTATCCATCTGGAA","561307.5.peg.184"," 935"
"9142",624,421,203,"TAAATTCATCCTCAGTCAT","AATTGTGTATCCATCTGGAA","561307.5.peg.184"," 935"
"9143",208,421,213,"AGCATTTCCGCGTAATGAAT","AATTGTGTATCCATCTGGAA","561307.5.peg.184"," 935"
"9144",315,421,106,"ACTGCTAATGCACCACCAGC","AATTGTGTATCCATCTGGAA","561307.5.peg.184"," 935"
"9145",168,421,253,"AATTTATCAGTATGGTGCGC","AATTGTGTATCCATCTGGAA","561307.5.peg.184"," 935"
"9146",88,421,333,"TTGATATGCCGCTTCTGAAC","AATTGTGTATCCATCTGGAA","561307.5.peg.184"," 935"
"9147",88,426,338,"TTGATATGCCGCTTCTGAAC","GCGATAATTGTGTATCCATC","561307.5.peg.184"," 935"
"9148",168,426,258,"AATTTATCAGTATGGTGCGC","GCGATAATTGTGTATCCATC","561307.5.peg.184"," 935"
"9149",208,426,218,"AGCATTTCCGCGTAATGAAT","GCGATAATTGTGTATCCATC","561307.5.peg.184"," 935"
"9150",624,426,198,"TAAATTCATCCTCAGTCAT","GCGATAATTGTGTATCCATC","561307.5.peg.184"," 935"
"9151",586,426,160,"AGCTTCACCTTTATCATAAC","GCGATAATTGTGTATCCATC","561307.5.peg.184"," 935"
"9152",315,426,111,"ACTGCTAATGCACCACCAGC","GCGATAATTGTGTATCCATC","561307.5.peg.184"," 935"
"9153",168,456,288,"AATTTATCAGTATGGTGCGC","GCAAGGGTTTCTGTAGTAAG","561307.5.peg.184"," 935"
"9154",88,456,368,"TTGATATGCCGCTTCTGAAC","GCAAGGGTTTCTGTAGTAAG","561307.5.peg.184"," 935"
"9155",315,456,141,"ACTGCTAATGCACCACCAGC","GCAAGGGTTTCTGTAGTAAG","561307.5.peg.184"," 935"
"9156",624,456,168,"TAAATTCATCCTCAGTCAT","GCAAGGGTTTCTGTAGTAAG","561307.5.peg.184"," 935"
"9157",208,456,248,"AGCATTTCCGCGTAATGAAT","GCAAGGGTTTCTGTAGTAAG","561307.5.peg.184"," 935"
"9158",586,456,130,"AGCTTCACCTTTATCATAAC","GCAAGGGTTTCTGTAGTAAG","561307.5.peg.184"," 935"
"9159",208,472,264,"AGCATTTCCGCGTAATGAAT","GTCCACTATTTCTTGCGCAA","561307.5.peg.184"," 935"
"9160",624,472,152,"TAAATTCATCCTCAGTCAT","GTCCACTATTTCTTGCGCAA","561307.5.peg.184"," 935"
"9161",168,472,304,"AATTTATCAGTATGGTGCGC","GTCCACTATTTCTTGCGCAA","561307.5.peg.184"," 935"
"9162",315,472,157,"ACTGCTAATGCACCACCAGC","GTCCACTATTTCTTGCGCAA","561307.5.peg.184"," 935"
"9163",88,472,384,"TTGATATGCCGCTTCTGAAC","GTCCACTATTTCTTGCGCAA","561307.5.peg.184"," 935"
"9164",586,472,114,"AGCTTCACCTTTATCATAAC","GTCCACTATTTCTTGCGCAA","561307.5.peg.184"," 935"
"9165",315,586,271,"ACTGCTAATGCACCACCAGC","AGCTTCACCTTTATCATAAC","561307.5.peg.184"," 935"
"9166",426,586,160,"GCGATAATTGTGTATCCATC","AGCTTCACCTTTATCATAAC","561307.5.peg.184"," 935"
"9167",421,586,165,"AATTGTGTATCCATCTGGAA","AGCTTCACCTTTATCATAAC","561307.5.peg.184"," 935"
"9168",208,586,378,"AGCATTTCCGCGTAATGAAT","AGCTTCACCTTTATCATAAC","561307.5.peg.184"," 935"
"9169",168,586,418,"AATTTATCAGTATGGTGCGC","AGCTTCACCTTTATCATAAC","561307.5.peg.184"," 935"
"9170",88,586,498,"TTGATATGCCGCTTCTGAAC","AGCTTCACCTTTATCATAAC","561307.5.peg.184"," 935"
"9171",472,586,114,"GTCCACTATTTCTTGCGCAA","AGCTTCACCTTTATCATAAC","561307.5.peg.184"," 935"
"9172",456,586,130,"GCAAGGGTTTCTGTAGTAAG","AGCTTCACCTTTATCATAAC","561307.5.peg.184"," 935"
"9173",456,624,168,"GCAAGGGTTTCTGTAGTAAG","TAAATTCATCCTCAGTCAT","561307.5.peg.184"," 935"
"9174",88,624,536,"TTGATATGCCGCTTCTGAAC","TAAATTCATCCTCAGTCAT","561307.5.peg.184"," 935"
"9175",421,624,203,"AATTGTGTATCCATCTGGAA","TAAATTCATCCTCAGTCAT","561307.5.peg.184"," 935"
"9176",315,624,309,"ACTGCTAATGCACCACCAGC","TAAATTCATCCTCAGTCAT","561307.5.peg.184"," 935"
"9177",426,624,198,"GCGATAATTGTGTATCCATC","TAAATTCATCCTCAGTCAT","561307.5.peg.184"," 935"
"9178",208,624,416,"AGCATTTCCGCGTAATGAAT","TAAATTCATCCTCAGTCAT","561307.5.peg.184"," 935"
"9179",168,624,456,"AATTTATCAGTATGGTGCGC","TAAATTCATCCTCAGTCAT","561307.5.peg.184"," 935"
"9180",472,624,152,"GTCCACTATTTCTTGCGCAA","TAAATTCATCCTCAGTCAT","561307.5.peg.184"," 935"
"9181",413,272,141,"GAATACCACATGCAAATTCA","TACCGCGAATACCACCTTCA","561307.5.peg.1841"," 937"
"9182",435,272,163,"ACTGCACCACCAATTGAACC","TACCGCGAATACCACCTTCA","561307.5.peg.1841"," 937"
"9183",272,413,141,"TACCGCGAATACCACCTTCA","GAATACCACATGCAAATTCA","561307.5.peg.1841"," 937"
"9184",272,435,163,"TACCGCGAATACCACCTTCA","ACTGCACCACCAATTGAACC","561307.5.peg.1841"," 937"
"9185",168,3,165,"CATGTCTTCCATTAAACAA","TAATAAAGTAAGGTGGTCA","561307.5.peg.1845"," 941"
"9186",240,3,237,"TTCATATCTGCATCATGTAC","TAATAAAGTAAGGTGGTCA","561307.5.peg.1845"," 941"
"9187",304,3,301,"AAATAAATTCCCCTCGATAA","TAATAAAGTAAGGTGGTCA","561307.5.peg.1845"," 941"
"9188",240,67,173,"TTCATATCTGCATCATGTAC","AATTCCATGAAACTCATCCA","561307.5.peg.1845"," 941"
"9189",168,67,101,"CATGTCTTCCATTAAACAA","AATTCCATGAAACTCATCCA","561307.5.peg.1845"," 941"
"9190",304,67,237,"AAATAAATTCCCCTCGATAA","AATTCCATGAAACTCATCCA","561307.5.peg.1845"," 941"
"9191",3,168,165,"TAATAAAGTAAGGTGGTCA","CATGTCTTCCATTAAACAA","561307.5.peg.1845"," 941"
"9192",67,168,101,"AATTCCATGAAACTCATCCA","CATGTCTTCCATTAAACAA","561307.5.peg.1845"," 941"
"9193",304,168,136,"AAATAAATTCCCCTCGATAA","CATGTCTTCCATTAAACAA","561307.5.peg.1845"," 941"
"9194",3,240,237,"TAATAAAGTAAGGTGGTCA","TTCATATCTGCATCATGTAC","561307.5.peg.1845"," 941"
"9195",67,240,173,"AATTCCATGAAACTCATCCA","TTCATATCTGCATCATGTAC","561307.5.peg.1845"," 941"
"9196",3,304,301,"TAATAAAGTAAGGTGGTCA","AAATAAATTCCCCTCGATAA","561307.5.peg.1845"," 941"
"9197",168,304,136,"CATGTCTTCCATTAAACAA","AAATAAATTCCCCTCGATAA","561307.5.peg.1845"," 941"
"9198",67,304,237,"AATTCCATGAAACTCATCCA","AAATAAATTCCCCTCGATAA","561307.5.peg.1845"," 941"
"9199",544,354,190,"TGGTGTAAATCCAATGCGAA","TAGTATTGCCTAGTTTGTA","561307.5.peg.1846"," 942"
"9200",544,402,142,"TGGTGTAAATCCAATGCGAA","CCAACTAAACTGTTAAGTTC","561307.5.peg.1846"," 942"
"9201",354,544,190,"TAGTATTGCCTAGTTTGTA","TGGTGTAAATCCAATGCGAA","561307.5.peg.1846"," 942"
"9202",402,544,142,"CCAACTAAACTGTTAAGTTC","TGGTGTAAATCCAATGCGAA","561307.5.peg.1846"," 942"
"9203",486,14,472,"ACTTCCGATAGTGTGTAAAT","ATAGCTAGTGGTCAATTAA","561307.5.peg.1849"," 945"
"9204",298,14,284,"ACAATTGCTACAATTACTG","ATAGCTAGTGGTCAATTAA","561307.5.peg.1849"," 945"
"9205",203,14,189,"AATCTTCACGATAAGGGATA","ATAGCTAGTGGTCAATTAA","561307.5.peg.1849"," 945"
"9206",298,107,191,"ACAATTGCTACAATTACTG","TTTCTGAATACTGTAAGCGA","561307.5.peg.1849"," 945"
"9207",486,107,379,"ACTTCCGATAGTGTGTAAAT","TTTCTGAATACTGTAAGCGA","561307.5.peg.1849"," 945"
"9208",14,203,189,"ATAGCTAGTGGTCAATTAA","AATCTTCACGATAAGGGATA","561307.5.peg.1849"," 945"
"9209",486,203,283,"ACTTCCGATAGTGTGTAAAT","AATCTTCACGATAAGGGATA","561307.5.peg.1849"," 945"
"9210",14,298,284,"ATAGCTAGTGGTCAATTAA","ACAATTGCTACAATTACTG","561307.5.peg.1849"," 945"
"9211",486,298,188,"ACTTCCGATAGTGTGTAAAT","ACAATTGCTACAATTACTG","561307.5.peg.1849"," 945"
"9212",107,298,191,"TTTCTGAATACTGTAAGCGA","ACAATTGCTACAATTACTG","561307.5.peg.1849"," 945"
"9213",203,486,283,"AATCTTCACGATAAGGGATA","ACTTCCGATAGTGTGTAAAT","561307.5.peg.1849"," 945"
"9214",107,486,379,"TTTCTGAATACTGTAAGCGA","ACTTCCGATAGTGTGTAAAT","561307.5.peg.1849"," 945"
"9215",14,486,472,"ATAGCTAGTGGTCAATTAA","ACTTCCGATAGTGTGTAAAT","561307.5.peg.1849"," 945"
"9216",298,486,188,"ACAATTGCTACAATTACTG","ACTTCCGATAGTGTGTAAAT","561307.5.peg.1849"," 945"
"9217",302,9,293,"AAGCAATTGCTTCACCTTCA","TAGTAATTAGATTAGCGAGG","561307.5.peg.185"," 946"
"9218",298,9,289,"AATTGCTTCACCTTCACGGT","TAGTAATTAGATTAGCGAGG","561307.5.peg.185"," 946"
"9219",798,9,789,"GAAGTTGTAAATGGGTTTGC","TAGTAATTAGATTAGCGAGG","561307.5.peg.185"," 946"
"9220",609,9,600,"CAATAGTCCAATATTCTTC","TAGTAATTAGATTAGCGAGG","561307.5.peg.185"," 946"
"9221",952,9,943,"ATCTGAAATACGTGTAGAAT","TAGTAATTAGATTAGCGAGG","561307.5.peg.185"," 946"
"9222",296,9,287,"TTGCTTCACCTTCACGGTCG","TAGTAATTAGATTAGCGAGG","561307.5.peg.185"," 946"
"9223",302,11,291,"AAGCAATTGCTTCACCTTCA","TTAGTAATTAGATTAGCGA","561307.5.peg.185"," 946"
"9224",798,11,787,"GAAGTTGTAAATGGGTTTGC","TTAGTAATTAGATTAGCGA","561307.5.peg.185"," 946"
"9225",296,11,285,"TTGCTTCACCTTCACGGTCG","TTAGTAATTAGATTAGCGA","561307.5.peg.185"," 946"
"9226",609,11,598,"CAATAGTCCAATATTCTTC","TTAGTAATTAGATTAGCGA","561307.5.peg.185"," 946"
"9227",298,11,287,"AATTGCTTCACCTTCACGGT","TTAGTAATTAGATTAGCGA","561307.5.peg.185"," 946"
"9228",952,11,941,"ATCTGAAATACGTGTAGAAT","TTAGTAATTAGATTAGCGA","561307.5.peg.185"," 946"
"9229",9,296,287,"TAGTAATTAGATTAGCGAGG","TTGCTTCACCTTCACGGTCG","561307.5.peg.185"," 946"
"9230",11,296,285,"TTAGTAATTAGATTAGCGA","TTGCTTCACCTTCACGGTCG","561307.5.peg.185"," 946"
"9231",609,296,313,"CAATAGTCCAATATTCTTC","TTGCTTCACCTTCACGGTCG","561307.5.peg.185"," 946"
"9232",798,296,502,"GAAGTTGTAAATGGGTTTGC","TTGCTTCACCTTCACGGTCG","561307.5.peg.185"," 946"
"9233",952,296,656,"ATCTGAAATACGTGTAGAAT","TTGCTTCACCTTCACGGTCG","561307.5.peg.185"," 946"
"9234",609,298,311,"CAATAGTCCAATATTCTTC","AATTGCTTCACCTTCACGGT","561307.5.peg.185"," 946"
"9235",952,298,654,"ATCTGAAATACGTGTAGAAT","AATTGCTTCACCTTCACGGT","561307.5.peg.185"," 946"
"9236",11,298,287,"TTAGTAATTAGATTAGCGA","AATTGCTTCACCTTCACGGT","561307.5.peg.185"," 946"
"9237",9,298,289,"TAGTAATTAGATTAGCGAGG","AATTGCTTCACCTTCACGGT","561307.5.peg.185"," 946"
"9238",798,298,500,"GAAGTTGTAAATGGGTTTGC","AATTGCTTCACCTTCACGGT","561307.5.peg.185"," 946"
"9239",9,302,293,"TAGTAATTAGATTAGCGAGG","AAGCAATTGCTTCACCTTCA","561307.5.peg.185"," 946"
"9240",798,302,496,"GAAGTTGTAAATGGGTTTGC","AAGCAATTGCTTCACCTTCA","561307.5.peg.185"," 946"
"9241",11,302,291,"TTAGTAATTAGATTAGCGA","AAGCAATTGCTTCACCTTCA","561307.5.peg.185"," 946"
"9242",952,302,650,"ATCTGAAATACGTGTAGAAT","AAGCAATTGCTTCACCTTCA","561307.5.peg.185"," 946"
"9243",609,302,307,"CAATAGTCCAATATTCTTC","AAGCAATTGCTTCACCTTCA","561307.5.peg.185"," 946"
"9244",9,609,600,"TAGTAATTAGATTAGCGAGG","CAATAGTCCAATATTCTTC","561307.5.peg.185"," 946"
"9245",798,609,189,"GAAGTTGTAAATGGGTTTGC","CAATAGTCCAATATTCTTC","561307.5.peg.185"," 946"
"9246",302,609,307,"AAGCAATTGCTTCACCTTCA","CAATAGTCCAATATTCTTC","561307.5.peg.185"," 946"
"9247",298,609,311,"AATTGCTTCACCTTCACGGT","CAATAGTCCAATATTCTTC","561307.5.peg.185"," 946"
"9248",952,609,343,"ATCTGAAATACGTGTAGAAT","CAATAGTCCAATATTCTTC","561307.5.peg.185"," 946"
"9249",296,609,313,"TTGCTTCACCTTCACGGTCG","CAATAGTCCAATATTCTTC","561307.5.peg.185"," 946"
"9250",11,609,598,"TTAGTAATTAGATTAGCGA","CAATAGTCCAATATTCTTC","561307.5.peg.185"," 946"
"9251",9,798,789,"TAGTAATTAGATTAGCGAGG","GAAGTTGTAAATGGGTTTGC","561307.5.peg.185"," 946"
"9252",302,798,496,"AAGCAATTGCTTCACCTTCA","GAAGTTGTAAATGGGTTTGC","561307.5.peg.185"," 946"
"9253",298,798,500,"AATTGCTTCACCTTCACGGT","GAAGTTGTAAATGGGTTTGC","561307.5.peg.185"," 946"
"9254",296,798,502,"TTGCTTCACCTTCACGGTCG","GAAGTTGTAAATGGGTTTGC","561307.5.peg.185"," 946"
"9255",609,798,189,"CAATAGTCCAATATTCTTC","GAAGTTGTAAATGGGTTTGC","561307.5.peg.185"," 946"
"9256",952,798,154,"ATCTGAAATACGTGTAGAAT","GAAGTTGTAAATGGGTTTGC","561307.5.peg.185"," 946"
"9257",11,798,787,"TTAGTAATTAGATTAGCGA","GAAGTTGTAAATGGGTTTGC","561307.5.peg.185"," 946"
"9258",9,952,943,"TAGTAATTAGATTAGCGAGG","ATCTGAAATACGTGTAGAAT","561307.5.peg.185"," 946"
"9259",298,952,654,"AATTGCTTCACCTTCACGGT","ATCTGAAATACGTGTAGAAT","561307.5.peg.185"," 946"
"9260",296,952,656,"TTGCTTCACCTTCACGGTCG","ATCTGAAATACGTGTAGAAT","561307.5.peg.185"," 946"
"9261",798,952,154,"GAAGTTGTAAATGGGTTTGC","ATCTGAAATACGTGTAGAAT","561307.5.peg.185"," 946"
"9262",11,952,941,"TTAGTAATTAGATTAGCGA","ATCTGAAATACGTGTAGAAT","561307.5.peg.185"," 946"
"9263",302,952,650,"AAGCAATTGCTTCACCTTCA","ATCTGAAATACGTGTAGAAT","561307.5.peg.185"," 946"
"9264",609,952,343,"CAATAGTCCAATATTCTTC","ATCTGAAATACGTGTAGAAT","561307.5.peg.185"," 946"
"9265",450,177,273,"CAATCCAAATCACAGTAAT","GTACCACCCATAACTGAAAT","561307.5.peg.1850"," 947"
"9266",450,264,186,"CAATCCAAATCACAGTAAT","TAATCGCACCAATAATAAG","561307.5.peg.1850"," 947"
"9267",177,450,273,"GTACCACCCATAACTGAAAT","CAATCCAAATCACAGTAAT","561307.5.peg.1850"," 947"
"9268",264,450,186,"TAATCGCACCAATAATAAG","CAATCCAAATCACAGTAAT","561307.5.peg.1850"," 947"
"9269",172,5,167,"ATCGTTTGTCTCTTTCTAA","TGCAGAAATTGTATATCACT","561307.5.peg.1853"," 950"
"9270",151,5,146,"GGCTCGAACAATATGTTCTG","TGCAGAAATTGTATATCACT","561307.5.peg.1853"," 950"
"9271",205,5,200,"TGTCTTACCTGCACCTGTTA","TGCAGAAATTGTATATCACT","561307.5.peg.1853"," 950"
"9272",428,5,423,"TATCAAAGTGCTGTTTGAAT","TGCAGAAATTGTATATCACT","561307.5.peg.1853"," 950"
"9273",291,5,286,"TCTACAACAACATCTACACG","TGCAGAAATTGTATATCACT","561307.5.peg.1853"," 950"
"9274",564,5,559,"TCTGACAGAAGTTGTTTCGG","TGCAGAAATTGTATATCACT","561307.5.peg.1853"," 950"
"9275",5,151,146,"TGCAGAAATTGTATATCACT","GGCTCGAACAATATGTTCTG","561307.5.peg.1853"," 950"
"9276",564,151,413,"TCTGACAGAAGTTGTTTCGG","GGCTCGAACAATATGTTCTG","561307.5.peg.1853"," 950"
"9277",291,151,140,"TCTACAACAACATCTACACG","GGCTCGAACAATATGTTCTG","561307.5.peg.1853"," 950"
"9278",428,151,277,"TATCAAAGTGCTGTTTGAAT","GGCTCGAACAATATGTTCTG","561307.5.peg.1853"," 950"
"9279",564,172,392,"TCTGACAGAAGTTGTTTCGG","ATCGTTTGTCTCTTTCTAA","561307.5.peg.1853"," 950"
"9280",5,172,167,"TGCAGAAATTGTATATCACT","ATCGTTTGTCTCTTTCTAA","561307.5.peg.1853"," 950"
"9281",291,172,119,"TCTACAACAACATCTACACG","ATCGTTTGTCTCTTTCTAA","561307.5.peg.1853"," 950"
"9282",428,172,256,"TATCAAAGTGCTGTTTGAAT","ATCGTTTGTCTCTTTCTAA","561307.5.peg.1853"," 950"
"9283",428,205,223,"TATCAAAGTGCTGTTTGAAT","TGTCTTACCTGCACCTGTTA","561307.5.peg.1853"," 950"
"9284",5,205,200,"TGCAGAAATTGTATATCACT","TGTCTTACCTGCACCTGTTA","561307.5.peg.1853"," 950"
"9285",564,205,359,"TCTGACAGAAGTTGTTTCGG","TGTCTTACCTGCACCTGTTA","561307.5.peg.1853"," 950"
"9286",428,291,137,"TATCAAAGTGCTGTTTGAAT","TCTACAACAACATCTACACG","561307.5.peg.1853"," 950"
"9287",151,291,140,"GGCTCGAACAATATGTTCTG","TCTACAACAACATCTACACG","561307.5.peg.1853"," 950"
"9288",564,291,273,"TCTGACAGAAGTTGTTTCGG","TCTACAACAACATCTACACG","561307.5.peg.1853"," 950"
"9289",5,291,286,"TGCAGAAATTGTATATCACT","TCTACAACAACATCTACACG","561307.5.peg.1853"," 950"
"9290",172,291,119,"ATCGTTTGTCTCTTTCTAA","TCTACAACAACATCTACACG","561307.5.peg.1853"," 950"
"9291",172,428,256,"ATCGTTTGTCTCTTTCTAA","TATCAAAGTGCTGTTTGAAT","561307.5.peg.1853"," 950"
"9292",5,428,423,"TGCAGAAATTGTATATCACT","TATCAAAGTGCTGTTTGAAT","561307.5.peg.1853"," 950"
"9293",205,428,223,"TGTCTTACCTGCACCTGTTA","TATCAAAGTGCTGTTTGAAT","561307.5.peg.1853"," 950"
"9294",151,428,277,"GGCTCGAACAATATGTTCTG","TATCAAAGTGCTGTTTGAAT","561307.5.peg.1853"," 950"
"9295",291,428,137,"TCTACAACAACATCTACACG","TATCAAAGTGCTGTTTGAAT","561307.5.peg.1853"," 950"
"9296",564,428,136,"TCTGACAGAAGTTGTTTCGG","TATCAAAGTGCTGTTTGAAT","561307.5.peg.1853"," 950"
"9297",5,564,559,"TGCAGAAATTGTATATCACT","TCTGACAGAAGTTGTTTCGG","561307.5.peg.1853"," 950"
"9298",151,564,413,"GGCTCGAACAATATGTTCTG","TCTGACAGAAGTTGTTTCGG","561307.5.peg.1853"," 950"
"9299",172,564,392,"ATCGTTTGTCTCTTTCTAA","TCTGACAGAAGTTGTTTCGG","561307.5.peg.1853"," 950"
"9300",428,564,136,"TATCAAAGTGCTGTTTGAAT","TCTGACAGAAGTTGTTTCGG","561307.5.peg.1853"," 950"
"9301",205,564,359,"TGTCTTACCTGCACCTGTTA","TCTGACAGAAGTTGTTTCGG","561307.5.peg.1853"," 950"
"9302",291,564,273,"TCTACAACAACATCTACACG","TCTGACAGAAGTTGTTTCGG","561307.5.peg.1853"," 950"
"9303",1257,1041,216,"GACTTATCGTTACGTTGCAC","CCTTCCGAGAAACGACGGCC","561307.5.peg.1856"," 953"
"9304",1257,1046,211,"GACTTATCGTTACGTTGCAC","GTAAACCTTCCGAGAAACGA","561307.5.peg.1856"," 953"
"9305",1041,1257,216,"CCTTCCGAGAAACGACGGCC","GACTTATCGTTACGTTGCAC","561307.5.peg.1856"," 953"
"9306",1046,1257,211,"GTAAACCTTCCGAGAAACGA","GACTTATCGTTACGTTGCAC","561307.5.peg.1856"," 953"
"9307",304,77,227,"AACTCTAGAATTGCGTTAT","TAATATCTTGCGCTTTCGTT","561307.5.peg.1857"," 954"
"9308",294,77,217,"ATTGCGTTATTGGCATCGTG","TAATATCTTGCGCTTTCGTT","561307.5.peg.1857"," 954"
"9309",438,77,361,"TTAATCCCCGCTTCATCCCC","TAATATCTTGCGCTTTCGTT","561307.5.peg.1857"," 954"
"9310",330,77,253,"GACTCCGTGCCACCTGCACC","TAATATCTTGCGCTTTCGTT","561307.5.peg.1857"," 954"
"9311",77,294,217,"TAATATCTTGCGCTTTCGTT","ATTGCGTTATTGGCATCGTG","561307.5.peg.1857"," 954"
"9312",438,294,144,"TTAATCCCCGCTTCATCCCC","ATTGCGTTATTGGCATCGTG","561307.5.peg.1857"," 954"
"9313",77,304,227,"TAATATCTTGCGCTTTCGTT","AACTCTAGAATTGCGTTAT","561307.5.peg.1857"," 954"
"9314",438,304,134,"TTAATCCCCGCTTCATCCCC","AACTCTAGAATTGCGTTAT","561307.5.peg.1857"," 954"
"9315",77,330,253,"TAATATCTTGCGCTTTCGTT","GACTCCGTGCCACCTGCACC","561307.5.peg.1857"," 954"
"9316",438,330,108,"TTAATCCCCGCTTCATCCCC","GACTCCGTGCCACCTGCACC","561307.5.peg.1857"," 954"
"9317",77,438,361,"TAATATCTTGCGCTTTCGTT","TTAATCCCCGCTTCATCCCC","561307.5.peg.1857"," 954"
"9318",294,438,144,"ATTGCGTTATTGGCATCGTG","TTAATCCCCGCTTCATCCCC","561307.5.peg.1857"," 954"
"9319",304,438,134,"AACTCTAGAATTGCGTTAT","TTAATCCCCGCTTCATCCCC","561307.5.peg.1857"," 954"
"9320",330,438,108,"GACTCCGTGCCACCTGCACC","TTAATCCCCGCTTCATCCCC","561307.5.peg.1857"," 954"
"9321",312,198,114,"ACAAGTGAAATCACGTCACC","GCAACTACTGTATAAGTTGT","561307.5.peg.1858"," 955"
"9322",198,312,114,"GCAACTACTGTATAAGTTGT","ACAAGTGAAATCACGTCACC","561307.5.peg.1858"," 955"
"9323",348,12,336,"GTAGACGGTACGTATGCCTC","AATAATACGTTGAAAGAGG","561307.5.peg.1861"," 959"
"9324",620,12,608,"GCACTCGAAACGTTCCTCGT","AATAATACGTTGAAAGAGG","561307.5.peg.1861"," 959"
"9325",722,12,710,"GGTAGTTAACTTCTCGGATA","AATAATACGTTGAAAGAGG","561307.5.peg.1861"," 959"
"9326",743,12,731,"CTTTCAACACTTCACCTGTT","AATAATACGTTGAAAGAGG","561307.5.peg.1861"," 959"
"9327",985,12,973,"TGGTCGCAAAGTTAAATGTA","AATAATACGTTGAAAGAGG","561307.5.peg.1861"," 959"
"9328",665,12,653,"AAAGTTCTTCTTTAGAGGCT","AATAATACGTTGAAAGAGG","561307.5.peg.1861"," 959"
"9329",728,12,716,"CTGTTAGGTAGTTAACTTCT","AATAATACGTTGAAAGAGG","561307.5.peg.1861"," 959"
"9330",231,12,219,"TTATGCGCGATAATTAACGT","AATAATACGTTGAAAGAGG","561307.5.peg.1861"," 959"
"9331",1005,12,993,"GTATATGGTGTCGAACCCAG","AATAATACGTTGAAAGAGG","561307.5.peg.1861"," 959"
"9332",788,12,776,"GTGTTACGAAGTGAGAAGCT","AATAATACGTTGAAAGAGG","561307.5.peg.1861"," 959"
"9333",348,104,244,"GTAGACGGTACGTATGCCTC","TTTCTTTAATTGCTTGCGGT","561307.5.peg.1861"," 959"
"9334",665,104,561,"AAAGTTCTTCTTTAGAGGCT","TTTCTTTAATTGCTTGCGGT","561307.5.peg.1861"," 959"
"9335",620,104,516,"GCACTCGAAACGTTCCTCGT","TTTCTTTAATTGCTTGCGGT","561307.5.peg.1861"," 959"
"9336",788,104,684,"GTGTTACGAAGTGAGAAGCT","TTTCTTTAATTGCTTGCGGT","561307.5.peg.1861"," 959"
"9337",1005,104,901,"GTATATGGTGTCGAACCCAG","TTTCTTTAATTGCTTGCGGT","561307.5.peg.1861"," 959"
"9338",722,104,618,"GGTAGTTAACTTCTCGGATA","TTTCTTTAATTGCTTGCGGT","561307.5.peg.1861"," 959"
"9339",743,104,639,"CTTTCAACACTTCACCTGTT","TTTCTTTAATTGCTTGCGGT","561307.5.peg.1861"," 959"
"9340",231,104,127,"TTATGCGCGATAATTAACGT","TTTCTTTAATTGCTTGCGGT","561307.5.peg.1861"," 959"
"9341",985,104,881,"TGGTCGCAAAGTTAAATGTA","TTTCTTTAATTGCTTGCGGT","561307.5.peg.1861"," 959"
"9342",728,104,624,"CTGTTAGGTAGTTAACTTCT","TTTCTTTAATTGCTTGCGGT","561307.5.peg.1861"," 959"
"9343",665,231,434,"AAAGTTCTTCTTTAGAGGCT","TTATGCGCGATAATTAACGT","561307.5.peg.1861"," 959"
"9344",12,231,219,"AATAATACGTTGAAAGAGG","TTATGCGCGATAATTAACGT","561307.5.peg.1861"," 959"
"9345",722,231,491,"GGTAGTTAACTTCTCGGATA","TTATGCGCGATAATTAACGT","561307.5.peg.1861"," 959"
"9346",348,231,117,"GTAGACGGTACGTATGCCTC","TTATGCGCGATAATTAACGT","561307.5.peg.1861"," 959"
"9347",728,231,497,"CTGTTAGGTAGTTAACTTCT","TTATGCGCGATAATTAACGT","561307.5.peg.1861"," 959"
"9348",104,231,127,"TTTCTTTAATTGCTTGCGGT","TTATGCGCGATAATTAACGT","561307.5.peg.1861"," 959"
"9349",985,231,754,"TGGTCGCAAAGTTAAATGTA","TTATGCGCGATAATTAACGT","561307.5.peg.1861"," 959"
"9350",1005,231,774,"GTATATGGTGTCGAACCCAG","TTATGCGCGATAATTAACGT","561307.5.peg.1861"," 959"
"9351",743,231,512,"CTTTCAACACTTCACCTGTT","TTATGCGCGATAATTAACGT","561307.5.peg.1861"," 959"
"9352",620,231,389,"GCACTCGAAACGTTCCTCGT","TTATGCGCGATAATTAACGT","561307.5.peg.1861"," 959"
"9353",788,231,557,"GTGTTACGAAGTGAGAAGCT","TTATGCGCGATAATTAACGT","561307.5.peg.1861"," 959"
"9354",665,348,317,"AAAGTTCTTCTTTAGAGGCT","GTAGACGGTACGTATGCCTC","561307.5.peg.1861"," 959"
"9355",728,348,380,"CTGTTAGGTAGTTAACTTCT","GTAGACGGTACGTATGCCTC","561307.5.peg.1861"," 959"
"9356",231,348,117,"TTATGCGCGATAATTAACGT","GTAGACGGTACGTATGCCTC","561307.5.peg.1861"," 959"
"9357",743,348,395,"CTTTCAACACTTCACCTGTT","GTAGACGGTACGTATGCCTC","561307.5.peg.1861"," 959"
"9358",620,348,272,"GCACTCGAAACGTTCCTCGT","GTAGACGGTACGTATGCCTC","561307.5.peg.1861"," 959"
"9359",1005,348,657,"GTATATGGTGTCGAACCCAG","GTAGACGGTACGTATGCCTC","561307.5.peg.1861"," 959"
"9360",104,348,244,"TTTCTTTAATTGCTTGCGGT","GTAGACGGTACGTATGCCTC","561307.5.peg.1861"," 959"
"9361",722,348,374,"GGTAGTTAACTTCTCGGATA","GTAGACGGTACGTATGCCTC","561307.5.peg.1861"," 959"
"9362",788,348,440,"GTGTTACGAAGTGAGAAGCT","GTAGACGGTACGTATGCCTC","561307.5.peg.1861"," 959"
"9363",12,348,336,"AATAATACGTTGAAAGAGG","GTAGACGGTACGTATGCCTC","561307.5.peg.1861"," 959"
"9364",985,348,637,"TGGTCGCAAAGTTAAATGTA","GTAGACGGTACGTATGCCTC","561307.5.peg.1861"," 959"
"9365",722,620,102,"GGTAGTTAACTTCTCGGATA","GCACTCGAAACGTTCCTCGT","561307.5.peg.1861"," 959"
"9366",985,620,365,"TGGTCGCAAAGTTAAATGTA","GCACTCGAAACGTTCCTCGT","561307.5.peg.1861"," 959"
"9367",743,620,123,"CTTTCAACACTTCACCTGTT","GCACTCGAAACGTTCCTCGT","561307.5.peg.1861"," 959"
"9368",728,620,108,"CTGTTAGGTAGTTAACTTCT","GCACTCGAAACGTTCCTCGT","561307.5.peg.1861"," 959"
"9369",788,620,168,"GTGTTACGAAGTGAGAAGCT","GCACTCGAAACGTTCCTCGT","561307.5.peg.1861"," 959"
"9370",12,620,608,"AATAATACGTTGAAAGAGG","GCACTCGAAACGTTCCTCGT","561307.5.peg.1861"," 959"
"9371",231,620,389,"TTATGCGCGATAATTAACGT","GCACTCGAAACGTTCCTCGT","561307.5.peg.1861"," 959"
"9372",348,620,272,"GTAGACGGTACGTATGCCTC","GCACTCGAAACGTTCCTCGT","561307.5.peg.1861"," 959"
"9373",1005,620,385,"GTATATGGTGTCGAACCCAG","GCACTCGAAACGTTCCTCGT","561307.5.peg.1861"," 959"
"9374",104,620,516,"TTTCTTTAATTGCTTGCGGT","GCACTCGAAACGTTCCTCGT","561307.5.peg.1861"," 959"
"9375",231,665,434,"TTATGCGCGATAATTAACGT","AAAGTTCTTCTTTAGAGGCT","561307.5.peg.1861"," 959"
"9376",12,665,653,"AATAATACGTTGAAAGAGG","AAAGTTCTTCTTTAGAGGCT","561307.5.peg.1861"," 959"
"9377",104,665,561,"TTTCTTTAATTGCTTGCGGT","AAAGTTCTTCTTTAGAGGCT","561307.5.peg.1861"," 959"
"9378",1005,665,340,"GTATATGGTGTCGAACCCAG","AAAGTTCTTCTTTAGAGGCT","561307.5.peg.1861"," 959"
"9379",985,665,320,"TGGTCGCAAAGTTAAATGTA","AAAGTTCTTCTTTAGAGGCT","561307.5.peg.1861"," 959"
"9380",788,665,123,"GTGTTACGAAGTGAGAAGCT","AAAGTTCTTCTTTAGAGGCT","561307.5.peg.1861"," 959"
"9381",348,665,317,"GTAGACGGTACGTATGCCTC","AAAGTTCTTCTTTAGAGGCT","561307.5.peg.1861"," 959"
"9382",12,722,710,"AATAATACGTTGAAAGAGG","GGTAGTTAACTTCTCGGATA","561307.5.peg.1861"," 959"
"9383",985,722,263,"TGGTCGCAAAGTTAAATGTA","GGTAGTTAACTTCTCGGATA","561307.5.peg.1861"," 959"
"9384",1005,722,283,"GTATATGGTGTCGAACCCAG","GGTAGTTAACTTCTCGGATA","561307.5.peg.1861"," 959"
"9385",620,722,102,"GCACTCGAAACGTTCCTCGT","GGTAGTTAACTTCTCGGATA","561307.5.peg.1861"," 959"
"9386",348,722,374,"GTAGACGGTACGTATGCCTC","GGTAGTTAACTTCTCGGATA","561307.5.peg.1861"," 959"
"9387",104,722,618,"TTTCTTTAATTGCTTGCGGT","GGTAGTTAACTTCTCGGATA","561307.5.peg.1861"," 959"
"9388",231,722,491,"TTATGCGCGATAATTAACGT","GGTAGTTAACTTCTCGGATA","561307.5.peg.1861"," 959"
"9389",1005,728,277,"GTATATGGTGTCGAACCCAG","CTGTTAGGTAGTTAACTTCT","561307.5.peg.1861"," 959"
"9390",348,728,380,"GTAGACGGTACGTATGCCTC","CTGTTAGGTAGTTAACTTCT","561307.5.peg.1861"," 959"
"9391",12,728,716,"AATAATACGTTGAAAGAGG","CTGTTAGGTAGTTAACTTCT","561307.5.peg.1861"," 959"
"9392",231,728,497,"TTATGCGCGATAATTAACGT","CTGTTAGGTAGTTAACTTCT","561307.5.peg.1861"," 959"
"9393",620,728,108,"GCACTCGAAACGTTCCTCGT","CTGTTAGGTAGTTAACTTCT","561307.5.peg.1861"," 959"
"9394",104,728,624,"TTTCTTTAATTGCTTGCGGT","CTGTTAGGTAGTTAACTTCT","561307.5.peg.1861"," 959"
"9395",985,728,257,"TGGTCGCAAAGTTAAATGTA","CTGTTAGGTAGTTAACTTCT","561307.5.peg.1861"," 959"
"9396",12,743,731,"AATAATACGTTGAAAGAGG","CTTTCAACACTTCACCTGTT","561307.5.peg.1861"," 959"
"9397",348,743,395,"GTAGACGGTACGTATGCCTC","CTTTCAACACTTCACCTGTT","561307.5.peg.1861"," 959"
"9398",104,743,639,"TTTCTTTAATTGCTTGCGGT","CTTTCAACACTTCACCTGTT","561307.5.peg.1861"," 959"
"9399",231,743,512,"TTATGCGCGATAATTAACGT","CTTTCAACACTTCACCTGTT","561307.5.peg.1861"," 959"
"9400",620,743,123,"GCACTCGAAACGTTCCTCGT","CTTTCAACACTTCACCTGTT","561307.5.peg.1861"," 959"
"9401",1005,743,262,"GTATATGGTGTCGAACCCAG","CTTTCAACACTTCACCTGTT","561307.5.peg.1861"," 959"
"9402",985,743,242,"TGGTCGCAAAGTTAAATGTA","CTTTCAACACTTCACCTGTT","561307.5.peg.1861"," 959"
"9403",231,788,557,"TTATGCGCGATAATTAACGT","GTGTTACGAAGTGAGAAGCT","561307.5.peg.1861"," 959"
"9404",104,788,684,"TTTCTTTAATTGCTTGCGGT","GTGTTACGAAGTGAGAAGCT","561307.5.peg.1861"," 959"
"9405",985,788,197,"TGGTCGCAAAGTTAAATGTA","GTGTTACGAAGTGAGAAGCT","561307.5.peg.1861"," 959"
"9406",1005,788,217,"GTATATGGTGTCGAACCCAG","GTGTTACGAAGTGAGAAGCT","561307.5.peg.1861"," 959"
"9407",620,788,168,"GCACTCGAAACGTTCCTCGT","GTGTTACGAAGTGAGAAGCT","561307.5.peg.1861"," 959"
"9408",665,788,123,"AAAGTTCTTCTTTAGAGGCT","GTGTTACGAAGTGAGAAGCT","561307.5.peg.1861"," 959"
"9409",12,788,776,"AATAATACGTTGAAAGAGG","GTGTTACGAAGTGAGAAGCT","561307.5.peg.1861"," 959"
"9410",348,788,440,"GTAGACGGTACGTATGCCTC","GTGTTACGAAGTGAGAAGCT","561307.5.peg.1861"," 959"
"9411",12,985,973,"AATAATACGTTGAAAGAGG","TGGTCGCAAAGTTAAATGTA","561307.5.peg.1861"," 959"
"9412",348,985,637,"GTAGACGGTACGTATGCCTC","TGGTCGCAAAGTTAAATGTA","561307.5.peg.1861"," 959"
"9413",743,985,242,"CTTTCAACACTTCACCTGTT","TGGTCGCAAAGTTAAATGTA","561307.5.peg.1861"," 959"
"9414",728,985,257,"CTGTTAGGTAGTTAACTTCT","TGGTCGCAAAGTTAAATGTA","561307.5.peg.1861"," 959"
"9415",104,985,881,"TTTCTTTAATTGCTTGCGGT","TGGTCGCAAAGTTAAATGTA","561307.5.peg.1861"," 959"
"9416",665,985,320,"AAAGTTCTTCTTTAGAGGCT","TGGTCGCAAAGTTAAATGTA","561307.5.peg.1861"," 959"
"9417",788,985,197,"GTGTTACGAAGTGAGAAGCT","TGGTCGCAAAGTTAAATGTA","561307.5.peg.1861"," 959"
"9418",231,985,754,"TTATGCGCGATAATTAACGT","TGGTCGCAAAGTTAAATGTA","561307.5.peg.1861"," 959"
"9419",722,985,263,"GGTAGTTAACTTCTCGGATA","TGGTCGCAAAGTTAAATGTA","561307.5.peg.1861"," 959"
"9420",620,985,365,"GCACTCGAAACGTTCCTCGT","TGGTCGCAAAGTTAAATGTA","561307.5.peg.1861"," 959"
"9421",12,1005,993,"AATAATACGTTGAAAGAGG","GTATATGGTGTCGAACCCAG","561307.5.peg.1861"," 959"
"9422",743,1005,262,"CTTTCAACACTTCACCTGTT","GTATATGGTGTCGAACCCAG","561307.5.peg.1861"," 959"
"9423",728,1005,277,"CTGTTAGGTAGTTAACTTCT","GTATATGGTGTCGAACCCAG","561307.5.peg.1861"," 959"
"9424",348,1005,657,"GTAGACGGTACGTATGCCTC","GTATATGGTGTCGAACCCAG","561307.5.peg.1861"," 959"
"9425",788,1005,217,"GTGTTACGAAGTGAGAAGCT","GTATATGGTGTCGAACCCAG","561307.5.peg.1861"," 959"
"9426",104,1005,901,"TTTCTTTAATTGCTTGCGGT","GTATATGGTGTCGAACCCAG","561307.5.peg.1861"," 959"
"9427",620,1005,385,"GCACTCGAAACGTTCCTCGT","GTATATGGTGTCGAACCCAG","561307.5.peg.1861"," 959"
"9428",722,1005,283,"GGTAGTTAACTTCTCGGATA","GTATATGGTGTCGAACCCAG","561307.5.peg.1861"," 959"
"9429",665,1005,340,"AAAGTTCTTCTTTAGAGGCT","GTATATGGTGTCGAACCCAG","561307.5.peg.1861"," 959"
"9430",231,1005,774,"TTATGCGCGATAATTAACGT","GTATATGGTGTCGAACCCAG","561307.5.peg.1861"," 959"
"9431",972,254,718,"TCAGAACTCGTCGGTATCCA","CAACATCTGGTTTGTCCATT","561307.5.peg.1862"," 960"
"9432",727,254,473,"TTGTCCTTCTGAAAGCTCTA","CAACATCTGGTTTGTCCATT","561307.5.peg.1862"," 960"
"9433",879,254,625,"TGGCCTAAGCCATCACATGT","CAACATCTGGTTTGTCCATT","561307.5.peg.1862"," 960"
"9434",1215,254,961,"TTTCACGTGTATATTCTGA","CAACATCTGGTTTGTCCATT","561307.5.peg.1862"," 960"
"9435",408,254,154,"TATTGTGATTTGGACAGTA","CAACATCTGGTTTGTCCATT","561307.5.peg.1862"," 960"
"9436",933,254,679,"TTTAGCGTCTTATCTTTGTC","CAACATCTGGTTTGTCCATT","561307.5.peg.1862"," 960"
"9437",467,254,213,"GTGCCTCTAATTCCATAATG","CAACATCTGGTTTGTCCATT","561307.5.peg.1862"," 960"
"9438",797,254,543,"ATCCACATATAGGACAAGCA","CAACATCTGGTTTGTCCATT","561307.5.peg.1862"," 960"
"9439",1263,254,1009,"TTTCCATGACAAGTTTCGCA","CAACATCTGGTTTGTCCATT","561307.5.peg.1862"," 960"
"9440",1205,254,951,"ATATTCTGAAGGAGATTCA","CAACATCTGGTTTGTCCATT","561307.5.peg.1862"," 960"
"9441",513,254,259,"CCTTTACGATGAGCGATGAC","CAACATCTGGTTTGTCCATT","561307.5.peg.1862"," 960"
"9442",1205,267,938,"ATATTCTGAAGGAGATTCA","CCTTCAATTGTATCAACATC","561307.5.peg.1862"," 960"
"9443",879,267,612,"TGGCCTAAGCCATCACATGT","CCTTCAATTGTATCAACATC","561307.5.peg.1862"," 960"
"9444",727,267,460,"TTGTCCTTCTGAAAGCTCTA","CCTTCAATTGTATCAACATC","561307.5.peg.1862"," 960"
"9445",797,267,530,"ATCCACATATAGGACAAGCA","CCTTCAATTGTATCAACATC","561307.5.peg.1862"," 960"
"9446",933,267,666,"TTTAGCGTCTTATCTTTGTC","CCTTCAATTGTATCAACATC","561307.5.peg.1862"," 960"
"9447",1263,267,996,"TTTCCATGACAAGTTTCGCA","CCTTCAATTGTATCAACATC","561307.5.peg.1862"," 960"
"9448",972,267,705,"TCAGAACTCGTCGGTATCCA","CCTTCAATTGTATCAACATC","561307.5.peg.1862"," 960"
"9449",513,267,246,"CCTTTACGATGAGCGATGAC","CCTTCAATTGTATCAACATC","561307.5.peg.1862"," 960"
"9450",1215,267,948,"TTTCACGTGTATATTCTGA","CCTTCAATTGTATCAACATC","561307.5.peg.1862"," 960"
"9451",408,267,141,"TATTGTGATTTGGACAGTA","CCTTCAATTGTATCAACATC","561307.5.peg.1862"," 960"
"9452",467,267,200,"GTGCCTCTAATTCCATAATG","CCTTCAATTGTATCAACATC","561307.5.peg.1862"," 960"
"9453",797,336,461,"ATCCACATATAGGACAAGCA","ACTGTTGCTACAGTTGATCT","561307.5.peg.1862"," 960"
"9454",933,336,597,"TTTAGCGTCTTATCTTTGTC","ACTGTTGCTACAGTTGATCT","561307.5.peg.1862"," 960"
"9455",1215,336,879,"TTTCACGTGTATATTCTGA","ACTGTTGCTACAGTTGATCT","561307.5.peg.1862"," 960"
"9456",467,336,131,"GTGCCTCTAATTCCATAATG","ACTGTTGCTACAGTTGATCT","561307.5.peg.1862"," 960"
"9457",513,336,177,"CCTTTACGATGAGCGATGAC","ACTGTTGCTACAGTTGATCT","561307.5.peg.1862"," 960"
"9458",1205,336,869,"ATATTCTGAAGGAGATTCA","ACTGTTGCTACAGTTGATCT","561307.5.peg.1862"," 960"
"9459",727,336,391,"TTGTCCTTCTGAAAGCTCTA","ACTGTTGCTACAGTTGATCT","561307.5.peg.1862"," 960"
"9460",972,336,636,"TCAGAACTCGTCGGTATCCA","ACTGTTGCTACAGTTGATCT","561307.5.peg.1862"," 960"
"9461",1263,336,927,"TTTCCATGACAAGTTTCGCA","ACTGTTGCTACAGTTGATCT","561307.5.peg.1862"," 960"
"9462",879,336,543,"TGGCCTAAGCCATCACATGT","ACTGTTGCTACAGTTGATCT","561307.5.peg.1862"," 960"
"9463",267,408,141,"CCTTCAATTGTATCAACATC","TATTGTGATTTGGACAGTA","561307.5.peg.1862"," 960"
"9464",1263,408,855,"TTTCCATGACAAGTTTCGCA","TATTGTGATTTGGACAGTA","561307.5.peg.1862"," 960"
"9465",933,408,525,"TTTAGCGTCTTATCTTTGTC","TATTGTGATTTGGACAGTA","561307.5.peg.1862"," 960"
"9466",972,408,564,"TCAGAACTCGTCGGTATCCA","TATTGTGATTTGGACAGTA","561307.5.peg.1862"," 960"
"9467",1205,408,797,"ATATTCTGAAGGAGATTCA","TATTGTGATTTGGACAGTA","561307.5.peg.1862"," 960"
"9468",254,408,154,"CAACATCTGGTTTGTCCATT","TATTGTGATTTGGACAGTA","561307.5.peg.1862"," 960"
"9469",727,408,319,"TTGTCCTTCTGAAAGCTCTA","TATTGTGATTTGGACAGTA","561307.5.peg.1862"," 960"
"9470",513,408,105,"CCTTTACGATGAGCGATGAC","TATTGTGATTTGGACAGTA","561307.5.peg.1862"," 960"
"9471",879,408,471,"TGGCCTAAGCCATCACATGT","TATTGTGATTTGGACAGTA","561307.5.peg.1862"," 960"
"9472",797,408,389,"ATCCACATATAGGACAAGCA","TATTGTGATTTGGACAGTA","561307.5.peg.1862"," 960"
"9473",1215,408,807,"TTTCACGTGTATATTCTGA","TATTGTGATTTGGACAGTA","561307.5.peg.1862"," 960"
"9474",254,467,213,"CAACATCTGGTTTGTCCATT","GTGCCTCTAATTCCATAATG","561307.5.peg.1862"," 960"
"9475",933,467,466,"TTTAGCGTCTTATCTTTGTC","GTGCCTCTAATTCCATAATG","561307.5.peg.1862"," 960"
"9476",1205,467,738,"ATATTCTGAAGGAGATTCA","GTGCCTCTAATTCCATAATG","561307.5.peg.1862"," 960"
"9477",336,467,131,"ACTGTTGCTACAGTTGATCT","GTGCCTCTAATTCCATAATG","561307.5.peg.1862"," 960"
"9478",1263,467,796,"TTTCCATGACAAGTTTCGCA","GTGCCTCTAATTCCATAATG","561307.5.peg.1862"," 960"
"9479",972,467,505,"TCAGAACTCGTCGGTATCCA","GTGCCTCTAATTCCATAATG","561307.5.peg.1862"," 960"
"9480",797,467,330,"ATCCACATATAGGACAAGCA","GTGCCTCTAATTCCATAATG","561307.5.peg.1862"," 960"
"9481",879,467,412,"TGGCCTAAGCCATCACATGT","GTGCCTCTAATTCCATAATG","561307.5.peg.1862"," 960"
"9482",267,467,200,"CCTTCAATTGTATCAACATC","GTGCCTCTAATTCCATAATG","561307.5.peg.1862"," 960"
"9483",1215,467,748,"TTTCACGTGTATATTCTGA","GTGCCTCTAATTCCATAATG","561307.5.peg.1862"," 960"
"9484",727,467,260,"TTGTCCTTCTGAAAGCTCTA","GTGCCTCTAATTCCATAATG","561307.5.peg.1862"," 960"
"9485",933,513,420,"TTTAGCGTCTTATCTTTGTC","CCTTTACGATGAGCGATGAC","561307.5.peg.1862"," 960"
"9486",267,513,246,"CCTTCAATTGTATCAACATC","CCTTTACGATGAGCGATGAC","561307.5.peg.1862"," 960"
"9487",727,513,214,"TTGTCCTTCTGAAAGCTCTA","CCTTTACGATGAGCGATGAC","561307.5.peg.1862"," 960"
"9488",336,513,177,"ACTGTTGCTACAGTTGATCT","CCTTTACGATGAGCGATGAC","561307.5.peg.1862"," 960"
"9489",1205,513,692,"ATATTCTGAAGGAGATTCA","CCTTTACGATGAGCGATGAC","561307.5.peg.1862"," 960"
"9490",408,513,105,"TATTGTGATTTGGACAGTA","CCTTTACGATGAGCGATGAC","561307.5.peg.1862"," 960"
"9491",1263,513,750,"TTTCCATGACAAGTTTCGCA","CCTTTACGATGAGCGATGAC","561307.5.peg.1862"," 960"
"9492",1215,513,702,"TTTCACGTGTATATTCTGA","CCTTTACGATGAGCGATGAC","561307.5.peg.1862"," 960"
"9493",254,513,259,"CAACATCTGGTTTGTCCATT","CCTTTACGATGAGCGATGAC","561307.5.peg.1862"," 960"
"9494",797,513,284,"ATCCACATATAGGACAAGCA","CCTTTACGATGAGCGATGAC","561307.5.peg.1862"," 960"
"9495",879,513,366,"TGGCCTAAGCCATCACATGT","CCTTTACGATGAGCGATGAC","561307.5.peg.1862"," 960"
"9496",972,513,459,"TCAGAACTCGTCGGTATCCA","CCTTTACGATGAGCGATGAC","561307.5.peg.1862"," 960"
"9497",1215,727,488,"TTTCACGTGTATATTCTGA","TTGTCCTTCTGAAAGCTCTA","561307.5.peg.1862"," 960"
"9498",879,727,152,"TGGCCTAAGCCATCACATGT","TTGTCCTTCTGAAAGCTCTA","561307.5.peg.1862"," 960"
"9499",254,727,473,"CAACATCTGGTTTGTCCATT","TTGTCCTTCTGAAAGCTCTA","561307.5.peg.1862"," 960"
"9500",513,727,214,"CCTTTACGATGAGCGATGAC","TTGTCCTTCTGAAAGCTCTA","561307.5.peg.1862"," 960"
"9501",467,727,260,"GTGCCTCTAATTCCATAATG","TTGTCCTTCTGAAAGCTCTA","561307.5.peg.1862"," 960"
"9502",336,727,391,"ACTGTTGCTACAGTTGATCT","TTGTCCTTCTGAAAGCTCTA","561307.5.peg.1862"," 960"
"9503",972,727,245,"TCAGAACTCGTCGGTATCCA","TTGTCCTTCTGAAAGCTCTA","561307.5.peg.1862"," 960"
"9504",267,727,460,"CCTTCAATTGTATCAACATC","TTGTCCTTCTGAAAGCTCTA","561307.5.peg.1862"," 960"
"9505",933,727,206,"TTTAGCGTCTTATCTTTGTC","TTGTCCTTCTGAAAGCTCTA","561307.5.peg.1862"," 960"
"9506",408,727,319,"TATTGTGATTTGGACAGTA","TTGTCCTTCTGAAAGCTCTA","561307.5.peg.1862"," 960"
"9507",1205,727,478,"ATATTCTGAAGGAGATTCA","TTGTCCTTCTGAAAGCTCTA","561307.5.peg.1862"," 960"
"9508",1263,727,536,"TTTCCATGACAAGTTTCGCA","TTGTCCTTCTGAAAGCTCTA","561307.5.peg.1862"," 960"
"9509",972,797,175,"TCAGAACTCGTCGGTATCCA","ATCCACATATAGGACAAGCA","561307.5.peg.1862"," 960"
"9510",467,797,330,"GTGCCTCTAATTCCATAATG","ATCCACATATAGGACAAGCA","561307.5.peg.1862"," 960"
"9511",1205,797,408,"ATATTCTGAAGGAGATTCA","ATCCACATATAGGACAAGCA","561307.5.peg.1862"," 960"
"9512",254,797,543,"CAACATCTGGTTTGTCCATT","ATCCACATATAGGACAAGCA","561307.5.peg.1862"," 960"
"9513",267,797,530,"CCTTCAATTGTATCAACATC","ATCCACATATAGGACAAGCA","561307.5.peg.1862"," 960"
"9514",933,797,136,"TTTAGCGTCTTATCTTTGTC","ATCCACATATAGGACAAGCA","561307.5.peg.1862"," 960"
"9515",1263,797,466,"TTTCCATGACAAGTTTCGCA","ATCCACATATAGGACAAGCA","561307.5.peg.1862"," 960"
"9516",513,797,284,"CCTTTACGATGAGCGATGAC","ATCCACATATAGGACAAGCA","561307.5.peg.1862"," 960"
"9517",1215,797,418,"TTTCACGTGTATATTCTGA","ATCCACATATAGGACAAGCA","561307.5.peg.1862"," 960"
"9518",408,797,389,"TATTGTGATTTGGACAGTA","ATCCACATATAGGACAAGCA","561307.5.peg.1862"," 960"
"9519",336,797,461,"ACTGTTGCTACAGTTGATCT","ATCCACATATAGGACAAGCA","561307.5.peg.1862"," 960"
"9520",467,879,412,"GTGCCTCTAATTCCATAATG","TGGCCTAAGCCATCACATGT","561307.5.peg.1862"," 960"
"9521",1205,879,326,"ATATTCTGAAGGAGATTCA","TGGCCTAAGCCATCACATGT","561307.5.peg.1862"," 960"
"9522",513,879,366,"CCTTTACGATGAGCGATGAC","TGGCCTAAGCCATCACATGT","561307.5.peg.1862"," 960"
"9523",727,879,152,"TTGTCCTTCTGAAAGCTCTA","TGGCCTAAGCCATCACATGT","561307.5.peg.1862"," 960"
"9524",267,879,612,"CCTTCAATTGTATCAACATC","TGGCCTAAGCCATCACATGT","561307.5.peg.1862"," 960"
"9525",336,879,543,"ACTGTTGCTACAGTTGATCT","TGGCCTAAGCCATCACATGT","561307.5.peg.1862"," 960"
"9526",1263,879,384,"TTTCCATGACAAGTTTCGCA","TGGCCTAAGCCATCACATGT","561307.5.peg.1862"," 960"
"9527",408,879,471,"TATTGTGATTTGGACAGTA","TGGCCTAAGCCATCACATGT","561307.5.peg.1862"," 960"
"9528",1215,879,336,"TTTCACGTGTATATTCTGA","TGGCCTAAGCCATCACATGT","561307.5.peg.1862"," 960"
"9529",254,879,625,"CAACATCTGGTTTGTCCATT","TGGCCTAAGCCATCACATGT","561307.5.peg.1862"," 960"
"9530",254,933,679,"CAACATCTGGTTTGTCCATT","TTTAGCGTCTTATCTTTGTC","561307.5.peg.1862"," 960"
"9531",467,933,466,"GTGCCTCTAATTCCATAATG","TTTAGCGTCTTATCTTTGTC","561307.5.peg.1862"," 960"
"9532",1215,933,282,"TTTCACGTGTATATTCTGA","TTTAGCGTCTTATCTTTGTC","561307.5.peg.1862"," 960"
"9533",1205,933,272,"ATATTCTGAAGGAGATTCA","TTTAGCGTCTTATCTTTGTC","561307.5.peg.1862"," 960"
"9534",513,933,420,"CCTTTACGATGAGCGATGAC","TTTAGCGTCTTATCTTTGTC","561307.5.peg.1862"," 960"
"9535",267,933,666,"CCTTCAATTGTATCAACATC","TTTAGCGTCTTATCTTTGTC","561307.5.peg.1862"," 960"
"9536",1263,933,330,"TTTCCATGACAAGTTTCGCA","TTTAGCGTCTTATCTTTGTC","561307.5.peg.1862"," 960"
"9537",336,933,597,"ACTGTTGCTACAGTTGATCT","TTTAGCGTCTTATCTTTGTC","561307.5.peg.1862"," 960"
"9538",408,933,525,"TATTGTGATTTGGACAGTA","TTTAGCGTCTTATCTTTGTC","561307.5.peg.1862"," 960"
"9539",727,933,206,"TTGTCCTTCTGAAAGCTCTA","TTTAGCGTCTTATCTTTGTC","561307.5.peg.1862"," 960"
"9540",797,933,136,"ATCCACATATAGGACAAGCA","TTTAGCGTCTTATCTTTGTC","561307.5.peg.1862"," 960"
"9541",513,972,459,"CCTTTACGATGAGCGATGAC","TCAGAACTCGTCGGTATCCA","561307.5.peg.1862"," 960"
"9542",267,972,705,"CCTTCAATTGTATCAACATC","TCAGAACTCGTCGGTATCCA","561307.5.peg.1862"," 960"
"9543",467,972,505,"GTGCCTCTAATTCCATAATG","TCAGAACTCGTCGGTATCCA","561307.5.peg.1862"," 960"
"9544",408,972,564,"TATTGTGATTTGGACAGTA","TCAGAACTCGTCGGTATCCA","561307.5.peg.1862"," 960"
"9545",254,972,718,"CAACATCTGGTTTGTCCATT","TCAGAACTCGTCGGTATCCA","561307.5.peg.1862"," 960"
"9546",336,972,636,"ACTGTTGCTACAGTTGATCT","TCAGAACTCGTCGGTATCCA","561307.5.peg.1862"," 960"
"9547",727,972,245,"TTGTCCTTCTGAAAGCTCTA","TCAGAACTCGTCGGTATCCA","561307.5.peg.1862"," 960"
"9548",797,972,175,"ATCCACATATAGGACAAGCA","TCAGAACTCGTCGGTATCCA","561307.5.peg.1862"," 960"
"9549",1215,972,243,"TTTCACGTGTATATTCTGA","TCAGAACTCGTCGGTATCCA","561307.5.peg.1862"," 960"
"9550",1205,972,233,"ATATTCTGAAGGAGATTCA","TCAGAACTCGTCGGTATCCA","561307.5.peg.1862"," 960"
"9551",1263,972,291,"TTTCCATGACAAGTTTCGCA","TCAGAACTCGTCGGTATCCA","561307.5.peg.1862"," 960"
"9552",879,1205,326,"TGGCCTAAGCCATCACATGT","ATATTCTGAAGGAGATTCA","561307.5.peg.1862"," 960"
"9553",467,1205,738,"GTGCCTCTAATTCCATAATG","ATATTCTGAAGGAGATTCA","561307.5.peg.1862"," 960"
"9554",336,1205,869,"ACTGTTGCTACAGTTGATCT","ATATTCTGAAGGAGATTCA","561307.5.peg.1862"," 960"
"9555",933,1205,272,"TTTAGCGTCTTATCTTTGTC","ATATTCTGAAGGAGATTCA","561307.5.peg.1862"," 960"
"9556",797,1205,408,"ATCCACATATAGGACAAGCA","ATATTCTGAAGGAGATTCA","561307.5.peg.1862"," 960"
"9557",727,1205,478,"TTGTCCTTCTGAAAGCTCTA","ATATTCTGAAGGAGATTCA","561307.5.peg.1862"," 960"
"9558",972,1205,233,"TCAGAACTCGTCGGTATCCA","ATATTCTGAAGGAGATTCA","561307.5.peg.1862"," 960"
"9559",267,1205,938,"CCTTCAATTGTATCAACATC","ATATTCTGAAGGAGATTCA","561307.5.peg.1862"," 960"
"9560",254,1205,951,"CAACATCTGGTTTGTCCATT","ATATTCTGAAGGAGATTCA","561307.5.peg.1862"," 960"
"9561",513,1205,692,"CCTTTACGATGAGCGATGAC","ATATTCTGAAGGAGATTCA","561307.5.peg.1862"," 960"
"9562",408,1205,797,"TATTGTGATTTGGACAGTA","ATATTCTGAAGGAGATTCA","561307.5.peg.1862"," 960"
"9563",727,1215,488,"TTGTCCTTCTGAAAGCTCTA","TTTCACGTGTATATTCTGA","561307.5.peg.1862"," 960"
"9564",513,1215,702,"CCTTTACGATGAGCGATGAC","TTTCACGTGTATATTCTGA","561307.5.peg.1862"," 960"
"9565",254,1215,961,"CAACATCTGGTTTGTCCATT","TTTCACGTGTATATTCTGA","561307.5.peg.1862"," 960"
"9566",879,1215,336,"TGGCCTAAGCCATCACATGT","TTTCACGTGTATATTCTGA","561307.5.peg.1862"," 960"
"9567",408,1215,807,"TATTGTGATTTGGACAGTA","TTTCACGTGTATATTCTGA","561307.5.peg.1862"," 960"
"9568",797,1215,418,"ATCCACATATAGGACAAGCA","TTTCACGTGTATATTCTGA","561307.5.peg.1862"," 960"
"9569",467,1215,748,"GTGCCTCTAATTCCATAATG","TTTCACGTGTATATTCTGA","561307.5.peg.1862"," 960"
"9570",933,1215,282,"TTTAGCGTCTTATCTTTGTC","TTTCACGTGTATATTCTGA","561307.5.peg.1862"," 960"
"9571",336,1215,879,"ACTGTTGCTACAGTTGATCT","TTTCACGTGTATATTCTGA","561307.5.peg.1862"," 960"
"9572",267,1215,948,"CCTTCAATTGTATCAACATC","TTTCACGTGTATATTCTGA","561307.5.peg.1862"," 960"
"9573",972,1215,243,"TCAGAACTCGTCGGTATCCA","TTTCACGTGTATATTCTGA","561307.5.peg.1862"," 960"
"9574",879,1263,384,"TGGCCTAAGCCATCACATGT","TTTCCATGACAAGTTTCGCA","561307.5.peg.1862"," 960"
"9575",336,1263,927,"ACTGTTGCTACAGTTGATCT","TTTCCATGACAAGTTTCGCA","561307.5.peg.1862"," 960"
"9576",467,1263,796,"GTGCCTCTAATTCCATAATG","TTTCCATGACAAGTTTCGCA","561307.5.peg.1862"," 960"
"9577",254,1263,1009,"CAACATCTGGTTTGTCCATT","TTTCCATGACAAGTTTCGCA","561307.5.peg.1862"," 960"
"9578",933,1263,330,"TTTAGCGTCTTATCTTTGTC","TTTCCATGACAAGTTTCGCA","561307.5.peg.1862"," 960"
"9579",267,1263,996,"CCTTCAATTGTATCAACATC","TTTCCATGACAAGTTTCGCA","561307.5.peg.1862"," 960"
"9580",797,1263,466,"ATCCACATATAGGACAAGCA","TTTCCATGACAAGTTTCGCA","561307.5.peg.1862"," 960"
"9581",513,1263,750,"CCTTTACGATGAGCGATGAC","TTTCCATGACAAGTTTCGCA","561307.5.peg.1862"," 960"
"9582",727,1263,536,"TTGTCCTTCTGAAAGCTCTA","TTTCCATGACAAGTTTCGCA","561307.5.peg.1862"," 960"
"9583",972,1263,291,"TCAGAACTCGTCGGTATCCA","TTTCCATGACAAGTTTCGCA","561307.5.peg.1862"," 960"
"9584",408,1263,855,"TATTGTGATTTGGACAGTA","TTTCCATGACAAGTTTCGCA","561307.5.peg.1862"," 960"
"9585",279,10,269,"TCTTCCAATCGTAAATCACT","GATCCTATCGAAGCAATTGG","561307.5.peg.1864"," 962"
"9586",10,279,269,"GATCCTATCGAAGCAATTGG","TCTTCCAATCGTAAATCACT","561307.5.peg.1864"," 962"
"9587",270,107,163,"CGCGCTGTTAACATAATAAC","CAATGTGCTCTGTTTGTAAA","561307.5.peg.1866"," 964"
"9588",349,107,242,"TTCCTTAACCTCAAAGGGTT","CAATGTGCTCTGTTTGTAAA","561307.5.peg.1866"," 964"
"9589",354,107,247,"ATAAGTTCCTTAACCTCAAA","CAATGTGCTCTGTTTGTAAA","561307.5.peg.1866"," 964"
"9590",270,144,126,"CGCGCTGTTAACATAATAAC","TTTAATGCAGCTTCACCACT","561307.5.peg.1866"," 964"
"9591",349,144,205,"TTCCTTAACCTCAAAGGGTT","TTTAATGCAGCTTCACCACT","561307.5.peg.1866"," 964"
"9592",354,144,210,"ATAAGTTCCTTAACCTCAAA","TTTAATGCAGCTTCACCACT","561307.5.peg.1866"," 964"
"9593",107,270,163,"CAATGTGCTCTGTTTGTAAA","CGCGCTGTTAACATAATAAC","561307.5.peg.1866"," 964"
"9594",144,270,126,"TTTAATGCAGCTTCACCACT","CGCGCTGTTAACATAATAAC","561307.5.peg.1866"," 964"
"9595",107,349,242,"CAATGTGCTCTGTTTGTAAA","TTCCTTAACCTCAAAGGGTT","561307.5.peg.1866"," 964"
"9596",144,349,205,"TTTAATGCAGCTTCACCACT","TTCCTTAACCTCAAAGGGTT","561307.5.peg.1866"," 964"
"9597",107,354,247,"CAATGTGCTCTGTTTGTAAA","ATAAGTTCCTTAACCTCAAA","561307.5.peg.1866"," 964"
"9598",144,354,210,"TTTAATGCAGCTTCACCACT","ATAAGTTCCTTAACCTCAAA","561307.5.peg.1866"," 964"
"9599",646,7,639,"ATCACCATCAATTAAGCGTT","AAGAGGACAAGGCTATAAGG","561307.5.peg.1867"," 965"
"9600",405,7,398,"CCAGTTACGAATAATGCGAA","AAGAGGACAAGGCTATAAGG","561307.5.peg.1867"," 965"
"9601",228,7,221,"AATATTGTTGAATGTGCGT","AAGAGGACAAGGCTATAAGG","561307.5.peg.1867"," 965"
"9602",228,10,218,"AATATTGTTGAATGTGCGT","AGTAAGAGGACAAGGCTATA","561307.5.peg.1867"," 965"
"9603",405,10,395,"CCAGTTACGAATAATGCGAA","AGTAAGAGGACAAGGCTATA","561307.5.peg.1867"," 965"
"9604",646,10,636,"ATCACCATCAATTAAGCGTT","AGTAAGAGGACAAGGCTATA","561307.5.peg.1867"," 965"
"9605",405,18,387,"CCAGTTACGAATAATGCGAA","ATTGAAACAGTAAGAGGACA","561307.5.peg.1867"," 965"
"9606",228,18,210,"AATATTGTTGAATGTGCGT","ATTGAAACAGTAAGAGGACA","561307.5.peg.1867"," 965"
"9607",646,18,628,"ATCACCATCAATTAAGCGTT","ATTGAAACAGTAAGAGGACA","561307.5.peg.1867"," 965"
"9608",18,228,210,"ATTGAAACAGTAAGAGGACA","AATATTGTTGAATGTGCGT","561307.5.peg.1867"," 965"
"9609",7,228,221,"AAGAGGACAAGGCTATAAGG","AATATTGTTGAATGTGCGT","561307.5.peg.1867"," 965"
"9610",646,228,418,"ATCACCATCAATTAAGCGTT","AATATTGTTGAATGTGCGT","561307.5.peg.1867"," 965"
"9611",10,228,218,"AGTAAGAGGACAAGGCTATA","AATATTGTTGAATGTGCGT","561307.5.peg.1867"," 965"
"9612",405,228,177,"CCAGTTACGAATAATGCGAA","AATATTGTTGAATGTGCGT","561307.5.peg.1867"," 965"
"9613",10,405,395,"AGTAAGAGGACAAGGCTATA","CCAGTTACGAATAATGCGAA","561307.5.peg.1867"," 965"
"9614",7,405,398,"AAGAGGACAAGGCTATAAGG","CCAGTTACGAATAATGCGAA","561307.5.peg.1867"," 965"
"9615",646,405,241,"ATCACCATCAATTAAGCGTT","CCAGTTACGAATAATGCGAA","561307.5.peg.1867"," 965"
"9616",18,405,387,"ATTGAAACAGTAAGAGGACA","CCAGTTACGAATAATGCGAA","561307.5.peg.1867"," 965"
"9617",228,405,177,"AATATTGTTGAATGTGCGT","CCAGTTACGAATAATGCGAA","561307.5.peg.1867"," 965"
"9618",7,646,639,"AAGAGGACAAGGCTATAAGG","ATCACCATCAATTAAGCGTT","561307.5.peg.1867"," 965"
"9619",228,646,418,"AATATTGTTGAATGTGCGT","ATCACCATCAATTAAGCGTT","561307.5.peg.1867"," 965"
"9620",405,646,241,"CCAGTTACGAATAATGCGAA","ATCACCATCAATTAAGCGTT","561307.5.peg.1867"," 965"
"9621",10,646,636,"AGTAAGAGGACAAGGCTATA","ATCACCATCAATTAAGCGTT","561307.5.peg.1867"," 965"
"9622",18,646,628,"ATTGAAACAGTAAGAGGACA","ATCACCATCAATTAAGCGTT","561307.5.peg.1867"," 965"
"9623",470,11,459,"ATCCTGTTGTATAACCTTGA","GCATAATTTAAATCGAAGGC","561307.5.peg.187"," 968"
"9624",11,470,459,"GCATAATTTAAATCGAAGGC","ATCCTGTTGTATAACCTTGA","561307.5.peg.187"," 968"
"9625",368,180,188,"CCGCTTGAATAAAGCGATCT","ACATTTGAACTCTCTTCGCC","561307.5.peg.1870"," 969"
"9626",525,180,345,"TTACGACCTTCAATCATTAA","ACATTTGAACTCTCTTCGCC","561307.5.peg.1870"," 969"
"9627",368,214,154,"CCGCTTGAATAAAGCGATCT","AAGTGCTGAATGCCCTGTAC","561307.5.peg.1870"," 969"
"9628",525,214,311,"TTACGACCTTCAATCATTAA","AAGTGCTGAATGCCCTGTAC","561307.5.peg.1870"," 969"
"9629",180,368,188,"ACATTTGAACTCTCTTCGCC","CCGCTTGAATAAAGCGATCT","561307.5.peg.1870"," 969"
"9630",525,368,157,"TTACGACCTTCAATCATTAA","CCGCTTGAATAAAGCGATCT","561307.5.peg.1870"," 969"
"9631",214,368,154,"AAGTGCTGAATGCCCTGTAC","CCGCTTGAATAAAGCGATCT","561307.5.peg.1870"," 969"
"9632",214,525,311,"AAGTGCTGAATGCCCTGTAC","TTACGACCTTCAATCATTAA","561307.5.peg.1870"," 969"
"9633",180,525,345,"ACATTTGAACTCTCTTCGCC","TTACGACCTTCAATCATTAA","561307.5.peg.1870"," 969"
"9634",368,525,157,"CCGCTTGAATAAAGCGATCT","TTACGACCTTCAATCATTAA","561307.5.peg.1870"," 969"
"9635",569,225,344,"ACGTTTCTACAACACCTACA","GCACCAGAAGCGATACCAAC","561307.5.peg.1871"," 970"
"9636",600,225,375,"CCTAATACTGAAACATCTCC","GCACCAGAAGCGATACCAAC","561307.5.peg.1871"," 970"
"9637",813,225,588,"GCTAACATTGTTAATAACGG","GCACCAGAAGCGATACCAAC","561307.5.peg.1871"," 970"
"9638",813,266,547,"GCTAACATTGTTAATAACGG","AGCCAATCGGAATGATACCT","561307.5.peg.1871"," 970"
"9639",569,266,303,"ACGTTTCTACAACACCTACA","AGCCAATCGGAATGATACCT","561307.5.peg.1871"," 970"
"9640",600,266,334,"CCTAATACTGAAACATCTCC","AGCCAATCGGAATGATACCT","561307.5.peg.1871"," 970"
"9641",600,279,321,"CCTAATACTGAAACATCTCC","ATCATAACGATATAGCCAAT","561307.5.peg.1871"," 970"
"9642",569,279,290,"ACGTTTCTACAACACCTACA","ATCATAACGATATAGCCAAT","561307.5.peg.1871"," 970"
"9643",813,279,534,"GCTAACATTGTTAATAACGG","ATCATAACGATATAGCCAAT","561307.5.peg.1871"," 970"
"9644",225,569,344,"GCACCAGAAGCGATACCAAC","ACGTTTCTACAACACCTACA","561307.5.peg.1871"," 970"
"9645",279,569,290,"ATCATAACGATATAGCCAAT","ACGTTTCTACAACACCTACA","561307.5.peg.1871"," 970"
"9646",266,569,303,"AGCCAATCGGAATGATACCT","ACGTTTCTACAACACCTACA","561307.5.peg.1871"," 970"
"9647",813,569,244,"GCTAACATTGTTAATAACGG","ACGTTTCTACAACACCTACA","561307.5.peg.1871"," 970"
"9648",225,600,375,"GCACCAGAAGCGATACCAAC","CCTAATACTGAAACATCTCC","561307.5.peg.1871"," 970"
"9649",813,600,213,"GCTAACATTGTTAATAACGG","CCTAATACTGAAACATCTCC","561307.5.peg.1871"," 970"
"9650",279,600,321,"ATCATAACGATATAGCCAAT","CCTAATACTGAAACATCTCC","561307.5.peg.1871"," 970"
"9651",266,600,334,"AGCCAATCGGAATGATACCT","CCTAATACTGAAACATCTCC","561307.5.peg.1871"," 970"
"9652",225,813,588,"GCACCAGAAGCGATACCAAC","GCTAACATTGTTAATAACGG","561307.5.peg.1871"," 970"
"9653",266,813,547,"AGCCAATCGGAATGATACCT","GCTAACATTGTTAATAACGG","561307.5.peg.1871"," 970"
"9654",600,813,213,"CCTAATACTGAAACATCTCC","GCTAACATTGTTAATAACGG","561307.5.peg.1871"," 970"
"9655",279,813,534,"ATCATAACGATATAGCCAAT","GCTAACATTGTTAATAACGG","561307.5.peg.1871"," 970"
"9656",569,813,244,"ACGTTTCTACAACACCTACA","GCTAACATTGTTAATAACGG","561307.5.peg.1871"," 970"
"9657",643,2,641,"CCATTTAGGTAGCATAAACT","ATAAGGAAGATACTACGATG","561307.5.peg.1872"," 971"
"9658",465,2,463,"ATTGAAGCACTTGTTGCTAT","ATAAGGAAGATACTACGATG","561307.5.peg.1872"," 971"
"9659",210,2,208,"TAATCAACCACGATAGACTT","ATAAGGAAGATACTACGATG","561307.5.peg.1872"," 971"
"9660",463,2,461,"TGAAGCACTTGTTGCTATAG","ATAAGGAAGATACTACGATG","561307.5.peg.1872"," 971"
"9661",153,2,151,"TCATTATCTCATTGGCATA","ATAAGGAAGATACTACGATG","561307.5.peg.1872"," 971"
"9662",324,2,322,"TGAATCGCATATATCAGGTT","ATAAGGAAGATACTACGATG","561307.5.peg.1872"," 971"
"9663",329,2,327,"TCTGTTGAATCGCATATATC","ATAAGGAAGATACTACGATG","561307.5.peg.1872"," 971"
"9664",719,2,717,"CGTTTGGTTGCTTCGTATAC","ATAAGGAAGATACTACGATG","561307.5.peg.1872"," 971"
"9665",329,153,176,"TCTGTTGAATCGCATATATC","TCATTATCTCATTGGCATA","561307.5.peg.1872"," 971"
"9666",324,153,171,"TGAATCGCATATATCAGGTT","TCATTATCTCATTGGCATA","561307.5.peg.1872"," 971"
"9667",2,153,151,"ATAAGGAAGATACTACGATG","TCATTATCTCATTGGCATA","561307.5.peg.1872"," 971"
"9668",719,153,566,"CGTTTGGTTGCTTCGTATAC","TCATTATCTCATTGGCATA","561307.5.peg.1872"," 971"
"9669",643,153,490,"CCATTTAGGTAGCATAAACT","TCATTATCTCATTGGCATA","561307.5.peg.1872"," 971"
"9670",463,153,310,"TGAAGCACTTGTTGCTATAG","TCATTATCTCATTGGCATA","561307.5.peg.1872"," 971"
"9671",465,153,312,"ATTGAAGCACTTGTTGCTAT","TCATTATCTCATTGGCATA","561307.5.peg.1872"," 971"
"9672",463,210,253,"TGAAGCACTTGTTGCTATAG","TAATCAACCACGATAGACTT","561307.5.peg.1872"," 971"
"9673",329,210,119,"TCTGTTGAATCGCATATATC","TAATCAACCACGATAGACTT","561307.5.peg.1872"," 971"
"9674",719,210,509,"CGTTTGGTTGCTTCGTATAC","TAATCAACCACGATAGACTT","561307.5.peg.1872"," 971"
"9675",643,210,433,"CCATTTAGGTAGCATAAACT","TAATCAACCACGATAGACTT","561307.5.peg.1872"," 971"
"9676",465,210,255,"ATTGAAGCACTTGTTGCTAT","TAATCAACCACGATAGACTT","561307.5.peg.1872"," 971"
"9677",2,210,208,"ATAAGGAAGATACTACGATG","TAATCAACCACGATAGACTT","561307.5.peg.1872"," 971"
"9678",324,210,114,"TGAATCGCATATATCAGGTT","TAATCAACCACGATAGACTT","561307.5.peg.1872"," 971"
"9679",153,324,171,"TCATTATCTCATTGGCATA","TGAATCGCATATATCAGGTT","561307.5.peg.1872"," 971"
"9680",465,324,141,"ATTGAAGCACTTGTTGCTAT","TGAATCGCATATATCAGGTT","561307.5.peg.1872"," 971"
"9681",2,324,322,"ATAAGGAAGATACTACGATG","TGAATCGCATATATCAGGTT","561307.5.peg.1872"," 971"
"9682",463,324,139,"TGAAGCACTTGTTGCTATAG","TGAATCGCATATATCAGGTT","561307.5.peg.1872"," 971"
"9683",643,324,319,"CCATTTAGGTAGCATAAACT","TGAATCGCATATATCAGGTT","561307.5.peg.1872"," 971"
"9684",719,324,395,"CGTTTGGTTGCTTCGTATAC","TGAATCGCATATATCAGGTT","561307.5.peg.1872"," 971"
"9685",210,324,114,"TAATCAACCACGATAGACTT","TGAATCGCATATATCAGGTT","561307.5.peg.1872"," 971"
"9686",210,329,119,"TAATCAACCACGATAGACTT","TCTGTTGAATCGCATATATC","561307.5.peg.1872"," 971"
"9687",153,329,176,"TCATTATCTCATTGGCATA","TCTGTTGAATCGCATATATC","561307.5.peg.1872"," 971"
"9688",719,329,390,"CGTTTGGTTGCTTCGTATAC","TCTGTTGAATCGCATATATC","561307.5.peg.1872"," 971"
"9689",2,329,327,"ATAAGGAAGATACTACGATG","TCTGTTGAATCGCATATATC","561307.5.peg.1872"," 971"
"9690",643,329,314,"CCATTTAGGTAGCATAAACT","TCTGTTGAATCGCATATATC","561307.5.peg.1872"," 971"
"9691",465,329,136,"ATTGAAGCACTTGTTGCTAT","TCTGTTGAATCGCATATATC","561307.5.peg.1872"," 971"
"9692",463,329,134,"TGAAGCACTTGTTGCTATAG","TCTGTTGAATCGCATATATC","561307.5.peg.1872"," 971"
"9693",643,463,180,"CCATTTAGGTAGCATAAACT","TGAAGCACTTGTTGCTATAG","561307.5.peg.1872"," 971"
"9694",153,463,310,"TCATTATCTCATTGGCATA","TGAAGCACTTGTTGCTATAG","561307.5.peg.1872"," 971"
"9695",324,463,139,"TGAATCGCATATATCAGGTT","TGAAGCACTTGTTGCTATAG","561307.5.peg.1872"," 971"
"9696",210,463,253,"TAATCAACCACGATAGACTT","TGAAGCACTTGTTGCTATAG","561307.5.peg.1872"," 971"
"9697",329,463,134,"TCTGTTGAATCGCATATATC","TGAAGCACTTGTTGCTATAG","561307.5.peg.1872"," 971"
"9698",2,463,461,"ATAAGGAAGATACTACGATG","TGAAGCACTTGTTGCTATAG","561307.5.peg.1872"," 971"
"9699",719,463,256,"CGTTTGGTTGCTTCGTATAC","TGAAGCACTTGTTGCTATAG","561307.5.peg.1872"," 971"
"9700",2,465,463,"ATAAGGAAGATACTACGATG","ATTGAAGCACTTGTTGCTAT","561307.5.peg.1872"," 971"
"9701",324,465,141,"TGAATCGCATATATCAGGTT","ATTGAAGCACTTGTTGCTAT","561307.5.peg.1872"," 971"
"9702",643,465,178,"CCATTTAGGTAGCATAAACT","ATTGAAGCACTTGTTGCTAT","561307.5.peg.1872"," 971"
"9703",329,465,136,"TCTGTTGAATCGCATATATC","ATTGAAGCACTTGTTGCTAT","561307.5.peg.1872"," 971"
"9704",153,465,312,"TCATTATCTCATTGGCATA","ATTGAAGCACTTGTTGCTAT","561307.5.peg.1872"," 971"
"9705",210,465,255,"TAATCAACCACGATAGACTT","ATTGAAGCACTTGTTGCTAT","561307.5.peg.1872"," 971"
"9706",719,465,254,"CGTTTGGTTGCTTCGTATAC","ATTGAAGCACTTGTTGCTAT","561307.5.peg.1872"," 971"
"9707",210,643,433,"TAATCAACCACGATAGACTT","CCATTTAGGTAGCATAAACT","561307.5.peg.1872"," 971"
"9708",465,643,178,"ATTGAAGCACTTGTTGCTAT","CCATTTAGGTAGCATAAACT","561307.5.peg.1872"," 971"
"9709",329,643,314,"TCTGTTGAATCGCATATATC","CCATTTAGGTAGCATAAACT","561307.5.peg.1872"," 971"
"9710",324,643,319,"TGAATCGCATATATCAGGTT","CCATTTAGGTAGCATAAACT","561307.5.peg.1872"," 971"
"9711",153,643,490,"TCATTATCTCATTGGCATA","CCATTTAGGTAGCATAAACT","561307.5.peg.1872"," 971"
"9712",463,643,180,"TGAAGCACTTGTTGCTATAG","CCATTTAGGTAGCATAAACT","561307.5.peg.1872"," 971"
"9713",2,643,641,"ATAAGGAAGATACTACGATG","CCATTTAGGTAGCATAAACT","561307.5.peg.1872"," 971"
"9714",329,719,390,"TCTGTTGAATCGCATATATC","CGTTTGGTTGCTTCGTATAC","561307.5.peg.1872"," 971"
"9715",465,719,254,"ATTGAAGCACTTGTTGCTAT","CGTTTGGTTGCTTCGTATAC","561307.5.peg.1872"," 971"
"9716",153,719,566,"TCATTATCTCATTGGCATA","CGTTTGGTTGCTTCGTATAC","561307.5.peg.1872"," 971"
"9717",210,719,509,"TAATCAACCACGATAGACTT","CGTTTGGTTGCTTCGTATAC","561307.5.peg.1872"," 971"
"9718",2,719,717,"ATAAGGAAGATACTACGATG","CGTTTGGTTGCTTCGTATAC","561307.5.peg.1872"," 971"
"9719",324,719,395,"TGAATCGCATATATCAGGTT","CGTTTGGTTGCTTCGTATAC","561307.5.peg.1872"," 971"
"9720",463,719,256,"TGAAGCACTTGTTGCTATAG","CGTTTGGTTGCTTCGTATAC","561307.5.peg.1872"," 971"
"9721",178,75,103,"AACCGATCTTTATCATACA","GCGCAATAATCCTCGCAAGT","561307.5.peg.1876"," 975"
"9722",75,178,103,"GCGCAATAATCCTCGCAAGT","AACCGATCTTTATCATACA","561307.5.peg.1876"," 975"
"9723",273,7,266,"CGTTCATTCAAATGAACTTC","TGAATATAGAGAGTCATAGG","561307.5.peg.1877"," 976"
"9724",273,81,192,"CGTTCATTCAAATGAACTTC","AAGCTTGCATACAAACCAGA","561307.5.peg.1877"," 976"
"9725",7,273,266,"TGAATATAGAGAGTCATAGG","CGTTCATTCAAATGAACTTC","561307.5.peg.1877"," 976"
"9726",81,273,192,"AAGCTTGCATACAAACCAGA","CGTTCATTCAAATGAACTTC","561307.5.peg.1877"," 976"
"9727",135,12,123,"TTGGTTTAGGATTATATGC","CAACACATTGTCTAATAAGG","561307.5.peg.1880"," 980"
"9728",450,12,438,"ATTTGTTGAACCACTTGTGG","CAACACATTGTCTAATAAGG","561307.5.peg.1880"," 980"
"9729",12,135,123,"CAACACATTGTCTAATAAGG","TTGGTTTAGGATTATATGC","561307.5.peg.1880"," 980"
"9730",450,135,315,"ATTTGTTGAACCACTTGTGG","TTGGTTTAGGATTATATGC","561307.5.peg.1880"," 980"
"9731",12,450,438,"CAACACATTGTCTAATAAGG","ATTTGTTGAACCACTTGTGG","561307.5.peg.1880"," 980"
"9732",135,450,315,"TTGGTTTAGGATTATATGC","ATTTGTTGAACCACTTGTGG","561307.5.peg.1880"," 980"
"9733",209,21,188,"AACTTTCTTCTGAGTCCAAA","GTTCCTTTCTAAAGGATTT","561307.5.peg.1882"," 982"
"9734",189,21,168,"GGGTCACGTATAAAGTCTTC","GTTCCTTTCTAAAGGATTT","561307.5.peg.1882"," 982"
"9735",472,21,451,"AAGTTACGATTATAATGGT","GTTCCTTTCTAAAGGATTT","561307.5.peg.1882"," 982"
"9736",285,21,264,"CGATTAGTTGAATTGACGAT","GTTCCTTTCTAAAGGATTT","561307.5.peg.1882"," 982"
"9737",21,189,168,"GTTCCTTTCTAAAGGATTT","GGGTCACGTATAAAGTCTTC","561307.5.peg.1882"," 982"
"9738",472,189,283,"AAGTTACGATTATAATGGT","GGGTCACGTATAAAGTCTTC","561307.5.peg.1882"," 982"
"9739",21,209,188,"GTTCCTTTCTAAAGGATTT","AACTTTCTTCTGAGTCCAAA","561307.5.peg.1882"," 982"
"9740",472,209,263,"AAGTTACGATTATAATGGT","AACTTTCTTCTGAGTCCAAA","561307.5.peg.1882"," 982"
"9741",21,285,264,"GTTCCTTTCTAAAGGATTT","CGATTAGTTGAATTGACGAT","561307.5.peg.1882"," 982"
"9742",472,285,187,"AAGTTACGATTATAATGGT","CGATTAGTTGAATTGACGAT","561307.5.peg.1882"," 982"
"9743",21,472,451,"GTTCCTTTCTAAAGGATTT","AAGTTACGATTATAATGGT","561307.5.peg.1882"," 982"
"9744",189,472,283,"GGGTCACGTATAAAGTCTTC","AAGTTACGATTATAATGGT","561307.5.peg.1882"," 982"
"9745",209,472,263,"AACTTTCTTCTGAGTCCAAA","AAGTTACGATTATAATGGT","561307.5.peg.1882"," 982"
"9746",285,472,187,"CGATTAGTTGAATTGACGAT","AAGTTACGATTATAATGGT","561307.5.peg.1882"," 982"
"9747",645,9,636,"TCGTATGCGCTCATTAGCGA","TGGAACCGGTTCTAATTAGG","561307.5.peg.1883"," 983"
"9748",402,9,393,"AAACCACCAGCAACGATGGC","TGGAACCGGTTCTAATTAGG","561307.5.peg.1883"," 983"
"9749",310,9,301,"TTGTGCTTTGACTTCCGAAG","TGGAACCGGTTCTAATTAGG","561307.5.peg.1883"," 983"
"9750",233,9,224,"ACCAGACCCAATAATAATT","TGGAACCGGTTCTAATTAGG","561307.5.peg.1883"," 983"
"9751",393,9,384,"GCAACGATGGCTGGTATAAT","TGGAACCGGTTCTAATTAGG","561307.5.peg.1883"," 983"
"9752",310,12,298,"TTGTGCTTTGACTTCCGAAG","AAATGGAACCGGTTCTAATT","561307.5.peg.1883"," 983"
"9753",393,12,381,"GCAACGATGGCTGGTATAAT","AAATGGAACCGGTTCTAATT","561307.5.peg.1883"," 983"
"9754",233,12,221,"ACCAGACCCAATAATAATT","AAATGGAACCGGTTCTAATT","561307.5.peg.1883"," 983"
"9755",402,12,390,"AAACCACCAGCAACGATGGC","AAATGGAACCGGTTCTAATT","561307.5.peg.1883"," 983"
"9756",645,12,633,"TCGTATGCGCTCATTAGCGA","AAATGGAACCGGTTCTAATT","561307.5.peg.1883"," 983"
"9757",310,23,287,"TTGTGCTTTGACTTCCGAAG","TAAAGTGGAATAAATGGAAC","561307.5.peg.1883"," 983"
"9758",645,23,622,"TCGTATGCGCTCATTAGCGA","TAAAGTGGAATAAATGGAAC","561307.5.peg.1883"," 983"
"9759",402,23,379,"AAACCACCAGCAACGATGGC","TAAAGTGGAATAAATGGAAC","561307.5.peg.1883"," 983"
"9760",393,23,370,"GCAACGATGGCTGGTATAAT","TAAAGTGGAATAAATGGAAC","561307.5.peg.1883"," 983"
"9761",233,23,210,"ACCAGACCCAATAATAATT","TAAAGTGGAATAAATGGAAC","561307.5.peg.1883"," 983"
"9762",393,25,368,"GCAACGATGGCTGGTATAAT","TTTAGCCTCCTAATTAGAAC","561307.5.peg.1883"," 983"
"9763",233,25,208,"ACCAGACCCAATAATAATT","TTTAGCCTCCTAATTAGAAC","561307.5.peg.1883"," 983"
"9764",310,25,285,"TTGTGCTTTGACTTCCGAAG","TTTAGCCTCCTAATTAGAAC","561307.5.peg.1883"," 983"
"9765",645,25,620,"TCGTATGCGCTCATTAGCGA","TTTAGCCTCCTAATTAGAAC","561307.5.peg.1883"," 983"
"9766",402,25,377,"AAACCACCAGCAACGATGGC","TTTAGCCTCCTAATTAGAAC","561307.5.peg.1883"," 983"
"9767",9,233,224,"TGGAACCGGTTCTAATTAGG","ACCAGACCCAATAATAATT","561307.5.peg.1883"," 983"
"9768",12,233,221,"AAATGGAACCGGTTCTAATT","ACCAGACCCAATAATAATT","561307.5.peg.1883"," 983"
"9769",402,233,169,"AAACCACCAGCAACGATGGC","ACCAGACCCAATAATAATT","561307.5.peg.1883"," 983"
"9770",23,233,210,"TAAAGTGGAATAAATGGAAC","ACCAGACCCAATAATAATT","561307.5.peg.1883"," 983"
"9771",393,233,160,"GCAACGATGGCTGGTATAAT","ACCAGACCCAATAATAATT","561307.5.peg.1883"," 983"
"9772",645,233,412,"TCGTATGCGCTCATTAGCGA","ACCAGACCCAATAATAATT","561307.5.peg.1883"," 983"
"9773",25,233,208,"TTTAGCCTCCTAATTAGAAC","ACCAGACCCAATAATAATT","561307.5.peg.1883"," 983"
"9774",9,310,301,"TGGAACCGGTTCTAATTAGG","TTGTGCTTTGACTTCCGAAG","561307.5.peg.1883"," 983"
"9775",25,310,285,"TTTAGCCTCCTAATTAGAAC","TTGTGCTTTGACTTCCGAAG","561307.5.peg.1883"," 983"
"9776",12,310,298,"AAATGGAACCGGTTCTAATT","TTGTGCTTTGACTTCCGAAG","561307.5.peg.1883"," 983"
"9777",23,310,287,"TAAAGTGGAATAAATGGAAC","TTGTGCTTTGACTTCCGAAG","561307.5.peg.1883"," 983"
"9778",645,310,335,"TCGTATGCGCTCATTAGCGA","TTGTGCTTTGACTTCCGAAG","561307.5.peg.1883"," 983"
"9779",9,393,384,"TGGAACCGGTTCTAATTAGG","GCAACGATGGCTGGTATAAT","561307.5.peg.1883"," 983"
"9780",25,393,368,"TTTAGCCTCCTAATTAGAAC","GCAACGATGGCTGGTATAAT","561307.5.peg.1883"," 983"
"9781",12,393,381,"AAATGGAACCGGTTCTAATT","GCAACGATGGCTGGTATAAT","561307.5.peg.1883"," 983"
"9782",23,393,370,"TAAAGTGGAATAAATGGAAC","GCAACGATGGCTGGTATAAT","561307.5.peg.1883"," 983"
"9783",645,393,252,"TCGTATGCGCTCATTAGCGA","GCAACGATGGCTGGTATAAT","561307.5.peg.1883"," 983"
"9784",233,393,160,"ACCAGACCCAATAATAATT","GCAACGATGGCTGGTATAAT","561307.5.peg.1883"," 983"
"9785",23,402,379,"TAAAGTGGAATAAATGGAAC","AAACCACCAGCAACGATGGC","561307.5.peg.1883"," 983"
"9786",12,402,390,"AAATGGAACCGGTTCTAATT","AAACCACCAGCAACGATGGC","561307.5.peg.1883"," 983"
"9787",9,402,393,"TGGAACCGGTTCTAATTAGG","AAACCACCAGCAACGATGGC","561307.5.peg.1883"," 983"
"9788",645,402,243,"TCGTATGCGCTCATTAGCGA","AAACCACCAGCAACGATGGC","561307.5.peg.1883"," 983"
"9789",25,402,377,"TTTAGCCTCCTAATTAGAAC","AAACCACCAGCAACGATGGC","561307.5.peg.1883"," 983"
"9790",233,402,169,"ACCAGACCCAATAATAATT","AAACCACCAGCAACGATGGC","561307.5.peg.1883"," 983"
"9791",23,645,622,"TAAAGTGGAATAAATGGAAC","TCGTATGCGCTCATTAGCGA","561307.5.peg.1883"," 983"
"9792",25,645,620,"TTTAGCCTCCTAATTAGAAC","TCGTATGCGCTCATTAGCGA","561307.5.peg.1883"," 983"
"9793",12,645,633,"AAATGGAACCGGTTCTAATT","TCGTATGCGCTCATTAGCGA","561307.5.peg.1883"," 983"
"9794",233,645,412,"ACCAGACCCAATAATAATT","TCGTATGCGCTCATTAGCGA","561307.5.peg.1883"," 983"
"9795",402,645,243,"AAACCACCAGCAACGATGGC","TCGTATGCGCTCATTAGCGA","561307.5.peg.1883"," 983"
"9796",9,645,636,"TGGAACCGGTTCTAATTAGG","TCGTATGCGCTCATTAGCGA","561307.5.peg.1883"," 983"
"9797",393,645,252,"GCAACGATGGCTGGTATAAT","TCGTATGCGCTCATTAGCGA","561307.5.peg.1883"," 983"
"9798",310,645,335,"TTGTGCTTTGACTTCCGAAG","TCGTATGCGCTCATTAGCGA","561307.5.peg.1883"," 983"
"9799",774,372,402,"ACGAGTGAACGGAACTGTTT","CCCATTAAAGAAGAACTTGT","561307.5.peg.1885"," 985"
"9800",816,372,444,"TCTTGTTGGAAGTGTATTTG","CCCATTAAAGAAGAACTTGT","561307.5.peg.1885"," 985"
"9801",489,372,117,"TTTACACAGTCTATGAACAC","CCCATTAAAGAAGAACTTGT","561307.5.peg.1885"," 985"
"9802",830,372,458,"TTGTGATACGTTATCTTGT","CCCATTAAAGAAGAACTTGT","561307.5.peg.1885"," 985"
"9803",785,372,413,"TAATCTTGGAAACGAGTGAA","CCCATTAAAGAAGAACTTGT","561307.5.peg.1885"," 985"
"9804",813,372,441,"TGTTGGAAGTGTATTTGTGG","CCCATTAAAGAAGAACTTGT","561307.5.peg.1885"," 985"
"9805",799,372,427,"TTGTGGTGGTTCAGTAATCT","CCCATTAAAGAAGAACTTGT","561307.5.peg.1885"," 985"
"9806",933,372,561,"GCACGCTGACTTCGATCTTT","CCCATTAAAGAAGAACTTGT","561307.5.peg.1885"," 985"
"9807",372,489,117,"CCCATTAAAGAAGAACTTGT","TTTACACAGTCTATGAACAC","561307.5.peg.1885"," 985"
"9808",933,489,444,"GCACGCTGACTTCGATCTTT","TTTACACAGTCTATGAACAC","561307.5.peg.1885"," 985"
"9809",816,489,327,"TCTTGTTGGAAGTGTATTTG","TTTACACAGTCTATGAACAC","561307.5.peg.1885"," 985"
"9810",830,489,341,"TTGTGATACGTTATCTTGT","TTTACACAGTCTATGAACAC","561307.5.peg.1885"," 985"
"9811",774,489,285,"ACGAGTGAACGGAACTGTTT","TTTACACAGTCTATGAACAC","561307.5.peg.1885"," 985"
"9812",813,489,324,"TGTTGGAAGTGTATTTGTGG","TTTACACAGTCTATGAACAC","561307.5.peg.1885"," 985"
"9813",785,489,296,"TAATCTTGGAAACGAGTGAA","TTTACACAGTCTATGAACAC","561307.5.peg.1885"," 985"
"9814",799,489,310,"TTGTGGTGGTTCAGTAATCT","TTTACACAGTCTATGAACAC","561307.5.peg.1885"," 985"
"9815",489,774,285,"TTTACACAGTCTATGAACAC","ACGAGTGAACGGAACTGTTT","561307.5.peg.1885"," 985"
"9816",372,774,402,"CCCATTAAAGAAGAACTTGT","ACGAGTGAACGGAACTGTTT","561307.5.peg.1885"," 985"
"9817",933,774,159,"GCACGCTGACTTCGATCTTT","ACGAGTGAACGGAACTGTTT","561307.5.peg.1885"," 985"
"9818",933,785,148,"GCACGCTGACTTCGATCTTT","TAATCTTGGAAACGAGTGAA","561307.5.peg.1885"," 985"
"9819",489,785,296,"TTTACACAGTCTATGAACAC","TAATCTTGGAAACGAGTGAA","561307.5.peg.1885"," 985"
"9820",372,785,413,"CCCATTAAAGAAGAACTTGT","TAATCTTGGAAACGAGTGAA","561307.5.peg.1885"," 985"
"9821",489,799,310,"TTTACACAGTCTATGAACAC","TTGTGGTGGTTCAGTAATCT","561307.5.peg.1885"," 985"
"9822",933,799,134,"GCACGCTGACTTCGATCTTT","TTGTGGTGGTTCAGTAATCT","561307.5.peg.1885"," 985"
"9823",372,799,427,"CCCATTAAAGAAGAACTTGT","TTGTGGTGGTTCAGTAATCT","561307.5.peg.1885"," 985"
"9824",933,813,120,"GCACGCTGACTTCGATCTTT","TGTTGGAAGTGTATTTGTGG","561307.5.peg.1885"," 985"
"9825",489,813,324,"TTTACACAGTCTATGAACAC","TGTTGGAAGTGTATTTGTGG","561307.5.peg.1885"," 985"
"9826",372,813,441,"CCCATTAAAGAAGAACTTGT","TGTTGGAAGTGTATTTGTGG","561307.5.peg.1885"," 985"
"9827",372,816,444,"CCCATTAAAGAAGAACTTGT","TCTTGTTGGAAGTGTATTTG","561307.5.peg.1885"," 985"
"9828",489,816,327,"TTTACACAGTCTATGAACAC","TCTTGTTGGAAGTGTATTTG","561307.5.peg.1885"," 985"
"9829",933,816,117,"GCACGCTGACTTCGATCTTT","TCTTGTTGGAAGTGTATTTG","561307.5.peg.1885"," 985"
"9830",372,830,458,"CCCATTAAAGAAGAACTTGT","TTGTGATACGTTATCTTGT","561307.5.peg.1885"," 985"
"9831",933,830,103,"GCACGCTGACTTCGATCTTT","TTGTGATACGTTATCTTGT","561307.5.peg.1885"," 985"
"9832",489,830,341,"TTTACACAGTCTATGAACAC","TTGTGATACGTTATCTTGT","561307.5.peg.1885"," 985"
"9833",785,933,148,"TAATCTTGGAAACGAGTGAA","GCACGCTGACTTCGATCTTT","561307.5.peg.1885"," 985"
"9834",774,933,159,"ACGAGTGAACGGAACTGTTT","GCACGCTGACTTCGATCTTT","561307.5.peg.1885"," 985"
"9835",372,933,561,"CCCATTAAAGAAGAACTTGT","GCACGCTGACTTCGATCTTT","561307.5.peg.1885"," 985"
"9836",813,933,120,"TGTTGGAAGTGTATTTGTGG","GCACGCTGACTTCGATCTTT","561307.5.peg.1885"," 985"
"9837",489,933,444,"TTTACACAGTCTATGAACAC","GCACGCTGACTTCGATCTTT","561307.5.peg.1885"," 985"
"9838",830,933,103,"TTGTGATACGTTATCTTGT","GCACGCTGACTTCGATCTTT","561307.5.peg.1885"," 985"
"9839",816,933,117,"TCTTGTTGGAAGTGTATTTG","GCACGCTGACTTCGATCTTT","561307.5.peg.1885"," 985"
"9840",799,933,134,"TTGTGGTGGTTCAGTAATCT","GCACGCTGACTTCGATCTTT","561307.5.peg.1885"," 985"
"9841",353,11,342,"ATCCAGCACCTGGTTTAAAT","TTGAGTGATGTCAGATGAAG","561307.5.peg.1888"," 988"
"9842",472,11,461,"GTCGGAATAATATGTACAA","TTGAGTGATGTCAGATGAAG","561307.5.peg.1888"," 988"
"9843",353,77,276,"ATCCAGCACCTGGTTTAAAT","CAATAACAACTTGCATAGGT","561307.5.peg.1888"," 988"
"9844",472,77,395,"GTCGGAATAATATGTACAA","CAATAACAACTTGCATAGGT","561307.5.peg.1888"," 988"
"9845",472,81,391,"GTCGGAATAATATGTACAA","ATGCAATAACAACTTGCAT","561307.5.peg.1888"," 988"
"9846",353,81,272,"ATCCAGCACCTGGTTTAAAT","ATGCAATAACAACTTGCAT","561307.5.peg.1888"," 988"
"9847",11,353,342,"TTGAGTGATGTCAGATGAAG","ATCCAGCACCTGGTTTAAAT","561307.5.peg.1888"," 988"
"9848",472,353,119,"GTCGGAATAATATGTACAA","ATCCAGCACCTGGTTTAAAT","561307.5.peg.1888"," 988"
"9849",77,353,276,"CAATAACAACTTGCATAGGT","ATCCAGCACCTGGTTTAAAT","561307.5.peg.1888"," 988"
"9850",81,353,272,"ATGCAATAACAACTTGCAT","ATCCAGCACCTGGTTTAAAT","561307.5.peg.1888"," 988"
"9851",77,472,395,"CAATAACAACTTGCATAGGT","GTCGGAATAATATGTACAA","561307.5.peg.1888"," 988"
"9852",11,472,461,"TTGAGTGATGTCAGATGAAG","GTCGGAATAATATGTACAA","561307.5.peg.1888"," 988"
"9853",353,472,119,"ATCCAGCACCTGGTTTAAAT","GTCGGAATAATATGTACAA","561307.5.peg.1888"," 988"
"9854",81,472,391,"ATGCAATAACAACTTGCAT","GTCGGAATAATATGTACAA","561307.5.peg.1888"," 988"
"9855",414,10,404,"GTAATCACACCTGGACAGTT","AAGAAGCATAAGGAAAGGAT","561307.5.peg.189"," 990"
"9856",423,10,413,"TCATCTGCTGTAATCACACC","AAGAAGCATAAGGAAAGGAT","561307.5.peg.189"," 990"
"9857",10,414,404,"AAGAAGCATAAGGAAAGGAT","GTAATCACACCTGGACAGTT","561307.5.peg.189"," 990"
"9858",10,423,413,"AAGAAGCATAAGGAAAGGAT","TCATCTGCTGTAATCACACC","561307.5.peg.189"," 990"
"9859",336,227,109,"CCTGAAGCCATTAACATACC","TTAAATAACCAAATGGCACA","561307.5.peg.1892"," 993"
"9860",501,227,274,"CCAATAATACCCGCTATCGG","TTAAATAACCAAATGGCACA","561307.5.peg.1892"," 993"
"9861",504,227,277,"CAACCAATAATACCCGCTAT","TTAAATAACCAAATGGCACA","561307.5.peg.1892"," 993"
"9862",504,323,181,"CAACCAATAATACCCGCTAT","ACATACCCGGTGTTTGTGCT","561307.5.peg.1892"," 993"
"9863",501,323,178,"CCAATAATACCCGCTATCGG","ACATACCCGGTGTTTGTGCT","561307.5.peg.1892"," 993"
"9864",227,336,109,"TTAAATAACCAAATGGCACA","CCTGAAGCCATTAACATACC","561307.5.peg.1892"," 993"
"9865",501,336,165,"CCAATAATACCCGCTATCGG","CCTGAAGCCATTAACATACC","561307.5.peg.1892"," 993"
"9866",504,336,168,"CAACCAATAATACCCGCTAT","CCTGAAGCCATTAACATACC","561307.5.peg.1892"," 993"
"9867",227,501,274,"TTAAATAACCAAATGGCACA","CCAATAATACCCGCTATCGG","561307.5.peg.1892"," 993"
"9868",336,501,165,"CCTGAAGCCATTAACATACC","CCAATAATACCCGCTATCGG","561307.5.peg.1892"," 993"
"9869",323,501,178,"ACATACCCGGTGTTTGTGCT","CCAATAATACCCGCTATCGG","561307.5.peg.1892"," 993"
"9870",227,504,277,"TTAAATAACCAAATGGCACA","CAACCAATAATACCCGCTAT","561307.5.peg.1892"," 993"
"9871",323,504,181,"ACATACCCGGTGTTTGTGCT","CAACCAATAATACCCGCTAT","561307.5.peg.1892"," 993"
"9872",336,504,168,"CCTGAAGCCATTAACATACC","CAACCAATAATACCCGCTAT","561307.5.peg.1892"," 993"
"9873",108,7,101,"ATTGAATCACGGTCGTTTAT","TTTATGCTGACAACATAAGG","561307.5.peg.1893"," 994"
"9874",252,7,245,"TCAGACATGCGTAAATCTTT","TTTATGCTGACAACATAAGG","561307.5.peg.1893"," 994"
"9875",238,7,231,"TCTTTGGGAGAAATTTGAA","TTTATGCTGACAACATAAGG","561307.5.peg.1893"," 994"
"9876",275,7,268,"CAGGTATTGTATTGACATT","TTTATGCTGACAACATAAGG","561307.5.peg.1893"," 994"
"9877",238,10,228,"TCTTTGGGAGAAATTTGAA","TCCTTTATGCTGACAACATA","561307.5.peg.1893"," 994"
"9878",275,10,265,"CAGGTATTGTATTGACATT","TCCTTTATGCTGACAACATA","561307.5.peg.1893"," 994"
"9879",252,10,242,"TCAGACATGCGTAAATCTTT","TCCTTTATGCTGACAACATA","561307.5.peg.1893"," 994"
"9880",7,108,101,"TTTATGCTGACAACATAAGG","ATTGAATCACGGTCGTTTAT","561307.5.peg.1893"," 994"
"9881",238,108,130,"TCTTTGGGAGAAATTTGAA","ATTGAATCACGGTCGTTTAT","561307.5.peg.1893"," 994"
"9882",275,108,167,"CAGGTATTGTATTGACATT","ATTGAATCACGGTCGTTTAT","561307.5.peg.1893"," 994"
"9883",252,108,144,"TCAGACATGCGTAAATCTTT","ATTGAATCACGGTCGTTTAT","561307.5.peg.1893"," 994"
"9884",10,238,228,"TCCTTTATGCTGACAACATA","TCTTTGGGAGAAATTTGAA","561307.5.peg.1893"," 994"
"9885",7,238,231,"TTTATGCTGACAACATAAGG","TCTTTGGGAGAAATTTGAA","561307.5.peg.1893"," 994"
"9886",108,238,130,"ATTGAATCACGGTCGTTTAT","TCTTTGGGAGAAATTTGAA","561307.5.peg.1893"," 994"
"9887",10,252,242,"TCCTTTATGCTGACAACATA","TCAGACATGCGTAAATCTTT","561307.5.peg.1893"," 994"
"9888",7,252,245,"TTTATGCTGACAACATAAGG","TCAGACATGCGTAAATCTTT","561307.5.peg.1893"," 994"
"9889",108,252,144,"ATTGAATCACGGTCGTTTAT","TCAGACATGCGTAAATCTTT","561307.5.peg.1893"," 994"
"9890",7,275,268,"TTTATGCTGACAACATAAGG","CAGGTATTGTATTGACATT","561307.5.peg.1893"," 994"
"9891",10,275,265,"TCCTTTATGCTGACAACATA","CAGGTATTGTATTGACATT","561307.5.peg.1893"," 994"
"9892",108,275,167,"ATTGAATCACGGTCGTTTAT","CAGGTATTGTATTGACATT","561307.5.peg.1893"," 994"
"9893",168,7,161,"ATAAGACCTGACTCACCTGG","ATCACGCTGTTGTCCGTACG","561307.5.peg.1896"," 997"
"9894",171,7,164,"GCGATAAGACCTGACTCACC","ATCACGCTGTTGTCCGTACG","561307.5.peg.1896"," 997"
"9895",168,9,159,"ATAAGACCTGACTCACCTGG","TGATCACGCTGTTGTCCGTA","561307.5.peg.1896"," 997"
"9896",171,9,162,"GCGATAAGACCTGACTCACC","TGATCACGCTGTTGTCCGTA","561307.5.peg.1896"," 997"
"9897",168,16,152,"ATAAGACCTGACTCACCTGG","ACGGACAACAGCGTGATCAT","561307.5.peg.1896"," 997"
"9898",171,16,155,"GCGATAAGACCTGACTCACC","ACGGACAACAGCGTGATCAT","561307.5.peg.1896"," 997"
"9899",168,35,133,"ATAAGACCTGACTCACCTGG","AAATCATAGAGAACCCCGTA","561307.5.peg.1896"," 997"
"9900",171,35,136,"GCGATAAGACCTGACTCACC","AAATCATAGAGAACCCCGTA","561307.5.peg.1896"," 997"
"9901",7,168,161,"ATCACGCTGTTGTCCGTACG","ATAAGACCTGACTCACCTGG","561307.5.peg.1896"," 997"
"9902",9,168,159,"TGATCACGCTGTTGTCCGTA","ATAAGACCTGACTCACCTGG","561307.5.peg.1896"," 997"
"9903",16,168,152,"ACGGACAACAGCGTGATCAT","ATAAGACCTGACTCACCTGG","561307.5.peg.1896"," 997"
"9904",35,168,133,"AAATCATAGAGAACCCCGTA","ATAAGACCTGACTCACCTGG","561307.5.peg.1896"," 997"
"9905",7,171,164,"ATCACGCTGTTGTCCGTACG","GCGATAAGACCTGACTCACC","561307.5.peg.1896"," 997"
"9906",9,171,162,"TGATCACGCTGTTGTCCGTA","GCGATAAGACCTGACTCACC","561307.5.peg.1896"," 997"
"9907",16,171,155,"ACGGACAACAGCGTGATCAT","GCGATAAGACCTGACTCACC","561307.5.peg.1896"," 997"
"9908",35,171,136,"AAATCATAGAGAACCCCGTA","GCGATAAGACCTGACTCACC","561307.5.peg.1896"," 997"
"9909",501,4,497,"AATGGTGAAAGTCCGATTAC","TAACCTAAGTAACAGGAGGA","561307.5.peg.190","1002"
"9910",524,4,520,"TAAACGCAATTCGTCTTGCT","TAACCTAAGTAACAGGAGGA","561307.5.peg.190","1002"
"9911",407,4,403,"CAGACGCCATCAATGTTACT","TAACCTAAGTAACAGGAGGA","561307.5.peg.190","1002"
"9912",519,4,515,"GCAATTCGTCTTGCTTGGAA","TAACCTAAGTAACAGGAGGA","561307.5.peg.190","1002"
"9913",108,4,104,"GTAAATGCTACTCGTCCTTC","TAACCTAAGTAACAGGAGGA","561307.5.peg.190","1002"
"9914",519,8,511,"GCAATTCGTCTTGCTTGGAA","AACTTAACCTAAGTAACAGG","561307.5.peg.190","1002"
"9915",501,8,493,"AATGGTGAAAGTCCGATTAC","AACTTAACCTAAGTAACAGG","561307.5.peg.190","1002"
"9916",407,8,399,"CAGACGCCATCAATGTTACT","AACTTAACCTAAGTAACAGG","561307.5.peg.190","1002"
"9917",108,8,100,"GTAAATGCTACTCGTCCTTC","AACTTAACCTAAGTAACAGG","561307.5.peg.190","1002"
"9918",524,8,516,"TAAACGCAATTCGTCTTGCT","AACTTAACCTAAGTAACAGG","561307.5.peg.190","1002"
"9919",524,11,513,"TAAACGCAATTCGTCTTGCT","GGGAACTTAACCTAAGTAAC","561307.5.peg.190","1002"
"9920",407,11,396,"CAGACGCCATCAATGTTACT","GGGAACTTAACCTAAGTAAC","561307.5.peg.190","1002"
"9921",501,11,490,"AATGGTGAAAGTCCGATTAC","GGGAACTTAACCTAAGTAAC","561307.5.peg.190","1002"
"9922",519,11,508,"GCAATTCGTCTTGCTTGGAA","GGGAACTTAACCTAAGTAAC","561307.5.peg.190","1002"
"9923",519,28,491,"GCAATTCGTCTTGCTTGGAA","CTTCCATCCTCCTGTTACTT","561307.5.peg.190","1002"
"9924",501,28,473,"AATGGTGAAAGTCCGATTAC","CTTCCATCCTCCTGTTACTT","561307.5.peg.190","1002"
"9925",407,28,379,"CAGACGCCATCAATGTTACT","CTTCCATCCTCCTGTTACTT","561307.5.peg.190","1002"
"9926",524,28,496,"TAAACGCAATTCGTCTTGCT","CTTCCATCCTCCTGTTACTT","561307.5.peg.190","1002"
"9927",519,59,460,"GCAATTCGTCTTGCTTGGAA","TTTCTTTACCTTGATACTCG","561307.5.peg.190","1002"
"9928",501,59,442,"AATGGTGAAAGTCCGATTAC","TTTCTTTACCTTGATACTCG","561307.5.peg.190","1002"
"9929",524,59,465,"TAAACGCAATTCGTCTTGCT","TTTCTTTACCTTGATACTCG","561307.5.peg.190","1002"
"9930",407,59,348,"CAGACGCCATCAATGTTACT","TTTCTTTACCTTGATACTCG","561307.5.peg.190","1002"
"9931",8,108,100,"AACTTAACCTAAGTAACAGG","GTAAATGCTACTCGTCCTTC","561307.5.peg.190","1002"
"9932",519,108,411,"GCAATTCGTCTTGCTTGGAA","GTAAATGCTACTCGTCCTTC","561307.5.peg.190","1002"
"9933",407,108,299,"CAGACGCCATCAATGTTACT","GTAAATGCTACTCGTCCTTC","561307.5.peg.190","1002"
"9934",501,108,393,"AATGGTGAAAGTCCGATTAC","GTAAATGCTACTCGTCCTTC","561307.5.peg.190","1002"
"9935",4,108,104,"TAACCTAAGTAACAGGAGGA","GTAAATGCTACTCGTCCTTC","561307.5.peg.190","1002"
"9936",524,108,416,"TAAACGCAATTCGTCTTGCT","GTAAATGCTACTCGTCCTTC","561307.5.peg.190","1002"
"9937",8,407,399,"AACTTAACCTAAGTAACAGG","CAGACGCCATCAATGTTACT","561307.5.peg.190","1002"
"9938",59,407,348,"TTTCTTTACCTTGATACTCG","CAGACGCCATCAATGTTACT","561307.5.peg.190","1002"
"9939",28,407,379,"CTTCCATCCTCCTGTTACTT","CAGACGCCATCAATGTTACT","561307.5.peg.190","1002"
"9940",108,407,299,"GTAAATGCTACTCGTCCTTC","CAGACGCCATCAATGTTACT","561307.5.peg.190","1002"
"9941",4,407,403,"TAACCTAAGTAACAGGAGGA","CAGACGCCATCAATGTTACT","561307.5.peg.190","1002"
"9942",519,407,112,"GCAATTCGTCTTGCTTGGAA","CAGACGCCATCAATGTTACT","561307.5.peg.190","1002"
"9943",11,407,396,"GGGAACTTAACCTAAGTAAC","CAGACGCCATCAATGTTACT","561307.5.peg.190","1002"
"9944",524,407,117,"TAAACGCAATTCGTCTTGCT","CAGACGCCATCAATGTTACT","561307.5.peg.190","1002"
"9945",28,501,473,"CTTCCATCCTCCTGTTACTT","AATGGTGAAAGTCCGATTAC","561307.5.peg.190","1002"
"9946",108,501,393,"GTAAATGCTACTCGTCCTTC","AATGGTGAAAGTCCGATTAC","561307.5.peg.190","1002"
"9947",11,501,490,"GGGAACTTAACCTAAGTAAC","AATGGTGAAAGTCCGATTAC","561307.5.peg.190","1002"
"9948",4,501,497,"TAACCTAAGTAACAGGAGGA","AATGGTGAAAGTCCGATTAC","561307.5.peg.190","1002"
"9949",8,501,493,"AACTTAACCTAAGTAACAGG","AATGGTGAAAGTCCGATTAC","561307.5.peg.190","1002"
"9950",59,501,442,"TTTCTTTACCTTGATACTCG","AATGGTGAAAGTCCGATTAC","561307.5.peg.190","1002"
"9951",407,519,112,"CAGACGCCATCAATGTTACT","GCAATTCGTCTTGCTTGGAA","561307.5.peg.190","1002"
"9952",11,519,508,"GGGAACTTAACCTAAGTAAC","GCAATTCGTCTTGCTTGGAA","561307.5.peg.190","1002"
"9953",59,519,460,"TTTCTTTACCTTGATACTCG","GCAATTCGTCTTGCTTGGAA","561307.5.peg.190","1002"
"9954",4,519,515,"TAACCTAAGTAACAGGAGGA","GCAATTCGTCTTGCTTGGAA","561307.5.peg.190","1002"
"9955",28,519,491,"CTTCCATCCTCCTGTTACTT","GCAATTCGTCTTGCTTGGAA","561307.5.peg.190","1002"
"9956",8,519,511,"AACTTAACCTAAGTAACAGG","GCAATTCGTCTTGCTTGGAA","561307.5.peg.190","1002"
"9957",108,519,411,"GTAAATGCTACTCGTCCTTC","GCAATTCGTCTTGCTTGGAA","561307.5.peg.190","1002"
"9958",4,524,520,"TAACCTAAGTAACAGGAGGA","TAAACGCAATTCGTCTTGCT","561307.5.peg.190","1002"
"9959",108,524,416,"GTAAATGCTACTCGTCCTTC","TAAACGCAATTCGTCTTGCT","561307.5.peg.190","1002"
"9960",407,524,117,"CAGACGCCATCAATGTTACT","TAAACGCAATTCGTCTTGCT","561307.5.peg.190","1002"
"9961",28,524,496,"CTTCCATCCTCCTGTTACTT","TAAACGCAATTCGTCTTGCT","561307.5.peg.190","1002"
"9962",8,524,516,"AACTTAACCTAAGTAACAGG","TAAACGCAATTCGTCTTGCT","561307.5.peg.190","1002"
"9963",59,524,465,"TTTCTTTACCTTGATACTCG","TAAACGCAATTCGTCTTGCT","561307.5.peg.190","1002"
"9964",11,524,513,"GGGAACTTAACCTAAGTAAC","TAAACGCAATTCGTCTTGCT","561307.5.peg.190","1002"
"9965",680,11,669,"GCATACCCGCCTCGATTCTC","AACACTTGGACAAATCGTCC","561307.5.peg.1901","1004"
"9966",525,11,514,"CGTTTATACATAGCACCTGA","AACACTTGGACAAATCGTCC","561307.5.peg.1901","1004"
"9967",504,11,493,"GGACACGATGCAACGCAACT","AACACTTGGACAAATCGTCC","561307.5.peg.1901","1004"
"9968",360,11,349,"GCTAAGTCATCTTCCCAGTT","AACACTTGGACAAATCGTCC","561307.5.peg.1901","1004"
"9969",702,11,691,"CAAGTTTCAGAGCATACCGT","AACACTTGGACAAATCGTCC","561307.5.peg.1901","1004"
"9970",303,11,292,"TCTGAATACGCTCTAGCAAC","AACACTTGGACAAATCGTCC","561307.5.peg.1901","1004"
"9971",477,11,466,"AAGCAATGTTCACATAAACG","AACACTTGGACAAATCGTCC","561307.5.peg.1901","1004"
"9972",575,11,564,"GCCATCCACGACATGCGTCT","AACACTTGGACAAATCGTCC","561307.5.peg.1901","1004"
"9973",504,78,426,"GGACACGATGCAACGCAACT","CGTTTCGGATACCCTACACC","561307.5.peg.1901","1004"
"9974",525,78,447,"CGTTTATACATAGCACCTGA","CGTTTCGGATACCCTACACC","561307.5.peg.1901","1004"
"9975",680,78,602,"GCATACCCGCCTCGATTCTC","CGTTTCGGATACCCTACACC","561307.5.peg.1901","1004"
"9976",575,78,497,"GCCATCCACGACATGCGTCT","CGTTTCGGATACCCTACACC","561307.5.peg.1901","1004"
"9977",702,78,624,"CAAGTTTCAGAGCATACCGT","CGTTTCGGATACCCTACACC","561307.5.peg.1901","1004"
"9978",360,78,282,"GCTAAGTCATCTTCCCAGTT","CGTTTCGGATACCCTACACC","561307.5.peg.1901","1004"
"9979",303,78,225,"TCTGAATACGCTCTAGCAAC","CGTTTCGGATACCCTACACC","561307.5.peg.1901","1004"
"9980",477,78,399,"AAGCAATGTTCACATAAACG","CGTTTCGGATACCCTACACC","561307.5.peg.1901","1004"
"9981",702,93,609,"CAAGTTTCAGAGCATACCGT","TCTTGGTCTTCCCAACGTTT","561307.5.peg.1901","1004"
"9982",477,93,384,"AAGCAATGTTCACATAAACG","TCTTGGTCTTCCCAACGTTT","561307.5.peg.1901","1004"
"9983",504,93,411,"GGACACGATGCAACGCAACT","TCTTGGTCTTCCCAACGTTT","561307.5.peg.1901","1004"
"9984",303,93,210,"TCTGAATACGCTCTAGCAAC","TCTTGGTCTTCCCAACGTTT","561307.5.peg.1901","1004"
"9985",360,93,267,"GCTAAGTCATCTTCCCAGTT","TCTTGGTCTTCCCAACGTTT","561307.5.peg.1901","1004"
"9986",575,93,482,"GCCATCCACGACATGCGTCT","TCTTGGTCTTCCCAACGTTT","561307.5.peg.1901","1004"
"9987",680,93,587,"GCATACCCGCCTCGATTCTC","TCTTGGTCTTCCCAACGTTT","561307.5.peg.1901","1004"
"9988",525,93,432,"CGTTTATACATAGCACCTGA","TCTTGGTCTTCCCAACGTTT","561307.5.peg.1901","1004"
"9989",680,110,570,"GCATACCCGCCTCGATTCTC","AACCACCTTTGTAGTGTTCT","561307.5.peg.1901","1004"
"9990",477,110,367,"AAGCAATGTTCACATAAACG","AACCACCTTTGTAGTGTTCT","561307.5.peg.1901","1004"
"9991",303,110,193,"TCTGAATACGCTCTAGCAAC","AACCACCTTTGTAGTGTTCT","561307.5.peg.1901","1004"
"9992",360,110,250,"GCTAAGTCATCTTCCCAGTT","AACCACCTTTGTAGTGTTCT","561307.5.peg.1901","1004"
"9993",525,110,415,"CGTTTATACATAGCACCTGA","AACCACCTTTGTAGTGTTCT","561307.5.peg.1901","1004"
"9994",702,110,592,"CAAGTTTCAGAGCATACCGT","AACCACCTTTGTAGTGTTCT","561307.5.peg.1901","1004"
"9995",575,110,465,"GCCATCCACGACATGCGTCT","AACCACCTTTGTAGTGTTCT","561307.5.peg.1901","1004"
"9996",504,110,394,"GGACACGATGCAACGCAACT","AACCACCTTTGTAGTGTTCT","561307.5.peg.1901","1004"
"9997",11,303,292,"AACACTTGGACAAATCGTCC","TCTGAATACGCTCTAGCAAC","561307.5.peg.1901","1004"
"9998",504,303,201,"GGACACGATGCAACGCAACT","TCTGAATACGCTCTAGCAAC","561307.5.peg.1901","1004"
"9999",78,303,225,"CGTTTCGGATACCCTACACC","TCTGAATACGCTCTAGCAAC","561307.5.peg.1901","1004"
"10000",680,303,377,"GCATACCCGCCTCGATTCTC","TCTGAATACGCTCTAGCAAC","561307.5.peg.1901","1004"
"10001",93,303,210,"TCTTGGTCTTCCCAACGTTT","TCTGAATACGCTCTAGCAAC","561307.5.peg.1901","1004"
"10002",110,303,193,"AACCACCTTTGTAGTGTTCT","TCTGAATACGCTCTAGCAAC","561307.5.peg.1901","1004"
"10003",477,303,174,"AAGCAATGTTCACATAAACG","TCTGAATACGCTCTAGCAAC","561307.5.peg.1901","1004"
"10004",575,303,272,"GCCATCCACGACATGCGTCT","TCTGAATACGCTCTAGCAAC","561307.5.peg.1901","1004"
"10005",702,303,399,"CAAGTTTCAGAGCATACCGT","TCTGAATACGCTCTAGCAAC","561307.5.peg.1901","1004"
"10006",525,303,222,"CGTTTATACATAGCACCTGA","TCTGAATACGCTCTAGCAAC","561307.5.peg.1901","1004"
"10007",702,360,342,"CAAGTTTCAGAGCATACCGT","GCTAAGTCATCTTCCCAGTT","561307.5.peg.1901","1004"
"10008",110,360,250,"AACCACCTTTGTAGTGTTCT","GCTAAGTCATCTTCCCAGTT","561307.5.peg.1901","1004"
"10009",11,360,349,"AACACTTGGACAAATCGTCC","GCTAAGTCATCTTCCCAGTT","561307.5.peg.1901","1004"
"10010",504,360,144,"GGACACGATGCAACGCAACT","GCTAAGTCATCTTCCCAGTT","561307.5.peg.1901","1004"
"10011",93,360,267,"TCTTGGTCTTCCCAACGTTT","GCTAAGTCATCTTCCCAGTT","561307.5.peg.1901","1004"
"10012",525,360,165,"CGTTTATACATAGCACCTGA","GCTAAGTCATCTTCCCAGTT","561307.5.peg.1901","1004"
"10013",78,360,282,"CGTTTCGGATACCCTACACC","GCTAAGTCATCTTCCCAGTT","561307.5.peg.1901","1004"
"10014",477,360,117,"AAGCAATGTTCACATAAACG","GCTAAGTCATCTTCCCAGTT","561307.5.peg.1901","1004"
"10015",680,360,320,"GCATACCCGCCTCGATTCTC","GCTAAGTCATCTTCCCAGTT","561307.5.peg.1901","1004"
"10016",575,360,215,"GCCATCCACGACATGCGTCT","GCTAAGTCATCTTCCCAGTT","561307.5.peg.1901","1004"
"10017",360,477,117,"GCTAAGTCATCTTCCCAGTT","AAGCAATGTTCACATAAACG","561307.5.peg.1901","1004"
"10018",110,477,367,"AACCACCTTTGTAGTGTTCT","AAGCAATGTTCACATAAACG","561307.5.peg.1901","1004"
"10019",680,477,203,"GCATACCCGCCTCGATTCTC","AAGCAATGTTCACATAAACG","561307.5.peg.1901","1004"
"10020",11,477,466,"AACACTTGGACAAATCGTCC","AAGCAATGTTCACATAAACG","561307.5.peg.1901","1004"
"10021",78,477,399,"CGTTTCGGATACCCTACACC","AAGCAATGTTCACATAAACG","561307.5.peg.1901","1004"
"10022",702,477,225,"CAAGTTTCAGAGCATACCGT","AAGCAATGTTCACATAAACG","561307.5.peg.1901","1004"
"10023",93,477,384,"TCTTGGTCTTCCCAACGTTT","AAGCAATGTTCACATAAACG","561307.5.peg.1901","1004"
"10024",303,477,174,"TCTGAATACGCTCTAGCAAC","AAGCAATGTTCACATAAACG","561307.5.peg.1901","1004"
"10025",110,504,394,"AACCACCTTTGTAGTGTTCT","GGACACGATGCAACGCAACT","561307.5.peg.1901","1004"
"10026",360,504,144,"GCTAAGTCATCTTCCCAGTT","GGACACGATGCAACGCAACT","561307.5.peg.1901","1004"
"10027",93,504,411,"TCTTGGTCTTCCCAACGTTT","GGACACGATGCAACGCAACT","561307.5.peg.1901","1004"
"10028",680,504,176,"GCATACCCGCCTCGATTCTC","GGACACGATGCAACGCAACT","561307.5.peg.1901","1004"
"10029",702,504,198,"CAAGTTTCAGAGCATACCGT","GGACACGATGCAACGCAACT","561307.5.peg.1901","1004"
"10030",78,504,426,"CGTTTCGGATACCCTACACC","GGACACGATGCAACGCAACT","561307.5.peg.1901","1004"
"10031",11,504,493,"AACACTTGGACAAATCGTCC","GGACACGATGCAACGCAACT","561307.5.peg.1901","1004"
"10032",303,504,201,"TCTGAATACGCTCTAGCAAC","GGACACGATGCAACGCAACT","561307.5.peg.1901","1004"
"10033",93,525,432,"TCTTGGTCTTCCCAACGTTT","CGTTTATACATAGCACCTGA","561307.5.peg.1901","1004"
"10034",702,525,177,"CAAGTTTCAGAGCATACCGT","CGTTTATACATAGCACCTGA","561307.5.peg.1901","1004"
"10035",78,525,447,"CGTTTCGGATACCCTACACC","CGTTTATACATAGCACCTGA","561307.5.peg.1901","1004"
"10036",110,525,415,"AACCACCTTTGTAGTGTTCT","CGTTTATACATAGCACCTGA","561307.5.peg.1901","1004"
"10037",11,525,514,"AACACTTGGACAAATCGTCC","CGTTTATACATAGCACCTGA","561307.5.peg.1901","1004"
"10038",360,525,165,"GCTAAGTCATCTTCCCAGTT","CGTTTATACATAGCACCTGA","561307.5.peg.1901","1004"
"10039",303,525,222,"TCTGAATACGCTCTAGCAAC","CGTTTATACATAGCACCTGA","561307.5.peg.1901","1004"
"10040",680,525,155,"GCATACCCGCCTCGATTCTC","CGTTTATACATAGCACCTGA","561307.5.peg.1901","1004"
"10041",110,575,465,"AACCACCTTTGTAGTGTTCT","GCCATCCACGACATGCGTCT","561307.5.peg.1901","1004"
"10042",11,575,564,"AACACTTGGACAAATCGTCC","GCCATCCACGACATGCGTCT","561307.5.peg.1901","1004"
"10043",303,575,272,"TCTGAATACGCTCTAGCAAC","GCCATCCACGACATGCGTCT","561307.5.peg.1901","1004"
"10044",360,575,215,"GCTAAGTCATCTTCCCAGTT","GCCATCCACGACATGCGTCT","561307.5.peg.1901","1004"
"10045",93,575,482,"TCTTGGTCTTCCCAACGTTT","GCCATCCACGACATGCGTCT","561307.5.peg.1901","1004"
"10046",680,575,105,"GCATACCCGCCTCGATTCTC","GCCATCCACGACATGCGTCT","561307.5.peg.1901","1004"
"10047",702,575,127,"CAAGTTTCAGAGCATACCGT","GCCATCCACGACATGCGTCT","561307.5.peg.1901","1004"
"10048",78,575,497,"CGTTTCGGATACCCTACACC","GCCATCCACGACATGCGTCT","561307.5.peg.1901","1004"
"10049",360,680,320,"GCTAAGTCATCTTCCCAGTT","GCATACCCGCCTCGATTCTC","561307.5.peg.1901","1004"
"10050",93,680,587,"TCTTGGTCTTCCCAACGTTT","GCATACCCGCCTCGATTCTC","561307.5.peg.1901","1004"
"10051",110,680,570,"AACCACCTTTGTAGTGTTCT","GCATACCCGCCTCGATTCTC","561307.5.peg.1901","1004"
"10052",575,680,105,"GCCATCCACGACATGCGTCT","GCATACCCGCCTCGATTCTC","561307.5.peg.1901","1004"
"10053",303,680,377,"TCTGAATACGCTCTAGCAAC","GCATACCCGCCTCGATTCTC","561307.5.peg.1901","1004"
"10054",525,680,155,"CGTTTATACATAGCACCTGA","GCATACCCGCCTCGATTCTC","561307.5.peg.1901","1004"
"10055",504,680,176,"GGACACGATGCAACGCAACT","GCATACCCGCCTCGATTCTC","561307.5.peg.1901","1004"
"10056",11,680,669,"AACACTTGGACAAATCGTCC","GCATACCCGCCTCGATTCTC","561307.5.peg.1901","1004"
"10057",78,680,602,"CGTTTCGGATACCCTACACC","GCATACCCGCCTCGATTCTC","561307.5.peg.1901","1004"
"10058",477,680,203,"AAGCAATGTTCACATAAACG","GCATACCCGCCTCGATTCTC","561307.5.peg.1901","1004"
"10059",93,702,609,"TCTTGGTCTTCCCAACGTTT","CAAGTTTCAGAGCATACCGT","561307.5.peg.1901","1004"
"10060",110,702,592,"AACCACCTTTGTAGTGTTCT","CAAGTTTCAGAGCATACCGT","561307.5.peg.1901","1004"
"10061",303,702,399,"TCTGAATACGCTCTAGCAAC","CAAGTTTCAGAGCATACCGT","561307.5.peg.1901","1004"
"10062",360,702,342,"GCTAAGTCATCTTCCCAGTT","CAAGTTTCAGAGCATACCGT","561307.5.peg.1901","1004"
"10063",11,702,691,"AACACTTGGACAAATCGTCC","CAAGTTTCAGAGCATACCGT","561307.5.peg.1901","1004"
"10064",575,702,127,"GCCATCCACGACATGCGTCT","CAAGTTTCAGAGCATACCGT","561307.5.peg.1901","1004"
"10065",78,702,624,"CGTTTCGGATACCCTACACC","CAAGTTTCAGAGCATACCGT","561307.5.peg.1901","1004"
"10066",477,702,225,"AAGCAATGTTCACATAAACG","CAAGTTTCAGAGCATACCGT","561307.5.peg.1901","1004"
"10067",525,702,177,"CGTTTATACATAGCACCTGA","CAAGTTTCAGAGCATACCGT","561307.5.peg.1901","1004"
"10068",504,702,198,"GGACACGATGCAACGCAACT","CAAGTTTCAGAGCATACCGT","561307.5.peg.1901","1004"
"10069",1056,276,780,"TCATCCAGCATGATAAGAAA","GGCATATCCGGACCACAACT","561307.5.peg.1902","1005"
"10070",759,276,483,"TTATACCAGTCACTTGATTC","GGCATATCCGGACCACAACT","561307.5.peg.1902","1005"
"10071",1197,276,921,"CGTTGACCCATTGTGCCATT","GGCATATCCGGACCACAACT","561307.5.peg.1902","1005"
"10072",499,276,223,"CACGTGCCCTCCCATACCTC","GGCATATCCGGACCACAACT","561307.5.peg.1902","1005"
"10073",591,276,315,"GTAAATCCTGCGATTCGATC","GGCATATCCGGACCACAACT","561307.5.peg.1902","1005"
"10074",1764,276,1488,"ACAGTACTCCATCCTTCAAT","GGCATATCCGGACCACAACT","561307.5.peg.1902","1005"
"10075",724,276,448,"CTCTCCCCAAATTTGTGGAG","GGCATATCCGGACCACAACT","561307.5.peg.1902","1005"
"10076",481,276,205,"TCGGGCTTGCTTATATTGTT","GGCATATCCGGACCACAACT","561307.5.peg.1902","1005"
"10077",1331,276,1055,"CTCCATCACTATCAAAGTAT","GGCATATCCGGACCACAACT","561307.5.peg.1902","1005"
"10078",1859,276,1583,"TGACTCTTCATATTTCCAT","GGCATATCCGGACCACAACT","561307.5.peg.1902","1005"
"10079",717,276,441,"CAAATTTGTGGAGAGGCAGG","GGCATATCCGGACCACAACT","561307.5.peg.1902","1005"
"10080",615,276,339,"ATCATTGACATCGCTGGAAT","GGCATATCCGGACCACAACT","561307.5.peg.1902","1005"
"10081",1521,276,1245,"GAAATGGCTTCTTGCCAAGC","GGCATATCCGGACCACAACT","561307.5.peg.1902","1005"
"10082",1371,276,1095,"GTGACTTGTCGAGTTGGAAT","GGCATATCCGGACCACAACT","561307.5.peg.1902","1005"
"10083",729,276,453,"GTTTGCTCTCCCCAAATTTG","GGCATATCCGGACCACAACT","561307.5.peg.1902","1005"
"10084",1377,276,1101,"GCTAAAGTGACTTGTCGAGT","GGCATATCCGGACCACAACT","561307.5.peg.1902","1005"
"10085",816,276,540,"GCATCCGGAGTACGTGTTAA","GGCATATCCGGACCACAACT","561307.5.peg.1902","1005"
"10086",1646,276,1370,"TCGTATCTGAGTTAAACCAA","GGCATATCCGGACCACAACT","561307.5.peg.1902","1005"
"10087",720,276,444,"CCCCAAATTTGTGGAGAGGC","GGCATATCCGGACCACAACT","561307.5.peg.1902","1005"
"10088",1158,276,882,"CTGATTGCATCATGAATAAC","GGCATATCCGGACCACAACT","561307.5.peg.1902","1005"
"10089",729,288,441,"GTTTGCTCTCCCCAAATTTG","GGTTCATATTCAGGCATATC","561307.5.peg.1902","1005"
"10090",499,288,211,"CACGTGCCCTCCCATACCTC","GGTTCATATTCAGGCATATC","561307.5.peg.1902","1005"
"10091",1371,288,1083,"GTGACTTGTCGAGTTGGAAT","GGTTCATATTCAGGCATATC","561307.5.peg.1902","1005"
"10092",591,288,303,"GTAAATCCTGCGATTCGATC","GGTTCATATTCAGGCATATC","561307.5.peg.1902","1005"
"10093",615,288,327,"ATCATTGACATCGCTGGAAT","GGTTCATATTCAGGCATATC","561307.5.peg.1902","1005"
"10094",1056,288,768,"TCATCCAGCATGATAAGAAA","GGTTCATATTCAGGCATATC","561307.5.peg.1902","1005"
"10095",1764,288,1476,"ACAGTACTCCATCCTTCAAT","GGTTCATATTCAGGCATATC","561307.5.peg.1902","1005"
"10096",720,288,432,"CCCCAAATTTGTGGAGAGGC","GGTTCATATTCAGGCATATC","561307.5.peg.1902","1005"
"10097",1521,288,1233,"GAAATGGCTTCTTGCCAAGC","GGTTCATATTCAGGCATATC","561307.5.peg.1902","1005"
"10098",1197,288,909,"CGTTGACCCATTGTGCCATT","GGTTCATATTCAGGCATATC","561307.5.peg.1902","1005"
"10099",759,288,471,"TTATACCAGTCACTTGATTC","GGTTCATATTCAGGCATATC","561307.5.peg.1902","1005"
"10100",724,288,436,"CTCTCCCCAAATTTGTGGAG","GGTTCATATTCAGGCATATC","561307.5.peg.1902","1005"
"10101",1331,288,1043,"CTCCATCACTATCAAAGTAT","GGTTCATATTCAGGCATATC","561307.5.peg.1902","1005"
"10102",1646,288,1358,"TCGTATCTGAGTTAAACCAA","GGTTCATATTCAGGCATATC","561307.5.peg.1902","1005"
"10103",1377,288,1089,"GCTAAAGTGACTTGTCGAGT","GGTTCATATTCAGGCATATC","561307.5.peg.1902","1005"
"10104",717,288,429,"CAAATTTGTGGAGAGGCAGG","GGTTCATATTCAGGCATATC","561307.5.peg.1902","1005"
"10105",481,288,193,"TCGGGCTTGCTTATATTGTT","GGTTCATATTCAGGCATATC","561307.5.peg.1902","1005"
"10106",1158,288,870,"CTGATTGCATCATGAATAAC","GGTTCATATTCAGGCATATC","561307.5.peg.1902","1005"
"10107",1859,288,1571,"TGACTCTTCATATTTCCAT","GGTTCATATTCAGGCATATC","561307.5.peg.1902","1005"
"10108",816,288,528,"GCATCCGGAGTACGTGTTAA","GGTTCATATTCAGGCATATC","561307.5.peg.1902","1005"
"10109",1764,297,1467,"ACAGTACTCCATCCTTCAAT","CATCCTCTCGGTTCATATTC","561307.5.peg.1902","1005"
"10110",724,297,427,"CTCTCCCCAAATTTGTGGAG","CATCCTCTCGGTTCATATTC","561307.5.peg.1902","1005"
"10111",1056,297,759,"TCATCCAGCATGATAAGAAA","CATCCTCTCGGTTCATATTC","561307.5.peg.1902","1005"
"10112",1371,297,1074,"GTGACTTGTCGAGTTGGAAT","CATCCTCTCGGTTCATATTC","561307.5.peg.1902","1005"
"10113",816,297,519,"GCATCCGGAGTACGTGTTAA","CATCCTCTCGGTTCATATTC","561307.5.peg.1902","1005"
"10114",720,297,423,"CCCCAAATTTGTGGAGAGGC","CATCCTCTCGGTTCATATTC","561307.5.peg.1902","1005"
"10115",1646,297,1349,"TCGTATCTGAGTTAAACCAA","CATCCTCTCGGTTCATATTC","561307.5.peg.1902","1005"
"10116",499,297,202,"CACGTGCCCTCCCATACCTC","CATCCTCTCGGTTCATATTC","561307.5.peg.1902","1005"
"10117",1158,297,861,"CTGATTGCATCATGAATAAC","CATCCTCTCGGTTCATATTC","561307.5.peg.1902","1005"
"10118",1859,297,1562,"TGACTCTTCATATTTCCAT","CATCCTCTCGGTTCATATTC","561307.5.peg.1902","1005"
"10119",481,297,184,"TCGGGCTTGCTTATATTGTT","CATCCTCTCGGTTCATATTC","561307.5.peg.1902","1005"
"10120",759,297,462,"TTATACCAGTCACTTGATTC","CATCCTCTCGGTTCATATTC","561307.5.peg.1902","1005"
"10121",1331,297,1034,"CTCCATCACTATCAAAGTAT","CATCCTCTCGGTTCATATTC","561307.5.peg.1902","1005"
"10122",1197,297,900,"CGTTGACCCATTGTGCCATT","CATCCTCTCGGTTCATATTC","561307.5.peg.1902","1005"
"10123",729,297,432,"GTTTGCTCTCCCCAAATTTG","CATCCTCTCGGTTCATATTC","561307.5.peg.1902","1005"
"10124",615,297,318,"ATCATTGACATCGCTGGAAT","CATCCTCTCGGTTCATATTC","561307.5.peg.1902","1005"
"10125",1521,297,1224,"GAAATGGCTTCTTGCCAAGC","CATCCTCTCGGTTCATATTC","561307.5.peg.1902","1005"
"10126",1377,297,1080,"GCTAAAGTGACTTGTCGAGT","CATCCTCTCGGTTCATATTC","561307.5.peg.1902","1005"
"10127",591,297,294,"GTAAATCCTGCGATTCGATC","CATCCTCTCGGTTCATATTC","561307.5.peg.1902","1005"
"10128",717,297,420,"CAAATTTGTGGAGAGGCAGG","CATCCTCTCGGTTCATATTC","561307.5.peg.1902","1005"
"10129",724,309,415,"CTCTCCCCAAATTTGTGGAG","GCACCTCGTGGACATCCTCT","561307.5.peg.1902","1005"
"10130",1764,309,1455,"ACAGTACTCCATCCTTCAAT","GCACCTCGTGGACATCCTCT","561307.5.peg.1902","1005"
"10131",591,309,282,"GTAAATCCTGCGATTCGATC","GCACCTCGTGGACATCCTCT","561307.5.peg.1902","1005"
"10132",1521,309,1212,"GAAATGGCTTCTTGCCAAGC","GCACCTCGTGGACATCCTCT","561307.5.peg.1902","1005"
"10133",717,309,408,"CAAATTTGTGGAGAGGCAGG","GCACCTCGTGGACATCCTCT","561307.5.peg.1902","1005"
"10134",1158,309,849,"CTGATTGCATCATGAATAAC","GCACCTCGTGGACATCCTCT","561307.5.peg.1902","1005"
"10135",729,309,420,"GTTTGCTCTCCCCAAATTTG","GCACCTCGTGGACATCCTCT","561307.5.peg.1902","1005"
"10136",481,309,172,"TCGGGCTTGCTTATATTGTT","GCACCTCGTGGACATCCTCT","561307.5.peg.1902","1005"
"10137",1197,309,888,"CGTTGACCCATTGTGCCATT","GCACCTCGTGGACATCCTCT","561307.5.peg.1902","1005"
"10138",1859,309,1550,"TGACTCTTCATATTTCCAT","GCACCTCGTGGACATCCTCT","561307.5.peg.1902","1005"
"10139",1377,309,1068,"GCTAAAGTGACTTGTCGAGT","GCACCTCGTGGACATCCTCT","561307.5.peg.1902","1005"
"10140",720,309,411,"CCCCAAATTTGTGGAGAGGC","GCACCTCGTGGACATCCTCT","561307.5.peg.1902","1005"
"10141",1371,309,1062,"GTGACTTGTCGAGTTGGAAT","GCACCTCGTGGACATCCTCT","561307.5.peg.1902","1005"
"10142",1331,309,1022,"CTCCATCACTATCAAAGTAT","GCACCTCGTGGACATCCTCT","561307.5.peg.1902","1005"
"10143",1646,309,1337,"TCGTATCTGAGTTAAACCAA","GCACCTCGTGGACATCCTCT","561307.5.peg.1902","1005"
"10144",499,309,190,"CACGTGCCCTCCCATACCTC","GCACCTCGTGGACATCCTCT","561307.5.peg.1902","1005"
"10145",759,309,450,"TTATACCAGTCACTTGATTC","GCACCTCGTGGACATCCTCT","561307.5.peg.1902","1005"
"10146",816,309,507,"GCATCCGGAGTACGTGTTAA","GCACCTCGTGGACATCCTCT","561307.5.peg.1902","1005"
"10147",615,309,306,"ATCATTGACATCGCTGGAAT","GCACCTCGTGGACATCCTCT","561307.5.peg.1902","1005"
"10148",1056,309,747,"TCATCCAGCATGATAAGAAA","GCACCTCGTGGACATCCTCT","561307.5.peg.1902","1005"
"10149",724,321,403,"CTCTCCCCAAATTTGTGGAG","CAAGAGAATGACGCACCTCG","561307.5.peg.1902","1005"
"10150",1764,321,1443,"ACAGTACTCCATCCTTCAAT","CAAGAGAATGACGCACCTCG","561307.5.peg.1902","1005"
"10151",1521,321,1200,"GAAATGGCTTCTTGCCAAGC","CAAGAGAATGACGCACCTCG","561307.5.peg.1902","1005"
"10152",1377,321,1056,"GCTAAAGTGACTTGTCGAGT","CAAGAGAATGACGCACCTCG","561307.5.peg.1902","1005"
"10153",759,321,438,"TTATACCAGTCACTTGATTC","CAAGAGAATGACGCACCTCG","561307.5.peg.1902","1005"
"10154",720,321,399,"CCCCAAATTTGTGGAGAGGC","CAAGAGAATGACGCACCTCG","561307.5.peg.1902","1005"
"10155",1371,321,1050,"GTGACTTGTCGAGTTGGAAT","CAAGAGAATGACGCACCTCG","561307.5.peg.1902","1005"
"10156",1056,321,735,"TCATCCAGCATGATAAGAAA","CAAGAGAATGACGCACCTCG","561307.5.peg.1902","1005"
"10157",591,321,270,"GTAAATCCTGCGATTCGATC","CAAGAGAATGACGCACCTCG","561307.5.peg.1902","1005"
"10158",1331,321,1010,"CTCCATCACTATCAAAGTAT","CAAGAGAATGACGCACCTCG","561307.5.peg.1902","1005"
"10159",615,321,294,"ATCATTGACATCGCTGGAAT","CAAGAGAATGACGCACCTCG","561307.5.peg.1902","1005"
"10160",1158,321,837,"CTGATTGCATCATGAATAAC","CAAGAGAATGACGCACCTCG","561307.5.peg.1902","1005"
"10161",1197,321,876,"CGTTGACCCATTGTGCCATT","CAAGAGAATGACGCACCTCG","561307.5.peg.1902","1005"
"10162",717,321,396,"CAAATTTGTGGAGAGGCAGG","CAAGAGAATGACGCACCTCG","561307.5.peg.1902","1005"
"10163",499,321,178,"CACGTGCCCTCCCATACCTC","CAAGAGAATGACGCACCTCG","561307.5.peg.1902","1005"
"10164",1859,321,1538,"TGACTCTTCATATTTCCAT","CAAGAGAATGACGCACCTCG","561307.5.peg.1902","1005"
"10165",1646,321,1325,"TCGTATCTGAGTTAAACCAA","CAAGAGAATGACGCACCTCG","561307.5.peg.1902","1005"
"10166",816,321,495,"GCATCCGGAGTACGTGTTAA","CAAGAGAATGACGCACCTCG","561307.5.peg.1902","1005"
"10167",729,321,408,"GTTTGCTCTCCCCAAATTTG","CAAGAGAATGACGCACCTCG","561307.5.peg.1902","1005"
"10168",481,321,160,"TCGGGCTTGCTTATATTGTT","CAAGAGAATGACGCACCTCG","561307.5.peg.1902","1005"
"10169",1331,357,974,"CTCCATCACTATCAAAGTAT","TATGGATATTTGATTCGAAG","561307.5.peg.1902","1005"
"10170",1371,357,1014,"GTGACTTGTCGAGTTGGAAT","TATGGATATTTGATTCGAAG","561307.5.peg.1902","1005"
"10171",1158,357,801,"CTGATTGCATCATGAATAAC","TATGGATATTTGATTCGAAG","561307.5.peg.1902","1005"
"10172",1764,357,1407,"ACAGTACTCCATCCTTCAAT","TATGGATATTTGATTCGAAG","561307.5.peg.1902","1005"
"10173",1377,357,1020,"GCTAAAGTGACTTGTCGAGT","TATGGATATTTGATTCGAAG","561307.5.peg.1902","1005"
"10174",499,357,142,"CACGTGCCCTCCCATACCTC","TATGGATATTTGATTCGAAG","561307.5.peg.1902","1005"
"10175",717,357,360,"CAAATTTGTGGAGAGGCAGG","TATGGATATTTGATTCGAAG","561307.5.peg.1902","1005"
"10176",1521,357,1164,"GAAATGGCTTCTTGCCAAGC","TATGGATATTTGATTCGAAG","561307.5.peg.1902","1005"
"10177",724,357,367,"CTCTCCCCAAATTTGTGGAG","TATGGATATTTGATTCGAAG","561307.5.peg.1902","1005"
"10178",759,357,402,"TTATACCAGTCACTTGATTC","TATGGATATTTGATTCGAAG","561307.5.peg.1902","1005"
"10179",1859,357,1502,"TGACTCTTCATATTTCCAT","TATGGATATTTGATTCGAAG","561307.5.peg.1902","1005"
"10180",720,357,363,"CCCCAAATTTGTGGAGAGGC","TATGGATATTTGATTCGAAG","561307.5.peg.1902","1005"
"10181",481,357,124,"TCGGGCTTGCTTATATTGTT","TATGGATATTTGATTCGAAG","561307.5.peg.1902","1005"
"10182",1197,357,840,"CGTTGACCCATTGTGCCATT","TATGGATATTTGATTCGAAG","561307.5.peg.1902","1005"
"10183",729,357,372,"GTTTGCTCTCCCCAAATTTG","TATGGATATTTGATTCGAAG","561307.5.peg.1902","1005"
"10184",1056,357,699,"TCATCCAGCATGATAAGAAA","TATGGATATTTGATTCGAAG","561307.5.peg.1902","1005"
"10185",1646,357,1289,"TCGTATCTGAGTTAAACCAA","TATGGATATTTGATTCGAAG","561307.5.peg.1902","1005"
"10186",591,357,234,"GTAAATCCTGCGATTCGATC","TATGGATATTTGATTCGAAG","561307.5.peg.1902","1005"
"10187",615,357,258,"ATCATTGACATCGCTGGAAT","TATGGATATTTGATTCGAAG","561307.5.peg.1902","1005"
"10188",816,357,459,"GCATCCGGAGTACGTGTTAA","TATGGATATTTGATTCGAAG","561307.5.peg.1902","1005"
"10189",1056,481,575,"TCATCCAGCATGATAAGAAA","TCGGGCTTGCTTATATTGTT","561307.5.peg.1902","1005"
"10190",1521,481,1040,"GAAATGGCTTCTTGCCAAGC","TCGGGCTTGCTTATATTGTT","561307.5.peg.1902","1005"
"10191",729,481,248,"GTTTGCTCTCCCCAAATTTG","TCGGGCTTGCTTATATTGTT","561307.5.peg.1902","1005"
"10192",1764,481,1283,"ACAGTACTCCATCCTTCAAT","TCGGGCTTGCTTATATTGTT","561307.5.peg.1902","1005"
"10193",1646,481,1165,"TCGTATCTGAGTTAAACCAA","TCGGGCTTGCTTATATTGTT","561307.5.peg.1902","1005"
"10194",321,481,160,"CAAGAGAATGACGCACCTCG","TCGGGCTTGCTTATATTGTT","561307.5.peg.1902","1005"
"10195",357,481,124,"TATGGATATTTGATTCGAAG","TCGGGCTTGCTTATATTGTT","561307.5.peg.1902","1005"
"10196",1331,481,850,"CTCCATCACTATCAAAGTAT","TCGGGCTTGCTTATATTGTT","561307.5.peg.1902","1005"
"10197",1377,481,896,"GCTAAAGTGACTTGTCGAGT","TCGGGCTTGCTTATATTGTT","561307.5.peg.1902","1005"
"10198",720,481,239,"CCCCAAATTTGTGGAGAGGC","TCGGGCTTGCTTATATTGTT","561307.5.peg.1902","1005"
"10199",276,481,205,"GGCATATCCGGACCACAACT","TCGGGCTTGCTTATATTGTT","561307.5.peg.1902","1005"
"10200",1197,481,716,"CGTTGACCCATTGTGCCATT","TCGGGCTTGCTTATATTGTT","561307.5.peg.1902","1005"
"10201",309,481,172,"GCACCTCGTGGACATCCTCT","TCGGGCTTGCTTATATTGTT","561307.5.peg.1902","1005"
"10202",288,481,193,"GGTTCATATTCAGGCATATC","TCGGGCTTGCTTATATTGTT","561307.5.peg.1902","1005"
"10203",591,481,110,"GTAAATCCTGCGATTCGATC","TCGGGCTTGCTTATATTGTT","561307.5.peg.1902","1005"
"10204",717,481,236,"CAAATTTGTGGAGAGGCAGG","TCGGGCTTGCTTATATTGTT","561307.5.peg.1902","1005"
"10205",297,481,184,"CATCCTCTCGGTTCATATTC","TCGGGCTTGCTTATATTGTT","561307.5.peg.1902","1005"
"10206",816,481,335,"GCATCCGGAGTACGTGTTAA","TCGGGCTTGCTTATATTGTT","561307.5.peg.1902","1005"
"10207",1859,481,1378,"TGACTCTTCATATTTCCAT","TCGGGCTTGCTTATATTGTT","561307.5.peg.1902","1005"
"10208",759,481,278,"TTATACCAGTCACTTGATTC","TCGGGCTTGCTTATATTGTT","561307.5.peg.1902","1005"
"10209",1371,481,890,"GTGACTTGTCGAGTTGGAAT","TCGGGCTTGCTTATATTGTT","561307.5.peg.1902","1005"
"10210",1158,481,677,"CTGATTGCATCATGAATAAC","TCGGGCTTGCTTATATTGTT","561307.5.peg.1902","1005"
"10211",724,481,243,"CTCTCCCCAAATTTGTGGAG","TCGGGCTTGCTTATATTGTT","561307.5.peg.1902","1005"
"10212",615,481,134,"ATCATTGACATCGCTGGAAT","TCGGGCTTGCTTATATTGTT","561307.5.peg.1902","1005"
"10213",1521,499,1022,"GAAATGGCTTCTTGCCAAGC","CACGTGCCCTCCCATACCTC","561307.5.peg.1902","1005"
"10214",1646,499,1147,"TCGTATCTGAGTTAAACCAA","CACGTGCCCTCCCATACCTC","561307.5.peg.1902","1005"
"10215",297,499,202,"CATCCTCTCGGTTCATATTC","CACGTGCCCTCCCATACCTC","561307.5.peg.1902","1005"
"10216",717,499,218,"CAAATTTGTGGAGAGGCAGG","CACGTGCCCTCCCATACCTC","561307.5.peg.1902","1005"
"10217",759,499,260,"TTATACCAGTCACTTGATTC","CACGTGCCCTCCCATACCTC","561307.5.peg.1902","1005"
"10218",276,499,223,"GGCATATCCGGACCACAACT","CACGTGCCCTCCCATACCTC","561307.5.peg.1902","1005"
"10219",816,499,317,"GCATCCGGAGTACGTGTTAA","CACGTGCCCTCCCATACCTC","561307.5.peg.1902","1005"
"10220",615,499,116,"ATCATTGACATCGCTGGAAT","CACGTGCCCTCCCATACCTC","561307.5.peg.1902","1005"
"10221",1331,499,832,"CTCCATCACTATCAAAGTAT","CACGTGCCCTCCCATACCTC","561307.5.peg.1902","1005"
"10222",724,499,225,"CTCTCCCCAAATTTGTGGAG","CACGTGCCCTCCCATACCTC","561307.5.peg.1902","1005"
"10223",1056,499,557,"TCATCCAGCATGATAAGAAA","CACGTGCCCTCCCATACCTC","561307.5.peg.1902","1005"
"10224",321,499,178,"CAAGAGAATGACGCACCTCG","CACGTGCCCTCCCATACCTC","561307.5.peg.1902","1005"
"10225",1371,499,872,"GTGACTTGTCGAGTTGGAAT","CACGTGCCCTCCCATACCTC","561307.5.peg.1902","1005"
"10226",1377,499,878,"GCTAAAGTGACTTGTCGAGT","CACGTGCCCTCCCATACCTC","561307.5.peg.1902","1005"
"10227",288,499,211,"GGTTCATATTCAGGCATATC","CACGTGCCCTCCCATACCTC","561307.5.peg.1902","1005"
"10228",1158,499,659,"CTGATTGCATCATGAATAAC","CACGTGCCCTCCCATACCTC","561307.5.peg.1902","1005"
"10229",1197,499,698,"CGTTGACCCATTGTGCCATT","CACGTGCCCTCCCATACCTC","561307.5.peg.1902","1005"
"10230",1764,499,1265,"ACAGTACTCCATCCTTCAAT","CACGTGCCCTCCCATACCTC","561307.5.peg.1902","1005"
"10231",309,499,190,"GCACCTCGTGGACATCCTCT","CACGTGCCCTCCCATACCTC","561307.5.peg.1902","1005"
"10232",357,499,142,"TATGGATATTTGATTCGAAG","CACGTGCCCTCCCATACCTC","561307.5.peg.1902","1005"
"10233",729,499,230,"GTTTGCTCTCCCCAAATTTG","CACGTGCCCTCCCATACCTC","561307.5.peg.1902","1005"
"10234",1859,499,1360,"TGACTCTTCATATTTCCAT","CACGTGCCCTCCCATACCTC","561307.5.peg.1902","1005"
"10235",720,499,221,"CCCCAAATTTGTGGAGAGGC","CACGTGCCCTCCCATACCTC","561307.5.peg.1902","1005"
"10236",1197,591,606,"CGTTGACCCATTGTGCCATT","GTAAATCCTGCGATTCGATC","561307.5.peg.1902","1005"
"10237",1646,591,1055,"TCGTATCTGAGTTAAACCAA","GTAAATCCTGCGATTCGATC","561307.5.peg.1902","1005"
"10238",321,591,270,"CAAGAGAATGACGCACCTCG","GTAAATCCTGCGATTCGATC","561307.5.peg.1902","1005"
"10239",357,591,234,"TATGGATATTTGATTCGAAG","GTAAATCCTGCGATTCGATC","561307.5.peg.1902","1005"
"10240",1859,591,1268,"TGACTCTTCATATTTCCAT","GTAAATCCTGCGATTCGATC","561307.5.peg.1902","1005"
"10241",1521,591,930,"GAAATGGCTTCTTGCCAAGC","GTAAATCCTGCGATTCGATC","561307.5.peg.1902","1005"
"10242",1331,591,740,"CTCCATCACTATCAAAGTAT","GTAAATCCTGCGATTCGATC","561307.5.peg.1902","1005"
"10243",276,591,315,"GGCATATCCGGACCACAACT","GTAAATCCTGCGATTCGATC","561307.5.peg.1902","1005"
"10244",1377,591,786,"GCTAAAGTGACTTGTCGAGT","GTAAATCCTGCGATTCGATC","561307.5.peg.1902","1005"
"10245",724,591,133,"CTCTCCCCAAATTTGTGGAG","GTAAATCCTGCGATTCGATC","561307.5.peg.1902","1005"
"10246",288,591,303,"GGTTCATATTCAGGCATATC","GTAAATCCTGCGATTCGATC","561307.5.peg.1902","1005"
"10247",720,591,129,"CCCCAAATTTGTGGAGAGGC","GTAAATCCTGCGATTCGATC","561307.5.peg.1902","1005"
"10248",1056,591,465,"TCATCCAGCATGATAAGAAA","GTAAATCCTGCGATTCGATC","561307.5.peg.1902","1005"
"10249",1371,591,780,"GTGACTTGTCGAGTTGGAAT","GTAAATCCTGCGATTCGATC","561307.5.peg.1902","1005"
"10250",1158,591,567,"CTGATTGCATCATGAATAAC","GTAAATCCTGCGATTCGATC","561307.5.peg.1902","1005"
"10251",759,591,168,"TTATACCAGTCACTTGATTC","GTAAATCCTGCGATTCGATC","561307.5.peg.1902","1005"
"10252",297,591,294,"CATCCTCTCGGTTCATATTC","GTAAATCCTGCGATTCGATC","561307.5.peg.1902","1005"
"10253",309,591,282,"GCACCTCGTGGACATCCTCT","GTAAATCCTGCGATTCGATC","561307.5.peg.1902","1005"
"10254",717,591,126,"CAAATTTGTGGAGAGGCAGG","GTAAATCCTGCGATTCGATC","561307.5.peg.1902","1005"
"10255",1764,591,1173,"ACAGTACTCCATCCTTCAAT","GTAAATCCTGCGATTCGATC","561307.5.peg.1902","1005"
"10256",481,591,110,"TCGGGCTTGCTTATATTGTT","GTAAATCCTGCGATTCGATC","561307.5.peg.1902","1005"
"10257",816,591,225,"GCATCCGGAGTACGTGTTAA","GTAAATCCTGCGATTCGATC","561307.5.peg.1902","1005"
"10258",729,591,138,"GTTTGCTCTCCCCAAATTTG","GTAAATCCTGCGATTCGATC","561307.5.peg.1902","1005"
"10259",717,615,102,"CAAATTTGTGGAGAGGCAGG","ATCATTGACATCGCTGGAAT","561307.5.peg.1902","1005"
"10260",1197,615,582,"CGTTGACCCATTGTGCCATT","ATCATTGACATCGCTGGAAT","561307.5.peg.1902","1005"
"10261",321,615,294,"CAAGAGAATGACGCACCTCG","ATCATTGACATCGCTGGAAT","561307.5.peg.1902","1005"
"10262",759,615,144,"TTATACCAGTCACTTGATTC","ATCATTGACATCGCTGGAAT","561307.5.peg.1902","1005"
"10263",297,615,318,"CATCCTCTCGGTTCATATTC","ATCATTGACATCGCTGGAAT","561307.5.peg.1902","1005"
"10264",1859,615,1244,"TGACTCTTCATATTTCCAT","ATCATTGACATCGCTGGAAT","561307.5.peg.1902","1005"
"10265",1764,615,1149,"ACAGTACTCCATCCTTCAAT","ATCATTGACATCGCTGGAAT","561307.5.peg.1902","1005"
"10266",1158,615,543,"CTGATTGCATCATGAATAAC","ATCATTGACATCGCTGGAAT","561307.5.peg.1902","1005"
"10267",724,615,109,"CTCTCCCCAAATTTGTGGAG","ATCATTGACATCGCTGGAAT","561307.5.peg.1902","1005"
"10268",288,615,327,"GGTTCATATTCAGGCATATC","ATCATTGACATCGCTGGAAT","561307.5.peg.1902","1005"
"10269",816,615,201,"GCATCCGGAGTACGTGTTAA","ATCATTGACATCGCTGGAAT","561307.5.peg.1902","1005"
"10270",1377,615,762,"GCTAAAGTGACTTGTCGAGT","ATCATTGACATCGCTGGAAT","561307.5.peg.1902","1005"
"10271",357,615,258,"TATGGATATTTGATTCGAAG","ATCATTGACATCGCTGGAAT","561307.5.peg.1902","1005"
"10272",1331,615,716,"CTCCATCACTATCAAAGTAT","ATCATTGACATCGCTGGAAT","561307.5.peg.1902","1005"
"10273",729,615,114,"GTTTGCTCTCCCCAAATTTG","ATCATTGACATCGCTGGAAT","561307.5.peg.1902","1005"
"10274",1521,615,906,"GAAATGGCTTCTTGCCAAGC","ATCATTGACATCGCTGGAAT","561307.5.peg.1902","1005"
"10275",481,615,134,"TCGGGCTTGCTTATATTGTT","ATCATTGACATCGCTGGAAT","561307.5.peg.1902","1005"
"10276",276,615,339,"GGCATATCCGGACCACAACT","ATCATTGACATCGCTGGAAT","561307.5.peg.1902","1005"
"10277",309,615,306,"GCACCTCGTGGACATCCTCT","ATCATTGACATCGCTGGAAT","561307.5.peg.1902","1005"
"10278",499,615,116,"CACGTGCCCTCCCATACCTC","ATCATTGACATCGCTGGAAT","561307.5.peg.1902","1005"
"10279",1056,615,441,"TCATCCAGCATGATAAGAAA","ATCATTGACATCGCTGGAAT","561307.5.peg.1902","1005"
"10280",720,615,105,"CCCCAAATTTGTGGAGAGGC","ATCATTGACATCGCTGGAAT","561307.5.peg.1902","1005"
"10281",1646,615,1031,"TCGTATCTGAGTTAAACCAA","ATCATTGACATCGCTGGAAT","561307.5.peg.1902","1005"
"10282",1371,615,756,"GTGACTTGTCGAGTTGGAAT","ATCATTGACATCGCTGGAAT","561307.5.peg.1902","1005"
"10283",1371,717,654,"GTGACTTGTCGAGTTGGAAT","CAAATTTGTGGAGAGGCAGG","561307.5.peg.1902","1005"
"10284",481,717,236,"TCGGGCTTGCTTATATTGTT","CAAATTTGTGGAGAGGCAGG","561307.5.peg.1902","1005"
"10285",1377,717,660,"GCTAAAGTGACTTGTCGAGT","CAAATTTGTGGAGAGGCAGG","561307.5.peg.1902","1005"
"10286",1056,717,339,"TCATCCAGCATGATAAGAAA","CAAATTTGTGGAGAGGCAGG","561307.5.peg.1902","1005"
"10287",321,717,396,"CAAGAGAATGACGCACCTCG","CAAATTTGTGGAGAGGCAGG","561307.5.peg.1902","1005"
"10288",615,717,102,"ATCATTGACATCGCTGGAAT","CAAATTTGTGGAGAGGCAGG","561307.5.peg.1902","1005"
"10289",357,717,360,"TATGGATATTTGATTCGAAG","CAAATTTGTGGAGAGGCAGG","561307.5.peg.1902","1005"
"10290",499,717,218,"CACGTGCCCTCCCATACCTC","CAAATTTGTGGAGAGGCAGG","561307.5.peg.1902","1005"
"10291",1197,717,480,"CGTTGACCCATTGTGCCATT","CAAATTTGTGGAGAGGCAGG","561307.5.peg.1902","1005"
"10292",297,717,420,"CATCCTCTCGGTTCATATTC","CAAATTTGTGGAGAGGCAGG","561307.5.peg.1902","1005"
"10293",309,717,408,"GCACCTCGTGGACATCCTCT","CAAATTTGTGGAGAGGCAGG","561307.5.peg.1902","1005"
"10294",288,717,429,"GGTTCATATTCAGGCATATC","CAAATTTGTGGAGAGGCAGG","561307.5.peg.1902","1005"
"10295",1859,717,1142,"TGACTCTTCATATTTCCAT","CAAATTTGTGGAGAGGCAGG","561307.5.peg.1902","1005"
"10296",1646,717,929,"TCGTATCTGAGTTAAACCAA","CAAATTTGTGGAGAGGCAGG","561307.5.peg.1902","1005"
"10297",591,717,126,"GTAAATCCTGCGATTCGATC","CAAATTTGTGGAGAGGCAGG","561307.5.peg.1902","1005"
"10298",1331,717,614,"CTCCATCACTATCAAAGTAT","CAAATTTGTGGAGAGGCAGG","561307.5.peg.1902","1005"
"10299",1521,717,804,"GAAATGGCTTCTTGCCAAGC","CAAATTTGTGGAGAGGCAGG","561307.5.peg.1902","1005"
"10300",276,717,441,"GGCATATCCGGACCACAACT","CAAATTTGTGGAGAGGCAGG","561307.5.peg.1902","1005"
"10301",1764,717,1047,"ACAGTACTCCATCCTTCAAT","CAAATTTGTGGAGAGGCAGG","561307.5.peg.1902","1005"
"10302",1158,717,441,"CTGATTGCATCATGAATAAC","CAAATTTGTGGAGAGGCAGG","561307.5.peg.1902","1005"
"10303",1377,720,657,"GCTAAAGTGACTTGTCGAGT","CCCCAAATTTGTGGAGAGGC","561307.5.peg.1902","1005"
"10304",1521,720,801,"GAAATGGCTTCTTGCCAAGC","CCCCAAATTTGTGGAGAGGC","561307.5.peg.1902","1005"
"10305",309,720,411,"GCACCTCGTGGACATCCTCT","CCCCAAATTTGTGGAGAGGC","561307.5.peg.1902","1005"
"10306",1056,720,336,"TCATCCAGCATGATAAGAAA","CCCCAAATTTGTGGAGAGGC","561307.5.peg.1902","1005"
"10307",615,720,105,"ATCATTGACATCGCTGGAAT","CCCCAAATTTGTGGAGAGGC","561307.5.peg.1902","1005"
"10308",1371,720,651,"GTGACTTGTCGAGTTGGAAT","CCCCAAATTTGTGGAGAGGC","561307.5.peg.1902","1005"
"10309",1764,720,1044,"ACAGTACTCCATCCTTCAAT","CCCCAAATTTGTGGAGAGGC","561307.5.peg.1902","1005"
"10310",499,720,221,"CACGTGCCCTCCCATACCTC","CCCCAAATTTGTGGAGAGGC","561307.5.peg.1902","1005"
"10311",276,720,444,"GGCATATCCGGACCACAACT","CCCCAAATTTGTGGAGAGGC","561307.5.peg.1902","1005"
"10312",1646,720,926,"TCGTATCTGAGTTAAACCAA","CCCCAAATTTGTGGAGAGGC","561307.5.peg.1902","1005"
"10313",1158,720,438,"CTGATTGCATCATGAATAAC","CCCCAAATTTGTGGAGAGGC","561307.5.peg.1902","1005"
"10314",297,720,423,"CATCCTCTCGGTTCATATTC","CCCCAAATTTGTGGAGAGGC","561307.5.peg.1902","1005"
"10315",321,720,399,"CAAGAGAATGACGCACCTCG","CCCCAAATTTGTGGAGAGGC","561307.5.peg.1902","1005"
"10316",1331,720,611,"CTCCATCACTATCAAAGTAT","CCCCAAATTTGTGGAGAGGC","561307.5.peg.1902","1005"
"10317",591,720,129,"GTAAATCCTGCGATTCGATC","CCCCAAATTTGTGGAGAGGC","561307.5.peg.1902","1005"
"10318",1859,720,1139,"TGACTCTTCATATTTCCAT","CCCCAAATTTGTGGAGAGGC","561307.5.peg.1902","1005"
"10319",288,720,432,"GGTTCATATTCAGGCATATC","CCCCAAATTTGTGGAGAGGC","561307.5.peg.1902","1005"
"10320",357,720,363,"TATGGATATTTGATTCGAAG","CCCCAAATTTGTGGAGAGGC","561307.5.peg.1902","1005"
"10321",481,720,239,"TCGGGCTTGCTTATATTGTT","CCCCAAATTTGTGGAGAGGC","561307.5.peg.1902","1005"
"10322",1197,720,477,"CGTTGACCCATTGTGCCATT","CCCCAAATTTGTGGAGAGGC","561307.5.peg.1902","1005"
"10323",1331,724,607,"CTCCATCACTATCAAAGTAT","CTCTCCCCAAATTTGTGGAG","561307.5.peg.1902","1005"
"10324",1197,724,473,"CGTTGACCCATTGTGCCATT","CTCTCCCCAAATTTGTGGAG","561307.5.peg.1902","1005"
"10325",499,724,225,"CACGTGCCCTCCCATACCTC","CTCTCCCCAAATTTGTGGAG","561307.5.peg.1902","1005"
"10326",309,724,415,"GCACCTCGTGGACATCCTCT","CTCTCCCCAAATTTGTGGAG","561307.5.peg.1902","1005"
"10327",1764,724,1040,"ACAGTACTCCATCCTTCAAT","CTCTCCCCAAATTTGTGGAG","561307.5.peg.1902","1005"
"10328",481,724,243,"TCGGGCTTGCTTATATTGTT","CTCTCCCCAAATTTGTGGAG","561307.5.peg.1902","1005"
"10329",1521,724,797,"GAAATGGCTTCTTGCCAAGC","CTCTCCCCAAATTTGTGGAG","561307.5.peg.1902","1005"
"10330",288,724,436,"GGTTCATATTCAGGCATATC","CTCTCCCCAAATTTGTGGAG","561307.5.peg.1902","1005"
"10331",1371,724,647,"GTGACTTGTCGAGTTGGAAT","CTCTCCCCAAATTTGTGGAG","561307.5.peg.1902","1005"
"10332",1859,724,1135,"TGACTCTTCATATTTCCAT","CTCTCCCCAAATTTGTGGAG","561307.5.peg.1902","1005"
"10333",297,724,427,"CATCCTCTCGGTTCATATTC","CTCTCCCCAAATTTGTGGAG","561307.5.peg.1902","1005"
"10334",276,724,448,"GGCATATCCGGACCACAACT","CTCTCCCCAAATTTGTGGAG","561307.5.peg.1902","1005"
"10335",615,724,109,"ATCATTGACATCGCTGGAAT","CTCTCCCCAAATTTGTGGAG","561307.5.peg.1902","1005"
"10336",591,724,133,"GTAAATCCTGCGATTCGATC","CTCTCCCCAAATTTGTGGAG","561307.5.peg.1902","1005"
"10337",1377,724,653,"GCTAAAGTGACTTGTCGAGT","CTCTCCCCAAATTTGTGGAG","561307.5.peg.1902","1005"
"10338",357,724,367,"TATGGATATTTGATTCGAAG","CTCTCCCCAAATTTGTGGAG","561307.5.peg.1902","1005"
"10339",1646,724,922,"TCGTATCTGAGTTAAACCAA","CTCTCCCCAAATTTGTGGAG","561307.5.peg.1902","1005"
"10340",321,724,403,"CAAGAGAATGACGCACCTCG","CTCTCCCCAAATTTGTGGAG","561307.5.peg.1902","1005"
"10341",1158,724,434,"CTGATTGCATCATGAATAAC","CTCTCCCCAAATTTGTGGAG","561307.5.peg.1902","1005"
"10342",1056,724,332,"TCATCCAGCATGATAAGAAA","CTCTCCCCAAATTTGTGGAG","561307.5.peg.1902","1005"
"10343",499,729,230,"CACGTGCCCTCCCATACCTC","GTTTGCTCTCCCCAAATTTG","561307.5.peg.1902","1005"
"10344",1859,729,1130,"TGACTCTTCATATTTCCAT","GTTTGCTCTCCCCAAATTTG","561307.5.peg.1902","1005"
"10345",615,729,114,"ATCATTGACATCGCTGGAAT","GTTTGCTCTCCCCAAATTTG","561307.5.peg.1902","1005"
"10346",321,729,408,"CAAGAGAATGACGCACCTCG","GTTTGCTCTCCCCAAATTTG","561307.5.peg.1902","1005"
"10347",1377,729,648,"GCTAAAGTGACTTGTCGAGT","GTTTGCTCTCCCCAAATTTG","561307.5.peg.1902","1005"
"10348",1764,729,1035,"ACAGTACTCCATCCTTCAAT","GTTTGCTCTCCCCAAATTTG","561307.5.peg.1902","1005"
"10349",481,729,248,"TCGGGCTTGCTTATATTGTT","GTTTGCTCTCCCCAAATTTG","561307.5.peg.1902","1005"
"10350",309,729,420,"GCACCTCGTGGACATCCTCT","GTTTGCTCTCCCCAAATTTG","561307.5.peg.1902","1005"
"10351",1197,729,468,"CGTTGACCCATTGTGCCATT","GTTTGCTCTCCCCAAATTTG","561307.5.peg.1902","1005"
"10352",357,729,372,"TATGGATATTTGATTCGAAG","GTTTGCTCTCCCCAAATTTG","561307.5.peg.1902","1005"
"10353",591,729,138,"GTAAATCCTGCGATTCGATC","GTTTGCTCTCCCCAAATTTG","561307.5.peg.1902","1005"
"10354",276,729,453,"GGCATATCCGGACCACAACT","GTTTGCTCTCCCCAAATTTG","561307.5.peg.1902","1005"
"10355",297,729,432,"CATCCTCTCGGTTCATATTC","GTTTGCTCTCCCCAAATTTG","561307.5.peg.1902","1005"
"10356",1521,729,792,"GAAATGGCTTCTTGCCAAGC","GTTTGCTCTCCCCAAATTTG","561307.5.peg.1902","1005"
"10357",1158,729,429,"CTGATTGCATCATGAATAAC","GTTTGCTCTCCCCAAATTTG","561307.5.peg.1902","1005"
"10358",1331,729,602,"CTCCATCACTATCAAAGTAT","GTTTGCTCTCCCCAAATTTG","561307.5.peg.1902","1005"
"10359",288,729,441,"GGTTCATATTCAGGCATATC","GTTTGCTCTCCCCAAATTTG","561307.5.peg.1902","1005"
"10360",1646,729,917,"TCGTATCTGAGTTAAACCAA","GTTTGCTCTCCCCAAATTTG","561307.5.peg.1902","1005"
"10361",1056,729,327,"TCATCCAGCATGATAAGAAA","GTTTGCTCTCCCCAAATTTG","561307.5.peg.1902","1005"
"10362",1371,729,642,"GTGACTTGTCGAGTTGGAAT","GTTTGCTCTCCCCAAATTTG","561307.5.peg.1902","1005"
"10363",1197,759,438,"CGTTGACCCATTGTGCCATT","TTATACCAGTCACTTGATTC","561307.5.peg.1902","1005"
"10364",1764,759,1005,"ACAGTACTCCATCCTTCAAT","TTATACCAGTCACTTGATTC","561307.5.peg.1902","1005"
"10365",1331,759,572,"CTCCATCACTATCAAAGTAT","TTATACCAGTCACTTGATTC","561307.5.peg.1902","1005"
"10366",1646,759,887,"TCGTATCTGAGTTAAACCAA","TTATACCAGTCACTTGATTC","561307.5.peg.1902","1005"
"10367",309,759,450,"GCACCTCGTGGACATCCTCT","TTATACCAGTCACTTGATTC","561307.5.peg.1902","1005"
"10368",1859,759,1100,"TGACTCTTCATATTTCCAT","TTATACCAGTCACTTGATTC","561307.5.peg.1902","1005"
"10369",1521,759,762,"GAAATGGCTTCTTGCCAAGC","TTATACCAGTCACTTGATTC","561307.5.peg.1902","1005"
"10370",297,759,462,"CATCCTCTCGGTTCATATTC","TTATACCAGTCACTTGATTC","561307.5.peg.1902","1005"
"10371",499,759,260,"CACGTGCCCTCCCATACCTC","TTATACCAGTCACTTGATTC","561307.5.peg.1902","1005"
"10372",357,759,402,"TATGGATATTTGATTCGAAG","TTATACCAGTCACTTGATTC","561307.5.peg.1902","1005"
"10373",481,759,278,"TCGGGCTTGCTTATATTGTT","TTATACCAGTCACTTGATTC","561307.5.peg.1902","1005"
"10374",288,759,471,"GGTTCATATTCAGGCATATC","TTATACCAGTCACTTGATTC","561307.5.peg.1902","1005"
"10375",1158,759,399,"CTGATTGCATCATGAATAAC","TTATACCAGTCACTTGATTC","561307.5.peg.1902","1005"
"10376",1371,759,612,"GTGACTTGTCGAGTTGGAAT","TTATACCAGTCACTTGATTC","561307.5.peg.1902","1005"
"10377",1377,759,618,"GCTAAAGTGACTTGTCGAGT","TTATACCAGTCACTTGATTC","561307.5.peg.1902","1005"
"10378",276,759,483,"GGCATATCCGGACCACAACT","TTATACCAGTCACTTGATTC","561307.5.peg.1902","1005"
"10379",591,759,168,"GTAAATCCTGCGATTCGATC","TTATACCAGTCACTTGATTC","561307.5.peg.1902","1005"
"10380",615,759,144,"ATCATTGACATCGCTGGAAT","TTATACCAGTCACTTGATTC","561307.5.peg.1902","1005"
"10381",1056,759,297,"TCATCCAGCATGATAAGAAA","TTATACCAGTCACTTGATTC","561307.5.peg.1902","1005"
"10382",321,759,438,"CAAGAGAATGACGCACCTCG","TTATACCAGTCACTTGATTC","561307.5.peg.1902","1005"
"10383",1331,816,515,"CTCCATCACTATCAAAGTAT","GCATCCGGAGTACGTGTTAA","561307.5.peg.1902","1005"
"10384",1521,816,705,"GAAATGGCTTCTTGCCAAGC","GCATCCGGAGTACGTGTTAA","561307.5.peg.1902","1005"
"10385",321,816,495,"CAAGAGAATGACGCACCTCG","GCATCCGGAGTACGTGTTAA","561307.5.peg.1902","1005"
"10386",481,816,335,"TCGGGCTTGCTTATATTGTT","GCATCCGGAGTACGTGTTAA","561307.5.peg.1902","1005"
"10387",1197,816,381,"CGTTGACCCATTGTGCCATT","GCATCCGGAGTACGTGTTAA","561307.5.peg.1902","1005"
"10388",1158,816,342,"CTGATTGCATCATGAATAAC","GCATCCGGAGTACGTGTTAA","561307.5.peg.1902","1005"
"10389",591,816,225,"GTAAATCCTGCGATTCGATC","GCATCCGGAGTACGTGTTAA","561307.5.peg.1902","1005"
"10390",1646,816,830,"TCGTATCTGAGTTAAACCAA","GCATCCGGAGTACGTGTTAA","561307.5.peg.1902","1005"
"10391",357,816,459,"TATGGATATTTGATTCGAAG","GCATCCGGAGTACGTGTTAA","561307.5.peg.1902","1005"
"10392",309,816,507,"GCACCTCGTGGACATCCTCT","GCATCCGGAGTACGTGTTAA","561307.5.peg.1902","1005"
"10393",1764,816,948,"ACAGTACTCCATCCTTCAAT","GCATCCGGAGTACGTGTTAA","561307.5.peg.1902","1005"
"10394",1859,816,1043,"TGACTCTTCATATTTCCAT","GCATCCGGAGTACGTGTTAA","561307.5.peg.1902","1005"
"10395",276,816,540,"GGCATATCCGGACCACAACT","GCATCCGGAGTACGTGTTAA","561307.5.peg.1902","1005"
"10396",615,816,201,"ATCATTGACATCGCTGGAAT","GCATCCGGAGTACGTGTTAA","561307.5.peg.1902","1005"
"10397",499,816,317,"CACGTGCCCTCCCATACCTC","GCATCCGGAGTACGTGTTAA","561307.5.peg.1902","1005"
"10398",1371,816,555,"GTGACTTGTCGAGTTGGAAT","GCATCCGGAGTACGTGTTAA","561307.5.peg.1902","1005"
"10399",288,816,528,"GGTTCATATTCAGGCATATC","GCATCCGGAGTACGTGTTAA","561307.5.peg.1902","1005"
"10400",1056,816,240,"TCATCCAGCATGATAAGAAA","GCATCCGGAGTACGTGTTAA","561307.5.peg.1902","1005"
"10401",1377,816,561,"GCTAAAGTGACTTGTCGAGT","GCATCCGGAGTACGTGTTAA","561307.5.peg.1902","1005"
"10402",297,816,519,"CATCCTCTCGGTTCATATTC","GCATCCGGAGTACGTGTTAA","561307.5.peg.1902","1005"
"10403",720,1056,336,"CCCCAAATTTGTGGAGAGGC","TCATCCAGCATGATAAGAAA","561307.5.peg.1902","1005"
"10404",1197,1056,141,"CGTTGACCCATTGTGCCATT","TCATCCAGCATGATAAGAAA","561307.5.peg.1902","1005"
"10405",591,1056,465,"GTAAATCCTGCGATTCGATC","TCATCCAGCATGATAAGAAA","561307.5.peg.1902","1005"
"10406",1646,1056,590,"TCGTATCTGAGTTAAACCAA","TCATCCAGCATGATAAGAAA","561307.5.peg.1902","1005"
"10407",297,1056,759,"CATCCTCTCGGTTCATATTC","TCATCCAGCATGATAAGAAA","561307.5.peg.1902","1005"
"10408",759,1056,297,"TTATACCAGTCACTTGATTC","TCATCCAGCATGATAAGAAA","561307.5.peg.1902","1005"
"10409",1331,1056,275,"CTCCATCACTATCAAAGTAT","TCATCCAGCATGATAAGAAA","561307.5.peg.1902","1005"
"10410",1377,1056,321,"GCTAAAGTGACTTGTCGAGT","TCATCCAGCATGATAAGAAA","561307.5.peg.1902","1005"
"10411",615,1056,441,"ATCATTGACATCGCTGGAAT","TCATCCAGCATGATAAGAAA","561307.5.peg.1902","1005"
"10412",499,1056,557,"CACGTGCCCTCCCATACCTC","TCATCCAGCATGATAAGAAA","561307.5.peg.1902","1005"
"10413",724,1056,332,"CTCTCCCCAAATTTGTGGAG","TCATCCAGCATGATAAGAAA","561307.5.peg.1902","1005"
"10414",1859,1056,803,"TGACTCTTCATATTTCCAT","TCATCCAGCATGATAAGAAA","561307.5.peg.1902","1005"
"10415",816,1056,240,"GCATCCGGAGTACGTGTTAA","TCATCCAGCATGATAAGAAA","561307.5.peg.1902","1005"
"10416",321,1056,735,"CAAGAGAATGACGCACCTCG","TCATCCAGCATGATAAGAAA","561307.5.peg.1902","1005"
"10417",1371,1056,315,"GTGACTTGTCGAGTTGGAAT","TCATCCAGCATGATAAGAAA","561307.5.peg.1902","1005"
"10418",288,1056,768,"GGTTCATATTCAGGCATATC","TCATCCAGCATGATAAGAAA","561307.5.peg.1902","1005"
"10419",1158,1056,102,"CTGATTGCATCATGAATAAC","TCATCCAGCATGATAAGAAA","561307.5.peg.1902","1005"
"10420",309,1056,747,"GCACCTCGTGGACATCCTCT","TCATCCAGCATGATAAGAAA","561307.5.peg.1902","1005"
"10421",357,1056,699,"TATGGATATTTGATTCGAAG","TCATCCAGCATGATAAGAAA","561307.5.peg.1902","1005"
"10422",729,1056,327,"GTTTGCTCTCCCCAAATTTG","TCATCCAGCATGATAAGAAA","561307.5.peg.1902","1005"
"10423",481,1056,575,"TCGGGCTTGCTTATATTGTT","TCATCCAGCATGATAAGAAA","561307.5.peg.1902","1005"
"10424",1521,1056,465,"GAAATGGCTTCTTGCCAAGC","TCATCCAGCATGATAAGAAA","561307.5.peg.1902","1005"
"10425",276,1056,780,"GGCATATCCGGACCACAACT","TCATCCAGCATGATAAGAAA","561307.5.peg.1902","1005"
"10426",1764,1056,708,"ACAGTACTCCATCCTTCAAT","TCATCCAGCATGATAAGAAA","561307.5.peg.1902","1005"
"10427",717,1056,339,"CAAATTTGTGGAGAGGCAGG","TCATCCAGCATGATAAGAAA","561307.5.peg.1902","1005"
"10428",499,1158,659,"CACGTGCCCTCCCATACCTC","CTGATTGCATCATGAATAAC","561307.5.peg.1902","1005"
"10429",309,1158,849,"GCACCTCGTGGACATCCTCT","CTGATTGCATCATGAATAAC","561307.5.peg.1902","1005"
"10430",1859,1158,701,"TGACTCTTCATATTTCCAT","CTGATTGCATCATGAATAAC","561307.5.peg.1902","1005"
"10431",1377,1158,219,"GCTAAAGTGACTTGTCGAGT","CTGATTGCATCATGAATAAC","561307.5.peg.1902","1005"
"10432",357,1158,801,"TATGGATATTTGATTCGAAG","CTGATTGCATCATGAATAAC","561307.5.peg.1902","1005"
"10433",720,1158,438,"CCCCAAATTTGTGGAGAGGC","CTGATTGCATCATGAATAAC","561307.5.peg.1902","1005"
"10434",288,1158,870,"GGTTCATATTCAGGCATATC","CTGATTGCATCATGAATAAC","561307.5.peg.1902","1005"
"10435",1646,1158,488,"TCGTATCTGAGTTAAACCAA","CTGATTGCATCATGAATAAC","561307.5.peg.1902","1005"
"10436",729,1158,429,"GTTTGCTCTCCCCAAATTTG","CTGATTGCATCATGAATAAC","561307.5.peg.1902","1005"
"10437",1371,1158,213,"GTGACTTGTCGAGTTGGAAT","CTGATTGCATCATGAATAAC","561307.5.peg.1902","1005"
"10438",759,1158,399,"TTATACCAGTCACTTGATTC","CTGATTGCATCATGAATAAC","561307.5.peg.1902","1005"
"10439",615,1158,543,"ATCATTGACATCGCTGGAAT","CTGATTGCATCATGAATAAC","561307.5.peg.1902","1005"
"10440",481,1158,677,"TCGGGCTTGCTTATATTGTT","CTGATTGCATCATGAATAAC","561307.5.peg.1902","1005"
"10441",321,1158,837,"CAAGAGAATGACGCACCTCG","CTGATTGCATCATGAATAAC","561307.5.peg.1902","1005"
"10442",1764,1158,606,"ACAGTACTCCATCCTTCAAT","CTGATTGCATCATGAATAAC","561307.5.peg.1902","1005"
"10443",717,1158,441,"CAAATTTGTGGAGAGGCAGG","CTGATTGCATCATGAATAAC","561307.5.peg.1902","1005"
"10444",297,1158,861,"CATCCTCTCGGTTCATATTC","CTGATTGCATCATGAATAAC","561307.5.peg.1902","1005"
"10445",591,1158,567,"GTAAATCCTGCGATTCGATC","CTGATTGCATCATGAATAAC","561307.5.peg.1902","1005"
"10446",1521,1158,363,"GAAATGGCTTCTTGCCAAGC","CTGATTGCATCATGAATAAC","561307.5.peg.1902","1005"
"10447",276,1158,882,"GGCATATCCGGACCACAACT","CTGATTGCATCATGAATAAC","561307.5.peg.1902","1005"
"10448",1056,1158,102,"TCATCCAGCATGATAAGAAA","CTGATTGCATCATGAATAAC","561307.5.peg.1902","1005"
"10449",724,1158,434,"CTCTCCCCAAATTTGTGGAG","CTGATTGCATCATGAATAAC","561307.5.peg.1902","1005"
"10450",1331,1158,173,"CTCCATCACTATCAAAGTAT","CTGATTGCATCATGAATAAC","561307.5.peg.1902","1005"
"10451",816,1158,342,"GCATCCGGAGTACGTGTTAA","CTGATTGCATCATGAATAAC","561307.5.peg.1902","1005"
"10452",816,1197,381,"GCATCCGGAGTACGTGTTAA","CGTTGACCCATTGTGCCATT","561307.5.peg.1902","1005"
"10453",357,1197,840,"TATGGATATTTGATTCGAAG","CGTTGACCCATTGTGCCATT","561307.5.peg.1902","1005"
"10454",717,1197,480,"CAAATTTGTGGAGAGGCAGG","CGTTGACCCATTGTGCCATT","561307.5.peg.1902","1005"
"10455",724,1197,473,"CTCTCCCCAAATTTGTGGAG","CGTTGACCCATTGTGCCATT","561307.5.peg.1902","1005"
"10456",321,1197,876,"CAAGAGAATGACGCACCTCG","CGTTGACCCATTGTGCCATT","561307.5.peg.1902","1005"
"10457",591,1197,606,"GTAAATCCTGCGATTCGATC","CGTTGACCCATTGTGCCATT","561307.5.peg.1902","1005"
"10458",1377,1197,180,"GCTAAAGTGACTTGTCGAGT","CGTTGACCCATTGTGCCATT","561307.5.peg.1902","1005"
"10459",499,1197,698,"CACGTGCCCTCCCATACCTC","CGTTGACCCATTGTGCCATT","561307.5.peg.1902","1005"
"10460",1371,1197,174,"GTGACTTGTCGAGTTGGAAT","CGTTGACCCATTGTGCCATT","561307.5.peg.1902","1005"
"10461",615,1197,582,"ATCATTGACATCGCTGGAAT","CGTTGACCCATTGTGCCATT","561307.5.peg.1902","1005"
"10462",1521,1197,324,"GAAATGGCTTCTTGCCAAGC","CGTTGACCCATTGTGCCATT","561307.5.peg.1902","1005"
"10463",288,1197,909,"GGTTCATATTCAGGCATATC","CGTTGACCCATTGTGCCATT","561307.5.peg.1902","1005"
"10464",481,1197,716,"TCGGGCTTGCTTATATTGTT","CGTTGACCCATTGTGCCATT","561307.5.peg.1902","1005"
"10465",1056,1197,141,"TCATCCAGCATGATAAGAAA","CGTTGACCCATTGTGCCATT","561307.5.peg.1902","1005"
"10466",759,1197,438,"TTATACCAGTCACTTGATTC","CGTTGACCCATTGTGCCATT","561307.5.peg.1902","1005"
"10467",297,1197,900,"CATCCTCTCGGTTCATATTC","CGTTGACCCATTGTGCCATT","561307.5.peg.1902","1005"
"10468",1646,1197,449,"TCGTATCTGAGTTAAACCAA","CGTTGACCCATTGTGCCATT","561307.5.peg.1902","1005"
"10469",729,1197,468,"GTTTGCTCTCCCCAAATTTG","CGTTGACCCATTGTGCCATT","561307.5.peg.1902","1005"
"10470",309,1197,888,"GCACCTCGTGGACATCCTCT","CGTTGACCCATTGTGCCATT","561307.5.peg.1902","1005"
"10471",720,1197,477,"CCCCAAATTTGTGGAGAGGC","CGTTGACCCATTGTGCCATT","561307.5.peg.1902","1005"
"10472",1764,1197,567,"ACAGTACTCCATCCTTCAAT","CGTTGACCCATTGTGCCATT","561307.5.peg.1902","1005"
"10473",1331,1197,134,"CTCCATCACTATCAAAGTAT","CGTTGACCCATTGTGCCATT","561307.5.peg.1902","1005"
"10474",276,1197,921,"GGCATATCCGGACCACAACT","CGTTGACCCATTGTGCCATT","561307.5.peg.1902","1005"
"10475",1859,1197,662,"TGACTCTTCATATTTCCAT","CGTTGACCCATTGTGCCATT","561307.5.peg.1902","1005"
"10476",1646,1331,315,"TCGTATCTGAGTTAAACCAA","CTCCATCACTATCAAAGTAT","561307.5.peg.1902","1005"
"10477",288,1331,1043,"GGTTCATATTCAGGCATATC","CTCCATCACTATCAAAGTAT","561307.5.peg.1902","1005"
"10478",724,1331,607,"CTCTCCCCAAATTTGTGGAG","CTCCATCACTATCAAAGTAT","561307.5.peg.1902","1005"
"10479",759,1331,572,"TTATACCAGTCACTTGATTC","CTCCATCACTATCAAAGTAT","561307.5.peg.1902","1005"
"10480",1764,1331,433,"ACAGTACTCCATCCTTCAAT","CTCCATCACTATCAAAGTAT","561307.5.peg.1902","1005"
"10481",321,1331,1010,"CAAGAGAATGACGCACCTCG","CTCCATCACTATCAAAGTAT","561307.5.peg.1902","1005"
"10482",717,1331,614,"CAAATTTGTGGAGAGGCAGG","CTCCATCACTATCAAAGTAT","561307.5.peg.1902","1005"
"10483",1056,1331,275,"TCATCCAGCATGATAAGAAA","CTCCATCACTATCAAAGTAT","561307.5.peg.1902","1005"
"10484",720,1331,611,"CCCCAAATTTGTGGAGAGGC","CTCCATCACTATCAAAGTAT","561307.5.peg.1902","1005"
"10485",729,1331,602,"GTTTGCTCTCCCCAAATTTG","CTCCATCACTATCAAAGTAT","561307.5.peg.1902","1005"
"10486",615,1331,716,"ATCATTGACATCGCTGGAAT","CTCCATCACTATCAAAGTAT","561307.5.peg.1902","1005"
"10487",357,1331,974,"TATGGATATTTGATTCGAAG","CTCCATCACTATCAAAGTAT","561307.5.peg.1902","1005"
"10488",276,1331,1055,"GGCATATCCGGACCACAACT","CTCCATCACTATCAAAGTAT","561307.5.peg.1902","1005"
"10489",1521,1331,190,"GAAATGGCTTCTTGCCAAGC","CTCCATCACTATCAAAGTAT","561307.5.peg.1902","1005"
"10490",309,1331,1022,"GCACCTCGTGGACATCCTCT","CTCCATCACTATCAAAGTAT","561307.5.peg.1902","1005"
"10491",499,1331,832,"CACGTGCCCTCCCATACCTC","CTCCATCACTATCAAAGTAT","561307.5.peg.1902","1005"
"10492",297,1331,1034,"CATCCTCTCGGTTCATATTC","CTCCATCACTATCAAAGTAT","561307.5.peg.1902","1005"
"10493",1158,1331,173,"CTGATTGCATCATGAATAAC","CTCCATCACTATCAAAGTAT","561307.5.peg.1902","1005"
"10494",1859,1331,528,"TGACTCTTCATATTTCCAT","CTCCATCACTATCAAAGTAT","561307.5.peg.1902","1005"
"10495",481,1331,850,"TCGGGCTTGCTTATATTGTT","CTCCATCACTATCAAAGTAT","561307.5.peg.1902","1005"
"10496",816,1331,515,"GCATCCGGAGTACGTGTTAA","CTCCATCACTATCAAAGTAT","561307.5.peg.1902","1005"
"10497",1197,1331,134,"CGTTGACCCATTGTGCCATT","CTCCATCACTATCAAAGTAT","561307.5.peg.1902","1005"
"10498",591,1331,740,"GTAAATCCTGCGATTCGATC","CTCCATCACTATCAAAGTAT","561307.5.peg.1902","1005"
"10499",297,1371,1074,"CATCCTCTCGGTTCATATTC","GTGACTTGTCGAGTTGGAAT","561307.5.peg.1902","1005"
"10500",1056,1371,315,"TCATCCAGCATGATAAGAAA","GTGACTTGTCGAGTTGGAAT","561307.5.peg.1902","1005"
"10501",591,1371,780,"GTAAATCCTGCGATTCGATC","GTGACTTGTCGAGTTGGAAT","561307.5.peg.1902","1005"
"10502",309,1371,1062,"GCACCTCGTGGACATCCTCT","GTGACTTGTCGAGTTGGAAT","561307.5.peg.1902","1005"
"10503",1158,1371,213,"CTGATTGCATCATGAATAAC","GTGACTTGTCGAGTTGGAAT","561307.5.peg.1902","1005"
"10504",1521,1371,150,"GAAATGGCTTCTTGCCAAGC","GTGACTTGTCGAGTTGGAAT","561307.5.peg.1902","1005"
"10505",481,1371,890,"TCGGGCTTGCTTATATTGTT","GTGACTTGTCGAGTTGGAAT","561307.5.peg.1902","1005"
"10506",720,1371,651,"CCCCAAATTTGTGGAGAGGC","GTGACTTGTCGAGTTGGAAT","561307.5.peg.1902","1005"
"10507",816,1371,555,"GCATCCGGAGTACGTGTTAA","GTGACTTGTCGAGTTGGAAT","561307.5.peg.1902","1005"
"10508",717,1371,654,"CAAATTTGTGGAGAGGCAGG","GTGACTTGTCGAGTTGGAAT","561307.5.peg.1902","1005"
"10509",1764,1371,393,"ACAGTACTCCATCCTTCAAT","GTGACTTGTCGAGTTGGAAT","561307.5.peg.1902","1005"
"10510",759,1371,612,"TTATACCAGTCACTTGATTC","GTGACTTGTCGAGTTGGAAT","561307.5.peg.1902","1005"
"10511",499,1371,872,"CACGTGCCCTCCCATACCTC","GTGACTTGTCGAGTTGGAAT","561307.5.peg.1902","1005"
"10512",729,1371,642,"GTTTGCTCTCCCCAAATTTG","GTGACTTGTCGAGTTGGAAT","561307.5.peg.1902","1005"
"10513",1646,1371,275,"TCGTATCTGAGTTAAACCAA","GTGACTTGTCGAGTTGGAAT","561307.5.peg.1902","1005"
"10514",357,1371,1014,"TATGGATATTTGATTCGAAG","GTGACTTGTCGAGTTGGAAT","561307.5.peg.1902","1005"
"10515",724,1371,647,"CTCTCCCCAAATTTGTGGAG","GTGACTTGTCGAGTTGGAAT","561307.5.peg.1902","1005"
"10516",615,1371,756,"ATCATTGACATCGCTGGAAT","GTGACTTGTCGAGTTGGAAT","561307.5.peg.1902","1005"
"10517",288,1371,1083,"GGTTCATATTCAGGCATATC","GTGACTTGTCGAGTTGGAAT","561307.5.peg.1902","1005"
"10518",1859,1371,488,"TGACTCTTCATATTTCCAT","GTGACTTGTCGAGTTGGAAT","561307.5.peg.1902","1005"
"10519",321,1371,1050,"CAAGAGAATGACGCACCTCG","GTGACTTGTCGAGTTGGAAT","561307.5.peg.1902","1005"
"10520",1197,1371,174,"CGTTGACCCATTGTGCCATT","GTGACTTGTCGAGTTGGAAT","561307.5.peg.1902","1005"
"10521",276,1371,1095,"GGCATATCCGGACCACAACT","GTGACTTGTCGAGTTGGAAT","561307.5.peg.1902","1005"
"10522",1646,1377,269,"TCGTATCTGAGTTAAACCAA","GCTAAAGTGACTTGTCGAGT","561307.5.peg.1902","1005"
"10523",1056,1377,321,"TCATCCAGCATGATAAGAAA","GCTAAAGTGACTTGTCGAGT","561307.5.peg.1902","1005"
"10524",297,1377,1080,"CATCCTCTCGGTTCATATTC","GCTAAAGTGACTTGTCGAGT","561307.5.peg.1902","1005"
"10525",717,1377,660,"CAAATTTGTGGAGAGGCAGG","GCTAAAGTGACTTGTCGAGT","561307.5.peg.1902","1005"
"10526",276,1377,1101,"GGCATATCCGGACCACAACT","GCTAAAGTGACTTGTCGAGT","561307.5.peg.1902","1005"
"10527",591,1377,786,"GTAAATCCTGCGATTCGATC","GCTAAAGTGACTTGTCGAGT","561307.5.peg.1902","1005"
"10528",288,1377,1089,"GGTTCATATTCAGGCATATC","GCTAAAGTGACTTGTCGAGT","561307.5.peg.1902","1005"
"10529",816,1377,561,"GCATCCGGAGTACGTGTTAA","GCTAAAGTGACTTGTCGAGT","561307.5.peg.1902","1005"
"10530",357,1377,1020,"TATGGATATTTGATTCGAAG","GCTAAAGTGACTTGTCGAGT","561307.5.peg.1902","1005"
"10531",1859,1377,482,"TGACTCTTCATATTTCCAT","GCTAAAGTGACTTGTCGAGT","561307.5.peg.1902","1005"
"10532",481,1377,896,"TCGGGCTTGCTTATATTGTT","GCTAAAGTGACTTGTCGAGT","561307.5.peg.1902","1005"
"10533",1158,1377,219,"CTGATTGCATCATGAATAAC","GCTAAAGTGACTTGTCGAGT","561307.5.peg.1902","1005"
"10534",1521,1377,144,"GAAATGGCTTCTTGCCAAGC","GCTAAAGTGACTTGTCGAGT","561307.5.peg.1902","1005"
"10535",724,1377,653,"CTCTCCCCAAATTTGTGGAG","GCTAAAGTGACTTGTCGAGT","561307.5.peg.1902","1005"
"10536",720,1377,657,"CCCCAAATTTGTGGAGAGGC","GCTAAAGTGACTTGTCGAGT","561307.5.peg.1902","1005"
"10537",1764,1377,387,"ACAGTACTCCATCCTTCAAT","GCTAAAGTGACTTGTCGAGT","561307.5.peg.1902","1005"
"10538",759,1377,618,"TTATACCAGTCACTTGATTC","GCTAAAGTGACTTGTCGAGT","561307.5.peg.1902","1005"
"10539",729,1377,648,"GTTTGCTCTCCCCAAATTTG","GCTAAAGTGACTTGTCGAGT","561307.5.peg.1902","1005"
"10540",499,1377,878,"CACGTGCCCTCCCATACCTC","GCTAAAGTGACTTGTCGAGT","561307.5.peg.1902","1005"
"10541",309,1377,1068,"GCACCTCGTGGACATCCTCT","GCTAAAGTGACTTGTCGAGT","561307.5.peg.1902","1005"
"10542",1197,1377,180,"CGTTGACCCATTGTGCCATT","GCTAAAGTGACTTGTCGAGT","561307.5.peg.1902","1005"
"10543",615,1377,762,"ATCATTGACATCGCTGGAAT","GCTAAAGTGACTTGTCGAGT","561307.5.peg.1902","1005"
"10544",321,1377,1056,"CAAGAGAATGACGCACCTCG","GCTAAAGTGACTTGTCGAGT","561307.5.peg.1902","1005"
"10545",276,1521,1245,"GGCATATCCGGACCACAACT","GAAATGGCTTCTTGCCAAGC","561307.5.peg.1902","1005"
"10546",724,1521,797,"CTCTCCCCAAATTTGTGGAG","GAAATGGCTTCTTGCCAAGC","561307.5.peg.1902","1005"
"10547",499,1521,1022,"CACGTGCCCTCCCATACCTC","GAAATGGCTTCTTGCCAAGC","561307.5.peg.1902","1005"
"10548",1764,1521,243,"ACAGTACTCCATCCTTCAAT","GAAATGGCTTCTTGCCAAGC","561307.5.peg.1902","1005"
"10549",1056,1521,465,"TCATCCAGCATGATAAGAAA","GAAATGGCTTCTTGCCAAGC","561307.5.peg.1902","1005"
"10550",729,1521,792,"GTTTGCTCTCCCCAAATTTG","GAAATGGCTTCTTGCCAAGC","561307.5.peg.1902","1005"
"10551",591,1521,930,"GTAAATCCTGCGATTCGATC","GAAATGGCTTCTTGCCAAGC","561307.5.peg.1902","1005"
"10552",481,1521,1040,"TCGGGCTTGCTTATATTGTT","GAAATGGCTTCTTGCCAAGC","561307.5.peg.1902","1005"
"10553",816,1521,705,"GCATCCGGAGTACGTGTTAA","GAAATGGCTTCTTGCCAAGC","561307.5.peg.1902","1005"
"10554",1646,1521,125,"TCGTATCTGAGTTAAACCAA","GAAATGGCTTCTTGCCAAGC","561307.5.peg.1902","1005"
"10555",1197,1521,324,"CGTTGACCCATTGTGCCATT","GAAATGGCTTCTTGCCAAGC","561307.5.peg.1902","1005"
"10556",297,1521,1224,"CATCCTCTCGGTTCATATTC","GAAATGGCTTCTTGCCAAGC","561307.5.peg.1902","1005"
"10557",1371,1521,150,"GTGACTTGTCGAGTTGGAAT","GAAATGGCTTCTTGCCAAGC","561307.5.peg.1902","1005"
"10558",357,1521,1164,"TATGGATATTTGATTCGAAG","GAAATGGCTTCTTGCCAAGC","561307.5.peg.1902","1005"
"10559",615,1521,906,"ATCATTGACATCGCTGGAAT","GAAATGGCTTCTTGCCAAGC","561307.5.peg.1902","1005"
"10560",717,1521,804,"CAAATTTGTGGAGAGGCAGG","GAAATGGCTTCTTGCCAAGC","561307.5.peg.1902","1005"
"10561",288,1521,1233,"GGTTCATATTCAGGCATATC","GAAATGGCTTCTTGCCAAGC","561307.5.peg.1902","1005"
"10562",759,1521,762,"TTATACCAGTCACTTGATTC","GAAATGGCTTCTTGCCAAGC","561307.5.peg.1902","1005"
"10563",1331,1521,190,"CTCCATCACTATCAAAGTAT","GAAATGGCTTCTTGCCAAGC","561307.5.peg.1902","1005"
"10564",1859,1521,338,"TGACTCTTCATATTTCCAT","GAAATGGCTTCTTGCCAAGC","561307.5.peg.1902","1005"
"10565",720,1521,801,"CCCCAAATTTGTGGAGAGGC","GAAATGGCTTCTTGCCAAGC","561307.5.peg.1902","1005"
"10566",309,1521,1212,"GCACCTCGTGGACATCCTCT","GAAATGGCTTCTTGCCAAGC","561307.5.peg.1902","1005"
"10567",321,1521,1200,"CAAGAGAATGACGCACCTCG","GAAATGGCTTCTTGCCAAGC","561307.5.peg.1902","1005"
"10568",1158,1521,363,"CTGATTGCATCATGAATAAC","GAAATGGCTTCTTGCCAAGC","561307.5.peg.1902","1005"
"10569",1377,1521,144,"GCTAAAGTGACTTGTCGAGT","GAAATGGCTTCTTGCCAAGC","561307.5.peg.1902","1005"
"10570",615,1646,1031,"ATCATTGACATCGCTGGAAT","TCGTATCTGAGTTAAACCAA","561307.5.peg.1902","1005"
"10571",1859,1646,213,"TGACTCTTCATATTTCCAT","TCGTATCTGAGTTAAACCAA","561307.5.peg.1902","1005"
"10572",717,1646,929,"CAAATTTGTGGAGAGGCAGG","TCGTATCTGAGTTAAACCAA","561307.5.peg.1902","1005"
"10573",1331,1646,315,"CTCCATCACTATCAAAGTAT","TCGTATCTGAGTTAAACCAA","561307.5.peg.1902","1005"
"10574",1377,1646,269,"GCTAAAGTGACTTGTCGAGT","TCGTATCTGAGTTAAACCAA","561307.5.peg.1902","1005"
"10575",591,1646,1055,"GTAAATCCTGCGATTCGATC","TCGTATCTGAGTTAAACCAA","561307.5.peg.1902","1005"
"10576",1521,1646,125,"GAAATGGCTTCTTGCCAAGC","TCGTATCTGAGTTAAACCAA","561307.5.peg.1902","1005"
"10577",720,1646,926,"CCCCAAATTTGTGGAGAGGC","TCGTATCTGAGTTAAACCAA","561307.5.peg.1902","1005"
"10578",297,1646,1349,"CATCCTCTCGGTTCATATTC","TCGTATCTGAGTTAAACCAA","561307.5.peg.1902","1005"
"10579",309,1646,1337,"GCACCTCGTGGACATCCTCT","TCGTATCTGAGTTAAACCAA","561307.5.peg.1902","1005"
"10580",357,1646,1289,"TATGGATATTTGATTCGAAG","TCGTATCTGAGTTAAACCAA","561307.5.peg.1902","1005"
"10581",288,1646,1358,"GGTTCATATTCAGGCATATC","TCGTATCTGAGTTAAACCAA","561307.5.peg.1902","1005"
"10582",729,1646,917,"GTTTGCTCTCCCCAAATTTG","TCGTATCTGAGTTAAACCAA","561307.5.peg.1902","1005"
"10583",1371,1646,275,"GTGACTTGTCGAGTTGGAAT","TCGTATCTGAGTTAAACCAA","561307.5.peg.1902","1005"
"10584",724,1646,922,"CTCTCCCCAAATTTGTGGAG","TCGTATCTGAGTTAAACCAA","561307.5.peg.1902","1005"
"10585",1056,1646,590,"TCATCCAGCATGATAAGAAA","TCGTATCTGAGTTAAACCAA","561307.5.peg.1902","1005"
"10586",759,1646,887,"TTATACCAGTCACTTGATTC","TCGTATCTGAGTTAAACCAA","561307.5.peg.1902","1005"
"10587",321,1646,1325,"CAAGAGAATGACGCACCTCG","TCGTATCTGAGTTAAACCAA","561307.5.peg.1902","1005"
"10588",1764,1646,118,"ACAGTACTCCATCCTTCAAT","TCGTATCTGAGTTAAACCAA","561307.5.peg.1902","1005"
"10589",481,1646,1165,"TCGGGCTTGCTTATATTGTT","TCGTATCTGAGTTAAACCAA","561307.5.peg.1902","1005"
"10590",276,1646,1370,"GGCATATCCGGACCACAACT","TCGTATCTGAGTTAAACCAA","561307.5.peg.1902","1005"
"10591",816,1646,830,"GCATCCGGAGTACGTGTTAA","TCGTATCTGAGTTAAACCAA","561307.5.peg.1902","1005"
"10592",499,1646,1147,"CACGTGCCCTCCCATACCTC","TCGTATCTGAGTTAAACCAA","561307.5.peg.1902","1005"
"10593",1158,1646,488,"CTGATTGCATCATGAATAAC","TCGTATCTGAGTTAAACCAA","561307.5.peg.1902","1005"
"10594",1197,1646,449,"CGTTGACCCATTGTGCCATT","TCGTATCTGAGTTAAACCAA","561307.5.peg.1902","1005"
"10595",481,1764,1283,"TCGGGCTTGCTTATATTGTT","ACAGTACTCCATCCTTCAAT","561307.5.peg.1902","1005"
"10596",759,1764,1005,"TTATACCAGTCACTTGATTC","ACAGTACTCCATCCTTCAAT","561307.5.peg.1902","1005"
"10597",1197,1764,567,"CGTTGACCCATTGTGCCATT","ACAGTACTCCATCCTTCAAT","561307.5.peg.1902","1005"
"10598",1377,1764,387,"GCTAAAGTGACTTGTCGAGT","ACAGTACTCCATCCTTCAAT","561307.5.peg.1902","1005"
"10599",276,1764,1488,"GGCATATCCGGACCACAACT","ACAGTACTCCATCCTTCAAT","561307.5.peg.1902","1005"
"10600",288,1764,1476,"GGTTCATATTCAGGCATATC","ACAGTACTCCATCCTTCAAT","561307.5.peg.1902","1005"
"10601",309,1764,1455,"GCACCTCGTGGACATCCTCT","ACAGTACTCCATCCTTCAAT","561307.5.peg.1902","1005"
"10602",729,1764,1035,"GTTTGCTCTCCCCAAATTTG","ACAGTACTCCATCCTTCAAT","561307.5.peg.1902","1005"
"10603",724,1764,1040,"CTCTCCCCAAATTTGTGGAG","ACAGTACTCCATCCTTCAAT","561307.5.peg.1902","1005"
"10604",717,1764,1047,"CAAATTTGTGGAGAGGCAGG","ACAGTACTCCATCCTTCAAT","561307.5.peg.1902","1005"
"10605",1521,1764,243,"GAAATGGCTTCTTGCCAAGC","ACAGTACTCCATCCTTCAAT","561307.5.peg.1902","1005"
"10606",591,1764,1173,"GTAAATCCTGCGATTCGATC","ACAGTACTCCATCCTTCAAT","561307.5.peg.1902","1005"
"10607",1646,1764,118,"TCGTATCTGAGTTAAACCAA","ACAGTACTCCATCCTTCAAT","561307.5.peg.1902","1005"
"10608",1331,1764,433,"CTCCATCACTATCAAAGTAT","ACAGTACTCCATCCTTCAAT","561307.5.peg.1902","1005"
"10609",720,1764,1044,"CCCCAAATTTGTGGAGAGGC","ACAGTACTCCATCCTTCAAT","561307.5.peg.1902","1005"
"10610",321,1764,1443,"CAAGAGAATGACGCACCTCG","ACAGTACTCCATCCTTCAAT","561307.5.peg.1902","1005"
"10611",297,1764,1467,"CATCCTCTCGGTTCATATTC","ACAGTACTCCATCCTTCAAT","561307.5.peg.1902","1005"
"10612",615,1764,1149,"ATCATTGACATCGCTGGAAT","ACAGTACTCCATCCTTCAAT","561307.5.peg.1902","1005"
"10613",1158,1764,606,"CTGATTGCATCATGAATAAC","ACAGTACTCCATCCTTCAAT","561307.5.peg.1902","1005"
"10614",357,1764,1407,"TATGGATATTTGATTCGAAG","ACAGTACTCCATCCTTCAAT","561307.5.peg.1902","1005"
"10615",499,1764,1265,"CACGTGCCCTCCCATACCTC","ACAGTACTCCATCCTTCAAT","561307.5.peg.1902","1005"
"10616",816,1764,948,"GCATCCGGAGTACGTGTTAA","ACAGTACTCCATCCTTCAAT","561307.5.peg.1902","1005"
"10617",1056,1764,708,"TCATCCAGCATGATAAGAAA","ACAGTACTCCATCCTTCAAT","561307.5.peg.1902","1005"
"10618",1371,1764,393,"GTGACTTGTCGAGTTGGAAT","ACAGTACTCCATCCTTCAAT","561307.5.peg.1902","1005"
"10619",816,1859,1043,"GCATCCGGAGTACGTGTTAA","TGACTCTTCATATTTCCAT","561307.5.peg.1902","1005"
"10620",717,1859,1142,"CAAATTTGTGGAGAGGCAGG","TGACTCTTCATATTTCCAT","561307.5.peg.1902","1005"
"10621",720,1859,1139,"CCCCAAATTTGTGGAGAGGC","TGACTCTTCATATTTCCAT","561307.5.peg.1902","1005"
"10622",288,1859,1571,"GGTTCATATTCAGGCATATC","TGACTCTTCATATTTCCAT","561307.5.peg.1902","1005"
"10623",1371,1859,488,"GTGACTTGTCGAGTTGGAAT","TGACTCTTCATATTTCCAT","561307.5.peg.1902","1005"
"10624",297,1859,1562,"CATCCTCTCGGTTCATATTC","TGACTCTTCATATTTCCAT","561307.5.peg.1902","1005"
"10625",309,1859,1550,"GCACCTCGTGGACATCCTCT","TGACTCTTCATATTTCCAT","561307.5.peg.1902","1005"
"10626",1521,1859,338,"GAAATGGCTTCTTGCCAAGC","TGACTCTTCATATTTCCAT","561307.5.peg.1902","1005"
"10627",615,1859,1244,"ATCATTGACATCGCTGGAAT","TGACTCTTCATATTTCCAT","561307.5.peg.1902","1005"
"10628",1646,1859,213,"TCGTATCTGAGTTAAACCAA","TGACTCTTCATATTTCCAT","561307.5.peg.1902","1005"
"10629",1331,1859,528,"CTCCATCACTATCAAAGTAT","TGACTCTTCATATTTCCAT","561307.5.peg.1902","1005"
"10630",481,1859,1378,"TCGGGCTTGCTTATATTGTT","TGACTCTTCATATTTCCAT","561307.5.peg.1902","1005"
"10631",1158,1859,701,"CTGATTGCATCATGAATAAC","TGACTCTTCATATTTCCAT","561307.5.peg.1902","1005"
"10632",357,1859,1502,"TATGGATATTTGATTCGAAG","TGACTCTTCATATTTCCAT","561307.5.peg.1902","1005"
"10633",321,1859,1538,"CAAGAGAATGACGCACCTCG","TGACTCTTCATATTTCCAT","561307.5.peg.1902","1005"
"10634",1197,1859,662,"CGTTGACCCATTGTGCCATT","TGACTCTTCATATTTCCAT","561307.5.peg.1902","1005"
"10635",499,1859,1360,"CACGTGCCCTCCCATACCTC","TGACTCTTCATATTTCCAT","561307.5.peg.1902","1005"
"10636",1056,1859,803,"TCATCCAGCATGATAAGAAA","TGACTCTTCATATTTCCAT","561307.5.peg.1902","1005"
"10637",1377,1859,482,"GCTAAAGTGACTTGTCGAGT","TGACTCTTCATATTTCCAT","561307.5.peg.1902","1005"
"10638",724,1859,1135,"CTCTCCCCAAATTTGTGGAG","TGACTCTTCATATTTCCAT","561307.5.peg.1902","1005"
"10639",759,1859,1100,"TTATACCAGTCACTTGATTC","TGACTCTTCATATTTCCAT","561307.5.peg.1902","1005"
"10640",591,1859,1268,"GTAAATCCTGCGATTCGATC","TGACTCTTCATATTTCCAT","561307.5.peg.1902","1005"
"10641",729,1859,1130,"GTTTGCTCTCCCCAAATTTG","TGACTCTTCATATTTCCAT","561307.5.peg.1902","1005"
"10642",276,1859,1583,"GGCATATCCGGACCACAACT","TGACTCTTCATATTTCCAT","561307.5.peg.1902","1005"
"10643",333,12,321,"TGCACACGACCAAATATCGC","ATGAGGTAGAAGTTACAGAC","561307.5.peg.1903","1006"
"10644",405,12,393,"GCGCTCGCTGATGTCACCCC","ATGAGGTAGAAGTTACAGAC","561307.5.peg.1903","1006"
"10645",333,96,237,"TGCACACGACCAAATATCGC","GTCAAATAATTCGGATTACC","561307.5.peg.1903","1006"
"10646",405,96,309,"GCGCTCGCTGATGTCACCCC","GTCAAATAATTCGGATTACC","561307.5.peg.1903","1006"
"10647",12,333,321,"ATGAGGTAGAAGTTACAGAC","TGCACACGACCAAATATCGC","561307.5.peg.1903","1006"
"10648",96,333,237,"GTCAAATAATTCGGATTACC","TGCACACGACCAAATATCGC","561307.5.peg.1903","1006"
"10649",12,405,393,"ATGAGGTAGAAGTTACAGAC","GCGCTCGCTGATGTCACCCC","561307.5.peg.1903","1006"
"10650",96,405,309,"GTCAAATAATTCGGATTACC","GCGCTCGCTGATGTCACCCC","561307.5.peg.1903","1006"
"10651",405,165,240,"ACACTCGGTAATGTCGAACC","ATGCGGTTATAGTTTGGATA","561307.5.peg.1905","1008"
"10652",608,165,443,"TAAGCATATTTCCAGCTTTA","ATGCGGTTATAGTTTGGATA","561307.5.peg.1905","1008"
"10653",741,165,576,"GCCATAACAACTAAGTCTGC","ATGCGGTTATAGTTTGGATA","561307.5.peg.1905","1008"
"10654",921,165,756,"CTTTACCTTGTTCATATAG","ATGCGGTTATAGTTTGGATA","561307.5.peg.1905","1008"
"10655",777,165,612,"TCTTTGGCTACTTCTGTGTA","ATGCGGTTATAGTTTGGATA","561307.5.peg.1905","1008"
"10656",793,165,628,"AACATCTAGACCTGATTCTT","ATGCGGTTATAGTTTGGATA","561307.5.peg.1905","1008"
"10657",399,165,234,"GGTAATGTCGAACCTGGAAC","ATGCGGTTATAGTTTGGATA","561307.5.peg.1905","1008"
"10658",777,171,606,"TCTTTGGCTACTTCTGTGTA","AGCATGATGCGGTTATAGTT","561307.5.peg.1905","1008"
"10659",793,171,622,"AACATCTAGACCTGATTCTT","AGCATGATGCGGTTATAGTT","561307.5.peg.1905","1008"
"10660",608,171,437,"TAAGCATATTTCCAGCTTTA","AGCATGATGCGGTTATAGTT","561307.5.peg.1905","1008"
"10661",741,171,570,"GCCATAACAACTAAGTCTGC","AGCATGATGCGGTTATAGTT","561307.5.peg.1905","1008"
"10662",405,171,234,"ACACTCGGTAATGTCGAACC","AGCATGATGCGGTTATAGTT","561307.5.peg.1905","1008"
"10663",921,171,750,"CTTTACCTTGTTCATATAG","AGCATGATGCGGTTATAGTT","561307.5.peg.1905","1008"
"10664",399,171,228,"GGTAATGTCGAACCTGGAAC","AGCATGATGCGGTTATAGTT","561307.5.peg.1905","1008"
"10665",793,182,611,"AACATCTAGACCTGATTCTT","AATATTTGAAAGCATGATG","561307.5.peg.1905","1008"
"10666",777,182,595,"TCTTTGGCTACTTCTGTGTA","AATATTTGAAAGCATGATG","561307.5.peg.1905","1008"
"10667",741,182,559,"GCCATAACAACTAAGTCTGC","AATATTTGAAAGCATGATG","561307.5.peg.1905","1008"
"10668",399,182,217,"GGTAATGTCGAACCTGGAAC","AATATTTGAAAGCATGATG","561307.5.peg.1905","1008"
"10669",608,182,426,"TAAGCATATTTCCAGCTTTA","AATATTTGAAAGCATGATG","561307.5.peg.1905","1008"
"10670",405,182,223,"ACACTCGGTAATGTCGAACC","AATATTTGAAAGCATGATG","561307.5.peg.1905","1008"
"10671",921,182,739,"CTTTACCTTGTTCATATAG","AATATTTGAAAGCATGATG","561307.5.peg.1905","1008"
"10672",399,243,156,"GGTAATGTCGAACCTGGAAC","TGTTCCTCATACCACTCATA","561307.5.peg.1905","1008"
"10673",405,243,162,"ACACTCGGTAATGTCGAACC","TGTTCCTCATACCACTCATA","561307.5.peg.1905","1008"
"10674",777,243,534,"TCTTTGGCTACTTCTGTGTA","TGTTCCTCATACCACTCATA","561307.5.peg.1905","1008"
"10675",608,243,365,"TAAGCATATTTCCAGCTTTA","TGTTCCTCATACCACTCATA","561307.5.peg.1905","1008"
"10676",921,243,678,"CTTTACCTTGTTCATATAG","TGTTCCTCATACCACTCATA","561307.5.peg.1905","1008"
"10677",793,243,550,"AACATCTAGACCTGATTCTT","TGTTCCTCATACCACTCATA","561307.5.peg.1905","1008"
"10678",741,243,498,"GCCATAACAACTAAGTCTGC","TGTTCCTCATACCACTCATA","561307.5.peg.1905","1008"
"10679",608,399,209,"TAAGCATATTTCCAGCTTTA","GGTAATGTCGAACCTGGAAC","561307.5.peg.1905","1008"
"10680",165,399,234,"ATGCGGTTATAGTTTGGATA","GGTAATGTCGAACCTGGAAC","561307.5.peg.1905","1008"
"10681",921,399,522,"CTTTACCTTGTTCATATAG","GGTAATGTCGAACCTGGAAC","561307.5.peg.1905","1008"
"10682",793,399,394,"AACATCTAGACCTGATTCTT","GGTAATGTCGAACCTGGAAC","561307.5.peg.1905","1008"
"10683",777,399,378,"TCTTTGGCTACTTCTGTGTA","GGTAATGTCGAACCTGGAAC","561307.5.peg.1905","1008"
"10684",182,399,217,"AATATTTGAAAGCATGATG","GGTAATGTCGAACCTGGAAC","561307.5.peg.1905","1008"
"10685",243,399,156,"TGTTCCTCATACCACTCATA","GGTAATGTCGAACCTGGAAC","561307.5.peg.1905","1008"
"10686",741,399,342,"GCCATAACAACTAAGTCTGC","GGTAATGTCGAACCTGGAAC","561307.5.peg.1905","1008"
"10687",171,399,228,"AGCATGATGCGGTTATAGTT","GGTAATGTCGAACCTGGAAC","561307.5.peg.1905","1008"
"10688",165,405,240,"ATGCGGTTATAGTTTGGATA","ACACTCGGTAATGTCGAACC","561307.5.peg.1905","1008"
"10689",921,405,516,"CTTTACCTTGTTCATATAG","ACACTCGGTAATGTCGAACC","561307.5.peg.1905","1008"
"10690",608,405,203,"TAAGCATATTTCCAGCTTTA","ACACTCGGTAATGTCGAACC","561307.5.peg.1905","1008"
"10691",741,405,336,"GCCATAACAACTAAGTCTGC","ACACTCGGTAATGTCGAACC","561307.5.peg.1905","1008"
"10692",182,405,223,"AATATTTGAAAGCATGATG","ACACTCGGTAATGTCGAACC","561307.5.peg.1905","1008"
"10693",243,405,162,"TGTTCCTCATACCACTCATA","ACACTCGGTAATGTCGAACC","561307.5.peg.1905","1008"
"10694",793,405,388,"AACATCTAGACCTGATTCTT","ACACTCGGTAATGTCGAACC","561307.5.peg.1905","1008"
"10695",171,405,234,"AGCATGATGCGGTTATAGTT","ACACTCGGTAATGTCGAACC","561307.5.peg.1905","1008"
"10696",777,405,372,"TCTTTGGCTACTTCTGTGTA","ACACTCGGTAATGTCGAACC","561307.5.peg.1905","1008"
"10697",171,608,437,"AGCATGATGCGGTTATAGTT","TAAGCATATTTCCAGCTTTA","561307.5.peg.1905","1008"
"10698",777,608,169,"TCTTTGGCTACTTCTGTGTA","TAAGCATATTTCCAGCTTTA","561307.5.peg.1905","1008"
"10699",741,608,133,"GCCATAACAACTAAGTCTGC","TAAGCATATTTCCAGCTTTA","561307.5.peg.1905","1008"
"10700",405,608,203,"ACACTCGGTAATGTCGAACC","TAAGCATATTTCCAGCTTTA","561307.5.peg.1905","1008"
"10701",399,608,209,"GGTAATGTCGAACCTGGAAC","TAAGCATATTTCCAGCTTTA","561307.5.peg.1905","1008"
"10702",243,608,365,"TGTTCCTCATACCACTCATA","TAAGCATATTTCCAGCTTTA","561307.5.peg.1905","1008"
"10703",793,608,185,"AACATCTAGACCTGATTCTT","TAAGCATATTTCCAGCTTTA","561307.5.peg.1905","1008"
"10704",165,608,443,"ATGCGGTTATAGTTTGGATA","TAAGCATATTTCCAGCTTTA","561307.5.peg.1905","1008"
"10705",182,608,426,"AATATTTGAAAGCATGATG","TAAGCATATTTCCAGCTTTA","561307.5.peg.1905","1008"
"10706",921,608,313,"CTTTACCTTGTTCATATAG","TAAGCATATTTCCAGCTTTA","561307.5.peg.1905","1008"
"10707",921,741,180,"CTTTACCTTGTTCATATAG","GCCATAACAACTAAGTCTGC","561307.5.peg.1905","1008"
"10708",243,741,498,"TGTTCCTCATACCACTCATA","GCCATAACAACTAAGTCTGC","561307.5.peg.1905","1008"
"10709",182,741,559,"AATATTTGAAAGCATGATG","GCCATAACAACTAAGTCTGC","561307.5.peg.1905","1008"
"10710",171,741,570,"AGCATGATGCGGTTATAGTT","GCCATAACAACTAAGTCTGC","561307.5.peg.1905","1008"
"10711",608,741,133,"TAAGCATATTTCCAGCTTTA","GCCATAACAACTAAGTCTGC","561307.5.peg.1905","1008"
"10712",405,741,336,"ACACTCGGTAATGTCGAACC","GCCATAACAACTAAGTCTGC","561307.5.peg.1905","1008"
"10713",399,741,342,"GGTAATGTCGAACCTGGAAC","GCCATAACAACTAAGTCTGC","561307.5.peg.1905","1008"
"10714",165,741,576,"ATGCGGTTATAGTTTGGATA","GCCATAACAACTAAGTCTGC","561307.5.peg.1905","1008"
"10715",165,777,612,"ATGCGGTTATAGTTTGGATA","TCTTTGGCTACTTCTGTGTA","561307.5.peg.1905","1008"
"10716",182,777,595,"AATATTTGAAAGCATGATG","TCTTTGGCTACTTCTGTGTA","561307.5.peg.1905","1008"
"10717",608,777,169,"TAAGCATATTTCCAGCTTTA","TCTTTGGCTACTTCTGTGTA","561307.5.peg.1905","1008"
"10718",921,777,144,"CTTTACCTTGTTCATATAG","TCTTTGGCTACTTCTGTGTA","561307.5.peg.1905","1008"
"10719",405,777,372,"ACACTCGGTAATGTCGAACC","TCTTTGGCTACTTCTGTGTA","561307.5.peg.1905","1008"
"10720",171,777,606,"AGCATGATGCGGTTATAGTT","TCTTTGGCTACTTCTGTGTA","561307.5.peg.1905","1008"
"10721",399,777,378,"GGTAATGTCGAACCTGGAAC","TCTTTGGCTACTTCTGTGTA","561307.5.peg.1905","1008"
"10722",243,777,534,"TGTTCCTCATACCACTCATA","TCTTTGGCTACTTCTGTGTA","561307.5.peg.1905","1008"
"10723",243,793,550,"TGTTCCTCATACCACTCATA","AACATCTAGACCTGATTCTT","561307.5.peg.1905","1008"
"10724",171,793,622,"AGCATGATGCGGTTATAGTT","AACATCTAGACCTGATTCTT","561307.5.peg.1905","1008"
"10725",165,793,628,"ATGCGGTTATAGTTTGGATA","AACATCTAGACCTGATTCTT","561307.5.peg.1905","1008"
"10726",182,793,611,"AATATTTGAAAGCATGATG","AACATCTAGACCTGATTCTT","561307.5.peg.1905","1008"
"10727",921,793,128,"CTTTACCTTGTTCATATAG","AACATCTAGACCTGATTCTT","561307.5.peg.1905","1008"
"10728",405,793,388,"ACACTCGGTAATGTCGAACC","AACATCTAGACCTGATTCTT","561307.5.peg.1905","1008"
"10729",608,793,185,"TAAGCATATTTCCAGCTTTA","AACATCTAGACCTGATTCTT","561307.5.peg.1905","1008"
"10730",399,793,394,"GGTAATGTCGAACCTGGAAC","AACATCTAGACCTGATTCTT","561307.5.peg.1905","1008"
"10731",405,921,516,"ACACTCGGTAATGTCGAACC","CTTTACCTTGTTCATATAG","561307.5.peg.1905","1008"
"10732",399,921,522,"GGTAATGTCGAACCTGGAAC","CTTTACCTTGTTCATATAG","561307.5.peg.1905","1008"
"10733",243,921,678,"TGTTCCTCATACCACTCATA","CTTTACCTTGTTCATATAG","561307.5.peg.1905","1008"
"10734",182,921,739,"AATATTTGAAAGCATGATG","CTTTACCTTGTTCATATAG","561307.5.peg.1905","1008"
"10735",777,921,144,"TCTTTGGCTACTTCTGTGTA","CTTTACCTTGTTCATATAG","561307.5.peg.1905","1008"
"10736",171,921,750,"AGCATGATGCGGTTATAGTT","CTTTACCTTGTTCATATAG","561307.5.peg.1905","1008"
"10737",793,921,128,"AACATCTAGACCTGATTCTT","CTTTACCTTGTTCATATAG","561307.5.peg.1905","1008"
"10738",608,921,313,"TAAGCATATTTCCAGCTTTA","CTTTACCTTGTTCATATAG","561307.5.peg.1905","1008"
"10739",165,921,756,"ATGCGGTTATAGTTTGGATA","CTTTACCTTGTTCATATAG","561307.5.peg.1905","1008"
"10740",741,921,180,"GCCATAACAACTAAGTCTGC","CTTTACCTTGTTCATATAG","561307.5.peg.1905","1008"
"10741",387,285,102,"ATTAAAGGATGTGTGCCAAG","TTGCACTAAAGATTAGCAA","561307.5.peg.1906","1009"
"10742",285,387,102,"TTGCACTAAAGATTAGCAA","ATTAAAGGATGTGTGCCAAG","561307.5.peg.1906","1009"
"10743",156,8,148,"GCTTTAAGCATATATCGGCC","ATTTGATCAAAGTAAATGG","561307.5.peg.1908","1011"
"10744",283,8,275,"CAAACCTAAACTAAACGCAA","ATTTGATCAAAGTAAATGG","561307.5.peg.1908","1011"
"10745",161,8,153,"CATTGCTTTAAGCATATAT","ATTTGATCAAAGTAAATGG","561307.5.peg.1908","1011"
"10746",8,156,148,"ATTTGATCAAAGTAAATGG","GCTTTAAGCATATATCGGCC","561307.5.peg.1908","1011"
"10747",283,156,127,"CAAACCTAAACTAAACGCAA","GCTTTAAGCATATATCGGCC","561307.5.peg.1908","1011"
"10748",8,161,153,"ATTTGATCAAAGTAAATGG","CATTGCTTTAAGCATATAT","561307.5.peg.1908","1011"
"10749",283,161,122,"CAAACCTAAACTAAACGCAA","CATTGCTTTAAGCATATAT","561307.5.peg.1908","1011"
"10750",161,283,122,"CATTGCTTTAAGCATATAT","CAAACCTAAACTAAACGCAA","561307.5.peg.1908","1011"
"10751",156,283,127,"GCTTTAAGCATATATCGGCC","CAAACCTAAACTAAACGCAA","561307.5.peg.1908","1011"
"10752",8,283,275,"ATTTGATCAAAGTAAATGG","CAAACCTAAACTAAACGCAA","561307.5.peg.1908","1011"
"10753",330,84,246,"GATGCAACTTTCTTAGCAAC","GCTAATGATAAAGTTACGGC","561307.5.peg.1911","1015"
"10754",231,84,147,"CTATGTAAATCTGTCCCTGC","GCTAATGATAAAGTTACGGC","561307.5.peg.1911","1015"
"10755",507,84,423,"TTAGGATCTAACCATACGTG","GCTAATGATAAAGTTACGGC","561307.5.peg.1911","1015"
"10756",231,106,125,"CTATGTAAATCTGTCCCTGC","TCCATCATCATTCCCACATG","561307.5.peg.1911","1015"
"10757",507,106,401,"TTAGGATCTAACCATACGTG","TCCATCATCATTCCCACATG","561307.5.peg.1911","1015"
"10758",330,106,224,"GATGCAACTTTCTTAGCAAC","TCCATCATCATTCCCACATG","561307.5.peg.1911","1015"
"10759",84,231,147,"GCTAATGATAAAGTTACGGC","CTATGTAAATCTGTCCCTGC","561307.5.peg.1911","1015"
"10760",507,231,276,"TTAGGATCTAACCATACGTG","CTATGTAAATCTGTCCCTGC","561307.5.peg.1911","1015"
"10761",106,231,125,"TCCATCATCATTCCCACATG","CTATGTAAATCTGTCCCTGC","561307.5.peg.1911","1015"
"10762",84,330,246,"GCTAATGATAAAGTTACGGC","GATGCAACTTTCTTAGCAAC","561307.5.peg.1911","1015"
"10763",507,330,177,"TTAGGATCTAACCATACGTG","GATGCAACTTTCTTAGCAAC","561307.5.peg.1911","1015"
"10764",106,330,224,"TCCATCATCATTCCCACATG","GATGCAACTTTCTTAGCAAC","561307.5.peg.1911","1015"
"10765",84,507,423,"GCTAATGATAAAGTTACGGC","TTAGGATCTAACCATACGTG","561307.5.peg.1911","1015"
"10766",106,507,401,"TCCATCATCATTCCCACATG","TTAGGATCTAACCATACGTG","561307.5.peg.1911","1015"
"10767",231,507,276,"CTATGTAAATCTGTCCCTGC","TTAGGATCTAACCATACGTG","561307.5.peg.1911","1015"
"10768",330,507,177,"GATGCAACTTTCTTAGCAAC","TTAGGATCTAACCATACGTG","561307.5.peg.1911","1015"
"10769",150,8,142,"TCGCCATATACGACAACTAA","TGACGAACTAGATATGAAT","561307.5.peg.1914","1018"
"10770",8,150,142,"TGACGAACTAGATATGAAT","TCGCCATATACGACAACTAA","561307.5.peg.1914","1018"
"10771",273,6,267,"GATTTGTATAATCCATCAC","AGTTCAATTCAGAGAGGGAT","561307.5.peg.1916","1020"
"10772",431,6,425,"CCATTGTTCTAACAAATGCT","AGTTCAATTCAGAGAGGGAT","561307.5.peg.1916","1020"
"10773",482,6,476,"TCATTGAATCATAACCTACA","AGTTCAATTCAGAGAGGGAT","561307.5.peg.1916","1020"
"10774",473,6,467,"CATAACCTACAGGGAAACCT","AGTTCAATTCAGAGAGGGAT","561307.5.peg.1916","1020"
"10775",506,6,500,"ACACTGACAGCCAACGGATT","AGTTCAATTCAGAGAGGGAT","561307.5.peg.1916","1020"
"10776",512,6,506,"AATCTAACACTGACAGCCAA","AGTTCAATTCAGAGAGGGAT","561307.5.peg.1916","1020"
"10777",273,11,262,"GATTTGTATAATCCATCAC","TTATAGTTCAATTCAGAGA","561307.5.peg.1916","1020"
"10778",473,11,462,"CATAACCTACAGGGAAACCT","TTATAGTTCAATTCAGAGA","561307.5.peg.1916","1020"
"10779",482,11,471,"TCATTGAATCATAACCTACA","TTATAGTTCAATTCAGAGA","561307.5.peg.1916","1020"
"10780",431,11,420,"CCATTGTTCTAACAAATGCT","TTATAGTTCAATTCAGAGA","561307.5.peg.1916","1020"
"10781",506,11,495,"ACACTGACAGCCAACGGATT","TTATAGTTCAATTCAGAGA","561307.5.peg.1916","1020"
"10782",512,11,501,"AATCTAACACTGACAGCCAA","TTATAGTTCAATTCAGAGA","561307.5.peg.1916","1020"
"10783",6,273,267,"AGTTCAATTCAGAGAGGGAT","GATTTGTATAATCCATCAC","561307.5.peg.1916","1020"
"10784",431,273,158,"CCATTGTTCTAACAAATGCT","GATTTGTATAATCCATCAC","561307.5.peg.1916","1020"
"10785",11,273,262,"TTATAGTTCAATTCAGAGA","GATTTGTATAATCCATCAC","561307.5.peg.1916","1020"
"10786",482,273,209,"TCATTGAATCATAACCTACA","GATTTGTATAATCCATCAC","561307.5.peg.1916","1020"
"10787",473,273,200,"CATAACCTACAGGGAAACCT","GATTTGTATAATCCATCAC","561307.5.peg.1916","1020"
"10788",506,273,233,"ACACTGACAGCCAACGGATT","GATTTGTATAATCCATCAC","561307.5.peg.1916","1020"
"10789",512,273,239,"AATCTAACACTGACAGCCAA","GATTTGTATAATCCATCAC","561307.5.peg.1916","1020"
"10790",11,431,420,"TTATAGTTCAATTCAGAGA","CCATTGTTCTAACAAATGCT","561307.5.peg.1916","1020"
"10791",6,431,425,"AGTTCAATTCAGAGAGGGAT","CCATTGTTCTAACAAATGCT","561307.5.peg.1916","1020"
"10792",273,431,158,"GATTTGTATAATCCATCAC","CCATTGTTCTAACAAATGCT","561307.5.peg.1916","1020"
"10793",6,473,467,"AGTTCAATTCAGAGAGGGAT","CATAACCTACAGGGAAACCT","561307.5.peg.1916","1020"
"10794",273,473,200,"GATTTGTATAATCCATCAC","CATAACCTACAGGGAAACCT","561307.5.peg.1916","1020"
"10795",11,473,462,"TTATAGTTCAATTCAGAGA","CATAACCTACAGGGAAACCT","561307.5.peg.1916","1020"
"10796",11,482,471,"TTATAGTTCAATTCAGAGA","TCATTGAATCATAACCTACA","561307.5.peg.1916","1020"
"10797",6,482,476,"AGTTCAATTCAGAGAGGGAT","TCATTGAATCATAACCTACA","561307.5.peg.1916","1020"
"10798",273,482,209,"GATTTGTATAATCCATCAC","TCATTGAATCATAACCTACA","561307.5.peg.1916","1020"
"10799",6,506,500,"AGTTCAATTCAGAGAGGGAT","ACACTGACAGCCAACGGATT","561307.5.peg.1916","1020"
"10800",273,506,233,"GATTTGTATAATCCATCAC","ACACTGACAGCCAACGGATT","561307.5.peg.1916","1020"
"10801",11,506,495,"TTATAGTTCAATTCAGAGA","ACACTGACAGCCAACGGATT","561307.5.peg.1916","1020"
"10802",11,512,501,"TTATAGTTCAATTCAGAGA","AATCTAACACTGACAGCCAA","561307.5.peg.1916","1020"
"10803",6,512,506,"AGTTCAATTCAGAGAGGGAT","AATCTAACACTGACAGCCAA","561307.5.peg.1916","1020"
"10804",273,512,239,"GATTTGTATAATCCATCAC","AATCTAACACTGACAGCCAA","561307.5.peg.1916","1020"
"10805",350,114,236,"CTACAGGTGCCAATGTCCAT","TTGACCAAACCTTCTAGCAT","561307.5.peg.1918","1022"
"10806",366,114,252,"CCAATAATAGCAGCCACTAC","TTGACCAAACCTTCTAGCAT","561307.5.peg.1918","1022"
"10807",114,350,236,"TTGACCAAACCTTCTAGCAT","CTACAGGTGCCAATGTCCAT","561307.5.peg.1918","1022"
"10808",114,366,252,"TTGACCAAACCTTCTAGCAT","CCAATAATAGCAGCCACTAC","561307.5.peg.1918","1022"
"10809",393,183,210,"ACAGCACTTGAGAATGTGTA","CTTTATCGTGGAAACTAAA","561307.5.peg.1919","1023"
"10810",183,393,210,"CTTTATCGTGGAAACTAAA","ACAGCACTTGAGAATGTGTA","561307.5.peg.1919","1023"
"10811",294,69,225,"TGCTTAGCATCCACTGATAC","TTGGCTTTCGCCATATGTCC","561307.5.peg.192","1024"
"10812",402,69,333,"ATCATTGCTCTTATCGCTCT","TTGGCTTTCGCCATATGTCC","561307.5.peg.192","1024"
"10813",435,69,366,"ATGTGGATTTACCAACATT","TTGGCTTTCGCCATATGTCC","561307.5.peg.192","1024"
"10814",402,294,108,"ATCATTGCTCTTATCGCTCT","TGCTTAGCATCCACTGATAC","561307.5.peg.192","1024"
"10815",69,294,225,"TTGGCTTTCGCCATATGTCC","TGCTTAGCATCCACTGATAC","561307.5.peg.192","1024"
"10816",435,294,141,"ATGTGGATTTACCAACATT","TGCTTAGCATCCACTGATAC","561307.5.peg.192","1024"
"10817",69,402,333,"TTGGCTTTCGCCATATGTCC","ATCATTGCTCTTATCGCTCT","561307.5.peg.192","1024"
"10818",294,402,108,"TGCTTAGCATCCACTGATAC","ATCATTGCTCTTATCGCTCT","561307.5.peg.192","1024"
"10819",294,435,141,"TGCTTAGCATCCACTGATAC","ATGTGGATTTACCAACATT","561307.5.peg.192","1024"
"10820",69,435,366,"TTGGCTTTCGCCATATGTCC","ATGTGGATTTACCAACATT","561307.5.peg.192","1024"
"10821",425,231,194,"ATTTACCGCGTTCATGTGGT","TGTATAACAAGCGCGGACAA","561307.5.peg.1920","1025"
"10822",429,231,198,"ATATATTTACCGCGTTCATG","TGTATAACAAGCGCGGACAA","561307.5.peg.1920","1025"
"10823",495,231,264,"ACAAGGTAACCTGAAAGAGT","TGTATAACAAGCGCGGACAA","561307.5.peg.1920","1025"
"10824",483,231,252,"GAAAGAGTAGGTCCAATAGC","TGTATAACAAGCGCGGACAA","561307.5.peg.1920","1025"
"10825",545,231,314,"CTGCAATTGGAGCGACAACA","TGTATAACAAGCGCGGACAA","561307.5.peg.1920","1025"
"10826",425,238,187,"ATTTACCGCGTTCATGTGGT","ATAACGTTGTATAACAAGCG","561307.5.peg.1920","1025"
"10827",483,238,245,"GAAAGAGTAGGTCCAATAGC","ATAACGTTGTATAACAAGCG","561307.5.peg.1920","1025"
"10828",429,238,191,"ATATATTTACCGCGTTCATG","ATAACGTTGTATAACAAGCG","561307.5.peg.1920","1025"
"10829",545,238,307,"CTGCAATTGGAGCGACAACA","ATAACGTTGTATAACAAGCG","561307.5.peg.1920","1025"
"10830",495,238,257,"ACAAGGTAACCTGAAAGAGT","ATAACGTTGTATAACAAGCG","561307.5.peg.1920","1025"
"10831",483,330,153,"GAAAGAGTAGGTCCAATAGC","ACTAATAATGTTGCAAAGTG","561307.5.peg.1920","1025"
"10832",495,330,165,"ACAAGGTAACCTGAAAGAGT","ACTAATAATGTTGCAAAGTG","561307.5.peg.1920","1025"
"10833",545,330,215,"CTGCAATTGGAGCGACAACA","ACTAATAATGTTGCAAAGTG","561307.5.peg.1920","1025"
"10834",231,425,194,"TGTATAACAAGCGCGGACAA","ATTTACCGCGTTCATGTGGT","561307.5.peg.1920","1025"
"10835",238,425,187,"ATAACGTTGTATAACAAGCG","ATTTACCGCGTTCATGTGGT","561307.5.peg.1920","1025"
"10836",545,425,120,"CTGCAATTGGAGCGACAACA","ATTTACCGCGTTCATGTGGT","561307.5.peg.1920","1025"
"10837",231,429,198,"TGTATAACAAGCGCGGACAA","ATATATTTACCGCGTTCATG","561307.5.peg.1920","1025"
"10838",238,429,191,"ATAACGTTGTATAACAAGCG","ATATATTTACCGCGTTCATG","561307.5.peg.1920","1025"
"10839",545,429,116,"CTGCAATTGGAGCGACAACA","ATATATTTACCGCGTTCATG","561307.5.peg.1920","1025"
"10840",231,483,252,"TGTATAACAAGCGCGGACAA","GAAAGAGTAGGTCCAATAGC","561307.5.peg.1920","1025"
"10841",238,483,245,"ATAACGTTGTATAACAAGCG","GAAAGAGTAGGTCCAATAGC","561307.5.peg.1920","1025"
"10842",330,483,153,"ACTAATAATGTTGCAAAGTG","GAAAGAGTAGGTCCAATAGC","561307.5.peg.1920","1025"
"10843",238,495,257,"ATAACGTTGTATAACAAGCG","ACAAGGTAACCTGAAAGAGT","561307.5.peg.1920","1025"
"10844",330,495,165,"ACTAATAATGTTGCAAAGTG","ACAAGGTAACCTGAAAGAGT","561307.5.peg.1920","1025"
"10845",231,495,264,"TGTATAACAAGCGCGGACAA","ACAAGGTAACCTGAAAGAGT","561307.5.peg.1920","1025"
"10846",238,545,307,"ATAACGTTGTATAACAAGCG","CTGCAATTGGAGCGACAACA","561307.5.peg.1920","1025"
"10847",330,545,215,"ACTAATAATGTTGCAAAGTG","CTGCAATTGGAGCGACAACA","561307.5.peg.1920","1025"
"10848",429,545,116,"ATATATTTACCGCGTTCATG","CTGCAATTGGAGCGACAACA","561307.5.peg.1920","1025"
"10849",231,545,314,"TGTATAACAAGCGCGGACAA","CTGCAATTGGAGCGACAACA","561307.5.peg.1920","1025"
"10850",425,545,120,"ATTTACCGCGTTCATGTGGT","CTGCAATTGGAGCGACAACA","561307.5.peg.1920","1025"
"10851",314,6,308,"AGCCTTGCAATCCACCATAG","ATCTTTAGGACGTTATTTCA","561307.5.peg.1921","1026"
"10852",314,20,294,"AGCCTTGCAATCCACCATAG","CCTCTTTCCTTTAATCTTT","561307.5.peg.1921","1026"
"10853",6,314,308,"ATCTTTAGGACGTTATTTCA","AGCCTTGCAATCCACCATAG","561307.5.peg.1921","1026"
"10854",20,314,294,"CCTCTTTCCTTTAATCTTT","AGCCTTGCAATCCACCATAG","561307.5.peg.1921","1026"
"10855",443,338,105,"AAACTTGTTGGCTTCTATCA","GTTGTGCAACACGTCGGTCT","561307.5.peg.1923","1028"
"10856",558,338,220,"TATGCTGCTGATTTATCGTG","GTTGTGCAACACGTCGGTCT","561307.5.peg.1923","1028"
"10857",455,338,117,"CTGATTCTACCCAAACTTGT","GTTGTGCAACACGTCGGTCT","561307.5.peg.1923","1028"
"10858",338,443,105,"GTTGTGCAACACGTCGGTCT","AAACTTGTTGGCTTCTATCA","561307.5.peg.1923","1028"
"10859",558,443,115,"TATGCTGCTGATTTATCGTG","AAACTTGTTGGCTTCTATCA","561307.5.peg.1923","1028"
"10860",338,455,117,"GTTGTGCAACACGTCGGTCT","CTGATTCTACCCAAACTTGT","561307.5.peg.1923","1028"
"10861",558,455,103,"TATGCTGCTGATTTATCGTG","CTGATTCTACCCAAACTTGT","561307.5.peg.1923","1028"
"10862",455,558,103,"CTGATTCTACCCAAACTTGT","TATGCTGCTGATTTATCGTG","561307.5.peg.1923","1028"
"10863",443,558,115,"AAACTTGTTGGCTTCTATCA","TATGCTGCTGATTTATCGTG","561307.5.peg.1923","1028"
"10864",338,558,220,"GTTGTGCAACACGTCGGTCT","TATGCTGCTGATTTATCGTG","561307.5.peg.1923","1028"
"10865",307,136,171,"GCCTTGCATCTTAACAACTA","TATAAATGGATTGGCTAAAG","561307.5.peg.1924","1029"
"10866",307,138,169,"GCCTTGCATCTTAACAACTA","CTATAAATGGATTGGCTAA","561307.5.peg.1924","1029"
"10867",136,307,171,"TATAAATGGATTGGCTAAAG","GCCTTGCATCTTAACAACTA","561307.5.peg.1924","1029"
"10868",138,307,169,"CTATAAATGGATTGGCTAA","GCCTTGCATCTTAACAACTA","561307.5.peg.1924","1029"
"10869",196,79,117,"AATTTATCAGAATCTGCTG","TAATGCCATAGATGTAGCAA","561307.5.peg.1927","1032"
"10870",324,79,245,"AGTCATAGTCATTAGGATT","TAATGCCATAGATGTAGCAA","561307.5.peg.1927","1032"
"10871",79,196,117,"TAATGCCATAGATGTAGCAA","AATTTATCAGAATCTGCTG","561307.5.peg.1927","1032"
"10872",324,196,128,"AGTCATAGTCATTAGGATT","AATTTATCAGAATCTGCTG","561307.5.peg.1927","1032"
"10873",79,324,245,"TAATGCCATAGATGTAGCAA","AGTCATAGTCATTAGGATT","561307.5.peg.1927","1032"
"10874",196,324,128,"AATTTATCAGAATCTGCTG","AGTCATAGTCATTAGGATT","561307.5.peg.1927","1032"
"10875",123,8,115,"TCTAATCCTGGTATAATGGA","TTGTTTATGAAACGGTATAG","561307.5.peg.1928","1033"
"10876",162,8,154,"GCTAATATCAATAATGCTGC","TTGTTTATGAAACGGTATAG","561307.5.peg.1928","1033"
"10877",123,16,107,"TCTAATCCTGGTATAATGGA","GAAGCAAGTTGTTTATGAAA","561307.5.peg.1928","1033"
"10878",162,16,146,"GCTAATATCAATAATGCTGC","GAAGCAAGTTGTTTATGAAA","561307.5.peg.1928","1033"
"10879",8,123,115,"TTGTTTATGAAACGGTATAG","TCTAATCCTGGTATAATGGA","561307.5.peg.1928","1033"
"10880",16,123,107,"GAAGCAAGTTGTTTATGAAA","TCTAATCCTGGTATAATGGA","561307.5.peg.1928","1033"
"10881",8,162,154,"TTGTTTATGAAACGGTATAG","GCTAATATCAATAATGCTGC","561307.5.peg.1928","1033"
"10882",16,162,146,"GAAGCAAGTTGTTTATGAAA","GCTAATATCAATAATGCTGC","561307.5.peg.1928","1033"
"10883",1215,197,1018,"AGTATTGCGATGATGCATAC","TTTGAAATGGCATCATTTGA","561307.5.peg.193","1035"
"10884",1254,197,1057,"ATAAGTGCAAGTGGGTGTGT","TTTGAAATGGCATCATTTGA","561307.5.peg.193","1035"
"10885",1262,197,1065,"TACCTACTATAAGTGCAAGT","TTTGAAATGGCATCATTTGA","561307.5.peg.193","1035"
"10886",1289,197,1092,"TAACGGCAAGCACTATTAGC","TTTGAAATGGCATCATTTGA","561307.5.peg.193","1035"
"10887",1104,197,907,"ATATACACCCAACGCCTTTC","TTTGAAATGGCATCATTTGA","561307.5.peg.193","1035"
"10888",197,1104,907,"TTTGAAATGGCATCATTTGA","ATATACACCCAACGCCTTTC","561307.5.peg.193","1035"
"10889",1254,1104,150,"ATAAGTGCAAGTGGGTGTGT","ATATACACCCAACGCCTTTC","561307.5.peg.193","1035"
"10890",1215,1104,111,"AGTATTGCGATGATGCATAC","ATATACACCCAACGCCTTTC","561307.5.peg.193","1035"
"10891",1289,1104,185,"TAACGGCAAGCACTATTAGC","ATATACACCCAACGCCTTTC","561307.5.peg.193","1035"
"10892",1262,1104,158,"TACCTACTATAAGTGCAAGT","ATATACACCCAACGCCTTTC","561307.5.peg.193","1035"
"10893",197,1215,1018,"TTTGAAATGGCATCATTTGA","AGTATTGCGATGATGCATAC","561307.5.peg.193","1035"
"10894",1104,1215,111,"ATATACACCCAACGCCTTTC","AGTATTGCGATGATGCATAC","561307.5.peg.193","1035"
"10895",197,1254,1057,"TTTGAAATGGCATCATTTGA","ATAAGTGCAAGTGGGTGTGT","561307.5.peg.193","1035"
"10896",1104,1254,150,"ATATACACCCAACGCCTTTC","ATAAGTGCAAGTGGGTGTGT","561307.5.peg.193","1035"
"10897",1104,1262,158,"ATATACACCCAACGCCTTTC","TACCTACTATAAGTGCAAGT","561307.5.peg.193","1035"
"10898",197,1262,1065,"TTTGAAATGGCATCATTTGA","TACCTACTATAAGTGCAAGT","561307.5.peg.193","1035"
"10899",1104,1289,185,"ATATACACCCAACGCCTTTC","TAACGGCAAGCACTATTAGC","561307.5.peg.193","1035"
"10900",197,1289,1092,"TTTGAAATGGCATCATTTGA","TAACGGCAAGCACTATTAGC","561307.5.peg.193","1035"
"10901",289,170,119,"TGATCCTAGCAGCGTAGAAT","TATTGCCATTCGTATCGTAA","561307.5.peg.1932","1038"
"10902",602,170,432,"AATTACTGCGATAGAAAGAT","TATTGCCATTCGTATCGTAA","561307.5.peg.1932","1038"
"10903",170,289,119,"TATTGCCATTCGTATCGTAA","TGATCCTAGCAGCGTAGAAT","561307.5.peg.1932","1038"
"10904",602,289,313,"AATTACTGCGATAGAAAGAT","TGATCCTAGCAGCGTAGAAT","561307.5.peg.1932","1038"
"10905",170,602,432,"TATTGCCATTCGTATCGTAA","AATTACTGCGATAGAAAGAT","561307.5.peg.1932","1038"
"10906",289,602,313,"TGATCCTAGCAGCGTAGAAT","AATTACTGCGATAGAAAGAT","561307.5.peg.1932","1038"
"10907",159,9,150,"TGGCGTTCCTCAGTTTGAAA","AGTTTACATTTGGATTGAGG","561307.5.peg.1933","1039"
"10908",179,9,170,"AATCTGGAAACGTCCCGTCT","AGTTTACATTTGGATTGAGG","561307.5.peg.1933","1039"
"10909",267,9,258,"AATGCAAGGTGTGGTGATAC","AGTTTACATTTGGATTGAGG","561307.5.peg.1933","1039"
"10910",9,159,150,"AGTTTACATTTGGATTGAGG","TGGCGTTCCTCAGTTTGAAA","561307.5.peg.1933","1039"
"10911",267,159,108,"AATGCAAGGTGTGGTGATAC","TGGCGTTCCTCAGTTTGAAA","561307.5.peg.1933","1039"
"10912",9,179,170,"AGTTTACATTTGGATTGAGG","AATCTGGAAACGTCCCGTCT","561307.5.peg.1933","1039"
"10913",9,267,258,"AGTTTACATTTGGATTGAGG","AATGCAAGGTGTGGTGATAC","561307.5.peg.1933","1039"
"10914",159,267,108,"TGGCGTTCCTCAGTTTGAAA","AATGCAAGGTGTGGTGATAC","561307.5.peg.1933","1039"
"10915",840,371,469,"GATATCAAATACATGCCGAC","TAGATTCCACTACGCCTAAA","561307.5.peg.1935","1041"
"10916",840,450,390,"GATATCAAATACATGCCGAC","TCAGGAATCATATGTGCTAA","561307.5.peg.1935","1041"
"10917",840,468,372,"GATATCAAATACATGCCGAC","GTAAGTTTCCTATAACTTC","561307.5.peg.1935","1041"
"10918",371,840,469,"TAGATTCCACTACGCCTAAA","GATATCAAATACATGCCGAC","561307.5.peg.1935","1041"
"10919",450,840,390,"TCAGGAATCATATGTGCTAA","GATATCAAATACATGCCGAC","561307.5.peg.1935","1041"
"10920",468,840,372,"GTAAGTTTCCTATAACTTC","GATATCAAATACATGCCGAC","561307.5.peg.1935","1041"
"10921",160,10,150,"CGGAATGATATCATAATGAA","AGAGCGACAACAGTAATGAG","561307.5.peg.1937","1043"
"10922",180,10,170,"CCTTCACCACCATCAGCCAT","AGAGCGACAACAGTAATGAG","561307.5.peg.1937","1043"
"10923",235,10,225,"AACGATGACTGTATACTTAG","AGAGCGACAACAGTAATGAG","561307.5.peg.1937","1043"
"10924",403,10,393,"TGCATCTTTAATTAGTTCAC","AGAGCGACAACAGTAATGAG","561307.5.peg.1937","1043"
"10925",263,10,253,"CTTCAATAGGTCGCATTAAA","AGAGCGACAACAGTAATGAG","561307.5.peg.1937","1043"
"10926",235,78,157,"AACGATGACTGTATACTTAG","TACTTTCCTTAAATGAGTC","561307.5.peg.1937","1043"
"10927",180,78,102,"CCTTCACCACCATCAGCCAT","TACTTTCCTTAAATGAGTC","561307.5.peg.1937","1043"
"10928",403,78,325,"TGCATCTTTAATTAGTTCAC","TACTTTCCTTAAATGAGTC","561307.5.peg.1937","1043"
"10929",263,78,185,"CTTCAATAGGTCGCATTAAA","TACTTTCCTTAAATGAGTC","561307.5.peg.1937","1043"
"10930",235,103,132,"AACGATGACTGTATACTTAG","AATATTGCCAACTTGCTGTG","561307.5.peg.1937","1043"
"10931",263,103,160,"CTTCAATAGGTCGCATTAAA","AATATTGCCAACTTGCTGTG","561307.5.peg.1937","1043"
"10932",403,103,300,"TGCATCTTTAATTAGTTCAC","AATATTGCCAACTTGCTGTG","561307.5.peg.1937","1043"
"10933",10,160,150,"AGAGCGACAACAGTAATGAG","CGGAATGATATCATAATGAA","561307.5.peg.1937","1043"
"10934",263,160,103,"CTTCAATAGGTCGCATTAAA","CGGAATGATATCATAATGAA","561307.5.peg.1937","1043"
"10935",403,160,243,"TGCATCTTTAATTAGTTCAC","CGGAATGATATCATAATGAA","561307.5.peg.1937","1043"
"10936",403,180,223,"TGCATCTTTAATTAGTTCAC","CCTTCACCACCATCAGCCAT","561307.5.peg.1937","1043"
"10937",10,180,170,"AGAGCGACAACAGTAATGAG","CCTTCACCACCATCAGCCAT","561307.5.peg.1937","1043"
"10938",78,180,102,"TACTTTCCTTAAATGAGTC","CCTTCACCACCATCAGCCAT","561307.5.peg.1937","1043"
"10939",10,235,225,"AGAGCGACAACAGTAATGAG","AACGATGACTGTATACTTAG","561307.5.peg.1937","1043"
"10940",103,235,132,"AATATTGCCAACTTGCTGTG","AACGATGACTGTATACTTAG","561307.5.peg.1937","1043"
"10941",78,235,157,"TACTTTCCTTAAATGAGTC","AACGATGACTGTATACTTAG","561307.5.peg.1937","1043"
"10942",403,235,168,"TGCATCTTTAATTAGTTCAC","AACGATGACTGTATACTTAG","561307.5.peg.1937","1043"
"10943",10,263,253,"AGAGCGACAACAGTAATGAG","CTTCAATAGGTCGCATTAAA","561307.5.peg.1937","1043"
"10944",78,263,185,"TACTTTCCTTAAATGAGTC","CTTCAATAGGTCGCATTAAA","561307.5.peg.1937","1043"
"10945",403,263,140,"TGCATCTTTAATTAGTTCAC","CTTCAATAGGTCGCATTAAA","561307.5.peg.1937","1043"
"10946",160,263,103,"CGGAATGATATCATAATGAA","CTTCAATAGGTCGCATTAAA","561307.5.peg.1937","1043"
"10947",103,263,160,"AATATTGCCAACTTGCTGTG","CTTCAATAGGTCGCATTAAA","561307.5.peg.1937","1043"
"10948",103,403,300,"AATATTGCCAACTTGCTGTG","TGCATCTTTAATTAGTTCAC","561307.5.peg.1937","1043"
"10949",10,403,393,"AGAGCGACAACAGTAATGAG","TGCATCTTTAATTAGTTCAC","561307.5.peg.1937","1043"
"10950",180,403,223,"CCTTCACCACCATCAGCCAT","TGCATCTTTAATTAGTTCAC","561307.5.peg.1937","1043"
"10951",78,403,325,"TACTTTCCTTAAATGAGTC","TGCATCTTTAATTAGTTCAC","561307.5.peg.1937","1043"
"10952",160,403,243,"CGGAATGATATCATAATGAA","TGCATCTTTAATTAGTTCAC","561307.5.peg.1937","1043"
"10953",235,403,168,"AACGATGACTGTATACTTAG","TGCATCTTTAATTAGTTCAC","561307.5.peg.1937","1043"
"10954",263,403,140,"CTTCAATAGGTCGCATTAAA","TGCATCTTTAATTAGTTCAC","561307.5.peg.1937","1043"
"10955",277,162,115,"GCGACAATAATTAAGAGAA","TATCGTTCCGGGTGTTCTTC","561307.5.peg.1938","1044"
"10956",316,162,154,"TCGCTATCATTGTTAAGTA","TATCGTTCCGGGTGTTCTTC","561307.5.peg.1938","1044"
"10957",277,173,104,"GCGACAATAATTAAGAGAA","TACCATTATAGTATCGTTCC","561307.5.peg.1938","1044"
"10958",316,173,143,"TCGCTATCATTGTTAAGTA","TACCATTATAGTATCGTTCC","561307.5.peg.1938","1044"
"10959",162,277,115,"TATCGTTCCGGGTGTTCTTC","GCGACAATAATTAAGAGAA","561307.5.peg.1938","1044"
"10960",173,277,104,"TACCATTATAGTATCGTTCC","GCGACAATAATTAAGAGAA","561307.5.peg.1938","1044"
"10961",162,316,154,"TATCGTTCCGGGTGTTCTTC","TCGCTATCATTGTTAAGTA","561307.5.peg.1938","1044"
"10962",173,316,143,"TACCATTATAGTATCGTTCC","TCGCTATCATTGTTAAGTA","561307.5.peg.1938","1044"
"10963",424,128,296,"ACTAAATTTATCACCAGCAG","CGTACATATCTATAGTTAGT","561307.5.peg.1939","1045"
"10964",513,128,385,"AAAGCTAATCCACCGGCTAA","CGTACATATCTATAGTTAGT","561307.5.peg.1939","1045"
"10965",538,128,410,"AATAGAACGCCATGTTGCTA","CGTACATATCTATAGTTAGT","561307.5.peg.1939","1045"
"10966",128,424,296,"CGTACATATCTATAGTTAGT","ACTAAATTTATCACCAGCAG","561307.5.peg.1939","1045"
"10967",538,424,114,"AATAGAACGCCATGTTGCTA","ACTAAATTTATCACCAGCAG","561307.5.peg.1939","1045"
"10968",128,513,385,"CGTACATATCTATAGTTAGT","AAAGCTAATCCACCGGCTAA","561307.5.peg.1939","1045"
"10969",128,538,410,"CGTACATATCTATAGTTAGT","AATAGAACGCCATGTTGCTA","561307.5.peg.1939","1045"
"10970",424,538,114,"ACTAAATTTATCACCAGCAG","AATAGAACGCCATGTTGCTA","561307.5.peg.1939","1045"
"10971",116,11,105,"CACGTAAAGTATCACCAGGA","GGCAAGAACATAGGTTGAAG","561307.5.peg.194","1046"
"10972",176,11,165,"TTACAACGCCTTCGAATACT","GGCAAGAACATAGGTTGAAG","561307.5.peg.194","1046"
"10973",176,20,156,"TTACAACGCCTTCGAATACT","ATTTGTCGAGGCAAGAACAT","561307.5.peg.194","1046"
"10974",11,116,105,"GGCAAGAACATAGGTTGAAG","CACGTAAAGTATCACCAGGA","561307.5.peg.194","1046"
"10975",11,176,165,"GGCAAGAACATAGGTTGAAG","TTACAACGCCTTCGAATACT","561307.5.peg.194","1046"
"10976",20,176,156,"ATTTGTCGAGGCAAGAACAT","TTACAACGCCTTCGAATACT","561307.5.peg.194","1046"
"10977",195,69,126,"TGTGGATTGTTCGGATGTGT","AGCTGACTGATAGGTTTAAC","561307.5.peg.1941","1048"
"10978",315,69,246,"CCAGTGCCGTCTACGATATT","AGCTGACTGATAGGTTTAAC","561307.5.peg.1941","1048"
"10979",204,69,135,"TAACCTTTATGTGGATTGTT","AGCTGACTGATAGGTTTAAC","561307.5.peg.1941","1048"
"10980",213,69,144,"TGTCCAACATAACCTTTATG","AGCTGACTGATAGGTTTAAC","561307.5.peg.1941","1048"
"10981",195,78,117,"TGTGGATTGTTCGGATGTGT","ATAGGAAATAGCTGACTGAT","561307.5.peg.1941","1048"
"10982",204,78,126,"TAACCTTTATGTGGATTGTT","ATAGGAAATAGCTGACTGAT","561307.5.peg.1941","1048"
"10983",213,78,135,"TGTCCAACATAACCTTTATG","ATAGGAAATAGCTGACTGAT","561307.5.peg.1941","1048"
"10984",315,78,237,"CCAGTGCCGTCTACGATATT","ATAGGAAATAGCTGACTGAT","561307.5.peg.1941","1048"
"10985",213,96,117,"TGTCCAACATAACCTTTATG","CACCCCATGACCATAGGGAT","561307.5.peg.1941","1048"
"10986",204,96,108,"TAACCTTTATGTGGATTGTT","CACCCCATGACCATAGGGAT","561307.5.peg.1941","1048"
"10987",315,96,219,"CCAGTGCCGTCTACGATATT","CACCCCATGACCATAGGGAT","561307.5.peg.1941","1048"
"10988",213,101,112,"TGTCCAACATAACCTTTATG","CTTCACACCCCATGACCATA","561307.5.peg.1941","1048"
"10989",204,101,103,"TAACCTTTATGTGGATTGTT","CTTCACACCCCATGACCATA","561307.5.peg.1941","1048"
"10990",315,101,214,"CCAGTGCCGTCTACGATATT","CTTCACACCCCATGACCATA","561307.5.peg.1941","1048"
"10991",315,130,185,"CCAGTGCCGTCTACGATATT","GTATTGCAACATCATGGCTG","561307.5.peg.1941","1048"
"10992",315,158,157,"CCAGTGCCGTCTACGATATT","TTTCTGTAGCAGGGATATGT","561307.5.peg.1941","1048"
"10993",315,167,148,"CCAGTGCCGTCTACGATATT","GTCTCATAATTTCTGTAGCA","561307.5.peg.1941","1048"
"10994",69,195,126,"AGCTGACTGATAGGTTTAAC","TGTGGATTGTTCGGATGTGT","561307.5.peg.1941","1048"
"10995",78,195,117,"ATAGGAAATAGCTGACTGAT","TGTGGATTGTTCGGATGTGT","561307.5.peg.1941","1048"
"10996",315,195,120,"CCAGTGCCGTCTACGATATT","TGTGGATTGTTCGGATGTGT","561307.5.peg.1941","1048"
"10997",69,204,135,"AGCTGACTGATAGGTTTAAC","TAACCTTTATGTGGATTGTT","561307.5.peg.1941","1048"
"10998",78,204,126,"ATAGGAAATAGCTGACTGAT","TAACCTTTATGTGGATTGTT","561307.5.peg.1941","1048"
"10999",101,204,103,"CTTCACACCCCATGACCATA","TAACCTTTATGTGGATTGTT","561307.5.peg.1941","1048"
"11000",315,204,111,"CCAGTGCCGTCTACGATATT","TAACCTTTATGTGGATTGTT","561307.5.peg.1941","1048"
"11001",96,204,108,"CACCCCATGACCATAGGGAT","TAACCTTTATGTGGATTGTT","561307.5.peg.1941","1048"
"11002",96,213,117,"CACCCCATGACCATAGGGAT","TGTCCAACATAACCTTTATG","561307.5.peg.1941","1048"
"11003",69,213,144,"AGCTGACTGATAGGTTTAAC","TGTCCAACATAACCTTTATG","561307.5.peg.1941","1048"
"11004",315,213,102,"CCAGTGCCGTCTACGATATT","TGTCCAACATAACCTTTATG","561307.5.peg.1941","1048"
"11005",78,213,135,"ATAGGAAATAGCTGACTGAT","TGTCCAACATAACCTTTATG","561307.5.peg.1941","1048"
"11006",101,213,112,"CTTCACACCCCATGACCATA","TGTCCAACATAACCTTTATG","561307.5.peg.1941","1048"
"11007",69,315,246,"AGCTGACTGATAGGTTTAAC","CCAGTGCCGTCTACGATATT","561307.5.peg.1941","1048"
"11008",130,315,185,"GTATTGCAACATCATGGCTG","CCAGTGCCGTCTACGATATT","561307.5.peg.1941","1048"
"11009",158,315,157,"TTTCTGTAGCAGGGATATGT","CCAGTGCCGTCTACGATATT","561307.5.peg.1941","1048"
"11010",167,315,148,"GTCTCATAATTTCTGTAGCA","CCAGTGCCGTCTACGATATT","561307.5.peg.1941","1048"
"11011",78,315,237,"ATAGGAAATAGCTGACTGAT","CCAGTGCCGTCTACGATATT","561307.5.peg.1941","1048"
"11012",195,315,120,"TGTGGATTGTTCGGATGTGT","CCAGTGCCGTCTACGATATT","561307.5.peg.1941","1048"
"11013",204,315,111,"TAACCTTTATGTGGATTGTT","CCAGTGCCGTCTACGATATT","561307.5.peg.1941","1048"
"11014",213,315,102,"TGTCCAACATAACCTTTATG","CCAGTGCCGTCTACGATATT","561307.5.peg.1941","1048"
"11015",96,315,219,"CACCCCATGACCATAGGGAT","CCAGTGCCGTCTACGATATT","561307.5.peg.1941","1048"
"11016",101,315,214,"CTTCACACCCCATGACCATA","CCAGTGCCGTCTACGATATT","561307.5.peg.1941","1048"
"11017",243,106,137,"TTTCCAGGTACAAATTTCAC","CAATGCCTCTAAGTAATCTT","561307.5.peg.1942","1049"
"11018",258,106,152,"TCCCATAAATCATGGTTTCC","CAATGCCTCTAAGTAATCTT","561307.5.peg.1942","1049"
"11019",266,106,160,"TTCAACTTCCCATAAATCA","CAATGCCTCTAAGTAATCTT","561307.5.peg.1942","1049"
"11020",106,243,137,"CAATGCCTCTAAGTAATCTT","TTTCCAGGTACAAATTTCAC","561307.5.peg.1942","1049"
"11021",106,258,152,"CAATGCCTCTAAGTAATCTT","TCCCATAAATCATGGTTTCC","561307.5.peg.1942","1049"
"11022",106,266,160,"CAATGCCTCTAAGTAATCTT","TTCAACTTCCCATAAATCA","561307.5.peg.1942","1049"
"11023",407,7,400,"ATAGCACGGTAATCCAATTT","TTATTTGCTTTATCCTGAGG","561307.5.peg.1943","1050"
"11024",168,7,161,"TGTATGTGAATAACAGTGA","TTATTTGCTTTATCCTGAGG","561307.5.peg.1943","1050"
"11025",626,7,619,"AGAAACCAAATGTTCCACCA","TTATTTGCTTTATCCTGAGG","561307.5.peg.1943","1050"
"11026",469,7,462,"CTCCAGTTCACCAAATAATC","TTATTTGCTTTATCCTGAGG","561307.5.peg.1943","1050"
"11027",399,7,392,"GTAATCCAATTTGGGACTTG","TTATTTGCTTTATCCTGAGG","561307.5.peg.1943","1050"
"11028",362,7,355,"AGTATTGTCCCATCGCAGTT","TTATTTGCTTTATCCTGAGG","561307.5.peg.1943","1050"
"11029",134,7,127,"ATATTGTTTGACCTGATCCT","TTATTTGCTTTATCCTGAGG","561307.5.peg.1943","1050"
"11030",469,92,377,"CTCCAGTTCACCAAATAATC","CGCCCCCAATTGCTATTAAT","561307.5.peg.1943","1050"
"11031",399,92,307,"GTAATCCAATTTGGGACTTG","CGCCCCCAATTGCTATTAAT","561307.5.peg.1943","1050"
"11032",362,92,270,"AGTATTGTCCCATCGCAGTT","CGCCCCCAATTGCTATTAAT","561307.5.peg.1943","1050"
"11033",407,92,315,"ATAGCACGGTAATCCAATTT","CGCCCCCAATTGCTATTAAT","561307.5.peg.1943","1050"
"11034",626,92,534,"AGAAACCAAATGTTCCACCA","CGCCCCCAATTGCTATTAAT","561307.5.peg.1943","1050"
"11035",407,134,273,"ATAGCACGGTAATCCAATTT","ATATTGTTTGACCTGATCCT","561307.5.peg.1943","1050"
"11036",362,134,228,"AGTATTGTCCCATCGCAGTT","ATATTGTTTGACCTGATCCT","561307.5.peg.1943","1050"
"11037",626,134,492,"AGAAACCAAATGTTCCACCA","ATATTGTTTGACCTGATCCT","561307.5.peg.1943","1050"
"11038",399,134,265,"GTAATCCAATTTGGGACTTG","ATATTGTTTGACCTGATCCT","561307.5.peg.1943","1050"
"11039",7,134,127,"TTATTTGCTTTATCCTGAGG","ATATTGTTTGACCTGATCCT","561307.5.peg.1943","1050"
"11040",469,134,335,"CTCCAGTTCACCAAATAATC","ATATTGTTTGACCTGATCCT","561307.5.peg.1943","1050"
"11041",7,168,161,"TTATTTGCTTTATCCTGAGG","TGTATGTGAATAACAGTGA","561307.5.peg.1943","1050"
"11042",362,168,194,"AGTATTGTCCCATCGCAGTT","TGTATGTGAATAACAGTGA","561307.5.peg.1943","1050"
"11043",469,168,301,"CTCCAGTTCACCAAATAATC","TGTATGTGAATAACAGTGA","561307.5.peg.1943","1050"
"11044",399,168,231,"GTAATCCAATTTGGGACTTG","TGTATGTGAATAACAGTGA","561307.5.peg.1943","1050"
"11045",626,168,458,"AGAAACCAAATGTTCCACCA","TGTATGTGAATAACAGTGA","561307.5.peg.1943","1050"
"11046",407,168,239,"ATAGCACGGTAATCCAATTT","TGTATGTGAATAACAGTGA","561307.5.peg.1943","1050"
"11047",92,362,270,"CGCCCCCAATTGCTATTAAT","AGTATTGTCCCATCGCAGTT","561307.5.peg.1943","1050"
"11048",134,362,228,"ATATTGTTTGACCTGATCCT","AGTATTGTCCCATCGCAGTT","561307.5.peg.1943","1050"
"11049",469,362,107,"CTCCAGTTCACCAAATAATC","AGTATTGTCCCATCGCAGTT","561307.5.peg.1943","1050"
"11050",168,362,194,"TGTATGTGAATAACAGTGA","AGTATTGTCCCATCGCAGTT","561307.5.peg.1943","1050"
"11051",626,362,264,"AGAAACCAAATGTTCCACCA","AGTATTGTCCCATCGCAGTT","561307.5.peg.1943","1050"
"11052",7,362,355,"TTATTTGCTTTATCCTGAGG","AGTATTGTCCCATCGCAGTT","561307.5.peg.1943","1050"
"11053",92,399,307,"CGCCCCCAATTGCTATTAAT","GTAATCCAATTTGGGACTTG","561307.5.peg.1943","1050"
"11054",626,399,227,"AGAAACCAAATGTTCCACCA","GTAATCCAATTTGGGACTTG","561307.5.peg.1943","1050"
"11055",134,399,265,"ATATTGTTTGACCTGATCCT","GTAATCCAATTTGGGACTTG","561307.5.peg.1943","1050"
"11056",168,399,231,"TGTATGTGAATAACAGTGA","GTAATCCAATTTGGGACTTG","561307.5.peg.1943","1050"
"11057",7,399,392,"TTATTTGCTTTATCCTGAGG","GTAATCCAATTTGGGACTTG","561307.5.peg.1943","1050"
"11058",626,407,219,"AGAAACCAAATGTTCCACCA","ATAGCACGGTAATCCAATTT","561307.5.peg.1943","1050"
"11059",168,407,239,"TGTATGTGAATAACAGTGA","ATAGCACGGTAATCCAATTT","561307.5.peg.1943","1050"
"11060",92,407,315,"CGCCCCCAATTGCTATTAAT","ATAGCACGGTAATCCAATTT","561307.5.peg.1943","1050"
"11061",7,407,400,"TTATTTGCTTTATCCTGAGG","ATAGCACGGTAATCCAATTT","561307.5.peg.1943","1050"
"11062",134,407,273,"ATATTGTTTGACCTGATCCT","ATAGCACGGTAATCCAATTT","561307.5.peg.1943","1050"
"11063",92,469,377,"CGCCCCCAATTGCTATTAAT","CTCCAGTTCACCAAATAATC","561307.5.peg.1943","1050"
"11064",362,469,107,"AGTATTGTCCCATCGCAGTT","CTCCAGTTCACCAAATAATC","561307.5.peg.1943","1050"
"11065",134,469,335,"ATATTGTTTGACCTGATCCT","CTCCAGTTCACCAAATAATC","561307.5.peg.1943","1050"
"11066",7,469,462,"TTATTTGCTTTATCCTGAGG","CTCCAGTTCACCAAATAATC","561307.5.peg.1943","1050"
"11067",626,469,157,"AGAAACCAAATGTTCCACCA","CTCCAGTTCACCAAATAATC","561307.5.peg.1943","1050"
"11068",168,469,301,"TGTATGTGAATAACAGTGA","CTCCAGTTCACCAAATAATC","561307.5.peg.1943","1050"
"11069",399,626,227,"GTAATCCAATTTGGGACTTG","AGAAACCAAATGTTCCACCA","561307.5.peg.1943","1050"
"11070",7,626,619,"TTATTTGCTTTATCCTGAGG","AGAAACCAAATGTTCCACCA","561307.5.peg.1943","1050"
"11071",92,626,534,"CGCCCCCAATTGCTATTAAT","AGAAACCAAATGTTCCACCA","561307.5.peg.1943","1050"
"11072",469,626,157,"CTCCAGTTCACCAAATAATC","AGAAACCAAATGTTCCACCA","561307.5.peg.1943","1050"
"11073",168,626,458,"TGTATGTGAATAACAGTGA","AGAAACCAAATGTTCCACCA","561307.5.peg.1943","1050"
"11074",362,626,264,"AGTATTGTCCCATCGCAGTT","AGAAACCAAATGTTCCACCA","561307.5.peg.1943","1050"
"11075",407,626,219,"ATAGCACGGTAATCCAATTT","AGAAACCAAATGTTCCACCA","561307.5.peg.1943","1050"
"11076",134,626,492,"ATATTGTTTGACCTGATCCT","AGAAACCAAATGTTCCACCA","561307.5.peg.1943","1050"
"11077",806,122,684,"AACGGTCGCGTTCTAAACCA","TAAAGGCAGTAGGAATTTGT","561307.5.peg.1944","1051"
"11078",824,122,702,"CCGTTTGTGCTCTAATTAAA","TAAAGGCAGTAGGAATTTGT","561307.5.peg.1944","1051"
"11079",372,122,250,"GCGGCTGGCATTGGTAAGGC","TAAAGGCAGTAGGAATTTGT","561307.5.peg.1944","1051"
"11080",581,122,459,"GATAAATTGTTCAACAGCT","TAAAGGCAGTAGGAATTTGT","561307.5.peg.1944","1051"
"11081",581,132,449,"GATAAATTGTTCAACAGCT","GCAATTTGAATAAAGGCAGT","561307.5.peg.1944","1051"
"11082",372,132,240,"GCGGCTGGCATTGGTAAGGC","GCAATTTGAATAAAGGCAGT","561307.5.peg.1944","1051"
"11083",824,132,692,"CCGTTTGTGCTCTAATTAAA","GCAATTTGAATAAAGGCAGT","561307.5.peg.1944","1051"
"11084",806,132,674,"AACGGTCGCGTTCTAAACCA","GCAATTTGAATAAAGGCAGT","561307.5.peg.1944","1051"
"11085",122,372,250,"TAAAGGCAGTAGGAATTTGT","GCGGCTGGCATTGGTAAGGC","561307.5.peg.1944","1051"
"11086",581,372,209,"GATAAATTGTTCAACAGCT","GCGGCTGGCATTGGTAAGGC","561307.5.peg.1944","1051"
"11087",132,372,240,"GCAATTTGAATAAAGGCAGT","GCGGCTGGCATTGGTAAGGC","561307.5.peg.1944","1051"
"11088",806,372,434,"AACGGTCGCGTTCTAAACCA","GCGGCTGGCATTGGTAAGGC","561307.5.peg.1944","1051"
"11089",824,372,452,"CCGTTTGTGCTCTAATTAAA","GCGGCTGGCATTGGTAAGGC","561307.5.peg.1944","1051"
"11090",122,581,459,"TAAAGGCAGTAGGAATTTGT","GATAAATTGTTCAACAGCT","561307.5.peg.1944","1051"
"11091",132,581,449,"GCAATTTGAATAAAGGCAGT","GATAAATTGTTCAACAGCT","561307.5.peg.1944","1051"
"11092",372,581,209,"GCGGCTGGCATTGGTAAGGC","GATAAATTGTTCAACAGCT","561307.5.peg.1944","1051"
"11093",824,581,243,"CCGTTTGTGCTCTAATTAAA","GATAAATTGTTCAACAGCT","561307.5.peg.1944","1051"
"11094",806,581,225,"AACGGTCGCGTTCTAAACCA","GATAAATTGTTCAACAGCT","561307.5.peg.1944","1051"
"11095",122,806,684,"TAAAGGCAGTAGGAATTTGT","AACGGTCGCGTTCTAAACCA","561307.5.peg.1944","1051"
"11096",372,806,434,"GCGGCTGGCATTGGTAAGGC","AACGGTCGCGTTCTAAACCA","561307.5.peg.1944","1051"
"11097",132,806,674,"GCAATTTGAATAAAGGCAGT","AACGGTCGCGTTCTAAACCA","561307.5.peg.1944","1051"
"11098",581,806,225,"GATAAATTGTTCAACAGCT","AACGGTCGCGTTCTAAACCA","561307.5.peg.1944","1051"
"11099",122,824,702,"TAAAGGCAGTAGGAATTTGT","CCGTTTGTGCTCTAATTAAA","561307.5.peg.1944","1051"
"11100",132,824,692,"GCAATTTGAATAAAGGCAGT","CCGTTTGTGCTCTAATTAAA","561307.5.peg.1944","1051"
"11101",581,824,243,"GATAAATTGTTCAACAGCT","CCGTTTGTGCTCTAATTAAA","561307.5.peg.1944","1051"
"11102",372,824,452,"GCGGCTGGCATTGGTAAGGC","CCGTTTGTGCTCTAATTAAA","561307.5.peg.1944","1051"
"11103",315,183,132,"ATATACGCGCCGCCACCTTT","AGTGTAATCAGTATTTGTTC","561307.5.peg.1945","1052"
"11104",645,183,462,"CCTACTGATGCATGCATATG","AGTGTAATCAGTATTTGTTC","561307.5.peg.1945","1052"
"11105",550,183,367,"TACTGGATAGGATAATACGG","AGTGTAATCAGTATTTGTTC","561307.5.peg.1945","1052"
"11106",678,183,495,"AGCAAGAATAATGTTACTCC","AGTGTAATCAGTATTTGTTC","561307.5.peg.1945","1052"
"11107",620,183,437,"GAATATCTCCTGTCGCCACA","AGTGTAATCAGTATTTGTTC","561307.5.peg.1945","1052"
"11108",553,183,370,"TATACTGGATAGGATAATA","AGTGTAATCAGTATTTGTTC","561307.5.peg.1945","1052"
"11109",620,243,377,"GAATATCTCCTGTCGCCACA","ATCAGAACAGCACCTGCAAT","561307.5.peg.1945","1052"
"11110",553,243,310,"TATACTGGATAGGATAATA","ATCAGAACAGCACCTGCAAT","561307.5.peg.1945","1052"
"11111",645,243,402,"CCTACTGATGCATGCATATG","ATCAGAACAGCACCTGCAAT","561307.5.peg.1945","1052"
"11112",550,243,307,"TACTGGATAGGATAATACGG","ATCAGAACAGCACCTGCAAT","561307.5.peg.1945","1052"
"11113",678,243,435,"AGCAAGAATAATGTTACTCC","ATCAGAACAGCACCTGCAAT","561307.5.peg.1945","1052"
"11114",183,315,132,"AGTGTAATCAGTATTTGTTC","ATATACGCGCCGCCACCTTT","561307.5.peg.1945","1052"
"11115",678,315,363,"AGCAAGAATAATGTTACTCC","ATATACGCGCCGCCACCTTT","561307.5.peg.1945","1052"
"11116",620,315,305,"GAATATCTCCTGTCGCCACA","ATATACGCGCCGCCACCTTT","561307.5.peg.1945","1052"
"11117",645,315,330,"CCTACTGATGCATGCATATG","ATATACGCGCCGCCACCTTT","561307.5.peg.1945","1052"
"11118",553,315,238,"TATACTGGATAGGATAATA","ATATACGCGCCGCCACCTTT","561307.5.peg.1945","1052"
"11119",550,315,235,"TACTGGATAGGATAATACGG","ATATACGCGCCGCCACCTTT","561307.5.peg.1945","1052"
"11120",183,550,367,"AGTGTAATCAGTATTTGTTC","TACTGGATAGGATAATACGG","561307.5.peg.1945","1052"
"11121",315,550,235,"ATATACGCGCCGCCACCTTT","TACTGGATAGGATAATACGG","561307.5.peg.1945","1052"
"11122",243,550,307,"ATCAGAACAGCACCTGCAAT","TACTGGATAGGATAATACGG","561307.5.peg.1945","1052"
"11123",678,550,128,"AGCAAGAATAATGTTACTCC","TACTGGATAGGATAATACGG","561307.5.peg.1945","1052"
"11124",183,553,370,"AGTGTAATCAGTATTTGTTC","TATACTGGATAGGATAATA","561307.5.peg.1945","1052"
"11125",315,553,238,"ATATACGCGCCGCCACCTTT","TATACTGGATAGGATAATA","561307.5.peg.1945","1052"
"11126",678,553,125,"AGCAAGAATAATGTTACTCC","TATACTGGATAGGATAATA","561307.5.peg.1945","1052"
"11127",243,553,310,"ATCAGAACAGCACCTGCAAT","TATACTGGATAGGATAATA","561307.5.peg.1945","1052"
"11128",315,620,305,"ATATACGCGCCGCCACCTTT","GAATATCTCCTGTCGCCACA","561307.5.peg.1945","1052"
"11129",183,620,437,"AGTGTAATCAGTATTTGTTC","GAATATCTCCTGTCGCCACA","561307.5.peg.1945","1052"
"11130",243,620,377,"ATCAGAACAGCACCTGCAAT","GAATATCTCCTGTCGCCACA","561307.5.peg.1945","1052"
"11131",183,645,462,"AGTGTAATCAGTATTTGTTC","CCTACTGATGCATGCATATG","561307.5.peg.1945","1052"
"11132",315,645,330,"ATATACGCGCCGCCACCTTT","CCTACTGATGCATGCATATG","561307.5.peg.1945","1052"
"11133",243,645,402,"ATCAGAACAGCACCTGCAAT","CCTACTGATGCATGCATATG","561307.5.peg.1945","1052"
"11134",183,678,495,"AGTGTAATCAGTATTTGTTC","AGCAAGAATAATGTTACTCC","561307.5.peg.1945","1052"
"11135",315,678,363,"ATATACGCGCCGCCACCTTT","AGCAAGAATAATGTTACTCC","561307.5.peg.1945","1052"
"11136",243,678,435,"ATCAGAACAGCACCTGCAAT","AGCAAGAATAATGTTACTCC","561307.5.peg.1945","1052"
"11137",553,678,125,"TATACTGGATAGGATAATA","AGCAAGAATAATGTTACTCC","561307.5.peg.1945","1052"
"11138",550,678,128,"TACTGGATAGGATAATACGG","AGCAAGAATAATGTTACTCC","561307.5.peg.1945","1052"
"11139",312,157,155,"GCAATTTCATACTTTGTTGT","ATTTGTTGTTGCGAATCAT","561307.5.peg.1946","1053"
"11140",565,157,408,"TTCATCACCCATAATTGCAT","ATTTGTTGTTGCGAATCAT","561307.5.peg.1946","1053"
"11141",409,157,252,"ATGAGGCACATGTTTGGATA","ATTTGTTGTTGCGAATCAT","561307.5.peg.1946","1053"
"11142",600,157,443,"GAGTATTCAAATTCTTCTCC","ATTTGTTGTTGCGAATCAT","561307.5.peg.1946","1053"
"11143",711,157,554,"GATGTATGTGTCATATGCAA","ATTTGTTGTTGCGAATCAT","561307.5.peg.1946","1053"
"11144",157,312,155,"ATTTGTTGTTGCGAATCAT","GCAATTTCATACTTTGTTGT","561307.5.peg.1946","1053"
"11145",711,312,399,"GATGTATGTGTCATATGCAA","GCAATTTCATACTTTGTTGT","561307.5.peg.1946","1053"
"11146",565,312,253,"TTCATCACCCATAATTGCAT","GCAATTTCATACTTTGTTGT","561307.5.peg.1946","1053"
"11147",600,312,288,"GAGTATTCAAATTCTTCTCC","GCAATTTCATACTTTGTTGT","561307.5.peg.1946","1053"
"11148",157,409,252,"ATTTGTTGTTGCGAATCAT","ATGAGGCACATGTTTGGATA","561307.5.peg.1946","1053"
"11149",565,409,156,"TTCATCACCCATAATTGCAT","ATGAGGCACATGTTTGGATA","561307.5.peg.1946","1053"
"11150",600,409,191,"GAGTATTCAAATTCTTCTCC","ATGAGGCACATGTTTGGATA","561307.5.peg.1946","1053"
"11151",711,409,302,"GATGTATGTGTCATATGCAA","ATGAGGCACATGTTTGGATA","561307.5.peg.1946","1053"
"11152",157,565,408,"ATTTGTTGTTGCGAATCAT","TTCATCACCCATAATTGCAT","561307.5.peg.1946","1053"
"11153",312,565,253,"GCAATTTCATACTTTGTTGT","TTCATCACCCATAATTGCAT","561307.5.peg.1946","1053"
"11154",711,565,146,"GATGTATGTGTCATATGCAA","TTCATCACCCATAATTGCAT","561307.5.peg.1946","1053"
"11155",409,565,156,"ATGAGGCACATGTTTGGATA","TTCATCACCCATAATTGCAT","561307.5.peg.1946","1053"
"11156",711,600,111,"GATGTATGTGTCATATGCAA","GAGTATTCAAATTCTTCTCC","561307.5.peg.1946","1053"
"11157",157,600,443,"ATTTGTTGTTGCGAATCAT","GAGTATTCAAATTCTTCTCC","561307.5.peg.1946","1053"
"11158",312,600,288,"GCAATTTCATACTTTGTTGT","GAGTATTCAAATTCTTCTCC","561307.5.peg.1946","1053"
"11159",409,600,191,"ATGAGGCACATGTTTGGATA","GAGTATTCAAATTCTTCTCC","561307.5.peg.1946","1053"
"11160",565,711,146,"TTCATCACCCATAATTGCAT","GATGTATGTGTCATATGCAA","561307.5.peg.1946","1053"
"11161",600,711,111,"GAGTATTCAAATTCTTCTCC","GATGTATGTGTCATATGCAA","561307.5.peg.1946","1053"
"11162",157,711,554,"ATTTGTTGTTGCGAATCAT","GATGTATGTGTCATATGCAA","561307.5.peg.1946","1053"
"11163",312,711,399,"GCAATTTCATACTTTGTTGT","GATGTATGTGTCATATGCAA","561307.5.peg.1946","1053"
"11164",409,711,302,"ATGAGGCACATGTTTGGATA","GATGTATGTGTCATATGCAA","561307.5.peg.1946","1053"
"11165",455,1,454,"CAAGTAAATGACTGTGTCCA","AACGATGAAGAGGGGTTTAT","561307.5.peg.1948","1055"
"11166",455,9,446,"CAAGTAAATGACTGTGTCCA","TGAACAACAACGATGAAGAG","561307.5.peg.1948","1055"
"11167",455,11,444,"CAAGTAAATGACTGTGTCCA","AATGAACAACAACGATGAAG","561307.5.peg.1948","1055"
"11168",455,100,355,"CAAGTAAATGACTGTGTCCA","TATCCTGCTTGAAATAGTT","561307.5.peg.1948","1055"
"11169",1,455,454,"AACGATGAAGAGGGGTTTAT","CAAGTAAATGACTGTGTCCA","561307.5.peg.1948","1055"
"11170",9,455,446,"TGAACAACAACGATGAAGAG","CAAGTAAATGACTGTGTCCA","561307.5.peg.1948","1055"
"11171",11,455,444,"AATGAACAACAACGATGAAG","CAAGTAAATGACTGTGTCCA","561307.5.peg.1948","1055"
"11172",100,455,355,"TATCCTGCTTGAAATAGTT","CAAGTAAATGACTGTGTCCA","561307.5.peg.1948","1055"
"11173",207,5,202,"ATACCTTGTCCGCCACCATA","CACGCCAATGGAAGGATTGT","561307.5.peg.195","1057"
"11174",207,13,194,"ATACCTTGTCCGCCACCATA","ATTATCATCACGCCAATGGA","561307.5.peg.195","1057"
"11175",207,28,179,"ATACCTTGTCCGCCACCATA","TAATCCAACAATCCTTCCAT","561307.5.peg.195","1057"
"11176",5,207,202,"CACGCCAATGGAAGGATTGT","ATACCTTGTCCGCCACCATA","561307.5.peg.195","1057"
"11177",13,207,194,"ATTATCATCACGCCAATGGA","ATACCTTGTCCGCCACCATA","561307.5.peg.195","1057"
"11178",28,207,179,"TAATCCAACAATCCTTCCAT","ATACCTTGTCCGCCACCATA","561307.5.peg.195","1057"
"11179",120,9,111,"GTGCTCTTACTACCTAGTCC","AAGTATCTGGATAATTAGG","561307.5.peg.1951","1059"
"11180",9,120,111,"AAGTATCTGGATAATTAGG","GTGCTCTTACTACCTAGTCC","561307.5.peg.1951","1059"
"11181",193,13,180,"GCCACAGTTAATACAATAT","AATGTCAAAGTACGTGACAT","561307.5.peg.1952","1060"
"11182",234,13,221,"ATAGCAAGTACAGCTAGTGT","AATGTCAAAGTACGTGACAT","561307.5.peg.1952","1060"
"11183",288,13,275,"ATAAATAGCGCTACAATTGC","AATGTCAAAGTACGTGACAT","561307.5.peg.1952","1060"
"11184",13,193,180,"AATGTCAAAGTACGTGACAT","GCCACAGTTAATACAATAT","561307.5.peg.1952","1060"
"11185",13,234,221,"AATGTCAAAGTACGTGACAT","ATAGCAAGTACAGCTAGTGT","561307.5.peg.1952","1060"
"11186",13,288,275,"AATGTCAAAGTACGTGACAT","ATAAATAGCGCTACAATTGC","561307.5.peg.1952","1060"
"11187",447,197,250,"TGCCCACCTGATAGTTCTGC","CTTCTGTCGCTTCAATCATA","561307.5.peg.1953","1061"
"11188",315,197,118,"TCTCTTTAATCGTCATATG","CTTCTGTCGCTTCAATCATA","561307.5.peg.1953","1061"
"11189",552,197,355,"TGTAACGTATCTCTCGTAAT","CTTCTGTCGCTTCAATCATA","561307.5.peg.1953","1061"
"11190",552,261,291,"TGTAACGTATCTCTCGTAAT","ATATTTCTACGCAATTCGAC","561307.5.peg.1953","1061"
"11191",447,261,186,"TGCCCACCTGATAGTTCTGC","ATATTTCTACGCAATTCGAC","561307.5.peg.1953","1061"
"11192",197,315,118,"CTTCTGTCGCTTCAATCATA","TCTCTTTAATCGTCATATG","561307.5.peg.1953","1061"
"11193",552,315,237,"TGTAACGTATCTCTCGTAAT","TCTCTTTAATCGTCATATG","561307.5.peg.1953","1061"
"11194",447,315,132,"TGCCCACCTGATAGTTCTGC","TCTCTTTAATCGTCATATG","561307.5.peg.1953","1061"
"11195",315,447,132,"TCTCTTTAATCGTCATATG","TGCCCACCTGATAGTTCTGC","561307.5.peg.1953","1061"
"11196",197,447,250,"CTTCTGTCGCTTCAATCATA","TGCCCACCTGATAGTTCTGC","561307.5.peg.1953","1061"
"11197",261,447,186,"ATATTTCTACGCAATTCGAC","TGCCCACCTGATAGTTCTGC","561307.5.peg.1953","1061"
"11198",552,447,105,"TGTAACGTATCTCTCGTAAT","TGCCCACCTGATAGTTCTGC","561307.5.peg.1953","1061"
"11199",261,552,291,"ATATTTCTACGCAATTCGAC","TGTAACGTATCTCTCGTAAT","561307.5.peg.1953","1061"
"11200",197,552,355,"CTTCTGTCGCTTCAATCATA","TGTAACGTATCTCTCGTAAT","561307.5.peg.1953","1061"
"11201",447,552,105,"TGCCCACCTGATAGTTCTGC","TGTAACGTATCTCTCGTAAT","561307.5.peg.1953","1061"
"11202",315,552,237,"TCTCTTTAATCGTCATATG","TGTAACGTATCTCTCGTAAT","561307.5.peg.1953","1061"
"11203",586,94,492,"TGATAGCATCAACATGATGA","AACCCTAATAAGACTAATT","561307.5.peg.1955","1063"
"11204",289,94,195,"TAATGAGCCATGTGTATACT","AACCCTAATAAGACTAATT","561307.5.peg.1955","1063"
"11205",229,94,135,"GCCGATTTCAATGTAGTTAT","AACCCTAATAAGACTAATT","561307.5.peg.1955","1063"
"11206",405,94,311,"ATTGGTTTCGCCCAATGCCA","AACCCTAATAAGACTAATT","561307.5.peg.1955","1063"
"11207",576,94,482,"AACATGATGATGGTTAACAT","AACCCTAATAAGACTAATT","561307.5.peg.1955","1063"
"11208",209,94,115,"AGGCAATGGTTCCAATGACT","AACCCTAATAAGACTAATT","561307.5.peg.1955","1063"
"11209",261,94,167,"TTACTCATGCCACCTGATTG","AACCCTAATAAGACTAATT","561307.5.peg.1955","1063"
"11210",363,94,269,"ACAGCTGACACAGCTTCGAT","AACCCTAATAAGACTAATT","561307.5.peg.1955","1063"
"11211",223,94,129,"TCAATGTAGTTATAGGCAA","AACCCTAATAAGACTAATT","561307.5.peg.1955","1063"
"11212",632,94,538,"GCATAAATGTGCTTGCCGAA","AACCCTAATAAGACTAATT","561307.5.peg.1955","1063"
"11213",576,177,399,"AACATGATGATGGTTAACAT","ACCCATGATATGATTGCTGC","561307.5.peg.1955","1063"
"11214",632,177,455,"GCATAAATGTGCTTGCCGAA","ACCCATGATATGATTGCTGC","561307.5.peg.1955","1063"
"11215",289,177,112,"TAATGAGCCATGTGTATACT","ACCCATGATATGATTGCTGC","561307.5.peg.1955","1063"
"11216",586,177,409,"TGATAGCATCAACATGATGA","ACCCATGATATGATTGCTGC","561307.5.peg.1955","1063"
"11217",405,177,228,"ATTGGTTTCGCCCAATGCCA","ACCCATGATATGATTGCTGC","561307.5.peg.1955","1063"
"11218",363,177,186,"ACAGCTGACACAGCTTCGAT","ACCCATGATATGATTGCTGC","561307.5.peg.1955","1063"
"11219",576,209,367,"AACATGATGATGGTTAACAT","AGGCAATGGTTCCAATGACT","561307.5.peg.1955","1063"
"11220",632,209,423,"GCATAAATGTGCTTGCCGAA","AGGCAATGGTTCCAATGACT","561307.5.peg.1955","1063"
"11221",586,209,377,"TGATAGCATCAACATGATGA","AGGCAATGGTTCCAATGACT","561307.5.peg.1955","1063"
"11222",94,209,115,"AACCCTAATAAGACTAATT","AGGCAATGGTTCCAATGACT","561307.5.peg.1955","1063"
"11223",363,209,154,"ACAGCTGACACAGCTTCGAT","AGGCAATGGTTCCAATGACT","561307.5.peg.1955","1063"
"11224",405,209,196,"ATTGGTTTCGCCCAATGCCA","AGGCAATGGTTCCAATGACT","561307.5.peg.1955","1063"
"11225",363,223,140,"ACAGCTGACACAGCTTCGAT","TCAATGTAGTTATAGGCAA","561307.5.peg.1955","1063"
"11226",632,223,409,"GCATAAATGTGCTTGCCGAA","TCAATGTAGTTATAGGCAA","561307.5.peg.1955","1063"
"11227",576,223,353,"AACATGATGATGGTTAACAT","TCAATGTAGTTATAGGCAA","561307.5.peg.1955","1063"
"11228",586,223,363,"TGATAGCATCAACATGATGA","TCAATGTAGTTATAGGCAA","561307.5.peg.1955","1063"
"11229",405,223,182,"ATTGGTTTCGCCCAATGCCA","TCAATGTAGTTATAGGCAA","561307.5.peg.1955","1063"
"11230",94,223,129,"AACCCTAATAAGACTAATT","TCAATGTAGTTATAGGCAA","561307.5.peg.1955","1063"
"11231",94,229,135,"AACCCTAATAAGACTAATT","GCCGATTTCAATGTAGTTAT","561307.5.peg.1955","1063"
"11232",576,229,347,"AACATGATGATGGTTAACAT","GCCGATTTCAATGTAGTTAT","561307.5.peg.1955","1063"
"11233",363,229,134,"ACAGCTGACACAGCTTCGAT","GCCGATTTCAATGTAGTTAT","561307.5.peg.1955","1063"
"11234",405,229,176,"ATTGGTTTCGCCCAATGCCA","GCCGATTTCAATGTAGTTAT","561307.5.peg.1955","1063"
"11235",632,229,403,"GCATAAATGTGCTTGCCGAA","GCCGATTTCAATGTAGTTAT","561307.5.peg.1955","1063"
"11236",586,229,357,"TGATAGCATCAACATGATGA","GCCGATTTCAATGTAGTTAT","561307.5.peg.1955","1063"
"11237",94,261,167,"AACCCTAATAAGACTAATT","TTACTCATGCCACCTGATTG","561307.5.peg.1955","1063"
"11238",632,261,371,"GCATAAATGTGCTTGCCGAA","TTACTCATGCCACCTGATTG","561307.5.peg.1955","1063"
"11239",363,261,102,"ACAGCTGACACAGCTTCGAT","TTACTCATGCCACCTGATTG","561307.5.peg.1955","1063"
"11240",405,261,144,"ATTGGTTTCGCCCAATGCCA","TTACTCATGCCACCTGATTG","561307.5.peg.1955","1063"
"11241",576,261,315,"AACATGATGATGGTTAACAT","TTACTCATGCCACCTGATTG","561307.5.peg.1955","1063"
"11242",586,261,325,"TGATAGCATCAACATGATGA","TTACTCATGCCACCTGATTG","561307.5.peg.1955","1063"
"11243",632,289,343,"GCATAAATGTGCTTGCCGAA","TAATGAGCCATGTGTATACT","561307.5.peg.1955","1063"
"11244",576,289,287,"AACATGATGATGGTTAACAT","TAATGAGCCATGTGTATACT","561307.5.peg.1955","1063"
"11245",94,289,195,"AACCCTAATAAGACTAATT","TAATGAGCCATGTGTATACT","561307.5.peg.1955","1063"
"11246",405,289,116,"ATTGGTTTCGCCCAATGCCA","TAATGAGCCATGTGTATACT","561307.5.peg.1955","1063"
"11247",177,289,112,"ACCCATGATATGATTGCTGC","TAATGAGCCATGTGTATACT","561307.5.peg.1955","1063"
"11248",586,289,297,"TGATAGCATCAACATGATGA","TAATGAGCCATGTGTATACT","561307.5.peg.1955","1063"
"11249",586,363,223,"TGATAGCATCAACATGATGA","ACAGCTGACACAGCTTCGAT","561307.5.peg.1955","1063"
"11250",632,363,269,"GCATAAATGTGCTTGCCGAA","ACAGCTGACACAGCTTCGAT","561307.5.peg.1955","1063"
"11251",177,363,186,"ACCCATGATATGATTGCTGC","ACAGCTGACACAGCTTCGAT","561307.5.peg.1955","1063"
"11252",94,363,269,"AACCCTAATAAGACTAATT","ACAGCTGACACAGCTTCGAT","561307.5.peg.1955","1063"
"11253",209,363,154,"AGGCAATGGTTCCAATGACT","ACAGCTGACACAGCTTCGAT","561307.5.peg.1955","1063"
"11254",576,363,213,"AACATGATGATGGTTAACAT","ACAGCTGACACAGCTTCGAT","561307.5.peg.1955","1063"
"11255",223,363,140,"TCAATGTAGTTATAGGCAA","ACAGCTGACACAGCTTCGAT","561307.5.peg.1955","1063"
"11256",229,363,134,"GCCGATTTCAATGTAGTTAT","ACAGCTGACACAGCTTCGAT","561307.5.peg.1955","1063"
"11257",261,363,102,"TTACTCATGCCACCTGATTG","ACAGCTGACACAGCTTCGAT","561307.5.peg.1955","1063"
"11258",632,405,227,"GCATAAATGTGCTTGCCGAA","ATTGGTTTCGCCCAATGCCA","561307.5.peg.1955","1063"
"11259",209,405,196,"AGGCAATGGTTCCAATGACT","ATTGGTTTCGCCCAATGCCA","561307.5.peg.1955","1063"
"11260",289,405,116,"TAATGAGCCATGTGTATACT","ATTGGTTTCGCCCAATGCCA","561307.5.peg.1955","1063"
"11261",177,405,228,"ACCCATGATATGATTGCTGC","ATTGGTTTCGCCCAATGCCA","561307.5.peg.1955","1063"
"11262",223,405,182,"TCAATGTAGTTATAGGCAA","ATTGGTTTCGCCCAATGCCA","561307.5.peg.1955","1063"
"11263",261,405,144,"TTACTCATGCCACCTGATTG","ATTGGTTTCGCCCAATGCCA","561307.5.peg.1955","1063"
"11264",94,405,311,"AACCCTAATAAGACTAATT","ATTGGTTTCGCCCAATGCCA","561307.5.peg.1955","1063"
"11265",586,405,181,"TGATAGCATCAACATGATGA","ATTGGTTTCGCCCAATGCCA","561307.5.peg.1955","1063"
"11266",229,405,176,"GCCGATTTCAATGTAGTTAT","ATTGGTTTCGCCCAATGCCA","561307.5.peg.1955","1063"
"11267",576,405,171,"AACATGATGATGGTTAACAT","ATTGGTTTCGCCCAATGCCA","561307.5.peg.1955","1063"
"11268",177,576,399,"ACCCATGATATGATTGCTGC","AACATGATGATGGTTAACAT","561307.5.peg.1955","1063"
"11269",229,576,347,"GCCGATTTCAATGTAGTTAT","AACATGATGATGGTTAACAT","561307.5.peg.1955","1063"
"11270",289,576,287,"TAATGAGCCATGTGTATACT","AACATGATGATGGTTAACAT","561307.5.peg.1955","1063"
"11271",405,576,171,"ATTGGTTTCGCCCAATGCCA","AACATGATGATGGTTAACAT","561307.5.peg.1955","1063"
"11272",94,576,482,"AACCCTAATAAGACTAATT","AACATGATGATGGTTAACAT","561307.5.peg.1955","1063"
"11273",223,576,353,"TCAATGTAGTTATAGGCAA","AACATGATGATGGTTAACAT","561307.5.peg.1955","1063"
"11274",363,576,213,"ACAGCTGACACAGCTTCGAT","AACATGATGATGGTTAACAT","561307.5.peg.1955","1063"
"11275",261,576,315,"TTACTCATGCCACCTGATTG","AACATGATGATGGTTAACAT","561307.5.peg.1955","1063"
"11276",209,576,367,"AGGCAATGGTTCCAATGACT","AACATGATGATGGTTAACAT","561307.5.peg.1955","1063"
"11277",261,586,325,"TTACTCATGCCACCTGATTG","TGATAGCATCAACATGATGA","561307.5.peg.1955","1063"
"11278",229,586,357,"GCCGATTTCAATGTAGTTAT","TGATAGCATCAACATGATGA","561307.5.peg.1955","1063"
"11279",289,586,297,"TAATGAGCCATGTGTATACT","TGATAGCATCAACATGATGA","561307.5.peg.1955","1063"
"11280",223,586,363,"TCAATGTAGTTATAGGCAA","TGATAGCATCAACATGATGA","561307.5.peg.1955","1063"
"11281",177,586,409,"ACCCATGATATGATTGCTGC","TGATAGCATCAACATGATGA","561307.5.peg.1955","1063"
"11282",209,586,377,"AGGCAATGGTTCCAATGACT","TGATAGCATCAACATGATGA","561307.5.peg.1955","1063"
"11283",94,586,492,"AACCCTAATAAGACTAATT","TGATAGCATCAACATGATGA","561307.5.peg.1955","1063"
"11284",363,586,223,"ACAGCTGACACAGCTTCGAT","TGATAGCATCAACATGATGA","561307.5.peg.1955","1063"
"11285",405,586,181,"ATTGGTTTCGCCCAATGCCA","TGATAGCATCAACATGATGA","561307.5.peg.1955","1063"
"11286",177,632,455,"ACCCATGATATGATTGCTGC","GCATAAATGTGCTTGCCGAA","561307.5.peg.1955","1063"
"11287",209,632,423,"AGGCAATGGTTCCAATGACT","GCATAAATGTGCTTGCCGAA","561307.5.peg.1955","1063"
"11288",94,632,538,"AACCCTAATAAGACTAATT","GCATAAATGTGCTTGCCGAA","561307.5.peg.1955","1063"
"11289",289,632,343,"TAATGAGCCATGTGTATACT","GCATAAATGTGCTTGCCGAA","561307.5.peg.1955","1063"
"11290",223,632,409,"TCAATGTAGTTATAGGCAA","GCATAAATGTGCTTGCCGAA","561307.5.peg.1955","1063"
"11291",405,632,227,"ATTGGTTTCGCCCAATGCCA","GCATAAATGTGCTTGCCGAA","561307.5.peg.1955","1063"
"11292",363,632,269,"ACAGCTGACACAGCTTCGAT","GCATAAATGTGCTTGCCGAA","561307.5.peg.1955","1063"
"11293",229,632,403,"GCCGATTTCAATGTAGTTAT","GCATAAATGTGCTTGCCGAA","561307.5.peg.1955","1063"
"11294",261,632,371,"TTACTCATGCCACCTGATTG","GCATAAATGTGCTTGCCGAA","561307.5.peg.1955","1063"
"11295",221,7,214,"ATTTGTTGTCTGGTTGCGGT","TCCCCAATTTAATCATACCA","561307.5.peg.1956","1064"
"11296",524,7,517,"GACATTGATTTGATCTGAA","TCCCCAATTTAATCATACCA","561307.5.peg.1956","1064"
"11297",514,7,507,"TTGATCTGAAAGGCCATTAT","TCCCCAATTTAATCATACCA","561307.5.peg.1956","1064"
"11298",123,7,116,"TGAACTGGTGGTTCTGCATA","TCCCCAATTTAATCATACCA","561307.5.peg.1956","1064"
"11299",138,7,131,"TTAAAGCGATTGTCATGAAC","TCCCCAATTTAATCATACCA","561307.5.peg.1956","1064"
"11300",216,7,209,"TTGTCTGGTTGCGGTGGGAT","TCCCCAATTTAATCATACCA","561307.5.peg.1956","1064"
"11301",394,7,387,"ATGTGCCGGTTGATAGAGTT","TCCCCAATTTAATCATACCA","561307.5.peg.1956","1064"
"11302",135,7,128,"AAGCGATTGTCATGAACTGG","TCCCCAATTTAATCATACCA","561307.5.peg.1956","1064"
"11303",654,7,647,"TGGAAGTATGGCTCAATGTC","TCCCCAATTTAATCATACCA","561307.5.peg.1956","1064"
"11304",574,7,567,"GTTATTAGCGTCGCCACCGA","TCCCCAATTTAATCATACCA","561307.5.peg.1956","1064"
"11305",192,7,185,"GTATTTCAGTTGCATCAAT","TCCCCAATTTAATCATACCA","561307.5.peg.1956","1064"
"11306",225,7,218,"TCTAATTTGTTGTCTGGTTG","TCCCCAATTTAATCATACCA","561307.5.peg.1956","1064"
"11307",666,7,659,"AGAACGACTTTATGGAAGTA","TCCCCAATTTAATCATACCA","561307.5.peg.1956","1064"
"11308",674,7,667,"CACTTAGTAGAACGACTTTA","TCCCCAATTTAATCATACCA","561307.5.peg.1956","1064"
"11309",138,10,128,"TTAAAGCGATTGTCATGAAC","TAAATTGGGGATGATAAAGG","561307.5.peg.1956","1064"
"11310",524,10,514,"GACATTGATTTGATCTGAA","TAAATTGGGGATGATAAAGG","561307.5.peg.1956","1064"
"11311",135,10,125,"AAGCGATTGTCATGAACTGG","TAAATTGGGGATGATAAAGG","561307.5.peg.1956","1064"
"11312",514,10,504,"TTGATCTGAAAGGCCATTAT","TAAATTGGGGATGATAAAGG","561307.5.peg.1956","1064"
"11313",654,10,644,"TGGAAGTATGGCTCAATGTC","TAAATTGGGGATGATAAAGG","561307.5.peg.1956","1064"
"11314",574,10,564,"GTTATTAGCGTCGCCACCGA","TAAATTGGGGATGATAAAGG","561307.5.peg.1956","1064"
"11315",225,10,215,"TCTAATTTGTTGTCTGGTTG","TAAATTGGGGATGATAAAGG","561307.5.peg.1956","1064"
"11316",674,10,664,"CACTTAGTAGAACGACTTTA","TAAATTGGGGATGATAAAGG","561307.5.peg.1956","1064"
"11317",394,10,384,"ATGTGCCGGTTGATAGAGTT","TAAATTGGGGATGATAAAGG","561307.5.peg.1956","1064"
"11318",666,10,656,"AGAACGACTTTATGGAAGTA","TAAATTGGGGATGATAAAGG","561307.5.peg.1956","1064"
"11319",123,10,113,"TGAACTGGTGGTTCTGCATA","TAAATTGGGGATGATAAAGG","561307.5.peg.1956","1064"
"11320",221,10,211,"ATTTGTTGTCTGGTTGCGGT","TAAATTGGGGATGATAAAGG","561307.5.peg.1956","1064"
"11321",216,10,206,"TTGTCTGGTTGCGGTGGGAT","TAAATTGGGGATGATAAAGG","561307.5.peg.1956","1064"
"11322",192,10,182,"GTATTTCAGTTGCATCAAT","TAAATTGGGGATGATAAAGG","561307.5.peg.1956","1064"
"11323",221,23,198,"ATTTGTTGTCTGGTTGCGGT","ACCGTGGTATGATTAAATTG","561307.5.peg.1956","1064"
"11324",524,23,501,"GACATTGATTTGATCTGAA","ACCGTGGTATGATTAAATTG","561307.5.peg.1956","1064"
"11325",123,23,100,"TGAACTGGTGGTTCTGCATA","ACCGTGGTATGATTAAATTG","561307.5.peg.1956","1064"
"11326",394,23,371,"ATGTGCCGGTTGATAGAGTT","ACCGTGGTATGATTAAATTG","561307.5.peg.1956","1064"
"11327",138,23,115,"TTAAAGCGATTGTCATGAAC","ACCGTGGTATGATTAAATTG","561307.5.peg.1956","1064"
"11328",225,23,202,"TCTAATTTGTTGTCTGGTTG","ACCGTGGTATGATTAAATTG","561307.5.peg.1956","1064"
"11329",654,23,631,"TGGAAGTATGGCTCAATGTC","ACCGTGGTATGATTAAATTG","561307.5.peg.1956","1064"
"11330",135,23,112,"AAGCGATTGTCATGAACTGG","ACCGTGGTATGATTAAATTG","561307.5.peg.1956","1064"
"11331",674,23,651,"CACTTAGTAGAACGACTTTA","ACCGTGGTATGATTAAATTG","561307.5.peg.1956","1064"
"11332",666,23,643,"AGAACGACTTTATGGAAGTA","ACCGTGGTATGATTAAATTG","561307.5.peg.1956","1064"
"11333",216,23,193,"TTGTCTGGTTGCGGTGGGAT","ACCGTGGTATGATTAAATTG","561307.5.peg.1956","1064"
"11334",514,23,491,"TTGATCTGAAAGGCCATTAT","ACCGTGGTATGATTAAATTG","561307.5.peg.1956","1064"
"11335",192,23,169,"GTATTTCAGTTGCATCAAT","ACCGTGGTATGATTAAATTG","561307.5.peg.1956","1064"
"11336",574,23,551,"GTTATTAGCGTCGCCACCGA","ACCGTGGTATGATTAAATTG","561307.5.peg.1956","1064"
"11337",10,123,113,"TAAATTGGGGATGATAAAGG","TGAACTGGTGGTTCTGCATA","561307.5.peg.1956","1064"
"11338",7,123,116,"TCCCCAATTTAATCATACCA","TGAACTGGTGGTTCTGCATA","561307.5.peg.1956","1064"
"11339",524,123,401,"GACATTGATTTGATCTGAA","TGAACTGGTGGTTCTGCATA","561307.5.peg.1956","1064"
"11340",225,123,102,"TCTAATTTGTTGTCTGGTTG","TGAACTGGTGGTTCTGCATA","561307.5.peg.1956","1064"
"11341",666,123,543,"AGAACGACTTTATGGAAGTA","TGAACTGGTGGTTCTGCATA","561307.5.peg.1956","1064"
"11342",674,123,551,"CACTTAGTAGAACGACTTTA","TGAACTGGTGGTTCTGCATA","561307.5.peg.1956","1064"
"11343",23,123,100,"ACCGTGGTATGATTAAATTG","TGAACTGGTGGTTCTGCATA","561307.5.peg.1956","1064"
"11344",574,123,451,"GTTATTAGCGTCGCCACCGA","TGAACTGGTGGTTCTGCATA","561307.5.peg.1956","1064"
"11345",394,123,271,"ATGTGCCGGTTGATAGAGTT","TGAACTGGTGGTTCTGCATA","561307.5.peg.1956","1064"
"11346",654,123,531,"TGGAAGTATGGCTCAATGTC","TGAACTGGTGGTTCTGCATA","561307.5.peg.1956","1064"
"11347",514,123,391,"TTGATCTGAAAGGCCATTAT","TGAACTGGTGGTTCTGCATA","561307.5.peg.1956","1064"
"11348",574,135,439,"GTTATTAGCGTCGCCACCGA","AAGCGATTGTCATGAACTGG","561307.5.peg.1956","1064"
"11349",7,135,128,"TCCCCAATTTAATCATACCA","AAGCGATTGTCATGAACTGG","561307.5.peg.1956","1064"
"11350",10,135,125,"TAAATTGGGGATGATAAAGG","AAGCGATTGTCATGAACTGG","561307.5.peg.1956","1064"
"11351",394,135,259,"ATGTGCCGGTTGATAGAGTT","AAGCGATTGTCATGAACTGG","561307.5.peg.1956","1064"
"11352",666,135,531,"AGAACGACTTTATGGAAGTA","AAGCGATTGTCATGAACTGG","561307.5.peg.1956","1064"
"11353",654,135,519,"TGGAAGTATGGCTCAATGTC","AAGCGATTGTCATGAACTGG","561307.5.peg.1956","1064"
"11354",674,135,539,"CACTTAGTAGAACGACTTTA","AAGCGATTGTCATGAACTGG","561307.5.peg.1956","1064"
"11355",23,135,112,"ACCGTGGTATGATTAAATTG","AAGCGATTGTCATGAACTGG","561307.5.peg.1956","1064"
"11356",514,135,379,"TTGATCTGAAAGGCCATTAT","AAGCGATTGTCATGAACTGG","561307.5.peg.1956","1064"
"11357",524,135,389,"GACATTGATTTGATCTGAA","AAGCGATTGTCATGAACTGG","561307.5.peg.1956","1064"
"11358",524,138,386,"GACATTGATTTGATCTGAA","TTAAAGCGATTGTCATGAAC","561307.5.peg.1956","1064"
"11359",394,138,256,"ATGTGCCGGTTGATAGAGTT","TTAAAGCGATTGTCATGAAC","561307.5.peg.1956","1064"
"11360",666,138,528,"AGAACGACTTTATGGAAGTA","TTAAAGCGATTGTCATGAAC","561307.5.peg.1956","1064"
"11361",574,138,436,"GTTATTAGCGTCGCCACCGA","TTAAAGCGATTGTCATGAAC","561307.5.peg.1956","1064"
"11362",10,138,128,"TAAATTGGGGATGATAAAGG","TTAAAGCGATTGTCATGAAC","561307.5.peg.1956","1064"
"11363",654,138,516,"TGGAAGTATGGCTCAATGTC","TTAAAGCGATTGTCATGAAC","561307.5.peg.1956","1064"
"11364",23,138,115,"ACCGTGGTATGATTAAATTG","TTAAAGCGATTGTCATGAAC","561307.5.peg.1956","1064"
"11365",7,138,131,"TCCCCAATTTAATCATACCA","TTAAAGCGATTGTCATGAAC","561307.5.peg.1956","1064"
"11366",674,138,536,"CACTTAGTAGAACGACTTTA","TTAAAGCGATTGTCATGAAC","561307.5.peg.1956","1064"
"11367",514,138,376,"TTGATCTGAAAGGCCATTAT","TTAAAGCGATTGTCATGAAC","561307.5.peg.1956","1064"
"11368",514,192,322,"TTGATCTGAAAGGCCATTAT","GTATTTCAGTTGCATCAAT","561307.5.peg.1956","1064"
"11369",394,192,202,"ATGTGCCGGTTGATAGAGTT","GTATTTCAGTTGCATCAAT","561307.5.peg.1956","1064"
"11370",574,192,382,"GTTATTAGCGTCGCCACCGA","GTATTTCAGTTGCATCAAT","561307.5.peg.1956","1064"
"11371",666,192,474,"AGAACGACTTTATGGAAGTA","GTATTTCAGTTGCATCAAT","561307.5.peg.1956","1064"
"11372",654,192,462,"TGGAAGTATGGCTCAATGTC","GTATTTCAGTTGCATCAAT","561307.5.peg.1956","1064"
"11373",674,192,482,"CACTTAGTAGAACGACTTTA","GTATTTCAGTTGCATCAAT","561307.5.peg.1956","1064"
"11374",7,192,185,"TCCCCAATTTAATCATACCA","GTATTTCAGTTGCATCAAT","561307.5.peg.1956","1064"
"11375",524,192,332,"GACATTGATTTGATCTGAA","GTATTTCAGTTGCATCAAT","561307.5.peg.1956","1064"
"11376",23,192,169,"ACCGTGGTATGATTAAATTG","GTATTTCAGTTGCATCAAT","561307.5.peg.1956","1064"
"11377",10,192,182,"TAAATTGGGGATGATAAAGG","GTATTTCAGTTGCATCAAT","561307.5.peg.1956","1064"
"11378",23,216,193,"ACCGTGGTATGATTAAATTG","TTGTCTGGTTGCGGTGGGAT","561307.5.peg.1956","1064"
"11379",514,216,298,"TTGATCTGAAAGGCCATTAT","TTGTCTGGTTGCGGTGGGAT","561307.5.peg.1956","1064"
"11380",394,216,178,"ATGTGCCGGTTGATAGAGTT","TTGTCTGGTTGCGGTGGGAT","561307.5.peg.1956","1064"
"11381",654,216,438,"TGGAAGTATGGCTCAATGTC","TTGTCTGGTTGCGGTGGGAT","561307.5.peg.1956","1064"
"11382",7,216,209,"TCCCCAATTTAATCATACCA","TTGTCTGGTTGCGGTGGGAT","561307.5.peg.1956","1064"
"11383",574,216,358,"GTTATTAGCGTCGCCACCGA","TTGTCTGGTTGCGGTGGGAT","561307.5.peg.1956","1064"
"11384",674,216,458,"CACTTAGTAGAACGACTTTA","TTGTCTGGTTGCGGTGGGAT","561307.5.peg.1956","1064"
"11385",666,216,450,"AGAACGACTTTATGGAAGTA","TTGTCTGGTTGCGGTGGGAT","561307.5.peg.1956","1064"
"11386",524,216,308,"GACATTGATTTGATCTGAA","TTGTCTGGTTGCGGTGGGAT","561307.5.peg.1956","1064"
"11387",10,216,206,"TAAATTGGGGATGATAAAGG","TTGTCTGGTTGCGGTGGGAT","561307.5.peg.1956","1064"
"11388",7,221,214,"TCCCCAATTTAATCATACCA","ATTTGTTGTCTGGTTGCGGT","561307.5.peg.1956","1064"
"11389",524,221,303,"GACATTGATTTGATCTGAA","ATTTGTTGTCTGGTTGCGGT","561307.5.peg.1956","1064"
"11390",394,221,173,"ATGTGCCGGTTGATAGAGTT","ATTTGTTGTCTGGTTGCGGT","561307.5.peg.1956","1064"
"11391",654,221,433,"TGGAAGTATGGCTCAATGTC","ATTTGTTGTCTGGTTGCGGT","561307.5.peg.1956","1064"
"11392",10,221,211,"TAAATTGGGGATGATAAAGG","ATTTGTTGTCTGGTTGCGGT","561307.5.peg.1956","1064"
"11393",666,221,445,"AGAACGACTTTATGGAAGTA","ATTTGTTGTCTGGTTGCGGT","561307.5.peg.1956","1064"
"11394",574,221,353,"GTTATTAGCGTCGCCACCGA","ATTTGTTGTCTGGTTGCGGT","561307.5.peg.1956","1064"
"11395",514,221,293,"TTGATCTGAAAGGCCATTAT","ATTTGTTGTCTGGTTGCGGT","561307.5.peg.1956","1064"
"11396",23,221,198,"ACCGTGGTATGATTAAATTG","ATTTGTTGTCTGGTTGCGGT","561307.5.peg.1956","1064"
"11397",674,221,453,"CACTTAGTAGAACGACTTTA","ATTTGTTGTCTGGTTGCGGT","561307.5.peg.1956","1064"
"11398",10,225,215,"TAAATTGGGGATGATAAAGG","TCTAATTTGTTGTCTGGTTG","561307.5.peg.1956","1064"
"11399",23,225,202,"ACCGTGGTATGATTAAATTG","TCTAATTTGTTGTCTGGTTG","561307.5.peg.1956","1064"
"11400",524,225,299,"GACATTGATTTGATCTGAA","TCTAATTTGTTGTCTGGTTG","561307.5.peg.1956","1064"
"11401",123,225,102,"TGAACTGGTGGTTCTGCATA","TCTAATTTGTTGTCTGGTTG","561307.5.peg.1956","1064"
"11402",674,225,449,"CACTTAGTAGAACGACTTTA","TCTAATTTGTTGTCTGGTTG","561307.5.peg.1956","1064"
"11403",666,225,441,"AGAACGACTTTATGGAAGTA","TCTAATTTGTTGTCTGGTTG","561307.5.peg.1956","1064"
"11404",394,225,169,"ATGTGCCGGTTGATAGAGTT","TCTAATTTGTTGTCTGGTTG","561307.5.peg.1956","1064"
"11405",574,225,349,"GTTATTAGCGTCGCCACCGA","TCTAATTTGTTGTCTGGTTG","561307.5.peg.1956","1064"
"11406",514,225,289,"TTGATCTGAAAGGCCATTAT","TCTAATTTGTTGTCTGGTTG","561307.5.peg.1956","1064"
"11407",7,225,218,"TCCCCAATTTAATCATACCA","TCTAATTTGTTGTCTGGTTG","561307.5.peg.1956","1064"
"11408",654,225,429,"TGGAAGTATGGCTCAATGTC","TCTAATTTGTTGTCTGGTTG","561307.5.peg.1956","1064"
"11409",221,394,173,"ATTTGTTGTCTGGTTGCGGT","ATGTGCCGGTTGATAGAGTT","561307.5.peg.1956","1064"
"11410",10,394,384,"TAAATTGGGGATGATAAAGG","ATGTGCCGGTTGATAGAGTT","561307.5.peg.1956","1064"
"11411",574,394,180,"GTTATTAGCGTCGCCACCGA","ATGTGCCGGTTGATAGAGTT","561307.5.peg.1956","1064"
"11412",138,394,256,"TTAAAGCGATTGTCATGAAC","ATGTGCCGGTTGATAGAGTT","561307.5.peg.1956","1064"
"11413",135,394,259,"AAGCGATTGTCATGAACTGG","ATGTGCCGGTTGATAGAGTT","561307.5.peg.1956","1064"
"11414",7,394,387,"TCCCCAATTTAATCATACCA","ATGTGCCGGTTGATAGAGTT","561307.5.peg.1956","1064"
"11415",216,394,178,"TTGTCTGGTTGCGGTGGGAT","ATGTGCCGGTTGATAGAGTT","561307.5.peg.1956","1064"
"11416",674,394,280,"CACTTAGTAGAACGACTTTA","ATGTGCCGGTTGATAGAGTT","561307.5.peg.1956","1064"
"11417",514,394,120,"TTGATCTGAAAGGCCATTAT","ATGTGCCGGTTGATAGAGTT","561307.5.peg.1956","1064"
"11418",225,394,169,"TCTAATTTGTTGTCTGGTTG","ATGTGCCGGTTGATAGAGTT","561307.5.peg.1956","1064"
"11419",23,394,371,"ACCGTGGTATGATTAAATTG","ATGTGCCGGTTGATAGAGTT","561307.5.peg.1956","1064"
"11420",524,394,130,"GACATTGATTTGATCTGAA","ATGTGCCGGTTGATAGAGTT","561307.5.peg.1956","1064"
"11421",192,394,202,"GTATTTCAGTTGCATCAAT","ATGTGCCGGTTGATAGAGTT","561307.5.peg.1956","1064"
"11422",123,394,271,"TGAACTGGTGGTTCTGCATA","ATGTGCCGGTTGATAGAGTT","561307.5.peg.1956","1064"
"11423",654,394,260,"TGGAAGTATGGCTCAATGTC","ATGTGCCGGTTGATAGAGTT","561307.5.peg.1956","1064"
"11424",666,394,272,"AGAACGACTTTATGGAAGTA","ATGTGCCGGTTGATAGAGTT","561307.5.peg.1956","1064"
"11425",216,514,298,"TTGTCTGGTTGCGGTGGGAT","TTGATCTGAAAGGCCATTAT","561307.5.peg.1956","1064"
"11426",221,514,293,"ATTTGTTGTCTGGTTGCGGT","TTGATCTGAAAGGCCATTAT","561307.5.peg.1956","1064"
"11427",654,514,140,"TGGAAGTATGGCTCAATGTC","TTGATCTGAAAGGCCATTAT","561307.5.peg.1956","1064"
"11428",666,514,152,"AGAACGACTTTATGGAAGTA","TTGATCTGAAAGGCCATTAT","561307.5.peg.1956","1064"
"11429",135,514,379,"AAGCGATTGTCATGAACTGG","TTGATCTGAAAGGCCATTAT","561307.5.peg.1956","1064"
"11430",123,514,391,"TGAACTGGTGGTTCTGCATA","TTGATCTGAAAGGCCATTAT","561307.5.peg.1956","1064"
"11431",225,514,289,"TCTAATTTGTTGTCTGGTTG","TTGATCTGAAAGGCCATTAT","561307.5.peg.1956","1064"
"11432",394,514,120,"ATGTGCCGGTTGATAGAGTT","TTGATCTGAAAGGCCATTAT","561307.5.peg.1956","1064"
"11433",7,514,507,"TCCCCAATTTAATCATACCA","TTGATCTGAAAGGCCATTAT","561307.5.peg.1956","1064"
"11434",23,514,491,"ACCGTGGTATGATTAAATTG","TTGATCTGAAAGGCCATTAT","561307.5.peg.1956","1064"
"11435",10,514,504,"TAAATTGGGGATGATAAAGG","TTGATCTGAAAGGCCATTAT","561307.5.peg.1956","1064"
"11436",192,514,322,"GTATTTCAGTTGCATCAAT","TTGATCTGAAAGGCCATTAT","561307.5.peg.1956","1064"
"11437",138,514,376,"TTAAAGCGATTGTCATGAAC","TTGATCTGAAAGGCCATTAT","561307.5.peg.1956","1064"
"11438",674,514,160,"CACTTAGTAGAACGACTTTA","TTGATCTGAAAGGCCATTAT","561307.5.peg.1956","1064"
"11439",138,524,386,"TTAAAGCGATTGTCATGAAC","GACATTGATTTGATCTGAA","561307.5.peg.1956","1064"
"11440",666,524,142,"AGAACGACTTTATGGAAGTA","GACATTGATTTGATCTGAA","561307.5.peg.1956","1064"
"11441",135,524,389,"AAGCGATTGTCATGAACTGG","GACATTGATTTGATCTGAA","561307.5.peg.1956","1064"
"11442",225,524,299,"TCTAATTTGTTGTCTGGTTG","GACATTGATTTGATCTGAA","561307.5.peg.1956","1064"
"11443",216,524,308,"TTGTCTGGTTGCGGTGGGAT","GACATTGATTTGATCTGAA","561307.5.peg.1956","1064"
"11444",23,524,501,"ACCGTGGTATGATTAAATTG","GACATTGATTTGATCTGAA","561307.5.peg.1956","1064"
"11445",123,524,401,"TGAACTGGTGGTTCTGCATA","GACATTGATTTGATCTGAA","561307.5.peg.1956","1064"
"11446",654,524,130,"TGGAAGTATGGCTCAATGTC","GACATTGATTTGATCTGAA","561307.5.peg.1956","1064"
"11447",221,524,303,"ATTTGTTGTCTGGTTGCGGT","GACATTGATTTGATCTGAA","561307.5.peg.1956","1064"
"11448",674,524,150,"CACTTAGTAGAACGACTTTA","GACATTGATTTGATCTGAA","561307.5.peg.1956","1064"
"11449",394,524,130,"ATGTGCCGGTTGATAGAGTT","GACATTGATTTGATCTGAA","561307.5.peg.1956","1064"
"11450",7,524,517,"TCCCCAATTTAATCATACCA","GACATTGATTTGATCTGAA","561307.5.peg.1956","1064"
"11451",192,524,332,"GTATTTCAGTTGCATCAAT","GACATTGATTTGATCTGAA","561307.5.peg.1956","1064"
"11452",10,524,514,"TAAATTGGGGATGATAAAGG","GACATTGATTTGATCTGAA","561307.5.peg.1956","1064"
"11453",138,574,436,"TTAAAGCGATTGTCATGAAC","GTTATTAGCGTCGCCACCGA","561307.5.peg.1956","1064"
"11454",216,574,358,"TTGTCTGGTTGCGGTGGGAT","GTTATTAGCGTCGCCACCGA","561307.5.peg.1956","1064"
"11455",10,574,564,"TAAATTGGGGATGATAAAGG","GTTATTAGCGTCGCCACCGA","561307.5.peg.1956","1064"
"11456",135,574,439,"AAGCGATTGTCATGAACTGG","GTTATTAGCGTCGCCACCGA","561307.5.peg.1956","1064"
"11457",23,574,551,"ACCGTGGTATGATTAAATTG","GTTATTAGCGTCGCCACCGA","561307.5.peg.1956","1064"
"11458",394,574,180,"ATGTGCCGGTTGATAGAGTT","GTTATTAGCGTCGCCACCGA","561307.5.peg.1956","1064"
"11459",7,574,567,"TCCCCAATTTAATCATACCA","GTTATTAGCGTCGCCACCGA","561307.5.peg.1956","1064"
"11460",674,574,100,"CACTTAGTAGAACGACTTTA","GTTATTAGCGTCGCCACCGA","561307.5.peg.1956","1064"
"11461",221,574,353,"ATTTGTTGTCTGGTTGCGGT","GTTATTAGCGTCGCCACCGA","561307.5.peg.1956","1064"
"11462",123,574,451,"TGAACTGGTGGTTCTGCATA","GTTATTAGCGTCGCCACCGA","561307.5.peg.1956","1064"
"11463",225,574,349,"TCTAATTTGTTGTCTGGTTG","GTTATTAGCGTCGCCACCGA","561307.5.peg.1956","1064"
"11464",192,574,382,"GTATTTCAGTTGCATCAAT","GTTATTAGCGTCGCCACCGA","561307.5.peg.1956","1064"
"11465",123,654,531,"TGAACTGGTGGTTCTGCATA","TGGAAGTATGGCTCAATGTC","561307.5.peg.1956","1064"
"11466",135,654,519,"AAGCGATTGTCATGAACTGG","TGGAAGTATGGCTCAATGTC","561307.5.peg.1956","1064"
"11467",394,654,260,"ATGTGCCGGTTGATAGAGTT","TGGAAGTATGGCTCAATGTC","561307.5.peg.1956","1064"
"11468",7,654,647,"TCCCCAATTTAATCATACCA","TGGAAGTATGGCTCAATGTC","561307.5.peg.1956","1064"
"11469",216,654,438,"TTGTCTGGTTGCGGTGGGAT","TGGAAGTATGGCTCAATGTC","561307.5.peg.1956","1064"
"11470",524,654,130,"GACATTGATTTGATCTGAA","TGGAAGTATGGCTCAATGTC","561307.5.peg.1956","1064"
"11471",514,654,140,"TTGATCTGAAAGGCCATTAT","TGGAAGTATGGCTCAATGTC","561307.5.peg.1956","1064"
"11472",192,654,462,"GTATTTCAGTTGCATCAAT","TGGAAGTATGGCTCAATGTC","561307.5.peg.1956","1064"
"11473",221,654,433,"ATTTGTTGTCTGGTTGCGGT","TGGAAGTATGGCTCAATGTC","561307.5.peg.1956","1064"
"11474",23,654,631,"ACCGTGGTATGATTAAATTG","TGGAAGTATGGCTCAATGTC","561307.5.peg.1956","1064"
"11475",10,654,644,"TAAATTGGGGATGATAAAGG","TGGAAGTATGGCTCAATGTC","561307.5.peg.1956","1064"
"11476",138,654,516,"TTAAAGCGATTGTCATGAAC","TGGAAGTATGGCTCAATGTC","561307.5.peg.1956","1064"
"11477",225,654,429,"TCTAATTTGTTGTCTGGTTG","TGGAAGTATGGCTCAATGTC","561307.5.peg.1956","1064"
"11478",7,666,659,"TCCCCAATTTAATCATACCA","AGAACGACTTTATGGAAGTA","561307.5.peg.1956","1064"
"11479",10,666,656,"TAAATTGGGGATGATAAAGG","AGAACGACTTTATGGAAGTA","561307.5.peg.1956","1064"
"11480",514,666,152,"TTGATCTGAAAGGCCATTAT","AGAACGACTTTATGGAAGTA","561307.5.peg.1956","1064"
"11481",216,666,450,"TTGTCTGGTTGCGGTGGGAT","AGAACGACTTTATGGAAGTA","561307.5.peg.1956","1064"
"11482",23,666,643,"ACCGTGGTATGATTAAATTG","AGAACGACTTTATGGAAGTA","561307.5.peg.1956","1064"
"11483",135,666,531,"AAGCGATTGTCATGAACTGG","AGAACGACTTTATGGAAGTA","561307.5.peg.1956","1064"
"11484",123,666,543,"TGAACTGGTGGTTCTGCATA","AGAACGACTTTATGGAAGTA","561307.5.peg.1956","1064"
"11485",192,666,474,"GTATTTCAGTTGCATCAAT","AGAACGACTTTATGGAAGTA","561307.5.peg.1956","1064"
"11486",225,666,441,"TCTAATTTGTTGTCTGGTTG","AGAACGACTTTATGGAAGTA","561307.5.peg.1956","1064"
"11487",221,666,445,"ATTTGTTGTCTGGTTGCGGT","AGAACGACTTTATGGAAGTA","561307.5.peg.1956","1064"
"11488",524,666,142,"GACATTGATTTGATCTGAA","AGAACGACTTTATGGAAGTA","561307.5.peg.1956","1064"
"11489",138,666,528,"TTAAAGCGATTGTCATGAAC","AGAACGACTTTATGGAAGTA","561307.5.peg.1956","1064"
"11490",394,666,272,"ATGTGCCGGTTGATAGAGTT","AGAACGACTTTATGGAAGTA","561307.5.peg.1956","1064"
"11491",138,674,536,"TTAAAGCGATTGTCATGAAC","CACTTAGTAGAACGACTTTA","561307.5.peg.1956","1064"
"11492",221,674,453,"ATTTGTTGTCTGGTTGCGGT","CACTTAGTAGAACGACTTTA","561307.5.peg.1956","1064"
"11493",225,674,449,"TCTAATTTGTTGTCTGGTTG","CACTTAGTAGAACGACTTTA","561307.5.peg.1956","1064"
"11494",216,674,458,"TTGTCTGGTTGCGGTGGGAT","CACTTAGTAGAACGACTTTA","561307.5.peg.1956","1064"
"11495",123,674,551,"TGAACTGGTGGTTCTGCATA","CACTTAGTAGAACGACTTTA","561307.5.peg.1956","1064"
"11496",23,674,651,"ACCGTGGTATGATTAAATTG","CACTTAGTAGAACGACTTTA","561307.5.peg.1956","1064"
"11497",574,674,100,"GTTATTAGCGTCGCCACCGA","CACTTAGTAGAACGACTTTA","561307.5.peg.1956","1064"
"11498",135,674,539,"AAGCGATTGTCATGAACTGG","CACTTAGTAGAACGACTTTA","561307.5.peg.1956","1064"
"11499",192,674,482,"GTATTTCAGTTGCATCAAT","CACTTAGTAGAACGACTTTA","561307.5.peg.1956","1064"
"11500",524,674,150,"GACATTGATTTGATCTGAA","CACTTAGTAGAACGACTTTA","561307.5.peg.1956","1064"
"11501",7,674,667,"TCCCCAATTTAATCATACCA","CACTTAGTAGAACGACTTTA","561307.5.peg.1956","1064"
"11502",514,674,160,"TTGATCTGAAAGGCCATTAT","CACTTAGTAGAACGACTTTA","561307.5.peg.1956","1064"
"11503",10,674,664,"TAAATTGGGGATGATAAAGG","CACTTAGTAGAACGACTTTA","561307.5.peg.1956","1064"
"11504",394,674,280,"ATGTGCCGGTTGATAGAGTT","CACTTAGTAGAACGACTTTA","561307.5.peg.1956","1064"
"11505",486,27,459,"TCGCCGATAACCGTTCCAAT","TTCTAAGGGAAATGAATAT","561307.5.peg.1957","1065"
"11506",588,27,561,"CGTTGTATTTCCTGATCCTT","TTCTAAGGGAAATGAATAT","561307.5.peg.1957","1065"
"11507",614,27,587,"ATGGTGTCTCATGATTCACA","TTCTAAGGGAAATGAATAT","561307.5.peg.1957","1065"
"11508",588,486,102,"CGTTGTATTTCCTGATCCTT","TCGCCGATAACCGTTCCAAT","561307.5.peg.1957","1065"
"11509",27,486,459,"TTCTAAGGGAAATGAATAT","TCGCCGATAACCGTTCCAAT","561307.5.peg.1957","1065"
"11510",614,486,128,"ATGGTGTCTCATGATTCACA","TCGCCGATAACCGTTCCAAT","561307.5.peg.1957","1065"
"11511",27,588,561,"TTCTAAGGGAAATGAATAT","CGTTGTATTTCCTGATCCTT","561307.5.peg.1957","1065"
"11512",486,588,102,"TCGCCGATAACCGTTCCAAT","CGTTGTATTTCCTGATCCTT","561307.5.peg.1957","1065"
"11513",486,614,128,"TCGCCGATAACCGTTCCAAT","ATGGTGTCTCATGATTCACA","561307.5.peg.1957","1065"
"11514",27,614,587,"TTCTAAGGGAAATGAATAT","ATGGTGTCTCATGATTCACA","561307.5.peg.1957","1065"
"11515",210,6,204,"AATAAAGTTCTCCACTAGT","CTGATATATTACATGAGGAG","561307.5.peg.1959","1067"
"11516",243,6,237,"TCCGGGTCATAATCATTATA","CTGATATATTACATGAGGAG","561307.5.peg.1959","1067"
"11517",260,6,254,"TTCGTTGACGCAATTCTTCC","CTGATATATTACATGAGGAG","561307.5.peg.1959","1067"
"11518",344,6,338,"TATCATTACGTGCAAGTGAT","CTGATATATTACATGAGGAG","561307.5.peg.1959","1067"
"11519",6,210,204,"CTGATATATTACATGAGGAG","AATAAAGTTCTCCACTAGT","561307.5.peg.1959","1067"
"11520",344,210,134,"TATCATTACGTGCAAGTGAT","AATAAAGTTCTCCACTAGT","561307.5.peg.1959","1067"
"11521",6,243,237,"CTGATATATTACATGAGGAG","TCCGGGTCATAATCATTATA","561307.5.peg.1959","1067"
"11522",344,243,101,"TATCATTACGTGCAAGTGAT","TCCGGGTCATAATCATTATA","561307.5.peg.1959","1067"
"11523",6,260,254,"CTGATATATTACATGAGGAG","TTCGTTGACGCAATTCTTCC","561307.5.peg.1959","1067"
"11524",6,344,338,"CTGATATATTACATGAGGAG","TATCATTACGTGCAAGTGAT","561307.5.peg.1959","1067"
"11525",243,344,101,"TCCGGGTCATAATCATTATA","TATCATTACGTGCAAGTGAT","561307.5.peg.1959","1067"
"11526",210,344,134,"AATAAAGTTCTCCACTAGT","TATCATTACGTGCAAGTGAT","561307.5.peg.1959","1067"
"11527",115,8,107,"AACGTCTGTAAAGTCTGAAT","TGTTCAAAGCATAGAGTTGG","561307.5.peg.196","1068"
"11528",147,8,139,"ACAACTGTCAGCACTTGACC","TGTTCAAAGCATAGAGTTGG","561307.5.peg.196","1068"
"11529",115,11,104,"AACGTCTGTAAAGTCTGAAT","AAGTGTTCAAAGCATAGAGT","561307.5.peg.196","1068"
"11530",147,11,136,"ACAACTGTCAGCACTTGACC","AAGTGTTCAAAGCATAGAGT","561307.5.peg.196","1068"
"11531",8,115,107,"TGTTCAAAGCATAGAGTTGG","AACGTCTGTAAAGTCTGAAT","561307.5.peg.196","1068"
"11532",11,115,104,"AAGTGTTCAAAGCATAGAGT","AACGTCTGTAAAGTCTGAAT","561307.5.peg.196","1068"
"11533",8,147,139,"TGTTCAAAGCATAGAGTTGG","ACAACTGTCAGCACTTGACC","561307.5.peg.196","1068"
"11534",11,147,136,"AAGTGTTCAAAGCATAGAGT","ACAACTGTCAGCACTTGACC","561307.5.peg.196","1068"
"11535",402,150,252,"TCAGGCGTTAAGACATGTGG","CAATAATTTGATCACTGAC","561307.5.peg.1960","1069"
"11536",306,150,156,"TGATTCCACCATCCACCAAC","CAATAATTTGATCACTGAC","561307.5.peg.1960","1069"
"11537",531,150,381,"GCACTTCAAATTCACTATA","CAATAATTTGATCACTGAC","561307.5.peg.1960","1069"
"11538",405,150,255,"TCTTCAGGCGTTAAGACATG","CAATAATTTGATCACTGAC","561307.5.peg.1960","1069"
"11539",150,306,156,"CAATAATTTGATCACTGAC","TGATTCCACCATCCACCAAC","561307.5.peg.1960","1069"
"11540",531,306,225,"GCACTTCAAATTCACTATA","TGATTCCACCATCCACCAAC","561307.5.peg.1960","1069"
"11541",150,402,252,"CAATAATTTGATCACTGAC","TCAGGCGTTAAGACATGTGG","561307.5.peg.1960","1069"
"11542",531,402,129,"GCACTTCAAATTCACTATA","TCAGGCGTTAAGACATGTGG","561307.5.peg.1960","1069"
"11543",150,405,255,"CAATAATTTGATCACTGAC","TCTTCAGGCGTTAAGACATG","561307.5.peg.1960","1069"
"11544",531,405,126,"GCACTTCAAATTCACTATA","TCTTCAGGCGTTAAGACATG","561307.5.peg.1960","1069"
"11545",150,531,381,"CAATAATTTGATCACTGAC","GCACTTCAAATTCACTATA","561307.5.peg.1960","1069"
"11546",306,531,225,"TGATTCCACCATCCACCAAC","GCACTTCAAATTCACTATA","561307.5.peg.1960","1069"
"11547",402,531,129,"TCAGGCGTTAAGACATGTGG","GCACTTCAAATTCACTATA","561307.5.peg.1960","1069"
"11548",405,531,126,"TCTTCAGGCGTTAAGACATG","GCACTTCAAATTCACTATA","561307.5.peg.1960","1069"
"11549",334,186,148,"ATCTTTAGTAGTACCGAAGC","ATCTAATACGTGCTAGTAA","561307.5.peg.1964","1073"
"11550",393,186,207,"GAAATCTCATTACGTTGCAT","ATCTAATACGTGCTAGTAA","561307.5.peg.1964","1073"
"11551",747,186,561,"TCACGAACACCAAATAAACC","ATCTAATACGTGCTAGTAA","561307.5.peg.1964","1073"
"11552",498,186,312,"TAATACGGATCAATCTTTGT","ATCTAATACGTGCTAGTAA","561307.5.peg.1964","1073"
"11553",334,228,106,"ATCTTTAGTAGTACCGAAGC","ATAAATACTGACGTAATTC","561307.5.peg.1964","1073"
"11554",498,228,270,"TAATACGGATCAATCTTTGT","ATAAATACTGACGTAATTC","561307.5.peg.1964","1073"
"11555",747,228,519,"TCACGAACACCAAATAAACC","ATAAATACTGACGTAATTC","561307.5.peg.1964","1073"
"11556",393,228,165,"GAAATCTCATTACGTTGCAT","ATAAATACTGACGTAATTC","561307.5.peg.1964","1073"
"11557",228,334,106,"ATAAATACTGACGTAATTC","ATCTTTAGTAGTACCGAAGC","561307.5.peg.1964","1073"
"11558",186,334,148,"ATCTAATACGTGCTAGTAA","ATCTTTAGTAGTACCGAAGC","561307.5.peg.1964","1073"
"11559",498,334,164,"TAATACGGATCAATCTTTGT","ATCTTTAGTAGTACCGAAGC","561307.5.peg.1964","1073"
"11560",747,334,413,"TCACGAACACCAAATAAACC","ATCTTTAGTAGTACCGAAGC","561307.5.peg.1964","1073"
"11561",228,393,165,"ATAAATACTGACGTAATTC","GAAATCTCATTACGTTGCAT","561307.5.peg.1964","1073"
"11562",186,393,207,"ATCTAATACGTGCTAGTAA","GAAATCTCATTACGTTGCAT","561307.5.peg.1964","1073"
"11563",498,393,105,"TAATACGGATCAATCTTTGT","GAAATCTCATTACGTTGCAT","561307.5.peg.1964","1073"
"11564",747,393,354,"TCACGAACACCAAATAAACC","GAAATCTCATTACGTTGCAT","561307.5.peg.1964","1073"
"11565",186,498,312,"ATCTAATACGTGCTAGTAA","TAATACGGATCAATCTTTGT","561307.5.peg.1964","1073"
"11566",393,498,105,"GAAATCTCATTACGTTGCAT","TAATACGGATCAATCTTTGT","561307.5.peg.1964","1073"
"11567",228,498,270,"ATAAATACTGACGTAATTC","TAATACGGATCAATCTTTGT","561307.5.peg.1964","1073"
"11568",334,498,164,"ATCTTTAGTAGTACCGAAGC","TAATACGGATCAATCTTTGT","561307.5.peg.1964","1073"
"11569",747,498,249,"TCACGAACACCAAATAAACC","TAATACGGATCAATCTTTGT","561307.5.peg.1964","1073"
"11570",186,747,561,"ATCTAATACGTGCTAGTAA","TCACGAACACCAAATAAACC","561307.5.peg.1964","1073"
"11571",498,747,249,"TAATACGGATCAATCTTTGT","TCACGAACACCAAATAAACC","561307.5.peg.1964","1073"
"11572",228,747,519,"ATAAATACTGACGTAATTC","TCACGAACACCAAATAAACC","561307.5.peg.1964","1073"
"11573",393,747,354,"GAAATCTCATTACGTTGCAT","TCACGAACACCAAATAAACC","561307.5.peg.1964","1073"
"11574",334,747,413,"ATCTTTAGTAGTACCGAAGC","TCACGAACACCAAATAAACC","561307.5.peg.1964","1073"
"11575",499,115,384,"ATTTGCATTCCAAATACCTA","AACACGTTTAAGATTGCAT","561307.5.peg.1966","1075"
"11576",420,115,305,"CCTTCAGAACGATGTTCCTC","AACACGTTTAAGATTGCAT","561307.5.peg.1966","1075"
"11577",609,115,494,"TCAATCTTATCTGACGTATC","AACACGTTTAAGATTGCAT","561307.5.peg.1966","1075"
"11578",592,115,477,"ATCGGGTTCCTGTTCAGCAA","AACACGTTTAAGATTGCAT","561307.5.peg.1966","1075"
"11579",474,115,359,"ACTAATGGTCCGATTAAGTT","AACACGTTTAAGATTGCAT","561307.5.peg.1966","1075"
"11580",489,115,374,"CAAATACCTACGGCAACTAA","AACACGTTTAAGATTGCAT","561307.5.peg.1966","1075"
"11581",228,115,113,"GCAATAATTTGTCCTGCCCA","AACACGTTTAAGATTGCAT","561307.5.peg.1966","1075"
"11582",592,141,451,"ATCGGGTTCCTGTTCAGCAA","CCTAAATCATGCCCTCGTAA","561307.5.peg.1966","1075"
"11583",474,141,333,"ACTAATGGTCCGATTAAGTT","CCTAAATCATGCCCTCGTAA","561307.5.peg.1966","1075"
"11584",489,141,348,"CAAATACCTACGGCAACTAA","CCTAAATCATGCCCTCGTAA","561307.5.peg.1966","1075"
"11585",420,141,279,"CCTTCAGAACGATGTTCCTC","CCTAAATCATGCCCTCGTAA","561307.5.peg.1966","1075"
"11586",609,141,468,"TCAATCTTATCTGACGTATC","CCTAAATCATGCCCTCGTAA","561307.5.peg.1966","1075"
"11587",499,141,358,"ATTTGCATTCCAAATACCTA","CCTAAATCATGCCCTCGTAA","561307.5.peg.1966","1075"
"11588",115,228,113,"AACACGTTTAAGATTGCAT","GCAATAATTTGTCCTGCCCA","561307.5.peg.1966","1075"
"11589",474,228,246,"ACTAATGGTCCGATTAAGTT","GCAATAATTTGTCCTGCCCA","561307.5.peg.1966","1075"
"11590",489,228,261,"CAAATACCTACGGCAACTAA","GCAATAATTTGTCCTGCCCA","561307.5.peg.1966","1075"
"11591",420,228,192,"CCTTCAGAACGATGTTCCTC","GCAATAATTTGTCCTGCCCA","561307.5.peg.1966","1075"
"11592",592,228,364,"ATCGGGTTCCTGTTCAGCAA","GCAATAATTTGTCCTGCCCA","561307.5.peg.1966","1075"
"11593",499,228,271,"ATTTGCATTCCAAATACCTA","GCAATAATTTGTCCTGCCCA","561307.5.peg.1966","1075"
"11594",609,228,381,"TCAATCTTATCTGACGTATC","GCAATAATTTGTCCTGCCCA","561307.5.peg.1966","1075"
"11595",228,420,192,"GCAATAATTTGTCCTGCCCA","CCTTCAGAACGATGTTCCTC","561307.5.peg.1966","1075"
"11596",609,420,189,"TCAATCTTATCTGACGTATC","CCTTCAGAACGATGTTCCTC","561307.5.peg.1966","1075"
"11597",592,420,172,"ATCGGGTTCCTGTTCAGCAA","CCTTCAGAACGATGTTCCTC","561307.5.peg.1966","1075"
"11598",141,420,279,"CCTAAATCATGCCCTCGTAA","CCTTCAGAACGATGTTCCTC","561307.5.peg.1966","1075"
"11599",115,420,305,"AACACGTTTAAGATTGCAT","CCTTCAGAACGATGTTCCTC","561307.5.peg.1966","1075"
"11600",115,474,359,"AACACGTTTAAGATTGCAT","ACTAATGGTCCGATTAAGTT","561307.5.peg.1966","1075"
"11601",141,474,333,"CCTAAATCATGCCCTCGTAA","ACTAATGGTCCGATTAAGTT","561307.5.peg.1966","1075"
"11602",228,474,246,"GCAATAATTTGTCCTGCCCA","ACTAATGGTCCGATTAAGTT","561307.5.peg.1966","1075"
"11603",592,474,118,"ATCGGGTTCCTGTTCAGCAA","ACTAATGGTCCGATTAAGTT","561307.5.peg.1966","1075"
"11604",609,474,135,"TCAATCTTATCTGACGTATC","ACTAATGGTCCGATTAAGTT","561307.5.peg.1966","1075"
"11605",141,489,348,"CCTAAATCATGCCCTCGTAA","CAAATACCTACGGCAACTAA","561307.5.peg.1966","1075"
"11606",609,489,120,"TCAATCTTATCTGACGTATC","CAAATACCTACGGCAACTAA","561307.5.peg.1966","1075"
"11607",592,489,103,"ATCGGGTTCCTGTTCAGCAA","CAAATACCTACGGCAACTAA","561307.5.peg.1966","1075"
"11608",228,489,261,"GCAATAATTTGTCCTGCCCA","CAAATACCTACGGCAACTAA","561307.5.peg.1966","1075"
"11609",115,489,374,"AACACGTTTAAGATTGCAT","CAAATACCTACGGCAACTAA","561307.5.peg.1966","1075"
"11610",609,499,110,"TCAATCTTATCTGACGTATC","ATTTGCATTCCAAATACCTA","561307.5.peg.1966","1075"
"11611",228,499,271,"GCAATAATTTGTCCTGCCCA","ATTTGCATTCCAAATACCTA","561307.5.peg.1966","1075"
"11612",141,499,358,"CCTAAATCATGCCCTCGTAA","ATTTGCATTCCAAATACCTA","561307.5.peg.1966","1075"
"11613",115,499,384,"AACACGTTTAAGATTGCAT","ATTTGCATTCCAAATACCTA","561307.5.peg.1966","1075"
"11614",474,592,118,"ACTAATGGTCCGATTAAGTT","ATCGGGTTCCTGTTCAGCAA","561307.5.peg.1966","1075"
"11615",489,592,103,"CAAATACCTACGGCAACTAA","ATCGGGTTCCTGTTCAGCAA","561307.5.peg.1966","1075"
"11616",141,592,451,"CCTAAATCATGCCCTCGTAA","ATCGGGTTCCTGTTCAGCAA","561307.5.peg.1966","1075"
"11617",420,592,172,"CCTTCAGAACGATGTTCCTC","ATCGGGTTCCTGTTCAGCAA","561307.5.peg.1966","1075"
"11618",228,592,364,"GCAATAATTTGTCCTGCCCA","ATCGGGTTCCTGTTCAGCAA","561307.5.peg.1966","1075"
"11619",115,592,477,"AACACGTTTAAGATTGCAT","ATCGGGTTCCTGTTCAGCAA","561307.5.peg.1966","1075"
"11620",228,609,381,"GCAATAATTTGTCCTGCCCA","TCAATCTTATCTGACGTATC","561307.5.peg.1966","1075"
"11621",499,609,110,"ATTTGCATTCCAAATACCTA","TCAATCTTATCTGACGTATC","561307.5.peg.1966","1075"
"11622",489,609,120,"CAAATACCTACGGCAACTAA","TCAATCTTATCTGACGTATC","561307.5.peg.1966","1075"
"11623",141,609,468,"CCTAAATCATGCCCTCGTAA","TCAATCTTATCTGACGTATC","561307.5.peg.1966","1075"
"11624",115,609,494,"AACACGTTTAAGATTGCAT","TCAATCTTATCTGACGTATC","561307.5.peg.1966","1075"
"11625",474,609,135,"ACTAATGGTCCGATTAAGTT","TCAATCTTATCTGACGTATC","561307.5.peg.1966","1075"
"11626",420,609,189,"CCTTCAGAACGATGTTCCTC","TCAATCTTATCTGACGTATC","561307.5.peg.1966","1075"
"11627",231,117,114,"AAGGTTACACAACCTTTATC","AATGACACACCTTTCACGAT","561307.5.peg.1967","1076"
"11628",336,117,219,"TTTCTCTAACAGTCTGAAA","AATGACACACCTTTCACGAT","561307.5.peg.1967","1076"
"11629",264,117,147,"CTCACTTTCTTCTTATGCAT","AATGACACACCTTTCACGAT","561307.5.peg.1967","1076"
"11630",264,147,117,"CTCACTTTCTTCTTATGCAT","ATCGCAATCGTCGCACCGAT","561307.5.peg.1967","1076"
"11631",336,147,189,"TTTCTCTAACAGTCTGAAA","ATCGCAATCGTCGCACCGAT","561307.5.peg.1967","1076"
"11632",117,231,114,"AATGACACACCTTTCACGAT","AAGGTTACACAACCTTTATC","561307.5.peg.1967","1076"
"11633",336,231,105,"TTTCTCTAACAGTCTGAAA","AAGGTTACACAACCTTTATC","561307.5.peg.1967","1076"
"11634",117,264,147,"AATGACACACCTTTCACGAT","CTCACTTTCTTCTTATGCAT","561307.5.peg.1967","1076"
"11635",147,264,117,"ATCGCAATCGTCGCACCGAT","CTCACTTTCTTCTTATGCAT","561307.5.peg.1967","1076"
"11636",117,336,219,"AATGACACACCTTTCACGAT","TTTCTCTAACAGTCTGAAA","561307.5.peg.1967","1076"
"11637",231,336,105,"AAGGTTACACAACCTTTATC","TTTCTCTAACAGTCTGAAA","561307.5.peg.1967","1076"
"11638",147,336,189,"ATCGCAATCGTCGCACCGAT","TTTCTCTAACAGTCTGAAA","561307.5.peg.1967","1076"
"11639",216,91,125,"CCTGTCACCCCGAGTCGTTC","CACGAGTGGTTGATCTGTCC","561307.5.peg.1968","1077"
"11640",299,91,208,"CCATCGCAATGTCTTTACCA","CACGAGTGGTTGATCTGTCC","561307.5.peg.1968","1077"
"11641",343,91,252,"GACAGTAGTTGATGGGTCAA","CACGAGTGGTTGATCTGTCC","561307.5.peg.1968","1077"
"11642",299,105,194,"CCATCGCAATGTCTTTACCA","AAATTCACATCACTCACGAG","561307.5.peg.1968","1077"
"11643",216,105,111,"CCTGTCACCCCGAGTCGTTC","AAATTCACATCACTCACGAG","561307.5.peg.1968","1077"
"11644",343,105,238,"GACAGTAGTTGATGGGTCAA","AAATTCACATCACTCACGAG","561307.5.peg.1968","1077"
"11645",91,216,125,"CACGAGTGGTTGATCTGTCC","CCTGTCACCCCGAGTCGTTC","561307.5.peg.1968","1077"
"11646",105,216,111,"AAATTCACATCACTCACGAG","CCTGTCACCCCGAGTCGTTC","561307.5.peg.1968","1077"
"11647",343,216,127,"GACAGTAGTTGATGGGTCAA","CCTGTCACCCCGAGTCGTTC","561307.5.peg.1968","1077"
"11648",91,299,208,"CACGAGTGGTTGATCTGTCC","CCATCGCAATGTCTTTACCA","561307.5.peg.1968","1077"
"11649",105,299,194,"AAATTCACATCACTCACGAG","CCATCGCAATGTCTTTACCA","561307.5.peg.1968","1077"
"11650",91,343,252,"CACGAGTGGTTGATCTGTCC","GACAGTAGTTGATGGGTCAA","561307.5.peg.1968","1077"
"11651",216,343,127,"CCTGTCACCCCGAGTCGTTC","GACAGTAGTTGATGGGTCAA","561307.5.peg.1968","1077"
"11652",105,343,238,"AAATTCACATCACTCACGAG","GACAGTAGTTGATGGGTCAA","561307.5.peg.1968","1077"
"11653",167,7,160,"TTTGTTTGCTGTATCGATA","TTAAATCCAAGATTAAGGGA","561307.5.peg.1969","1078"
"11654",162,7,155,"TTTGCTGTATCGATATGGTT","TTAAATCCAAGATTAAGGGA","561307.5.peg.1969","1078"
"11655",353,7,346,"TTAAGGCGTCAACAAACCCT","TTAAATCCAAGATTAAGGGA","561307.5.peg.1969","1078"
"11656",407,7,400,"CTAACGTTACAACATAACTT","TTAAATCCAAGATTAAGGGA","561307.5.peg.1969","1078"
"11657",370,7,363,"ATCACACGCACGCATGATTA","TTAAATCCAAGATTAAGGGA","561307.5.peg.1969","1078"
"11658",162,28,134,"TTTGCTGTATCGATATGGTT","CGTGCGCCCTCCCTTAATCT","561307.5.peg.1969","1078"
"11659",370,28,342,"ATCACACGCACGCATGATTA","CGTGCGCCCTCCCTTAATCT","561307.5.peg.1969","1078"
"11660",407,28,379,"CTAACGTTACAACATAACTT","CGTGCGCCCTCCCTTAATCT","561307.5.peg.1969","1078"
"11661",353,28,325,"TTAAGGCGTCAACAAACCCT","CGTGCGCCCTCCCTTAATCT","561307.5.peg.1969","1078"
"11662",167,28,139,"TTTGTTTGCTGTATCGATA","CGTGCGCCCTCCCTTAATCT","561307.5.peg.1969","1078"
"11663",7,162,155,"TTAAATCCAAGATTAAGGGA","TTTGCTGTATCGATATGGTT","561307.5.peg.1969","1078"
"11664",353,162,191,"TTAAGGCGTCAACAAACCCT","TTTGCTGTATCGATATGGTT","561307.5.peg.1969","1078"
"11665",407,162,245,"CTAACGTTACAACATAACTT","TTTGCTGTATCGATATGGTT","561307.5.peg.1969","1078"
"11666",28,162,134,"CGTGCGCCCTCCCTTAATCT","TTTGCTGTATCGATATGGTT","561307.5.peg.1969","1078"
"11667",370,162,208,"ATCACACGCACGCATGATTA","TTTGCTGTATCGATATGGTT","561307.5.peg.1969","1078"
"11668",7,167,160,"TTAAATCCAAGATTAAGGGA","TTTGTTTGCTGTATCGATA","561307.5.peg.1969","1078"
"11669",28,167,139,"CGTGCGCCCTCCCTTAATCT","TTTGTTTGCTGTATCGATA","561307.5.peg.1969","1078"
"11670",370,167,203,"ATCACACGCACGCATGATTA","TTTGTTTGCTGTATCGATA","561307.5.peg.1969","1078"
"11671",353,167,186,"TTAAGGCGTCAACAAACCCT","TTTGTTTGCTGTATCGATA","561307.5.peg.1969","1078"
"11672",407,167,240,"CTAACGTTACAACATAACTT","TTTGTTTGCTGTATCGATA","561307.5.peg.1969","1078"
"11673",7,353,346,"TTAAATCCAAGATTAAGGGA","TTAAGGCGTCAACAAACCCT","561307.5.peg.1969","1078"
"11674",28,353,325,"CGTGCGCCCTCCCTTAATCT","TTAAGGCGTCAACAAACCCT","561307.5.peg.1969","1078"
"11675",167,353,186,"TTTGTTTGCTGTATCGATA","TTAAGGCGTCAACAAACCCT","561307.5.peg.1969","1078"
"11676",162,353,191,"TTTGCTGTATCGATATGGTT","TTAAGGCGTCAACAAACCCT","561307.5.peg.1969","1078"
"11677",28,370,342,"CGTGCGCCCTCCCTTAATCT","ATCACACGCACGCATGATTA","561307.5.peg.1969","1078"
"11678",7,370,363,"TTAAATCCAAGATTAAGGGA","ATCACACGCACGCATGATTA","561307.5.peg.1969","1078"
"11679",162,370,208,"TTTGCTGTATCGATATGGTT","ATCACACGCACGCATGATTA","561307.5.peg.1969","1078"
"11680",167,370,203,"TTTGTTTGCTGTATCGATA","ATCACACGCACGCATGATTA","561307.5.peg.1969","1078"
"11681",7,407,400,"TTAAATCCAAGATTAAGGGA","CTAACGTTACAACATAACTT","561307.5.peg.1969","1078"
"11682",28,407,379,"CGTGCGCCCTCCCTTAATCT","CTAACGTTACAACATAACTT","561307.5.peg.1969","1078"
"11683",162,407,245,"TTTGCTGTATCGATATGGTT","CTAACGTTACAACATAACTT","561307.5.peg.1969","1078"
"11684",167,407,240,"TTTGTTTGCTGTATCGATA","CTAACGTTACAACATAACTT","561307.5.peg.1969","1078"
"11685",317,195,122,"GACCAATACGTTCAGCAACT","TTCGTTTCTGCAATCAACTC","561307.5.peg.1970","1080"
"11686",489,195,294,"TTGAAGCTATCCAATATGA","TTCGTTTCTGCAATCAACTC","561307.5.peg.1970","1080"
"11687",195,317,122,"TTCGTTTCTGCAATCAACTC","GACCAATACGTTCAGCAACT","561307.5.peg.1970","1080"
"11688",489,317,172,"TTGAAGCTATCCAATATGA","GACCAATACGTTCAGCAACT","561307.5.peg.1970","1080"
"11689",195,489,294,"TTCGTTTCTGCAATCAACTC","TTGAAGCTATCCAATATGA","561307.5.peg.1970","1080"
"11690",317,489,172,"GACCAATACGTTCAGCAACT","TTGAAGCTATCCAATATGA","561307.5.peg.1970","1080"
"11691",546,195,351,"TTGGAGACACAAATACATA","ATTGATCCACCGTAAACATG","561307.5.peg.1971","1081"
"11692",540,195,345,"GACACAAATACATATGGACG","ATTGATCCACCGTAAACATG","561307.5.peg.1971","1081"
"11693",366,195,171,"TTAACTGCGTCAGCATCAAA","ATTGATCCACCGTAAACATG","561307.5.peg.1971","1081"
"11694",732,195,537,"AGGAATGCTGTTTCACCAGC","ATTGATCCACCGTAAACATG","561307.5.peg.1971","1081"
"11695",329,195,134,"TTTAACGTCATCTCTCAAA","ATTGATCCACCGTAAACATG","561307.5.peg.1971","1081"
"11696",784,195,589,"TGTACCTCTATCATCTGTGA","ATTGATCCACCGTAAACATG","561307.5.peg.1971","1081"
"11697",732,243,489,"AGGAATGCTGTTTCACCAGC","TCTTTCGTGTTACGTACAAG","561307.5.peg.1971","1081"
"11698",540,243,297,"GACACAAATACATATGGACG","TCTTTCGTGTTACGTACAAG","561307.5.peg.1971","1081"
"11699",784,243,541,"TGTACCTCTATCATCTGTGA","TCTTTCGTGTTACGTACAAG","561307.5.peg.1971","1081"
"11700",366,243,123,"TTAACTGCGTCAGCATCAAA","TCTTTCGTGTTACGTACAAG","561307.5.peg.1971","1081"
"11701",546,243,303,"TTGGAGACACAAATACATA","TCTTTCGTGTTACGTACAAG","561307.5.peg.1971","1081"
"11702",540,329,211,"GACACAAATACATATGGACG","TTTAACGTCATCTCTCAAA","561307.5.peg.1971","1081"
"11703",546,329,217,"TTGGAGACACAAATACATA","TTTAACGTCATCTCTCAAA","561307.5.peg.1971","1081"
"11704",732,329,403,"AGGAATGCTGTTTCACCAGC","TTTAACGTCATCTCTCAAA","561307.5.peg.1971","1081"
"11705",195,329,134,"ATTGATCCACCGTAAACATG","TTTAACGTCATCTCTCAAA","561307.5.peg.1971","1081"
"11706",784,329,455,"TGTACCTCTATCATCTGTGA","TTTAACGTCATCTCTCAAA","561307.5.peg.1971","1081"
"11707",243,366,123,"TCTTTCGTGTTACGTACAAG","TTAACTGCGTCAGCATCAAA","561307.5.peg.1971","1081"
"11708",195,366,171,"ATTGATCCACCGTAAACATG","TTAACTGCGTCAGCATCAAA","561307.5.peg.1971","1081"
"11709",540,366,174,"GACACAAATACATATGGACG","TTAACTGCGTCAGCATCAAA","561307.5.peg.1971","1081"
"11710",546,366,180,"TTGGAGACACAAATACATA","TTAACTGCGTCAGCATCAAA","561307.5.peg.1971","1081"
"11711",784,366,418,"TGTACCTCTATCATCTGTGA","TTAACTGCGTCAGCATCAAA","561307.5.peg.1971","1081"
"11712",732,366,366,"AGGAATGCTGTTTCACCAGC","TTAACTGCGTCAGCATCAAA","561307.5.peg.1971","1081"
"11713",195,540,345,"ATTGATCCACCGTAAACATG","GACACAAATACATATGGACG","561307.5.peg.1971","1081"
"11714",243,540,297,"TCTTTCGTGTTACGTACAAG","GACACAAATACATATGGACG","561307.5.peg.1971","1081"
"11715",329,540,211,"TTTAACGTCATCTCTCAAA","GACACAAATACATATGGACG","561307.5.peg.1971","1081"
"11716",784,540,244,"TGTACCTCTATCATCTGTGA","GACACAAATACATATGGACG","561307.5.peg.1971","1081"
"11717",366,540,174,"TTAACTGCGTCAGCATCAAA","GACACAAATACATATGGACG","561307.5.peg.1971","1081"
"11718",732,540,192,"AGGAATGCTGTTTCACCAGC","GACACAAATACATATGGACG","561307.5.peg.1971","1081"
"11719",366,546,180,"TTAACTGCGTCAGCATCAAA","TTGGAGACACAAATACATA","561307.5.peg.1971","1081"
"11720",195,546,351,"ATTGATCCACCGTAAACATG","TTGGAGACACAAATACATA","561307.5.peg.1971","1081"
"11721",243,546,303,"TCTTTCGTGTTACGTACAAG","TTGGAGACACAAATACATA","561307.5.peg.1971","1081"
"11722",784,546,238,"TGTACCTCTATCATCTGTGA","TTGGAGACACAAATACATA","561307.5.peg.1971","1081"
"11723",732,546,186,"AGGAATGCTGTTTCACCAGC","TTGGAGACACAAATACATA","561307.5.peg.1971","1081"
"11724",329,546,217,"TTTAACGTCATCTCTCAAA","TTGGAGACACAAATACATA","561307.5.peg.1971","1081"
"11725",195,732,537,"ATTGATCCACCGTAAACATG","AGGAATGCTGTTTCACCAGC","561307.5.peg.1971","1081"
"11726",540,732,192,"GACACAAATACATATGGACG","AGGAATGCTGTTTCACCAGC","561307.5.peg.1971","1081"
"11727",243,732,489,"TCTTTCGTGTTACGTACAAG","AGGAATGCTGTTTCACCAGC","561307.5.peg.1971","1081"
"11728",366,732,366,"TTAACTGCGTCAGCATCAAA","AGGAATGCTGTTTCACCAGC","561307.5.peg.1971","1081"
"11729",329,732,403,"TTTAACGTCATCTCTCAAA","AGGAATGCTGTTTCACCAGC","561307.5.peg.1971","1081"
"11730",546,732,186,"TTGGAGACACAAATACATA","AGGAATGCTGTTTCACCAGC","561307.5.peg.1971","1081"
"11731",243,784,541,"TCTTTCGTGTTACGTACAAG","TGTACCTCTATCATCTGTGA","561307.5.peg.1971","1081"
"11732",366,784,418,"TTAACTGCGTCAGCATCAAA","TGTACCTCTATCATCTGTGA","561307.5.peg.1971","1081"
"11733",540,784,244,"GACACAAATACATATGGACG","TGTACCTCTATCATCTGTGA","561307.5.peg.1971","1081"
"11734",329,784,455,"TTTAACGTCATCTCTCAAA","TGTACCTCTATCATCTGTGA","561307.5.peg.1971","1081"
"11735",195,784,589,"ATTGATCCACCGTAAACATG","TGTACCTCTATCATCTGTGA","561307.5.peg.1971","1081"
"11736",546,784,238,"TTGGAGACACAAATACATA","TGTACCTCTATCATCTGTGA","561307.5.peg.1971","1081"
"11737",408,1,407,"ATCATTTGCGAACCAAATGT","AGCTATAAAGGTAGGTATTA","561307.5.peg.1972","1082"
"11738",525,1,524,"CCTGTTGTCAACACATGATT","AGCTATAAAGGTAGGTATTA","561307.5.peg.1972","1082"
"11739",657,1,656,"TTTCGCGTTTCAGCATGCAG","AGCTATAAAGGTAGGTATTA","561307.5.peg.1972","1082"
"11740",408,81,327,"ATCATTTGCGAACCAAATGT","TTCGCTAATTGGATTGCGAC","561307.5.peg.1972","1082"
"11741",657,81,576,"TTTCGCGTTTCAGCATGCAG","TTCGCTAATTGGATTGCGAC","561307.5.peg.1972","1082"
"11742",525,81,444,"CCTGTTGTCAACACATGATT","TTCGCTAATTGGATTGCGAC","561307.5.peg.1972","1082"
"11743",1,408,407,"AGCTATAAAGGTAGGTATTA","ATCATTTGCGAACCAAATGT","561307.5.peg.1972","1082"
"11744",525,408,117,"CCTGTTGTCAACACATGATT","ATCATTTGCGAACCAAATGT","561307.5.peg.1972","1082"
"11745",81,408,327,"TTCGCTAATTGGATTGCGAC","ATCATTTGCGAACCAAATGT","561307.5.peg.1972","1082"
"11746",657,408,249,"TTTCGCGTTTCAGCATGCAG","ATCATTTGCGAACCAAATGT","561307.5.peg.1972","1082"
"11747",1,525,524,"AGCTATAAAGGTAGGTATTA","CCTGTTGTCAACACATGATT","561307.5.peg.1972","1082"
"11748",81,525,444,"TTCGCTAATTGGATTGCGAC","CCTGTTGTCAACACATGATT","561307.5.peg.1972","1082"
"11749",657,525,132,"TTTCGCGTTTCAGCATGCAG","CCTGTTGTCAACACATGATT","561307.5.peg.1972","1082"
"11750",408,525,117,"ATCATTTGCGAACCAAATGT","CCTGTTGTCAACACATGATT","561307.5.peg.1972","1082"
"11751",1,657,656,"AGCTATAAAGGTAGGTATTA","TTTCGCGTTTCAGCATGCAG","561307.5.peg.1972","1082"
"11752",525,657,132,"CCTGTTGTCAACACATGATT","TTTCGCGTTTCAGCATGCAG","561307.5.peg.1972","1082"
"11753",81,657,576,"TTCGCTAATTGGATTGCGAC","TTTCGCGTTTCAGCATGCAG","561307.5.peg.1972","1082"
"11754",408,657,249,"ATCATTTGCGAACCAAATGT","TTTCGCGTTTCAGCATGCAG","561307.5.peg.1972","1082"
"11755",343,30,313,"ATATTGTCAAAGTAACCTG","GGTTACAACTGTAGCTAC","561307.5.peg.1973","1083"
"11756",30,343,313,"GGTTACAACTGTAGCTAC","ATATTGTCAAAGTAACCTG","561307.5.peg.1973","1083"
"11757",323,87,236,"ACACCTTCACCTTAAACTGT","AGTATCGTCATATTCCCCGA","561307.5.peg.1974","1084"
"11758",408,87,321,"GGCACAACACGATGGGCTTG","AGTATCGTCATATTCCCCGA","561307.5.peg.1974","1084"
"11759",415,87,328,"TGTTGTTGGCACAACACGAT","AGTATCGTCATATTCCCCGA","561307.5.peg.1974","1084"
"11760",323,151,172,"ACACCTTCACCTTAAACTGT","TGTTGCGGCCATCAACTGAT","561307.5.peg.1974","1084"
"11761",415,151,264,"TGTTGTTGGCACAACACGAT","TGTTGCGGCCATCAACTGAT","561307.5.peg.1974","1084"
"11762",408,151,257,"GGCACAACACGATGGGCTTG","TGTTGCGGCCATCAACTGAT","561307.5.peg.1974","1084"
"11763",323,166,157,"ACACCTTCACCTTAAACTGT","TTCACAGCATACATGTGTTG","561307.5.peg.1974","1084"
"11764",415,166,249,"TGTTGTTGGCACAACACGAT","TTCACAGCATACATGTGTTG","561307.5.peg.1974","1084"
"11765",408,166,242,"GGCACAACACGATGGGCTTG","TTCACAGCATACATGTGTTG","561307.5.peg.1974","1084"
"11766",87,323,236,"AGTATCGTCATATTCCCCGA","ACACCTTCACCTTAAACTGT","561307.5.peg.1974","1084"
"11767",151,323,172,"TGTTGCGGCCATCAACTGAT","ACACCTTCACCTTAAACTGT","561307.5.peg.1974","1084"
"11768",166,323,157,"TTCACAGCATACATGTGTTG","ACACCTTCACCTTAAACTGT","561307.5.peg.1974","1084"
"11769",87,408,321,"AGTATCGTCATATTCCCCGA","GGCACAACACGATGGGCTTG","561307.5.peg.1974","1084"
"11770",166,408,242,"TTCACAGCATACATGTGTTG","GGCACAACACGATGGGCTTG","561307.5.peg.1974","1084"
"11771",151,408,257,"TGTTGCGGCCATCAACTGAT","GGCACAACACGATGGGCTTG","561307.5.peg.1974","1084"
"11772",87,415,328,"AGTATCGTCATATTCCCCGA","TGTTGTTGGCACAACACGAT","561307.5.peg.1974","1084"
"11773",166,415,249,"TTCACAGCATACATGTGTTG","TGTTGTTGGCACAACACGAT","561307.5.peg.1974","1084"
"11774",151,415,264,"TGTTGCGGCCATCAACTGAT","TGTTGTTGGCACAACACGAT","561307.5.peg.1974","1084"
"11775",379,11,368,"ATACAAGTCTGCTGCTTGTC","GCAATCGCTTTAGCTCAATA","561307.5.peg.1976","1086"
"11776",11,379,368,"GCAATCGCTTTAGCTCAATA","ATACAAGTCTGCTGCTTGTC","561307.5.peg.1976","1086"
"11777",568,129,439,"TGCTGCAAATCCTCCAACAG","AAGAATAAGACGCTAGGATC","561307.5.peg.1977","1087"
"11778",536,129,407,"CCATCGTTAGTCCAGCGATA","AAGAATAAGACGCTAGGATC","561307.5.peg.1977","1087"
"11779",260,129,131,"TATCATCGTAAATCCATCA","AAGAATAAGACGCTAGGATC","561307.5.peg.1977","1087"
"11780",469,129,340,"GATAATTGTCGCAGCATCGC","AAGAATAAGACGCTAGGATC","561307.5.peg.1977","1087"
"11781",314,129,185,"CTAGTACTAAGCCTAATGCT","AAGAATAAGACGCTAGGATC","561307.5.peg.1977","1087"
"11782",639,129,510,"TCTGAAACGATACGTGTTGC","AAGAATAAGACGCTAGGATC","561307.5.peg.1977","1087"
"11783",726,129,597,"GTTGTAACTAGCAATATCGT","AAGAATAAGACGCTAGGATC","561307.5.peg.1977","1087"
"11784",536,172,364,"CCATCGTTAGTCCAGCGATA","TGAGATAACCCATGTCATAA","561307.5.peg.1977","1087"
"11785",314,172,142,"CTAGTACTAAGCCTAATGCT","TGAGATAACCCATGTCATAA","561307.5.peg.1977","1087"
"11786",726,172,554,"GTTGTAACTAGCAATATCGT","TGAGATAACCCATGTCATAA","561307.5.peg.1977","1087"
"11787",469,172,297,"GATAATTGTCGCAGCATCGC","TGAGATAACCCATGTCATAA","561307.5.peg.1977","1087"
"11788",639,172,467,"TCTGAAACGATACGTGTTGC","TGAGATAACCCATGTCATAA","561307.5.peg.1977","1087"
"11789",568,172,396,"TGCTGCAAATCCTCCAACAG","TGAGATAACCCATGTCATAA","561307.5.peg.1977","1087"
"11790",469,219,250,"GATAATTGTCGCAGCATCGC","TAAATGGTTTGATGCGTACC","561307.5.peg.1977","1087"
"11791",568,219,349,"TGCTGCAAATCCTCCAACAG","TAAATGGTTTGATGCGTACC","561307.5.peg.1977","1087"
"11792",536,219,317,"CCATCGTTAGTCCAGCGATA","TAAATGGTTTGATGCGTACC","561307.5.peg.1977","1087"
"11793",726,219,507,"GTTGTAACTAGCAATATCGT","TAAATGGTTTGATGCGTACC","561307.5.peg.1977","1087"
"11794",639,219,420,"TCTGAAACGATACGTGTTGC","TAAATGGTTTGATGCGTACC","561307.5.peg.1977","1087"
"11795",469,260,209,"GATAATTGTCGCAGCATCGC","TATCATCGTAAATCCATCA","561307.5.peg.1977","1087"
"11796",129,260,131,"AAGAATAAGACGCTAGGATC","TATCATCGTAAATCCATCA","561307.5.peg.1977","1087"
"11797",536,260,276,"CCATCGTTAGTCCAGCGATA","TATCATCGTAAATCCATCA","561307.5.peg.1977","1087"
"11798",639,260,379,"TCTGAAACGATACGTGTTGC","TATCATCGTAAATCCATCA","561307.5.peg.1977","1087"
"11799",726,260,466,"GTTGTAACTAGCAATATCGT","TATCATCGTAAATCCATCA","561307.5.peg.1977","1087"
"11800",568,260,308,"TGCTGCAAATCCTCCAACAG","TATCATCGTAAATCCATCA","561307.5.peg.1977","1087"
"11801",129,314,185,"AAGAATAAGACGCTAGGATC","CTAGTACTAAGCCTAATGCT","561307.5.peg.1977","1087"
"11802",172,314,142,"TGAGATAACCCATGTCATAA","CTAGTACTAAGCCTAATGCT","561307.5.peg.1977","1087"
"11803",639,314,325,"TCTGAAACGATACGTGTTGC","CTAGTACTAAGCCTAATGCT","561307.5.peg.1977","1087"
"11804",726,314,412,"GTTGTAACTAGCAATATCGT","CTAGTACTAAGCCTAATGCT","561307.5.peg.1977","1087"
"11805",568,314,254,"TGCTGCAAATCCTCCAACAG","CTAGTACTAAGCCTAATGCT","561307.5.peg.1977","1087"
"11806",469,314,155,"GATAATTGTCGCAGCATCGC","CTAGTACTAAGCCTAATGCT","561307.5.peg.1977","1087"
"11807",536,314,222,"CCATCGTTAGTCCAGCGATA","CTAGTACTAAGCCTAATGCT","561307.5.peg.1977","1087"
"11808",129,469,340,"AAGAATAAGACGCTAGGATC","GATAATTGTCGCAGCATCGC","561307.5.peg.1977","1087"
"11809",260,469,209,"TATCATCGTAAATCCATCA","GATAATTGTCGCAGCATCGC","561307.5.peg.1977","1087"
"11810",172,469,297,"TGAGATAACCCATGTCATAA","GATAATTGTCGCAGCATCGC","561307.5.peg.1977","1087"
"11811",314,469,155,"CTAGTACTAAGCCTAATGCT","GATAATTGTCGCAGCATCGC","561307.5.peg.1977","1087"
"11812",219,469,250,"TAAATGGTTTGATGCGTACC","GATAATTGTCGCAGCATCGC","561307.5.peg.1977","1087"
"11813",726,469,257,"GTTGTAACTAGCAATATCGT","GATAATTGTCGCAGCATCGC","561307.5.peg.1977","1087"
"11814",639,469,170,"TCTGAAACGATACGTGTTGC","GATAATTGTCGCAGCATCGC","561307.5.peg.1977","1087"
"11815",172,536,364,"TGAGATAACCCATGTCATAA","CCATCGTTAGTCCAGCGATA","561307.5.peg.1977","1087"
"11816",219,536,317,"TAAATGGTTTGATGCGTACC","CCATCGTTAGTCCAGCGATA","561307.5.peg.1977","1087"
"11817",129,536,407,"AAGAATAAGACGCTAGGATC","CCATCGTTAGTCCAGCGATA","561307.5.peg.1977","1087"
"11818",726,536,190,"GTTGTAACTAGCAATATCGT","CCATCGTTAGTCCAGCGATA","561307.5.peg.1977","1087"
"11819",260,536,276,"TATCATCGTAAATCCATCA","CCATCGTTAGTCCAGCGATA","561307.5.peg.1977","1087"
"11820",639,536,103,"TCTGAAACGATACGTGTTGC","CCATCGTTAGTCCAGCGATA","561307.5.peg.1977","1087"
"11821",314,536,222,"CTAGTACTAAGCCTAATGCT","CCATCGTTAGTCCAGCGATA","561307.5.peg.1977","1087"
"11822",129,568,439,"AAGAATAAGACGCTAGGATC","TGCTGCAAATCCTCCAACAG","561307.5.peg.1977","1087"
"11823",314,568,254,"CTAGTACTAAGCCTAATGCT","TGCTGCAAATCCTCCAACAG","561307.5.peg.1977","1087"
"11824",260,568,308,"TATCATCGTAAATCCATCA","TGCTGCAAATCCTCCAACAG","561307.5.peg.1977","1087"
"11825",726,568,158,"GTTGTAACTAGCAATATCGT","TGCTGCAAATCCTCCAACAG","561307.5.peg.1977","1087"
"11826",172,568,396,"TGAGATAACCCATGTCATAA","TGCTGCAAATCCTCCAACAG","561307.5.peg.1977","1087"
"11827",219,568,349,"TAAATGGTTTGATGCGTACC","TGCTGCAAATCCTCCAACAG","561307.5.peg.1977","1087"
"11828",260,639,379,"TATCATCGTAAATCCATCA","TCTGAAACGATACGTGTTGC","561307.5.peg.1977","1087"
"11829",219,639,420,"TAAATGGTTTGATGCGTACC","TCTGAAACGATACGTGTTGC","561307.5.peg.1977","1087"
"11830",172,639,467,"TGAGATAACCCATGTCATAA","TCTGAAACGATACGTGTTGC","561307.5.peg.1977","1087"
"11831",469,639,170,"GATAATTGTCGCAGCATCGC","TCTGAAACGATACGTGTTGC","561307.5.peg.1977","1087"
"11832",536,639,103,"CCATCGTTAGTCCAGCGATA","TCTGAAACGATACGTGTTGC","561307.5.peg.1977","1087"
"11833",129,639,510,"AAGAATAAGACGCTAGGATC","TCTGAAACGATACGTGTTGC","561307.5.peg.1977","1087"
"11834",314,639,325,"CTAGTACTAAGCCTAATGCT","TCTGAAACGATACGTGTTGC","561307.5.peg.1977","1087"
"11835",469,726,257,"GATAATTGTCGCAGCATCGC","GTTGTAACTAGCAATATCGT","561307.5.peg.1977","1087"
"11836",219,726,507,"TAAATGGTTTGATGCGTACC","GTTGTAACTAGCAATATCGT","561307.5.peg.1977","1087"
"11837",129,726,597,"AAGAATAAGACGCTAGGATC","GTTGTAACTAGCAATATCGT","561307.5.peg.1977","1087"
"11838",260,726,466,"TATCATCGTAAATCCATCA","GTTGTAACTAGCAATATCGT","561307.5.peg.1977","1087"
"11839",568,726,158,"TGCTGCAAATCCTCCAACAG","GTTGTAACTAGCAATATCGT","561307.5.peg.1977","1087"
"11840",172,726,554,"TGAGATAACCCATGTCATAA","GTTGTAACTAGCAATATCGT","561307.5.peg.1977","1087"
"11841",536,726,190,"CCATCGTTAGTCCAGCGATA","GTTGTAACTAGCAATATCGT","561307.5.peg.1977","1087"
"11842",314,726,412,"CTAGTACTAAGCCTAATGCT","GTTGTAACTAGCAATATCGT","561307.5.peg.1977","1087"
"11843",351,238,113,"CCAACCATCATAACAACAGT","GTTAATGATTGCATTACAT","561307.5.peg.198","1090"
"11844",447,238,209,"ATATCTGCTGCAACTAACAT","GTTAATGATTGCATTACAT","561307.5.peg.198","1090"
"11845",525,238,287,"TGATCTCCTTCACTGTATAC","GTTAATGATTGCATTACAT","561307.5.peg.198","1090"
"11846",238,351,113,"GTTAATGATTGCATTACAT","CCAACCATCATAACAACAGT","561307.5.peg.198","1090"
"11847",525,351,174,"TGATCTCCTTCACTGTATAC","CCAACCATCATAACAACAGT","561307.5.peg.198","1090"
"11848",238,447,209,"GTTAATGATTGCATTACAT","ATATCTGCTGCAACTAACAT","561307.5.peg.198","1090"
"11849",238,525,287,"GTTAATGATTGCATTACAT","TGATCTCCTTCACTGTATAC","561307.5.peg.198","1090"
"11850",351,525,174,"CCAACCATCATAACAACAGT","TGATCTCCTTCACTGTATAC","561307.5.peg.198","1090"
"11851",424,31,393,"ATGAAGGCCAATATTGACAT","CATGATTTATCATCCTCGCT","561307.5.peg.1988","1099"
"11852",440,31,409,"CTTTATCTGTGACGGAATGA","CATGATTTATCATCCTCGCT","561307.5.peg.1988","1099"
"11853",448,31,417,"ATGTGGATCTTTATCTGTGA","CATGATTTATCATCCTCGCT","561307.5.peg.1988","1099"
"11854",532,31,501,"TCTACCGCCCAGCGAATGTC","CATGATTTATCATCCTCGCT","561307.5.peg.1988","1099"
"11855",31,424,393,"CATGATTTATCATCCTCGCT","ATGAAGGCCAATATTGACAT","561307.5.peg.1988","1099"
"11856",532,424,108,"TCTACCGCCCAGCGAATGTC","ATGAAGGCCAATATTGACAT","561307.5.peg.1988","1099"
"11857",31,440,409,"CATGATTTATCATCCTCGCT","CTTTATCTGTGACGGAATGA","561307.5.peg.1988","1099"
"11858",31,448,417,"CATGATTTATCATCCTCGCT","ATGTGGATCTTTATCTGTGA","561307.5.peg.1988","1099"
"11859",31,532,501,"CATGATTTATCATCCTCGCT","TCTACCGCCCAGCGAATGTC","561307.5.peg.1988","1099"
"11860",424,532,108,"ATGAAGGCCAATATTGACAT","TCTACCGCCCAGCGAATGTC","561307.5.peg.1988","1099"
"11861",240,17,223,"TTACAACTTGATTGACTTC","CAGATTACTATGGATATTC","561307.5.peg.1991","1103"
"11862",17,240,223,"CAGATTACTATGGATATTC","TTACAACTTGATTGACTTC","561307.5.peg.1991","1103"
"11863",250,3,247,"TAATAGTTGAGCCTTTAAGC","AACGGCTGGTATATCCGCTG","561307.5.peg.1992","1104"
"11864",586,3,583,"AATCCATTGCTCAGTCAGTG","AACGGCTGGTATATCCGCTG","561307.5.peg.1992","1104"
"11865",588,3,585,"TTAATCCATTGCTCAGTCAG","AACGGCTGGTATATCCGCTG","561307.5.peg.1992","1104"
"11866",250,5,245,"TAATAGTTGAGCCTTTAAGC","TTAACGGCTGGTATATCCGC","561307.5.peg.1992","1104"
"11867",588,5,583,"TTAATCCATTGCTCAGTCAG","TTAACGGCTGGTATATCCGC","561307.5.peg.1992","1104"
"11868",586,5,581,"AATCCATTGCTCAGTCAGTG","TTAACGGCTGGTATATCCGC","561307.5.peg.1992","1104"
"11869",3,250,247,"AACGGCTGGTATATCCGCTG","TAATAGTTGAGCCTTTAAGC","561307.5.peg.1992","1104"
"11870",5,250,245,"TTAACGGCTGGTATATCCGC","TAATAGTTGAGCCTTTAAGC","561307.5.peg.1992","1104"
"11871",586,250,336,"AATCCATTGCTCAGTCAGTG","TAATAGTTGAGCCTTTAAGC","561307.5.peg.1992","1104"
"11872",588,250,338,"TTAATCCATTGCTCAGTCAG","TAATAGTTGAGCCTTTAAGC","561307.5.peg.1992","1104"
"11873",3,586,583,"AACGGCTGGTATATCCGCTG","AATCCATTGCTCAGTCAGTG","561307.5.peg.1992","1104"
"11874",5,586,581,"TTAACGGCTGGTATATCCGC","AATCCATTGCTCAGTCAGTG","561307.5.peg.1992","1104"
"11875",250,586,336,"TAATAGTTGAGCCTTTAAGC","AATCCATTGCTCAGTCAGTG","561307.5.peg.1992","1104"
"11876",3,588,585,"AACGGCTGGTATATCCGCTG","TTAATCCATTGCTCAGTCAG","561307.5.peg.1992","1104"
"11877",250,588,338,"TAATAGTTGAGCCTTTAAGC","TTAATCCATTGCTCAGTCAG","561307.5.peg.1992","1104"
"11878",5,588,583,"TTAACGGCTGGTATATCCGC","TTAATCCATTGCTCAGTCAG","561307.5.peg.1992","1104"
"11879",732,262,470,"TGTAATAACTCAGGTACAAT","TATTGTTGGACTGTTTGTTT","561307.5.peg.1994","1106"
"11880",801,262,539,"ACTGAGCTGAAATTCGGATC","TATTGTTGGACTGTTTGTTT","561307.5.peg.1994","1106"
"11881",396,262,134,"CGCACCGCGAACGATAATTC","TATTGTTGGACTGTTTGTTT","561307.5.peg.1994","1106"
"11882",624,262,362,"TAGTCATCAGTTACAGATTT","TATTGTTGGACTGTTTGTTT","561307.5.peg.1994","1106"
"11883",807,262,545,"CTTTGAACTGAGCTGAAATT","TATTGTTGGACTGTTTGTTT","561307.5.peg.1994","1106"
"11884",262,396,134,"TATTGTTGGACTGTTTGTTT","CGCACCGCGAACGATAATTC","561307.5.peg.1994","1106"
"11885",732,396,336,"TGTAATAACTCAGGTACAAT","CGCACCGCGAACGATAATTC","561307.5.peg.1994","1106"
"11886",801,396,405,"ACTGAGCTGAAATTCGGATC","CGCACCGCGAACGATAATTC","561307.5.peg.1994","1106"
"11887",624,396,228,"TAGTCATCAGTTACAGATTT","CGCACCGCGAACGATAATTC","561307.5.peg.1994","1106"
"11888",807,396,411,"CTTTGAACTGAGCTGAAATT","CGCACCGCGAACGATAATTC","561307.5.peg.1994","1106"
"11889",801,624,177,"ACTGAGCTGAAATTCGGATC","TAGTCATCAGTTACAGATTT","561307.5.peg.1994","1106"
"11890",807,624,183,"CTTTGAACTGAGCTGAAATT","TAGTCATCAGTTACAGATTT","561307.5.peg.1994","1106"
"11891",396,624,228,"CGCACCGCGAACGATAATTC","TAGTCATCAGTTACAGATTT","561307.5.peg.1994","1106"
"11892",732,624,108,"TGTAATAACTCAGGTACAAT","TAGTCATCAGTTACAGATTT","561307.5.peg.1994","1106"
"11893",262,624,362,"TATTGTTGGACTGTTTGTTT","TAGTCATCAGTTACAGATTT","561307.5.peg.1994","1106"
"11894",262,732,470,"TATTGTTGGACTGTTTGTTT","TGTAATAACTCAGGTACAAT","561307.5.peg.1994","1106"
"11895",624,732,108,"TAGTCATCAGTTACAGATTT","TGTAATAACTCAGGTACAAT","561307.5.peg.1994","1106"
"11896",396,732,336,"CGCACCGCGAACGATAATTC","TGTAATAACTCAGGTACAAT","561307.5.peg.1994","1106"
"11897",262,801,539,"TATTGTTGGACTGTTTGTTT","ACTGAGCTGAAATTCGGATC","561307.5.peg.1994","1106"
"11898",396,801,405,"CGCACCGCGAACGATAATTC","ACTGAGCTGAAATTCGGATC","561307.5.peg.1994","1106"
"11899",624,801,177,"TAGTCATCAGTTACAGATTT","ACTGAGCTGAAATTCGGATC","561307.5.peg.1994","1106"
"11900",262,807,545,"TATTGTTGGACTGTTTGTTT","CTTTGAACTGAGCTGAAATT","561307.5.peg.1994","1106"
"11901",396,807,411,"CGCACCGCGAACGATAATTC","CTTTGAACTGAGCTGAAATT","561307.5.peg.1994","1106"
"11902",624,807,183,"TAGTCATCAGTTACAGATTT","CTTTGAACTGAGCTGAAATT","561307.5.peg.1994","1106"
"11903",519,376,143,"ACAATGACACCAATTAAAGC","AATGGTGATAGCTGTAGATA","561307.5.peg.1997","1109"
"11904",519,417,102,"ACAATGACACCAATTAAAGC","GGAAGAATTGCCCTAAACGC","561307.5.peg.1997","1109"
"11905",376,519,143,"AATGGTGATAGCTGTAGATA","ACAATGACACCAATTAAAGC","561307.5.peg.1997","1109"
"11906",417,519,102,"GGAAGAATTGCCCTAAACGC","ACAATGACACCAATTAAAGC","561307.5.peg.1997","1109"
"11907",168,5,163,"TGTTTCACTCGCTCTTCACC","GGAATCAAGAATCCAGACAC","561307.5.peg.1998","1110"
"11908",225,5,220,"GTTAATGGGTTCACTGTGAT","GGAATCAAGAATCCAGACAC","561307.5.peg.1998","1110"
"11909",168,21,147,"TGTTTCACTCGCTCTTCACC","GTGTCTGGATTCTTGATTCC","561307.5.peg.1998","1110"
"11910",225,21,204,"GTTAATGGGTTCACTGTGAT","GTGTCTGGATTCTTGATTCC","561307.5.peg.1998","1110"
"11911",5,168,163,"GGAATCAAGAATCCAGACAC","TGTTTCACTCGCTCTTCACC","561307.5.peg.1998","1110"
"11912",21,168,147,"GTGTCTGGATTCTTGATTCC","TGTTTCACTCGCTCTTCACC","561307.5.peg.1998","1110"
"11913",5,225,220,"GGAATCAAGAATCCAGACAC","GTTAATGGGTTCACTGTGAT","561307.5.peg.1998","1110"
"11914",21,225,204,"GTGTCTGGATTCTTGATTCC","GTTAATGGGTTCACTGTGAT","561307.5.peg.1998","1110"
"11915",497,4,493,"GTTCAATATCCTGTAAACCG","AATCCTTTAGTATTCCAAC","561307.5.peg.1999","1111"
"11916",486,4,482,"TGTAAACCGTGGAATTTATC","AATCCTTTAGTATTCCAAC","561307.5.peg.1999","1111"
"11917",125,4,121,"GGTCAAATTTAGAACCAAAC","AATCCTTTAGTATTCCAAC","561307.5.peg.1999","1111"
"11918",651,4,647,"CCAGCAATTTGGTGCATCAT","AATCCTTTAGTATTCCAAC","561307.5.peg.1999","1111"
"11919",480,4,476,"CCGTGGAATTTATCCGGTAA","AATCCTTTAGTATTCCAAC","561307.5.peg.1999","1111"
"11920",146,4,142,"AATCACTAGATAAACCTGAA","AATCCTTTAGTATTCCAAC","561307.5.peg.1999","1111"
"11921",662,4,658,"CAGCTGCTCCACCAGCAATT","AATCCTTTAGTATTCCAAC","561307.5.peg.1999","1111"
"11922",651,29,622,"CCAGCAATTTGGTGCATCAT","GTACCAGTTGGAATACTAA","561307.5.peg.1999","1111"
"11923",486,29,457,"TGTAAACCGTGGAATTTATC","GTACCAGTTGGAATACTAA","561307.5.peg.1999","1111"
"11924",662,29,633,"CAGCTGCTCCACCAGCAATT","GTACCAGTTGGAATACTAA","561307.5.peg.1999","1111"
"11925",497,29,468,"GTTCAATATCCTGTAAACCG","GTACCAGTTGGAATACTAA","561307.5.peg.1999","1111"
"11926",480,29,451,"CCGTGGAATTTATCCGGTAA","GTACCAGTTGGAATACTAA","561307.5.peg.1999","1111"
"11927",146,29,117,"AATCACTAGATAAACCTGAA","GTACCAGTTGGAATACTAA","561307.5.peg.1999","1111"
"11928",480,71,409,"CCGTGGAATTTATCCGGTAA","TTTGACGTCGAACCAACATT","561307.5.peg.1999","1111"
"11929",497,71,426,"GTTCAATATCCTGTAAACCG","TTTGACGTCGAACCAACATT","561307.5.peg.1999","1111"
"11930",662,71,591,"CAGCTGCTCCACCAGCAATT","TTTGACGTCGAACCAACATT","561307.5.peg.1999","1111"
"11931",486,71,415,"TGTAAACCGTGGAATTTATC","TTTGACGTCGAACCAACATT","561307.5.peg.1999","1111"
"11932",651,71,580,"CCAGCAATTTGGTGCATCAT","TTTGACGTCGAACCAACATT","561307.5.peg.1999","1111"
"11933",486,125,361,"TGTAAACCGTGGAATTTATC","GGTCAAATTTAGAACCAAAC","561307.5.peg.1999","1111"
"11934",480,125,355,"CCGTGGAATTTATCCGGTAA","GGTCAAATTTAGAACCAAAC","561307.5.peg.1999","1111"
"11935",497,125,372,"GTTCAATATCCTGTAAACCG","GGTCAAATTTAGAACCAAAC","561307.5.peg.1999","1111"
"11936",4,125,121,"AATCCTTTAGTATTCCAAC","GGTCAAATTTAGAACCAAAC","561307.5.peg.1999","1111"
"11937",662,125,537,"CAGCTGCTCCACCAGCAATT","GGTCAAATTTAGAACCAAAC","561307.5.peg.1999","1111"
"11938",651,125,526,"CCAGCAATTTGGTGCATCAT","GGTCAAATTTAGAACCAAAC","561307.5.peg.1999","1111"
"11939",4,146,142,"AATCCTTTAGTATTCCAAC","AATCACTAGATAAACCTGAA","561307.5.peg.1999","1111"
"11940",29,146,117,"GTACCAGTTGGAATACTAA","AATCACTAGATAAACCTGAA","561307.5.peg.1999","1111"
"11941",662,146,516,"CAGCTGCTCCACCAGCAATT","AATCACTAGATAAACCTGAA","561307.5.peg.1999","1111"
"11942",480,146,334,"CCGTGGAATTTATCCGGTAA","AATCACTAGATAAACCTGAA","561307.5.peg.1999","1111"
"11943",651,146,505,"CCAGCAATTTGGTGCATCAT","AATCACTAGATAAACCTGAA","561307.5.peg.1999","1111"
"11944",486,146,340,"TGTAAACCGTGGAATTTATC","AATCACTAGATAAACCTGAA","561307.5.peg.1999","1111"
"11945",497,146,351,"GTTCAATATCCTGTAAACCG","AATCACTAGATAAACCTGAA","561307.5.peg.1999","1111"
"11946",71,480,409,"TTTGACGTCGAACCAACATT","CCGTGGAATTTATCCGGTAA","561307.5.peg.1999","1111"
"11947",651,480,171,"CCAGCAATTTGGTGCATCAT","CCGTGGAATTTATCCGGTAA","561307.5.peg.1999","1111"
"11948",125,480,355,"GGTCAAATTTAGAACCAAAC","CCGTGGAATTTATCCGGTAA","561307.5.peg.1999","1111"
"11949",29,480,451,"GTACCAGTTGGAATACTAA","CCGTGGAATTTATCCGGTAA","561307.5.peg.1999","1111"
"11950",4,480,476,"AATCCTTTAGTATTCCAAC","CCGTGGAATTTATCCGGTAA","561307.5.peg.1999","1111"
"11951",146,480,334,"AATCACTAGATAAACCTGAA","CCGTGGAATTTATCCGGTAA","561307.5.peg.1999","1111"
"11952",662,480,182,"CAGCTGCTCCACCAGCAATT","CCGTGGAATTTATCCGGTAA","561307.5.peg.1999","1111"
"11953",4,486,482,"AATCCTTTAGTATTCCAAC","TGTAAACCGTGGAATTTATC","561307.5.peg.1999","1111"
"11954",651,486,165,"CCAGCAATTTGGTGCATCAT","TGTAAACCGTGGAATTTATC","561307.5.peg.1999","1111"
"11955",662,486,176,"CAGCTGCTCCACCAGCAATT","TGTAAACCGTGGAATTTATC","561307.5.peg.1999","1111"
"11956",146,486,340,"AATCACTAGATAAACCTGAA","TGTAAACCGTGGAATTTATC","561307.5.peg.1999","1111"
"11957",125,486,361,"GGTCAAATTTAGAACCAAAC","TGTAAACCGTGGAATTTATC","561307.5.peg.1999","1111"
"11958",29,486,457,"GTACCAGTTGGAATACTAA","TGTAAACCGTGGAATTTATC","561307.5.peg.1999","1111"
"11959",71,486,415,"TTTGACGTCGAACCAACATT","TGTAAACCGTGGAATTTATC","561307.5.peg.1999","1111"
"11960",4,497,493,"AATCCTTTAGTATTCCAAC","GTTCAATATCCTGTAAACCG","561307.5.peg.1999","1111"
"11961",662,497,165,"CAGCTGCTCCACCAGCAATT","GTTCAATATCCTGTAAACCG","561307.5.peg.1999","1111"
"11962",71,497,426,"TTTGACGTCGAACCAACATT","GTTCAATATCCTGTAAACCG","561307.5.peg.1999","1111"
"11963",651,497,154,"CCAGCAATTTGGTGCATCAT","GTTCAATATCCTGTAAACCG","561307.5.peg.1999","1111"
"11964",146,497,351,"AATCACTAGATAAACCTGAA","GTTCAATATCCTGTAAACCG","561307.5.peg.1999","1111"
"11965",125,497,372,"GGTCAAATTTAGAACCAAAC","GTTCAATATCCTGTAAACCG","561307.5.peg.1999","1111"
"11966",29,497,468,"GTACCAGTTGGAATACTAA","GTTCAATATCCTGTAAACCG","561307.5.peg.1999","1111"
"11967",29,651,622,"GTACCAGTTGGAATACTAA","CCAGCAATTTGGTGCATCAT","561307.5.peg.1999","1111"
"11968",497,651,154,"GTTCAATATCCTGTAAACCG","CCAGCAATTTGGTGCATCAT","561307.5.peg.1999","1111"
"11969",4,651,647,"AATCCTTTAGTATTCCAAC","CCAGCAATTTGGTGCATCAT","561307.5.peg.1999","1111"
"11970",480,651,171,"CCGTGGAATTTATCCGGTAA","CCAGCAATTTGGTGCATCAT","561307.5.peg.1999","1111"
"11971",125,651,526,"GGTCAAATTTAGAACCAAAC","CCAGCAATTTGGTGCATCAT","561307.5.peg.1999","1111"
"11972",146,651,505,"AATCACTAGATAAACCTGAA","CCAGCAATTTGGTGCATCAT","561307.5.peg.1999","1111"
"11973",71,651,580,"TTTGACGTCGAACCAACATT","CCAGCAATTTGGTGCATCAT","561307.5.peg.1999","1111"
"11974",486,651,165,"TGTAAACCGTGGAATTTATC","CCAGCAATTTGGTGCATCAT","561307.5.peg.1999","1111"
"11975",4,662,658,"AATCCTTTAGTATTCCAAC","CAGCTGCTCCACCAGCAATT","561307.5.peg.1999","1111"
"11976",146,662,516,"AATCACTAGATAAACCTGAA","CAGCTGCTCCACCAGCAATT","561307.5.peg.1999","1111"
"11977",71,662,591,"TTTGACGTCGAACCAACATT","CAGCTGCTCCACCAGCAATT","561307.5.peg.1999","1111"
"11978",125,662,537,"GGTCAAATTTAGAACCAAAC","CAGCTGCTCCACCAGCAATT","561307.5.peg.1999","1111"
"11979",29,662,633,"GTACCAGTTGGAATACTAA","CAGCTGCTCCACCAGCAATT","561307.5.peg.1999","1111"
"11980",480,662,182,"CCGTGGAATTTATCCGGTAA","CAGCTGCTCCACCAGCAATT","561307.5.peg.1999","1111"
"11981",486,662,176,"TGTAAACCGTGGAATTTATC","CAGCTGCTCCACCAGCAATT","561307.5.peg.1999","1111"
"11982",497,662,165,"GTTCAATATCCTGTAAACCG","CAGCTGCTCCACCAGCAATT","561307.5.peg.1999","1111"
"11983",219,8,211,"TCCGCTTCACTCAACTTGCG","AATAGATGATGTGTTGAAGG","561307.5.peg.200","1114"
"11984",219,11,208,"TCCGCTTCACTCAACTTGCG","ACAATAGATGATGTGTTGA","561307.5.peg.200","1114"
"11985",8,219,211,"AATAGATGATGTGTTGAAGG","TCCGCTTCACTCAACTTGCG","561307.5.peg.200","1114"
"11986",11,219,208,"ACAATAGATGATGTGTTGA","TCCGCTTCACTCAACTTGCG","561307.5.peg.200","1114"
"11987",165,4,161,"ACTGGTGCTGTTTCATAAAT","CCTACTCCATCATAATGACC","561307.5.peg.2000","1115"
"11988",183,4,179,"GGTTGCTCAGTATACCCAAC","CCTACTCCATCATAATGACC","561307.5.peg.2000","1115"
"11989",165,8,157,"ACTGGTGCTGTTTCATAAAT","AGTAGGTATCGAAATAGTGA","561307.5.peg.2000","1115"
"11990",183,8,175,"GGTTGCTCAGTATACCCAAC","AGTAGGTATCGAAATAGTGA","561307.5.peg.2000","1115"
"11991",165,25,140,"ACTGGTGCTGTTTCATAAAT","CCGGGTCATTATGATGGAGT","561307.5.peg.2000","1115"
"11992",183,25,158,"GGTTGCTCAGTATACCCAAC","CCGGGTCATTATGATGGAGT","561307.5.peg.2000","1115"
"11993",165,31,134,"ACTGGTGCTGTTTCATAAAT","ATTCCGGGTCATTATGA","561307.5.peg.2000","1115"
"11994",183,31,152,"GGTTGCTCAGTATACCCAAC","ATTCCGGGTCATTATGA","561307.5.peg.2000","1115"
"11995",4,165,161,"CCTACTCCATCATAATGACC","ACTGGTGCTGTTTCATAAAT","561307.5.peg.2000","1115"
"11996",8,165,157,"AGTAGGTATCGAAATAGTGA","ACTGGTGCTGTTTCATAAAT","561307.5.peg.2000","1115"
"11997",25,165,140,"CCGGGTCATTATGATGGAGT","ACTGGTGCTGTTTCATAAAT","561307.5.peg.2000","1115"
"11998",31,165,134,"ATTCCGGGTCATTATGA","ACTGGTGCTGTTTCATAAAT","561307.5.peg.2000","1115"
"11999",4,183,179,"CCTACTCCATCATAATGACC","GGTTGCTCAGTATACCCAAC","561307.5.peg.2000","1115"
"12000",8,183,175,"AGTAGGTATCGAAATAGTGA","GGTTGCTCAGTATACCCAAC","561307.5.peg.2000","1115"
"12001",25,183,158,"CCGGGTCATTATGATGGAGT","GGTTGCTCAGTATACCCAAC","561307.5.peg.2000","1115"
"12002",31,183,152,"ATTCCGGGTCATTATGA","GGTTGCTCAGTATACCCAAC","561307.5.peg.2000","1115"
"12003",207,90,117,"AATGAAACCATTTCATGACC","CCACCATCTGAGAATGAATC","561307.5.peg.2002","1117"
"12004",90,207,117,"CCACCATCTGAGAATGAATC","AATGAAACCATTTCATGACC","561307.5.peg.2002","1117"
"12005",339,171,168,"CGCTCTTGGCTCATTGTTTC","CTATCCTTTACAGAACCACC","561307.5.peg.2003","1118"
"12006",353,171,182,"TAATAAATTACGACGCTCT","CTATCCTTTACAGAACCACC","561307.5.peg.2003","1118"
"12007",405,171,234,"CCTTTCATCGCTTCTGATCC","CTATCCTTTACAGAACCACC","561307.5.peg.2003","1118"
"12008",405,264,141,"CCTTTCATCGCTTCTGATCC","ATACCTGTATTACCACTTGT","561307.5.peg.2003","1118"
"12009",171,339,168,"CTATCCTTTACAGAACCACC","CGCTCTTGGCTCATTGTTTC","561307.5.peg.2003","1118"
"12010",171,353,182,"CTATCCTTTACAGAACCACC","TAATAAATTACGACGCTCT","561307.5.peg.2003","1118"
"12011",171,405,234,"CTATCCTTTACAGAACCACC","CCTTTCATCGCTTCTGATCC","561307.5.peg.2003","1118"
"12012",264,405,141,"ATACCTGTATTACCACTTGT","CCTTTCATCGCTTCTGATCC","561307.5.peg.2003","1118"
"12013",267,162,105,"TCGGCAATAATTCGTCCAAT","CCCATTGCAGCAGATGCTGT","561307.5.peg.2004","1119"
"12014",162,267,105,"CCCATTGCAGCAGATGCTGT","TCGGCAATAATTCGTCCAAT","561307.5.peg.2004","1119"
"12015",995,144,851,"GACGTAATAAGGCTGGGTCA","GATTATATGTAAGCTGTTT","561307.5.peg.2005","1120"
"12016",987,144,843,"AAGGCTGGGTCAAGGATATC","GATTATATGTAAGCTGTTT","561307.5.peg.2005","1120"
"12017",983,144,839,"CTGGGTCAAGGATATCAGGA","GATTATATGTAAGCTGTTT","561307.5.peg.2005","1120"
"12018",782,144,638,"TATCGAATAAGTCACGAACA","GATTATATGTAAGCTGTTT","561307.5.peg.2005","1120"
"12019",642,144,498,"CCAACAAGTAAGACACCTTT","GATTATATGTAAGCTGTTT","561307.5.peg.2005","1120"
"12020",1067,144,923,"GAACATGAAGAATTGCTTCA","GATTATATGTAAGCTGTTT","561307.5.peg.2005","1120"
"12021",1053,144,909,"GCTTCACGGCCTTTCACATC","GATTATATGTAAGCTGTTT","561307.5.peg.2005","1120"
"12022",995,642,353,"GACGTAATAAGGCTGGGTCA","CCAACAAGTAAGACACCTTT","561307.5.peg.2005","1120"
"12023",782,642,140,"TATCGAATAAGTCACGAACA","CCAACAAGTAAGACACCTTT","561307.5.peg.2005","1120"
"12024",1053,642,411,"GCTTCACGGCCTTTCACATC","CCAACAAGTAAGACACCTTT","561307.5.peg.2005","1120"
"12025",987,642,345,"AAGGCTGGGTCAAGGATATC","CCAACAAGTAAGACACCTTT","561307.5.peg.2005","1120"
"12026",983,642,341,"CTGGGTCAAGGATATCAGGA","CCAACAAGTAAGACACCTTT","561307.5.peg.2005","1120"
"12027",144,642,498,"GATTATATGTAAGCTGTTT","CCAACAAGTAAGACACCTTT","561307.5.peg.2005","1120"
"12028",1067,642,425,"GAACATGAAGAATTGCTTCA","CCAACAAGTAAGACACCTTT","561307.5.peg.2005","1120"
"12029",144,782,638,"GATTATATGTAAGCTGTTT","TATCGAATAAGTCACGAACA","561307.5.peg.2005","1120"
"12030",995,782,213,"GACGTAATAAGGCTGGGTCA","TATCGAATAAGTCACGAACA","561307.5.peg.2005","1120"
"12031",983,782,201,"CTGGGTCAAGGATATCAGGA","TATCGAATAAGTCACGAACA","561307.5.peg.2005","1120"
"12032",1067,782,285,"GAACATGAAGAATTGCTTCA","TATCGAATAAGTCACGAACA","561307.5.peg.2005","1120"
"12033",1053,782,271,"GCTTCACGGCCTTTCACATC","TATCGAATAAGTCACGAACA","561307.5.peg.2005","1120"
"12034",642,782,140,"CCAACAAGTAAGACACCTTT","TATCGAATAAGTCACGAACA","561307.5.peg.2005","1120"
"12035",987,782,205,"AAGGCTGGGTCAAGGATATC","TATCGAATAAGTCACGAACA","561307.5.peg.2005","1120"
"12036",144,983,839,"GATTATATGTAAGCTGTTT","CTGGGTCAAGGATATCAGGA","561307.5.peg.2005","1120"
"12037",782,983,201,"TATCGAATAAGTCACGAACA","CTGGGTCAAGGATATCAGGA","561307.5.peg.2005","1120"
"12038",642,983,341,"CCAACAAGTAAGACACCTTT","CTGGGTCAAGGATATCAGGA","561307.5.peg.2005","1120"
"12039",782,987,205,"TATCGAATAAGTCACGAACA","AAGGCTGGGTCAAGGATATC","561307.5.peg.2005","1120"
"12040",642,987,345,"CCAACAAGTAAGACACCTTT","AAGGCTGGGTCAAGGATATC","561307.5.peg.2005","1120"
"12041",144,987,843,"GATTATATGTAAGCTGTTT","AAGGCTGGGTCAAGGATATC","561307.5.peg.2005","1120"
"12042",782,995,213,"TATCGAATAAGTCACGAACA","GACGTAATAAGGCTGGGTCA","561307.5.peg.2005","1120"
"12043",642,995,353,"CCAACAAGTAAGACACCTTT","GACGTAATAAGGCTGGGTCA","561307.5.peg.2005","1120"
"12044",144,995,851,"GATTATATGTAAGCTGTTT","GACGTAATAAGGCTGGGTCA","561307.5.peg.2005","1120"
"12045",642,1053,411,"CCAACAAGTAAGACACCTTT","GCTTCACGGCCTTTCACATC","561307.5.peg.2005","1120"
"12046",144,1053,909,"GATTATATGTAAGCTGTTT","GCTTCACGGCCTTTCACATC","561307.5.peg.2005","1120"
"12047",782,1053,271,"TATCGAATAAGTCACGAACA","GCTTCACGGCCTTTCACATC","561307.5.peg.2005","1120"
"12048",642,1067,425,"CCAACAAGTAAGACACCTTT","GAACATGAAGAATTGCTTCA","561307.5.peg.2005","1120"
"12049",144,1067,923,"GATTATATGTAAGCTGTTT","GAACATGAAGAATTGCTTCA","561307.5.peg.2005","1120"
"12050",782,1067,285,"TATCGAATAAGTCACGAACA","GAACATGAAGAATTGCTTCA","561307.5.peg.2005","1120"
"12051",557,86,471,"TGGAATATGATATCTCTCT","TAGAAACAGCGACAACAATA","561307.5.peg.2007","1122"
"12052",86,557,471,"TAGAAACAGCGACAACAATA","TGGAATATGATATCTCTCT","561307.5.peg.2007","1122"
"12053",1384,106,1278,"TACAGCAGAAAGTTCTTTGT","CCTTTATCGAATTGAACAT","561307.5.peg.201","1125"
"12054",1647,106,1541,"TTGCCTGAGTTAATTTAGA","CCTTTATCGAATTGAACAT","561307.5.peg.201","1125"
"12055",812,106,706,"CAGCTTCTTTATTTGCTTGT","CCTTTATCGAATTGAACAT","561307.5.peg.201","1125"
"12056",106,812,706,"CCTTTATCGAATTGAACAT","CAGCTTCTTTATTTGCTTGT","561307.5.peg.201","1125"
"12057",1384,812,572,"TACAGCAGAAAGTTCTTTGT","CAGCTTCTTTATTTGCTTGT","561307.5.peg.201","1125"
"12058",1647,812,835,"TTGCCTGAGTTAATTTAGA","CAGCTTCTTTATTTGCTTGT","561307.5.peg.201","1125"
"12059",106,1384,1278,"CCTTTATCGAATTGAACAT","TACAGCAGAAAGTTCTTTGT","561307.5.peg.201","1125"
"12060",1647,1384,263,"TTGCCTGAGTTAATTTAGA","TACAGCAGAAAGTTCTTTGT","561307.5.peg.201","1125"
"12061",812,1384,572,"CAGCTTCTTTATTTGCTTGT","TACAGCAGAAAGTTCTTTGT","561307.5.peg.201","1125"
"12062",106,1647,1541,"CCTTTATCGAATTGAACAT","TTGCCTGAGTTAATTTAGA","561307.5.peg.201","1125"
"12063",812,1647,835,"CAGCTTCTTTATTTGCTTGT","TTGCCTGAGTTAATTTAGA","561307.5.peg.201","1125"
"12064",1384,1647,263,"TACAGCAGAAAGTTCTTTGT","TTGCCTGAGTTAATTTAGA","561307.5.peg.201","1125"
"12065",324,7,317,"GTAGTTGTCTCAGCAACTCT","GATACAACTTTGAACCAAA","561307.5.peg.2011","1127"
"12066",168,7,161,"CTTGCAATGATTCTATAAC","GATACAACTTTGAACCAAA","561307.5.peg.2011","1127"
"12067",588,7,581,"ATTTGAACAGGGTAATCATC","GATACAACTTTGAACCAAA","561307.5.peg.2011","1127"
"12068",599,7,592,"CACCAGTGACAATTTGAACA","GATACAACTTTGAACCAAA","561307.5.peg.2011","1127"
"12069",315,7,308,"TCAGCAACTCTAGGATGACC","GATACAACTTTGAACCAAA","561307.5.peg.2011","1127"
"12070",450,7,443,"AACAGTGTGAAGCCATCATT","GATACAACTTTGAACCAAA","561307.5.peg.2011","1127"
"12071",168,61,107,"CTTGCAATGATTCTATAAC","TCCTAAGCCAACAATCGTAA","561307.5.peg.2011","1127"
"12072",588,61,527,"ATTTGAACAGGGTAATCATC","TCCTAAGCCAACAATCGTAA","561307.5.peg.2011","1127"
"12073",324,61,263,"GTAGTTGTCTCAGCAACTCT","TCCTAAGCCAACAATCGTAA","561307.5.peg.2011","1127"
"12074",599,61,538,"CACCAGTGACAATTTGAACA","TCCTAAGCCAACAATCGTAA","561307.5.peg.2011","1127"
"12075",315,61,254,"TCAGCAACTCTAGGATGACC","TCCTAAGCCAACAATCGTAA","561307.5.peg.2011","1127"
"12076",450,61,389,"AACAGTGTGAAGCCATCATT","TCCTAAGCCAACAATCGTAA","561307.5.peg.2011","1127"
"12077",7,168,161,"GATACAACTTTGAACCAAA","CTTGCAATGATTCTATAAC","561307.5.peg.2011","1127"
"12078",450,168,282,"AACAGTGTGAAGCCATCATT","CTTGCAATGATTCTATAAC","561307.5.peg.2011","1127"
"12079",315,168,147,"TCAGCAACTCTAGGATGACC","CTTGCAATGATTCTATAAC","561307.5.peg.2011","1127"
"12080",61,168,107,"TCCTAAGCCAACAATCGTAA","CTTGCAATGATTCTATAAC","561307.5.peg.2011","1127"
"12081",599,168,431,"CACCAGTGACAATTTGAACA","CTTGCAATGATTCTATAAC","561307.5.peg.2011","1127"
"12082",588,168,420,"ATTTGAACAGGGTAATCATC","CTTGCAATGATTCTATAAC","561307.5.peg.2011","1127"
"12083",324,168,156,"GTAGTTGTCTCAGCAACTCT","CTTGCAATGATTCTATAAC","561307.5.peg.2011","1127"
"12084",168,315,147,"CTTGCAATGATTCTATAAC","TCAGCAACTCTAGGATGACC","561307.5.peg.2011","1127"
"12085",7,315,308,"GATACAACTTTGAACCAAA","TCAGCAACTCTAGGATGACC","561307.5.peg.2011","1127"
"12086",450,315,135,"AACAGTGTGAAGCCATCATT","TCAGCAACTCTAGGATGACC","561307.5.peg.2011","1127"
"12087",588,315,273,"ATTTGAACAGGGTAATCATC","TCAGCAACTCTAGGATGACC","561307.5.peg.2011","1127"
"12088",599,315,284,"CACCAGTGACAATTTGAACA","TCAGCAACTCTAGGATGACC","561307.5.peg.2011","1127"
"12089",61,315,254,"TCCTAAGCCAACAATCGTAA","TCAGCAACTCTAGGATGACC","561307.5.peg.2011","1127"
"12090",168,324,156,"CTTGCAATGATTCTATAAC","GTAGTTGTCTCAGCAACTCT","561307.5.peg.2011","1127"
"12091",7,324,317,"GATACAACTTTGAACCAAA","GTAGTTGTCTCAGCAACTCT","561307.5.peg.2011","1127"
"12092",599,324,275,"CACCAGTGACAATTTGAACA","GTAGTTGTCTCAGCAACTCT","561307.5.peg.2011","1127"
"12093",61,324,263,"TCCTAAGCCAACAATCGTAA","GTAGTTGTCTCAGCAACTCT","561307.5.peg.2011","1127"
"12094",588,324,264,"ATTTGAACAGGGTAATCATC","GTAGTTGTCTCAGCAACTCT","561307.5.peg.2011","1127"
"12095",450,324,126,"AACAGTGTGAAGCCATCATT","GTAGTTGTCTCAGCAACTCT","561307.5.peg.2011","1127"
"12096",7,450,443,"GATACAACTTTGAACCAAA","AACAGTGTGAAGCCATCATT","561307.5.peg.2011","1127"
"12097",168,450,282,"CTTGCAATGATTCTATAAC","AACAGTGTGAAGCCATCATT","561307.5.peg.2011","1127"
"12098",61,450,389,"TCCTAAGCCAACAATCGTAA","AACAGTGTGAAGCCATCATT","561307.5.peg.2011","1127"
"12099",315,450,135,"TCAGCAACTCTAGGATGACC","AACAGTGTGAAGCCATCATT","561307.5.peg.2011","1127"
"12100",324,450,126,"GTAGTTGTCTCAGCAACTCT","AACAGTGTGAAGCCATCATT","561307.5.peg.2011","1127"
"12101",599,450,149,"CACCAGTGACAATTTGAACA","AACAGTGTGAAGCCATCATT","561307.5.peg.2011","1127"
"12102",588,450,138,"ATTTGAACAGGGTAATCATC","AACAGTGTGAAGCCATCATT","561307.5.peg.2011","1127"
"12103",7,588,581,"GATACAACTTTGAACCAAA","ATTTGAACAGGGTAATCATC","561307.5.peg.2011","1127"
"12104",61,588,527,"TCCTAAGCCAACAATCGTAA","ATTTGAACAGGGTAATCATC","561307.5.peg.2011","1127"
"12105",450,588,138,"AACAGTGTGAAGCCATCATT","ATTTGAACAGGGTAATCATC","561307.5.peg.2011","1127"
"12106",168,588,420,"CTTGCAATGATTCTATAAC","ATTTGAACAGGGTAATCATC","561307.5.peg.2011","1127"
"12107",315,588,273,"TCAGCAACTCTAGGATGACC","ATTTGAACAGGGTAATCATC","561307.5.peg.2011","1127"
"12108",324,588,264,"GTAGTTGTCTCAGCAACTCT","ATTTGAACAGGGTAATCATC","561307.5.peg.2011","1127"
"12109",7,599,592,"GATACAACTTTGAACCAAA","CACCAGTGACAATTTGAACA","561307.5.peg.2011","1127"
"12110",450,599,149,"AACAGTGTGAAGCCATCATT","CACCAGTGACAATTTGAACA","561307.5.peg.2011","1127"
"12111",324,599,275,"GTAGTTGTCTCAGCAACTCT","CACCAGTGACAATTTGAACA","561307.5.peg.2011","1127"
"12112",168,599,431,"CTTGCAATGATTCTATAAC","CACCAGTGACAATTTGAACA","561307.5.peg.2011","1127"
"12113",61,599,538,"TCCTAAGCCAACAATCGTAA","CACCAGTGACAATTTGAACA","561307.5.peg.2011","1127"
"12114",315,599,284,"TCAGCAACTCTAGGATGACC","CACCAGTGACAATTTGAACA","561307.5.peg.2011","1127"
"12115",390,192,198,"AAACTTGCAGCTTGAATCAT","TCATTCCTAATGCTACAAT","561307.5.peg.2012","1128"
"12116",483,192,291,"TCTATAACCTGGGAAATAGC","TCATTCCTAATGCTACAAT","561307.5.peg.2012","1128"
"12117",493,192,301,"ATAACTTGTTCTATAACCT","TCATTCCTAATGCTACAAT","561307.5.peg.2012","1128"
"12118",483,229,254,"TCTATAACCTGGGAAATAGC","TTGTGTAATTGCACTAGGAA","561307.5.peg.2012","1128"
"12119",390,229,161,"AAACTTGCAGCTTGAATCAT","TTGTGTAATTGCACTAGGAA","561307.5.peg.2012","1128"
"12120",493,229,264,"ATAACTTGTTCTATAACCT","TTGTGTAATTGCACTAGGAA","561307.5.peg.2012","1128"
"12121",192,390,198,"TCATTCCTAATGCTACAAT","AAACTTGCAGCTTGAATCAT","561307.5.peg.2012","1128"
"12122",229,390,161,"TTGTGTAATTGCACTAGGAA","AAACTTGCAGCTTGAATCAT","561307.5.peg.2012","1128"
"12123",493,390,103,"ATAACTTGTTCTATAACCT","AAACTTGCAGCTTGAATCAT","561307.5.peg.2012","1128"
"12124",192,483,291,"TCATTCCTAATGCTACAAT","TCTATAACCTGGGAAATAGC","561307.5.peg.2012","1128"
"12125",229,483,254,"TTGTGTAATTGCACTAGGAA","TCTATAACCTGGGAAATAGC","561307.5.peg.2012","1128"
"12126",192,493,301,"TCATTCCTAATGCTACAAT","ATAACTTGTTCTATAACCT","561307.5.peg.2012","1128"
"12127",390,493,103,"AAACTTGCAGCTTGAATCAT","ATAACTTGTTCTATAACCT","561307.5.peg.2012","1128"
"12128",229,493,264,"TTGTGTAATTGCACTAGGAA","ATAACTTGTTCTATAACCT","561307.5.peg.2012","1128"
"12129",332,98,234,"TACGTTCACTCATCAGTTGA","CTTGTCCAAATACCTGATTA","561307.5.peg.2013","1129"
"12130",1282,98,1184,"CATACGTTCAACTTTAGTTT","CTTGTCCAAATACCTGATTA","561307.5.peg.2013","1129"
"12131",541,98,443,"TTCACCAATATGCGATACCA","CTTGTCCAAATACCTGATTA","561307.5.peg.2013","1129"
"12132",597,98,499,"CTGATTGGTTCCCCAATTAG","CTTGTCCAAATACCTGATTA","561307.5.peg.2013","1129"
"12133",1668,98,1570,"ACTTGATCCATTTGATCTAC","CTTGTCCAAATACCTGATTA","561307.5.peg.2013","1129"
"12134",458,98,360,"CACCAACACGCAATGTCATT","CTTGTCCAAATACCTGATTA","561307.5.peg.2013","1129"
"12135",291,98,193,"TCGGTCATAATATCTTGCAC","CTTGTCCAAATACCTGATTA","561307.5.peg.2013","1129"
"12136",1416,98,1318,"ATGACAACTAATCCCATATC","CTTGTCCAAATACCTGATTA","561307.5.peg.2013","1129"
"12137",541,145,396,"TTCACCAATATGCGATACCA","CATCGTCACTTTAGCTGACG","561307.5.peg.2013","1129"
"12138",332,145,187,"TACGTTCACTCATCAGTTGA","CATCGTCACTTTAGCTGACG","561307.5.peg.2013","1129"
"12139",458,145,313,"CACCAACACGCAATGTCATT","CATCGTCACTTTAGCTGACG","561307.5.peg.2013","1129"
"12140",597,145,452,"CTGATTGGTTCCCCAATTAG","CATCGTCACTTTAGCTGACG","561307.5.peg.2013","1129"
"12141",291,145,146,"TCGGTCATAATATCTTGCAC","CATCGTCACTTTAGCTGACG","561307.5.peg.2013","1129"
"12142",1668,145,1523,"ACTTGATCCATTTGATCTAC","CATCGTCACTTTAGCTGACG","561307.5.peg.2013","1129"
"12143",1416,145,1271,"ATGACAACTAATCCCATATC","CATCGTCACTTTAGCTGACG","561307.5.peg.2013","1129"
"12144",1282,145,1137,"CATACGTTCAACTTTAGTTT","CATCGTCACTTTAGCTGACG","561307.5.peg.2013","1129"
"12145",1416,147,1269,"ATGACAACTAATCCCATATC","ATCATCGTCACTTTAGCTGA","561307.5.peg.2013","1129"
"12146",458,147,311,"CACCAACACGCAATGTCATT","ATCATCGTCACTTTAGCTGA","561307.5.peg.2013","1129"
"12147",1668,147,1521,"ACTTGATCCATTTGATCTAC","ATCATCGTCACTTTAGCTGA","561307.5.peg.2013","1129"
"12148",291,147,144,"TCGGTCATAATATCTTGCAC","ATCATCGTCACTTTAGCTGA","561307.5.peg.2013","1129"
"12149",332,147,185,"TACGTTCACTCATCAGTTGA","ATCATCGTCACTTTAGCTGA","561307.5.peg.2013","1129"
"12150",541,147,394,"TTCACCAATATGCGATACCA","ATCATCGTCACTTTAGCTGA","561307.5.peg.2013","1129"
"12151",597,147,450,"CTGATTGGTTCCCCAATTAG","ATCATCGTCACTTTAGCTGA","561307.5.peg.2013","1129"
"12152",1282,147,1135,"CATACGTTCAACTTTAGTTT","ATCATCGTCACTTTAGCTGA","561307.5.peg.2013","1129"
"12153",1416,291,1125,"ATGACAACTAATCCCATATC","TCGGTCATAATATCTTGCAC","561307.5.peg.2013","1129"
"12154",147,291,144,"ATCATCGTCACTTTAGCTGA","TCGGTCATAATATCTTGCAC","561307.5.peg.2013","1129"
"12155",98,291,193,"CTTGTCCAAATACCTGATTA","TCGGTCATAATATCTTGCAC","561307.5.peg.2013","1129"
"12156",458,291,167,"CACCAACACGCAATGTCATT","TCGGTCATAATATCTTGCAC","561307.5.peg.2013","1129"
"12157",597,291,306,"CTGATTGGTTCCCCAATTAG","TCGGTCATAATATCTTGCAC","561307.5.peg.2013","1129"
"12158",145,291,146,"CATCGTCACTTTAGCTGACG","TCGGTCATAATATCTTGCAC","561307.5.peg.2013","1129"
"12159",541,291,250,"TTCACCAATATGCGATACCA","TCGGTCATAATATCTTGCAC","561307.5.peg.2013","1129"
"12160",1282,291,991,"CATACGTTCAACTTTAGTTT","TCGGTCATAATATCTTGCAC","561307.5.peg.2013","1129"
"12161",1668,291,1377,"ACTTGATCCATTTGATCTAC","TCGGTCATAATATCTTGCAC","561307.5.peg.2013","1129"
"12162",1282,332,950,"CATACGTTCAACTTTAGTTT","TACGTTCACTCATCAGTTGA","561307.5.peg.2013","1129"
"12163",541,332,209,"TTCACCAATATGCGATACCA","TACGTTCACTCATCAGTTGA","561307.5.peg.2013","1129"
"12164",458,332,126,"CACCAACACGCAATGTCATT","TACGTTCACTCATCAGTTGA","561307.5.peg.2013","1129"
"12165",98,332,234,"CTTGTCCAAATACCTGATTA","TACGTTCACTCATCAGTTGA","561307.5.peg.2013","1129"
"12166",147,332,185,"ATCATCGTCACTTTAGCTGA","TACGTTCACTCATCAGTTGA","561307.5.peg.2013","1129"
"12167",145,332,187,"CATCGTCACTTTAGCTGACG","TACGTTCACTCATCAGTTGA","561307.5.peg.2013","1129"
"12168",597,332,265,"CTGATTGGTTCCCCAATTAG","TACGTTCACTCATCAGTTGA","561307.5.peg.2013","1129"
"12169",1416,332,1084,"ATGACAACTAATCCCATATC","TACGTTCACTCATCAGTTGA","561307.5.peg.2013","1129"
"12170",1668,332,1336,"ACTTGATCCATTTGATCTAC","TACGTTCACTCATCAGTTGA","561307.5.peg.2013","1129"
"12171",98,458,360,"CTTGTCCAAATACCTGATTA","CACCAACACGCAATGTCATT","561307.5.peg.2013","1129"
"12172",1282,458,824,"CATACGTTCAACTTTAGTTT","CACCAACACGCAATGTCATT","561307.5.peg.2013","1129"
"12173",1416,458,958,"ATGACAACTAATCCCATATC","CACCAACACGCAATGTCATT","561307.5.peg.2013","1129"
"12174",145,458,313,"CATCGTCACTTTAGCTGACG","CACCAACACGCAATGTCATT","561307.5.peg.2013","1129"
"12175",597,458,139,"CTGATTGGTTCCCCAATTAG","CACCAACACGCAATGTCATT","561307.5.peg.2013","1129"
"12176",291,458,167,"TCGGTCATAATATCTTGCAC","CACCAACACGCAATGTCATT","561307.5.peg.2013","1129"
"12177",1668,458,1210,"ACTTGATCCATTTGATCTAC","CACCAACACGCAATGTCATT","561307.5.peg.2013","1129"
"12178",147,458,311,"ATCATCGTCACTTTAGCTGA","CACCAACACGCAATGTCATT","561307.5.peg.2013","1129"
"12179",332,458,126,"TACGTTCACTCATCAGTTGA","CACCAACACGCAATGTCATT","561307.5.peg.2013","1129"
"12180",145,541,396,"CATCGTCACTTTAGCTGACG","TTCACCAATATGCGATACCA","561307.5.peg.2013","1129"
"12181",98,541,443,"CTTGTCCAAATACCTGATTA","TTCACCAATATGCGATACCA","561307.5.peg.2013","1129"
"12182",332,541,209,"TACGTTCACTCATCAGTTGA","TTCACCAATATGCGATACCA","561307.5.peg.2013","1129"
"12183",1282,541,741,"CATACGTTCAACTTTAGTTT","TTCACCAATATGCGATACCA","561307.5.peg.2013","1129"
"12184",147,541,394,"ATCATCGTCACTTTAGCTGA","TTCACCAATATGCGATACCA","561307.5.peg.2013","1129"
"12185",1416,541,875,"ATGACAACTAATCCCATATC","TTCACCAATATGCGATACCA","561307.5.peg.2013","1129"
"12186",1668,541,1127,"ACTTGATCCATTTGATCTAC","TTCACCAATATGCGATACCA","561307.5.peg.2013","1129"
"12187",291,541,250,"TCGGTCATAATATCTTGCAC","TTCACCAATATGCGATACCA","561307.5.peg.2013","1129"
"12188",98,597,499,"CTTGTCCAAATACCTGATTA","CTGATTGGTTCCCCAATTAG","561307.5.peg.2013","1129"
"12189",1416,597,819,"ATGACAACTAATCCCATATC","CTGATTGGTTCCCCAATTAG","561307.5.peg.2013","1129"
"12190",1282,597,685,"CATACGTTCAACTTTAGTTT","CTGATTGGTTCCCCAATTAG","561307.5.peg.2013","1129"
"12191",291,597,306,"TCGGTCATAATATCTTGCAC","CTGATTGGTTCCCCAATTAG","561307.5.peg.2013","1129"
"12192",332,597,265,"TACGTTCACTCATCAGTTGA","CTGATTGGTTCCCCAATTAG","561307.5.peg.2013","1129"
"12193",147,597,450,"ATCATCGTCACTTTAGCTGA","CTGATTGGTTCCCCAATTAG","561307.5.peg.2013","1129"
"12194",1668,597,1071,"ACTTGATCCATTTGATCTAC","CTGATTGGTTCCCCAATTAG","561307.5.peg.2013","1129"
"12195",145,597,452,"CATCGTCACTTTAGCTGACG","CTGATTGGTTCCCCAATTAG","561307.5.peg.2013","1129"
"12196",458,597,139,"CACCAACACGCAATGTCATT","CTGATTGGTTCCCCAATTAG","561307.5.peg.2013","1129"
"12197",291,1282,991,"TCGGTCATAATATCTTGCAC","CATACGTTCAACTTTAGTTT","561307.5.peg.2013","1129"
"12198",597,1282,685,"CTGATTGGTTCCCCAATTAG","CATACGTTCAACTTTAGTTT","561307.5.peg.2013","1129"
"12199",1668,1282,386,"ACTTGATCCATTTGATCTAC","CATACGTTCAACTTTAGTTT","561307.5.peg.2013","1129"
"12200",145,1282,1137,"CATCGTCACTTTAGCTGACG","CATACGTTCAACTTTAGTTT","561307.5.peg.2013","1129"
"12201",332,1282,950,"TACGTTCACTCATCAGTTGA","CATACGTTCAACTTTAGTTT","561307.5.peg.2013","1129"
"12202",458,1282,824,"CACCAACACGCAATGTCATT","CATACGTTCAACTTTAGTTT","561307.5.peg.2013","1129"
"12203",98,1282,1184,"CTTGTCCAAATACCTGATTA","CATACGTTCAACTTTAGTTT","561307.5.peg.2013","1129"
"12204",147,1282,1135,"ATCATCGTCACTTTAGCTGA","CATACGTTCAACTTTAGTTT","561307.5.peg.2013","1129"
"12205",1416,1282,134,"ATGACAACTAATCCCATATC","CATACGTTCAACTTTAGTTT","561307.5.peg.2013","1129"
"12206",541,1282,741,"TTCACCAATATGCGATACCA","CATACGTTCAACTTTAGTTT","561307.5.peg.2013","1129"
"12207",98,1416,1318,"CTTGTCCAAATACCTGATTA","ATGACAACTAATCCCATATC","561307.5.peg.2013","1129"
"12208",291,1416,1125,"TCGGTCATAATATCTTGCAC","ATGACAACTAATCCCATATC","561307.5.peg.2013","1129"
"12209",541,1416,875,"TTCACCAATATGCGATACCA","ATGACAACTAATCCCATATC","561307.5.peg.2013","1129"
"12210",458,1416,958,"CACCAACACGCAATGTCATT","ATGACAACTAATCCCATATC","561307.5.peg.2013","1129"
"12211",1282,1416,134,"CATACGTTCAACTTTAGTTT","ATGACAACTAATCCCATATC","561307.5.peg.2013","1129"
"12212",145,1416,1271,"CATCGTCACTTTAGCTGACG","ATGACAACTAATCCCATATC","561307.5.peg.2013","1129"
"12213",147,1416,1269,"ATCATCGTCACTTTAGCTGA","ATGACAACTAATCCCATATC","561307.5.peg.2013","1129"
"12214",332,1416,1084,"TACGTTCACTCATCAGTTGA","ATGACAACTAATCCCATATC","561307.5.peg.2013","1129"
"12215",597,1416,819,"CTGATTGGTTCCCCAATTAG","ATGACAACTAATCCCATATC","561307.5.peg.2013","1129"
"12216",1668,1416,252,"ACTTGATCCATTTGATCTAC","ATGACAACTAATCCCATATC","561307.5.peg.2013","1129"
"12217",458,1668,1210,"CACCAACACGCAATGTCATT","ACTTGATCCATTTGATCTAC","561307.5.peg.2013","1129"
"12218",291,1668,1377,"TCGGTCATAATATCTTGCAC","ACTTGATCCATTTGATCTAC","561307.5.peg.2013","1129"
"12219",147,1668,1521,"ATCATCGTCACTTTAGCTGA","ACTTGATCCATTTGATCTAC","561307.5.peg.2013","1129"
"12220",541,1668,1127,"TTCACCAATATGCGATACCA","ACTTGATCCATTTGATCTAC","561307.5.peg.2013","1129"
"12221",1416,1668,252,"ATGACAACTAATCCCATATC","ACTTGATCCATTTGATCTAC","561307.5.peg.2013","1129"
"12222",98,1668,1570,"CTTGTCCAAATACCTGATTA","ACTTGATCCATTTGATCTAC","561307.5.peg.2013","1129"
"12223",145,1668,1523,"CATCGTCACTTTAGCTGACG","ACTTGATCCATTTGATCTAC","561307.5.peg.2013","1129"
"12224",332,1668,1336,"TACGTTCACTCATCAGTTGA","ACTTGATCCATTTGATCTAC","561307.5.peg.2013","1129"
"12225",1282,1668,386,"CATACGTTCAACTTTAGTTT","ACTTGATCCATTTGATCTAC","561307.5.peg.2013","1129"
"12226",597,1668,1071,"CTGATTGGTTCCCCAATTAG","ACTTGATCCATTTGATCTAC","561307.5.peg.2013","1129"
"12227",206,74,132,"CACCGTTACGACCTACTTCA","AACGTGTTTGTTTACCTTGA","561307.5.peg.2015","1131"
"12228",302,74,228,"GAAGTCAATGTGAGTAATT","AACGTGTTTGTTTACCTTGA","561307.5.peg.2015","1131"
"12229",302,132,170,"GAAGTCAATGTGAGTAATT","CCGTAACCGTATACTACTGC","561307.5.peg.2015","1131"
"12230",74,206,132,"AACGTGTTTGTTTACCTTGA","CACCGTTACGACCTACTTCA","561307.5.peg.2015","1131"
"12231",74,302,228,"AACGTGTTTGTTTACCTTGA","GAAGTCAATGTGAGTAATT","561307.5.peg.2015","1131"
"12232",132,302,170,"CCGTAACCGTATACTACTGC","GAAGTCAATGTGAGTAATT","561307.5.peg.2015","1131"
"12233",465,8,457,"CAAAGAATCCTTGAATTTG","TGCGTAAGTAAATAATTGG","561307.5.peg.2016","1132"
"12234",134,8,126,"TACCTAGTTCAATTCCTACT","TGCGTAAGTAAATAATTGG","561307.5.peg.2016","1132"
"12235",339,8,331,"GTCTTGCATATCCATAATA","TGCGTAAGTAAATAATTGG","561307.5.peg.2016","1132"
"12236",387,8,379,"GCAACTAATTTAGCAGTGAT","TGCGTAAGTAAATAATTGG","561307.5.peg.2016","1132"
"12237",373,8,365,"AGTGATTGGCTCACGGCTAC","TGCGTAAGTAAATAATTGG","561307.5.peg.2016","1132"
"12238",255,8,247,"CCATTAAATGTAGATTCAC","TGCGTAAGTAAATAATTGG","561307.5.peg.2016","1132"
"12239",500,8,492,"GAATTGGCACACCCATTAAG","TGCGTAAGTAAATAATTGG","561307.5.peg.2016","1132"
"12240",380,8,372,"ATTTAGCAGTGATTGGCTCA","TGCGTAAGTAAATAATTGG","561307.5.peg.2016","1132"
"12241",492,8,484,"ACACCCATTAAGTGGTCAAT","TGCGTAAGTAAATAATTGG","561307.5.peg.2016","1132"
"12242",465,134,331,"CAAAGAATCCTTGAATTTG","TACCTAGTTCAATTCCTACT","561307.5.peg.2016","1132"
"12243",380,134,246,"ATTTAGCAGTGATTGGCTCA","TACCTAGTTCAATTCCTACT","561307.5.peg.2016","1132"
"12244",373,134,239,"AGTGATTGGCTCACGGCTAC","TACCTAGTTCAATTCCTACT","561307.5.peg.2016","1132"
"12245",255,134,121,"CCATTAAATGTAGATTCAC","TACCTAGTTCAATTCCTACT","561307.5.peg.2016","1132"
"12246",500,134,366,"GAATTGGCACACCCATTAAG","TACCTAGTTCAATTCCTACT","561307.5.peg.2016","1132"
"12247",339,134,205,"GTCTTGCATATCCATAATA","TACCTAGTTCAATTCCTACT","561307.5.peg.2016","1132"
"12248",8,134,126,"TGCGTAAGTAAATAATTGG","TACCTAGTTCAATTCCTACT","561307.5.peg.2016","1132"
"12249",387,134,253,"GCAACTAATTTAGCAGTGAT","TACCTAGTTCAATTCCTACT","561307.5.peg.2016","1132"
"12250",492,134,358,"ACACCCATTAAGTGGTCAAT","TACCTAGTTCAATTCCTACT","561307.5.peg.2016","1132"
"12251",8,255,247,"TGCGTAAGTAAATAATTGG","CCATTAAATGTAGATTCAC","561307.5.peg.2016","1132"
"12252",380,255,125,"ATTTAGCAGTGATTGGCTCA","CCATTAAATGTAGATTCAC","561307.5.peg.2016","1132"
"12253",387,255,132,"GCAACTAATTTAGCAGTGAT","CCATTAAATGTAGATTCAC","561307.5.peg.2016","1132"
"12254",134,255,121,"TACCTAGTTCAATTCCTACT","CCATTAAATGTAGATTCAC","561307.5.peg.2016","1132"
"12255",492,255,237,"ACACCCATTAAGTGGTCAAT","CCATTAAATGTAGATTCAC","561307.5.peg.2016","1132"
"12256",373,255,118,"AGTGATTGGCTCACGGCTAC","CCATTAAATGTAGATTCAC","561307.5.peg.2016","1132"
"12257",500,255,245,"GAATTGGCACACCCATTAAG","CCATTAAATGTAGATTCAC","561307.5.peg.2016","1132"
"12258",465,255,210,"CAAAGAATCCTTGAATTTG","CCATTAAATGTAGATTCAC","561307.5.peg.2016","1132"
"12259",465,339,126,"CAAAGAATCCTTGAATTTG","GTCTTGCATATCCATAATA","561307.5.peg.2016","1132"
"12260",134,339,205,"TACCTAGTTCAATTCCTACT","GTCTTGCATATCCATAATA","561307.5.peg.2016","1132"
"12261",492,339,153,"ACACCCATTAAGTGGTCAAT","GTCTTGCATATCCATAATA","561307.5.peg.2016","1132"
"12262",8,339,331,"TGCGTAAGTAAATAATTGG","GTCTTGCATATCCATAATA","561307.5.peg.2016","1132"
"12263",500,339,161,"GAATTGGCACACCCATTAAG","GTCTTGCATATCCATAATA","561307.5.peg.2016","1132"
"12264",8,373,365,"TGCGTAAGTAAATAATTGG","AGTGATTGGCTCACGGCTAC","561307.5.peg.2016","1132"
"12265",134,373,239,"TACCTAGTTCAATTCCTACT","AGTGATTGGCTCACGGCTAC","561307.5.peg.2016","1132"
"12266",500,373,127,"GAATTGGCACACCCATTAAG","AGTGATTGGCTCACGGCTAC","561307.5.peg.2016","1132"
"12267",255,373,118,"CCATTAAATGTAGATTCAC","AGTGATTGGCTCACGGCTAC","561307.5.peg.2016","1132"
"12268",492,373,119,"ACACCCATTAAGTGGTCAAT","AGTGATTGGCTCACGGCTAC","561307.5.peg.2016","1132"
"12269",8,380,372,"TGCGTAAGTAAATAATTGG","ATTTAGCAGTGATTGGCTCA","561307.5.peg.2016","1132"
"12270",492,380,112,"ACACCCATTAAGTGGTCAAT","ATTTAGCAGTGATTGGCTCA","561307.5.peg.2016","1132"
"12271",255,380,125,"CCATTAAATGTAGATTCAC","ATTTAGCAGTGATTGGCTCA","561307.5.peg.2016","1132"
"12272",500,380,120,"GAATTGGCACACCCATTAAG","ATTTAGCAGTGATTGGCTCA","561307.5.peg.2016","1132"
"12273",134,380,246,"TACCTAGTTCAATTCCTACT","ATTTAGCAGTGATTGGCTCA","561307.5.peg.2016","1132"
"12274",8,387,379,"TGCGTAAGTAAATAATTGG","GCAACTAATTTAGCAGTGAT","561307.5.peg.2016","1132"
"12275",134,387,253,"TACCTAGTTCAATTCCTACT","GCAACTAATTTAGCAGTGAT","561307.5.peg.2016","1132"
"12276",255,387,132,"CCATTAAATGTAGATTCAC","GCAACTAATTTAGCAGTGAT","561307.5.peg.2016","1132"
"12277",500,387,113,"GAATTGGCACACCCATTAAG","GCAACTAATTTAGCAGTGAT","561307.5.peg.2016","1132"
"12278",492,387,105,"ACACCCATTAAGTGGTCAAT","GCAACTAATTTAGCAGTGAT","561307.5.peg.2016","1132"
"12279",339,465,126,"GTCTTGCATATCCATAATA","CAAAGAATCCTTGAATTTG","561307.5.peg.2016","1132"
"12280",255,465,210,"CCATTAAATGTAGATTCAC","CAAAGAATCCTTGAATTTG","561307.5.peg.2016","1132"
"12281",8,465,457,"TGCGTAAGTAAATAATTGG","CAAAGAATCCTTGAATTTG","561307.5.peg.2016","1132"
"12282",134,465,331,"TACCTAGTTCAATTCCTACT","CAAAGAATCCTTGAATTTG","561307.5.peg.2016","1132"
"12283",8,492,484,"TGCGTAAGTAAATAATTGG","ACACCCATTAAGTGGTCAAT","561307.5.peg.2016","1132"
"12284",373,492,119,"AGTGATTGGCTCACGGCTAC","ACACCCATTAAGTGGTCAAT","561307.5.peg.2016","1132"
"12285",387,492,105,"GCAACTAATTTAGCAGTGAT","ACACCCATTAAGTGGTCAAT","561307.5.peg.2016","1132"
"12286",134,492,358,"TACCTAGTTCAATTCCTACT","ACACCCATTAAGTGGTCAAT","561307.5.peg.2016","1132"
"12287",380,492,112,"ATTTAGCAGTGATTGGCTCA","ACACCCATTAAGTGGTCAAT","561307.5.peg.2016","1132"
"12288",255,492,237,"CCATTAAATGTAGATTCAC","ACACCCATTAAGTGGTCAAT","561307.5.peg.2016","1132"
"12289",339,492,153,"GTCTTGCATATCCATAATA","ACACCCATTAAGTGGTCAAT","561307.5.peg.2016","1132"
"12290",255,500,245,"CCATTAAATGTAGATTCAC","GAATTGGCACACCCATTAAG","561307.5.peg.2016","1132"
"12291",134,500,366,"TACCTAGTTCAATTCCTACT","GAATTGGCACACCCATTAAG","561307.5.peg.2016","1132"
"12292",8,500,492,"TGCGTAAGTAAATAATTGG","GAATTGGCACACCCATTAAG","561307.5.peg.2016","1132"
"12293",339,500,161,"GTCTTGCATATCCATAATA","GAATTGGCACACCCATTAAG","561307.5.peg.2016","1132"
"12294",387,500,113,"GCAACTAATTTAGCAGTGAT","GAATTGGCACACCCATTAAG","561307.5.peg.2016","1132"
"12295",373,500,127,"AGTGATTGGCTCACGGCTAC","GAATTGGCACACCCATTAAG","561307.5.peg.2016","1132"
"12296",380,500,120,"ATTTAGCAGTGATTGGCTCA","GAATTGGCACACCCATTAAG","561307.5.peg.2016","1132"
"12297",360,141,219,"AATGTTTCCTTTGTGATGAG","TCCAATACATGTTCGACCAT","561307.5.peg.2017","1133"
"12298",453,141,312,"ACGATTCTTCCGTATCCATA","TCCAATACATGTTCGACCAT","561307.5.peg.2017","1133"
"12299",641,141,500,"TTAACGACAATACATCAGGG","TCCAATACATGTTCGACCAT","561307.5.peg.2017","1133"
"12300",644,141,503,"AATTAACGACAATACATCA","TCCAATACATGTTCGACCAT","561307.5.peg.2017","1133"
"12301",641,199,442,"TTAACGACAATACATCAGGG","TTCAGCACCATGTCCTACGA","561307.5.peg.2017","1133"
"12302",360,199,161,"AATGTTTCCTTTGTGATGAG","TTCAGCACCATGTCCTACGA","561307.5.peg.2017","1133"
"12303",644,199,445,"AATTAACGACAATACATCA","TTCAGCACCATGTCCTACGA","561307.5.peg.2017","1133"
"12304",453,199,254,"ACGATTCTTCCGTATCCATA","TTCAGCACCATGTCCTACGA","561307.5.peg.2017","1133"
"12305",141,360,219,"TCCAATACATGTTCGACCAT","AATGTTTCCTTTGTGATGAG","561307.5.peg.2017","1133"
"12306",641,360,281,"TTAACGACAATACATCAGGG","AATGTTTCCTTTGTGATGAG","561307.5.peg.2017","1133"
"12307",199,360,161,"TTCAGCACCATGTCCTACGA","AATGTTTCCTTTGTGATGAG","561307.5.peg.2017","1133"
"12308",644,360,284,"AATTAACGACAATACATCA","AATGTTTCCTTTGTGATGAG","561307.5.peg.2017","1133"
"12309",141,453,312,"TCCAATACATGTTCGACCAT","ACGATTCTTCCGTATCCATA","561307.5.peg.2017","1133"
"12310",641,453,188,"TTAACGACAATACATCAGGG","ACGATTCTTCCGTATCCATA","561307.5.peg.2017","1133"
"12311",199,453,254,"TTCAGCACCATGTCCTACGA","ACGATTCTTCCGTATCCATA","561307.5.peg.2017","1133"
"12312",644,453,191,"AATTAACGACAATACATCA","ACGATTCTTCCGTATCCATA","561307.5.peg.2017","1133"
"12313",360,641,281,"AATGTTTCCTTTGTGATGAG","TTAACGACAATACATCAGGG","561307.5.peg.2017","1133"
"12314",141,641,500,"TCCAATACATGTTCGACCAT","TTAACGACAATACATCAGGG","561307.5.peg.2017","1133"
"12315",453,641,188,"ACGATTCTTCCGTATCCATA","TTAACGACAATACATCAGGG","561307.5.peg.2017","1133"
"12316",199,641,442,"TTCAGCACCATGTCCTACGA","TTAACGACAATACATCAGGG","561307.5.peg.2017","1133"
"12317",141,644,503,"TCCAATACATGTTCGACCAT","AATTAACGACAATACATCA","561307.5.peg.2017","1133"
"12318",199,644,445,"TTCAGCACCATGTCCTACGA","AATTAACGACAATACATCA","561307.5.peg.2017","1133"
"12319",360,644,284,"AATGTTTCCTTTGTGATGAG","AATTAACGACAATACATCA","561307.5.peg.2017","1133"
"12320",453,644,191,"ACGATTCTTCCGTATCCATA","AATTAACGACAATACATCA","561307.5.peg.2017","1133"
"12321",285,11,274,"AAATTCCCTTCTGGCAAGTT","GATTCAAGAGCAACACATAA","561307.5.peg.202","1136"
"12322",322,11,311,"TGAGGGCTCACATACAATAG","GATTCAAGAGCAACACATAA","561307.5.peg.202","1136"
"12323",339,11,328,"TTCGCAAATATTACAAGTGA","GATTCAAGAGCAACACATAA","561307.5.peg.202","1136"
"12324",11,285,274,"GATTCAAGAGCAACACATAA","AAATTCCCTTCTGGCAAGTT","561307.5.peg.202","1136"
"12325",11,322,311,"GATTCAAGAGCAACACATAA","TGAGGGCTCACATACAATAG","561307.5.peg.202","1136"
"12326",11,339,328,"GATTCAAGAGCAACACATAA","TTCGCAAATATTACAAGTGA","561307.5.peg.202","1136"
"12327",225,3,222,"TCTGTCAATGACCCCATGCC","AGCTTGCCTTACATCCGCTT","561307.5.peg.2024","1141"
"12328",330,3,327,"ATCACCGTCACATTATCATA","AGCTTGCCTTACATCCGCTT","561307.5.peg.2024","1141"
"12329",437,3,434,"GCGTCGTAATATAGTACGGC","AGCTTGCCTTACATCCGCTT","561307.5.peg.2024","1141"
"12330",441,3,438,"ATTGGCGTCGTAATATAGTA","AGCTTGCCTTACATCCGCTT","561307.5.peg.2024","1141"
"12331",441,9,432,"ATTGGCGTCGTAATATAGTA","CAAGCTTTAGAAGATGAATG","561307.5.peg.2024","1141"
"12332",225,9,216,"TCTGTCAATGACCCCATGCC","CAAGCTTTAGAAGATGAATG","561307.5.peg.2024","1141"
"12333",330,9,321,"ATCACCGTCACATTATCATA","CAAGCTTTAGAAGATGAATG","561307.5.peg.2024","1141"
"12334",437,9,428,"GCGTCGTAATATAGTACGGC","CAAGCTTTAGAAGATGAATG","561307.5.peg.2024","1141"
"12335",437,78,359,"GCGTCGTAATATAGTACGGC","AACAACGCTCGCGTTCTTGA","561307.5.peg.2024","1141"
"12336",441,78,363,"ATTGGCGTCGTAATATAGTA","AACAACGCTCGCGTTCTTGA","561307.5.peg.2024","1141"
"12337",225,78,147,"TCTGTCAATGACCCCATGCC","AACAACGCTCGCGTTCTTGA","561307.5.peg.2024","1141"
"12338",330,78,252,"ATCACCGTCACATTATCATA","AACAACGCTCGCGTTCTTGA","561307.5.peg.2024","1141"
"12339",9,225,216,"CAAGCTTTAGAAGATGAATG","TCTGTCAATGACCCCATGCC","561307.5.peg.2024","1141"
"12340",78,225,147,"AACAACGCTCGCGTTCTTGA","TCTGTCAATGACCCCATGCC","561307.5.peg.2024","1141"
"12341",437,225,212,"GCGTCGTAATATAGTACGGC","TCTGTCAATGACCCCATGCC","561307.5.peg.2024","1141"
"12342",330,225,105,"ATCACCGTCACATTATCATA","TCTGTCAATGACCCCATGCC","561307.5.peg.2024","1141"
"12343",441,225,216,"ATTGGCGTCGTAATATAGTA","TCTGTCAATGACCCCATGCC","561307.5.peg.2024","1141"
"12344",3,225,222,"AGCTTGCCTTACATCCGCTT","TCTGTCAATGACCCCATGCC","561307.5.peg.2024","1141"
"12345",3,330,327,"AGCTTGCCTTACATCCGCTT","ATCACCGTCACATTATCATA","561307.5.peg.2024","1141"
"12346",9,330,321,"CAAGCTTTAGAAGATGAATG","ATCACCGTCACATTATCATA","561307.5.peg.2024","1141"
"12347",78,330,252,"AACAACGCTCGCGTTCTTGA","ATCACCGTCACATTATCATA","561307.5.peg.2024","1141"
"12348",225,330,105,"TCTGTCAATGACCCCATGCC","ATCACCGTCACATTATCATA","561307.5.peg.2024","1141"
"12349",437,330,107,"GCGTCGTAATATAGTACGGC","ATCACCGTCACATTATCATA","561307.5.peg.2024","1141"
"12350",441,330,111,"ATTGGCGTCGTAATATAGTA","ATCACCGTCACATTATCATA","561307.5.peg.2024","1141"
"12351",225,437,212,"TCTGTCAATGACCCCATGCC","GCGTCGTAATATAGTACGGC","561307.5.peg.2024","1141"
"12352",330,437,107,"ATCACCGTCACATTATCATA","GCGTCGTAATATAGTACGGC","561307.5.peg.2024","1141"
"12353",3,437,434,"AGCTTGCCTTACATCCGCTT","GCGTCGTAATATAGTACGGC","561307.5.peg.2024","1141"
"12354",78,437,359,"AACAACGCTCGCGTTCTTGA","GCGTCGTAATATAGTACGGC","561307.5.peg.2024","1141"
"12355",9,437,428,"CAAGCTTTAGAAGATGAATG","GCGTCGTAATATAGTACGGC","561307.5.peg.2024","1141"
"12356",3,441,438,"AGCTTGCCTTACATCCGCTT","ATTGGCGTCGTAATATAGTA","561307.5.peg.2024","1141"
"12357",78,441,363,"AACAACGCTCGCGTTCTTGA","ATTGGCGTCGTAATATAGTA","561307.5.peg.2024","1141"
"12358",330,441,111,"ATCACCGTCACATTATCATA","ATTGGCGTCGTAATATAGTA","561307.5.peg.2024","1141"
"12359",9,441,432,"CAAGCTTTAGAAGATGAATG","ATTGGCGTCGTAATATAGTA","561307.5.peg.2024","1141"
"12360",225,441,216,"TCTGTCAATGACCCCATGCC","ATTGGCGTCGTAATATAGTA","561307.5.peg.2024","1141"
"12361",438,8,430,"TCTGTATAGTATGTTTCATC","TGAAGTGAGACATTACGAGG","561307.5.peg.2027","1144"
"12362",672,8,664,"ACAGCTAAATCAGCAAGTCC","TGAAGTGAGACATTACGAGG","561307.5.peg.2027","1144"
"12363",516,8,508,"TCAACTTCGTGTCCAGAATC","TGAAGTGAGACATTACGAGG","561307.5.peg.2027","1144"
"12364",672,11,661,"ACAGCTAAATCAGCAAGTCC","ATTTGAAGTGAGACATTACG","561307.5.peg.2027","1144"
"12365",516,11,505,"TCAACTTCGTGTCCAGAATC","ATTTGAAGTGAGACATTACG","561307.5.peg.2027","1144"
"12366",438,11,427,"TCTGTATAGTATGTTTCATC","ATTTGAAGTGAGACATTACG","561307.5.peg.2027","1144"
"12367",516,79,437,"TCAACTTCGTGTCCAGAATC","CCCACTAGGATAGTATATTG","561307.5.peg.2027","1144"
"12368",438,79,359,"TCTGTATAGTATGTTTCATC","CCCACTAGGATAGTATATTG","561307.5.peg.2027","1144"
"12369",672,79,593,"ACAGCTAAATCAGCAAGTCC","CCCACTAGGATAGTATATTG","561307.5.peg.2027","1144"
"12370",516,81,435,"TCAACTTCGTGTCCAGAATC","TTCCCACTAGGATAGTATAT","561307.5.peg.2027","1144"
"12371",438,81,357,"TCTGTATAGTATGTTTCATC","TTCCCACTAGGATAGTATAT","561307.5.peg.2027","1144"
"12372",672,81,591,"ACAGCTAAATCAGCAAGTCC","TTCCCACTAGGATAGTATAT","561307.5.peg.2027","1144"
"12373",438,93,345,"TCTGTATAGTATGTTTCATC","CCTATATGTAAATTCCCACT","561307.5.peg.2027","1144"
"12374",516,93,423,"TCAACTTCGTGTCCAGAATC","CCTATATGTAAATTCCCACT","561307.5.peg.2027","1144"
"12375",672,93,579,"ACAGCTAAATCAGCAAGTCC","CCTATATGTAAATTCCCACT","561307.5.peg.2027","1144"
"12376",8,438,430,"TGAAGTGAGACATTACGAGG","TCTGTATAGTATGTTTCATC","561307.5.peg.2027","1144"
"12377",81,438,357,"TTCCCACTAGGATAGTATAT","TCTGTATAGTATGTTTCATC","561307.5.peg.2027","1144"
"12378",79,438,359,"CCCACTAGGATAGTATATTG","TCTGTATAGTATGTTTCATC","561307.5.peg.2027","1144"
"12379",11,438,427,"ATTTGAAGTGAGACATTACG","TCTGTATAGTATGTTTCATC","561307.5.peg.2027","1144"
"12380",672,438,234,"ACAGCTAAATCAGCAAGTCC","TCTGTATAGTATGTTTCATC","561307.5.peg.2027","1144"
"12381",93,438,345,"CCTATATGTAAATTCCCACT","TCTGTATAGTATGTTTCATC","561307.5.peg.2027","1144"
"12382",11,516,505,"ATTTGAAGTGAGACATTACG","TCAACTTCGTGTCCAGAATC","561307.5.peg.2027","1144"
"12383",8,516,508,"TGAAGTGAGACATTACGAGG","TCAACTTCGTGTCCAGAATC","561307.5.peg.2027","1144"
"12384",81,516,435,"TTCCCACTAGGATAGTATAT","TCAACTTCGTGTCCAGAATC","561307.5.peg.2027","1144"
"12385",79,516,437,"CCCACTAGGATAGTATATTG","TCAACTTCGTGTCCAGAATC","561307.5.peg.2027","1144"
"12386",93,516,423,"CCTATATGTAAATTCCCACT","TCAACTTCGTGTCCAGAATC","561307.5.peg.2027","1144"
"12387",672,516,156,"ACAGCTAAATCAGCAAGTCC","TCAACTTCGTGTCCAGAATC","561307.5.peg.2027","1144"
"12388",81,672,591,"TTCCCACTAGGATAGTATAT","ACAGCTAAATCAGCAAGTCC","561307.5.peg.2027","1144"
"12389",516,672,156,"TCAACTTCGTGTCCAGAATC","ACAGCTAAATCAGCAAGTCC","561307.5.peg.2027","1144"
"12390",8,672,664,"TGAAGTGAGACATTACGAGG","ACAGCTAAATCAGCAAGTCC","561307.5.peg.2027","1144"
"12391",79,672,593,"CCCACTAGGATAGTATATTG","ACAGCTAAATCAGCAAGTCC","561307.5.peg.2027","1144"
"12392",11,672,661,"ATTTGAAGTGAGACATTACG","ACAGCTAAATCAGCAAGTCC","561307.5.peg.2027","1144"
"12393",438,672,234,"TCTGTATAGTATGTTTCATC","ACAGCTAAATCAGCAAGTCC","561307.5.peg.2027","1144"
"12394",93,672,579,"CCTATATGTAAATTCCCACT","ACAGCTAAATCAGCAAGTCC","561307.5.peg.2027","1144"
"12395",306,195,111,"TATCCAGGATCACTAATTAA","GATATGACTTTAATGGAGT","561307.5.peg.2028","1145"
"12396",384,195,189,"AAAGCCGTCAGCCCAGCATT","GATATGACTTTAATGGAGT","561307.5.peg.2028","1145"
"12397",306,201,105,"TATCCAGGATCACTAATTAA","GTTCGTGATATGACTTTAA","561307.5.peg.2028","1145"
"12398",384,201,183,"AAAGCCGTCAGCCCAGCATT","GTTCGTGATATGACTTTAA","561307.5.peg.2028","1145"
"12399",195,306,111,"GATATGACTTTAATGGAGT","TATCCAGGATCACTAATTAA","561307.5.peg.2028","1145"
"12400",201,306,105,"GTTCGTGATATGACTTTAA","TATCCAGGATCACTAATTAA","561307.5.peg.2028","1145"
"12401",195,384,189,"GATATGACTTTAATGGAGT","AAAGCCGTCAGCCCAGCATT","561307.5.peg.2028","1145"
"12402",201,384,183,"GTTCGTGATATGACTTTAA","AAAGCCGTCAGCCCAGCATT","561307.5.peg.2028","1145"
"12403",189,6,183,"CTTCAGCAATATCCATTAA","TTTGTTCAAATACAAGCGT","561307.5.peg.2032","1150"
"12404",6,189,183,"TTTGTTCAAATACAAGCGT","CTTCAGCAATATCCATTAA","561307.5.peg.2032","1150"
"12405",467,289,178,"TGTGACCGTCATTATTCAAA","GACAGATAATATTCCTGAAG","561307.5.peg.2036","1154"
"12406",510,289,221,"ATGTTTCACCGTAATAGTT","GACAGATAATATTCCTGAAG","561307.5.peg.2036","1154"
"12407",576,289,287,"TGTGCTTCGTCAATGAGTAC","GACAGATAATATTCCTGAAG","561307.5.peg.2036","1154"
"12408",289,467,178,"GACAGATAATATTCCTGAAG","TGTGACCGTCATTATTCAAA","561307.5.peg.2036","1154"
"12409",576,467,109,"TGTGCTTCGTCAATGAGTAC","TGTGACCGTCATTATTCAAA","561307.5.peg.2036","1154"
"12410",289,510,221,"GACAGATAATATTCCTGAAG","ATGTTTCACCGTAATAGTT","561307.5.peg.2036","1154"
"12411",289,576,287,"GACAGATAATATTCCTGAAG","TGTGCTTCGTCAATGAGTAC","561307.5.peg.2036","1154"
"12412",467,576,109,"TGTGACCGTCATTATTCAAA","TGTGCTTCGTCAATGAGTAC","561307.5.peg.2036","1154"
"12413",459,15,444,"CTAATACGACTTACAGTAGA","AGTGACCAAACCCAAACTAA","561307.5.peg.2037","1155"
"12414",513,15,498,"TGTTCTGGCAAACAATTAAA","AGTGACCAAACCCAAACTAA","561307.5.peg.2037","1155"
"12415",284,15,269,"AACGTTGTTTAGCTAAGTTG","AGTGACCAAACCCAAACTAA","561307.5.peg.2037","1155"
"12416",528,15,513,"TCATCCATAGCGATGTGTTC","AGTGACCAAACCCAAACTAA","561307.5.peg.2037","1155"
"12417",184,15,169,"TTAACTCCACAACAATAAC","AGTGACCAAACCCAAACTAA","561307.5.peg.2037","1155"
"12418",184,19,165,"TTAACTCCACAACAATAAC","TGTCTCCTTTAGTTTGGGTT","561307.5.peg.2037","1155"
"12419",284,19,265,"AACGTTGTTTAGCTAAGTTG","TGTCTCCTTTAGTTTGGGTT","561307.5.peg.2037","1155"
"12420",459,19,440,"CTAATACGACTTACAGTAGA","TGTCTCCTTTAGTTTGGGTT","561307.5.peg.2037","1155"
"12421",513,19,494,"TGTTCTGGCAAACAATTAAA","TGTCTCCTTTAGTTTGGGTT","561307.5.peg.2037","1155"
"12422",528,19,509,"TCATCCATAGCGATGTGTTC","TGTCTCCTTTAGTTTGGGTT","561307.5.peg.2037","1155"
"12423",284,24,260,"AACGTTGTTTAGCTAAGTTG","GCACTTGTCTCCTTTAGTTT","561307.5.peg.2037","1155"
"12424",184,24,160,"TTAACTCCACAACAATAAC","GCACTTGTCTCCTTTAGTTT","561307.5.peg.2037","1155"
"12425",528,24,504,"TCATCCATAGCGATGTGTTC","GCACTTGTCTCCTTTAGTTT","561307.5.peg.2037","1155"
"12426",459,24,435,"CTAATACGACTTACAGTAGA","GCACTTGTCTCCTTTAGTTT","561307.5.peg.2037","1155"
"12427",513,24,489,"TGTTCTGGCAAACAATTAAA","GCACTTGTCTCCTTTAGTTT","561307.5.peg.2037","1155"
"12428",513,110,403,"TGTTCTGGCAAACAATTAAA","GATAATGACGTCAATTTCT","561307.5.peg.2037","1155"
"12429",284,110,174,"AACGTTGTTTAGCTAAGTTG","GATAATGACGTCAATTTCT","561307.5.peg.2037","1155"
"12430",528,110,418,"TCATCCATAGCGATGTGTTC","GATAATGACGTCAATTTCT","561307.5.peg.2037","1155"
"12431",459,110,349,"CTAATACGACTTACAGTAGA","GATAATGACGTCAATTTCT","561307.5.peg.2037","1155"
"12432",24,184,160,"GCACTTGTCTCCTTTAGTTT","TTAACTCCACAACAATAAC","561307.5.peg.2037","1155"
"12433",19,184,165,"TGTCTCCTTTAGTTTGGGTT","TTAACTCCACAACAATAAC","561307.5.peg.2037","1155"
"12434",459,184,275,"CTAATACGACTTACAGTAGA","TTAACTCCACAACAATAAC","561307.5.peg.2037","1155"
"12435",15,184,169,"AGTGACCAAACCCAAACTAA","TTAACTCCACAACAATAAC","561307.5.peg.2037","1155"
"12436",284,184,100,"AACGTTGTTTAGCTAAGTTG","TTAACTCCACAACAATAAC","561307.5.peg.2037","1155"
"12437",513,184,329,"TGTTCTGGCAAACAATTAAA","TTAACTCCACAACAATAAC","561307.5.peg.2037","1155"
"12438",528,184,344,"TCATCCATAGCGATGTGTTC","TTAACTCCACAACAATAAC","561307.5.peg.2037","1155"
"12439",15,284,269,"AGTGACCAAACCCAAACTAA","AACGTTGTTTAGCTAAGTTG","561307.5.peg.2037","1155"
"12440",19,284,265,"TGTCTCCTTTAGTTTGGGTT","AACGTTGTTTAGCTAAGTTG","561307.5.peg.2037","1155"
"12441",528,284,244,"TCATCCATAGCGATGTGTTC","AACGTTGTTTAGCTAAGTTG","561307.5.peg.2037","1155"
"12442",459,284,175,"CTAATACGACTTACAGTAGA","AACGTTGTTTAGCTAAGTTG","561307.5.peg.2037","1155"
"12443",110,284,174,"GATAATGACGTCAATTTCT","AACGTTGTTTAGCTAAGTTG","561307.5.peg.2037","1155"
"12444",24,284,260,"GCACTTGTCTCCTTTAGTTT","AACGTTGTTTAGCTAAGTTG","561307.5.peg.2037","1155"
"12445",184,284,100,"TTAACTCCACAACAATAAC","AACGTTGTTTAGCTAAGTTG","561307.5.peg.2037","1155"
"12446",513,284,229,"TGTTCTGGCAAACAATTAAA","AACGTTGTTTAGCTAAGTTG","561307.5.peg.2037","1155"
"12447",15,459,444,"AGTGACCAAACCCAAACTAA","CTAATACGACTTACAGTAGA","561307.5.peg.2037","1155"
"12448",284,459,175,"AACGTTGTTTAGCTAAGTTG","CTAATACGACTTACAGTAGA","561307.5.peg.2037","1155"
"12449",24,459,435,"GCACTTGTCTCCTTTAGTTT","CTAATACGACTTACAGTAGA","561307.5.peg.2037","1155"
"12450",110,459,349,"GATAATGACGTCAATTTCT","CTAATACGACTTACAGTAGA","561307.5.peg.2037","1155"
"12451",19,459,440,"TGTCTCCTTTAGTTTGGGTT","CTAATACGACTTACAGTAGA","561307.5.peg.2037","1155"
"12452",184,459,275,"TTAACTCCACAACAATAAC","CTAATACGACTTACAGTAGA","561307.5.peg.2037","1155"
"12453",184,513,329,"TTAACTCCACAACAATAAC","TGTTCTGGCAAACAATTAAA","561307.5.peg.2037","1155"
"12454",15,513,498,"AGTGACCAAACCCAAACTAA","TGTTCTGGCAAACAATTAAA","561307.5.peg.2037","1155"
"12455",284,513,229,"AACGTTGTTTAGCTAAGTTG","TGTTCTGGCAAACAATTAAA","561307.5.peg.2037","1155"
"12456",24,513,489,"GCACTTGTCTCCTTTAGTTT","TGTTCTGGCAAACAATTAAA","561307.5.peg.2037","1155"
"12457",110,513,403,"GATAATGACGTCAATTTCT","TGTTCTGGCAAACAATTAAA","561307.5.peg.2037","1155"
"12458",19,513,494,"TGTCTCCTTTAGTTTGGGTT","TGTTCTGGCAAACAATTAAA","561307.5.peg.2037","1155"
"12459",19,528,509,"TGTCTCCTTTAGTTTGGGTT","TCATCCATAGCGATGTGTTC","561307.5.peg.2037","1155"
"12460",24,528,504,"GCACTTGTCTCCTTTAGTTT","TCATCCATAGCGATGTGTTC","561307.5.peg.2037","1155"
"12461",110,528,418,"GATAATGACGTCAATTTCT","TCATCCATAGCGATGTGTTC","561307.5.peg.2037","1155"
"12462",15,528,513,"AGTGACCAAACCCAAACTAA","TCATCCATAGCGATGTGTTC","561307.5.peg.2037","1155"
"12463",184,528,344,"TTAACTCCACAACAATAAC","TCATCCATAGCGATGTGTTC","561307.5.peg.2037","1155"
"12464",284,528,244,"AACGTTGTTTAGCTAAGTTG","TCATCCATAGCGATGTGTTC","561307.5.peg.2037","1155"
"12465",336,7,329,"TGATCTCCACCAAGAACTAG","TTAATTACATAGAGCAAAGG","561307.5.peg.2038","1156"
"12466",450,7,443,"TTTCCACTTGGTGACTCTTC","TTAATTACATAGAGCAAAGG","561307.5.peg.2038","1156"
"12467",7,336,329,"TTAATTACATAGAGCAAAGG","TGATCTCCACCAAGAACTAG","561307.5.peg.2038","1156"
"12468",450,336,114,"TTTCCACTTGGTGACTCTTC","TGATCTCCACCAAGAACTAG","561307.5.peg.2038","1156"
"12469",7,450,443,"TTAATTACATAGAGCAAAGG","TTTCCACTTGGTGACTCTTC","561307.5.peg.2038","1156"
"12470",336,450,114,"TGATCTCCACCAAGAACTAG","TTTCCACTTGGTGACTCTTC","561307.5.peg.2038","1156"
"12471",305,36,269,"ACGCACGTCTAATTTCTGGT","AAATCCATAACATCTCCTCC","561307.5.peg.2039","1157"
"12472",305,107,198,"ACGCACGTCTAATTTCTGGT","CCAAACTATCAGTAAATCA","561307.5.peg.2039","1157"
"12473",36,305,269,"AAATCCATAACATCTCCTCC","ACGCACGTCTAATTTCTGGT","561307.5.peg.2039","1157"
"12474",107,305,198,"CCAAACTATCAGTAAATCA","ACGCACGTCTAATTTCTGGT","561307.5.peg.2039","1157"
"12475",363,95,268,"TAATACCATTATCTGCAAC","CCAATTCAGGTGTTAGTTCT","561307.5.peg.2041","1160"
"12476",461,95,366,"CAACTGGTCTTGGTAATTCT","CCAATTCAGGTGTTAGTTCT","561307.5.peg.2041","1160"
"12477",471,95,376,"ATATCATTGCCAACTGGTCT","CCAATTCAGGTGTTAGTTCT","561307.5.peg.2041","1160"
"12478",461,176,285,"CAACTGGTCTTGGTAATTCT","CGCGACCTACAAGTACACGT","561307.5.peg.2041","1160"
"12479",363,176,187,"TAATACCATTATCTGCAAC","CGCGACCTACAAGTACACGT","561307.5.peg.2041","1160"
"12480",471,176,295,"ATATCATTGCCAACTGGTCT","CGCGACCTACAAGTACACGT","561307.5.peg.2041","1160"
"12481",95,363,268,"CCAATTCAGGTGTTAGTTCT","TAATACCATTATCTGCAAC","561307.5.peg.2041","1160"
"12482",176,363,187,"CGCGACCTACAAGTACACGT","TAATACCATTATCTGCAAC","561307.5.peg.2041","1160"
"12483",471,363,108,"ATATCATTGCCAACTGGTCT","TAATACCATTATCTGCAAC","561307.5.peg.2041","1160"
"12484",95,461,366,"CCAATTCAGGTGTTAGTTCT","CAACTGGTCTTGGTAATTCT","561307.5.peg.2041","1160"
"12485",176,461,285,"CGCGACCTACAAGTACACGT","CAACTGGTCTTGGTAATTCT","561307.5.peg.2041","1160"
"12486",95,471,376,"CCAATTCAGGTGTTAGTTCT","ATATCATTGCCAACTGGTCT","561307.5.peg.2041","1160"
"12487",363,471,108,"TAATACCATTATCTGCAAC","ATATCATTGCCAACTGGTCT","561307.5.peg.2041","1160"
"12488",176,471,295,"CGCGACCTACAAGTACACGT","ATATCATTGCCAACTGGTCT","561307.5.peg.2041","1160"
"12489",1206,9,1197,"CTTTATTGTTAGTTGCTTT","AGCGAGAATAATCAACCAGG","561307.5.peg.2042","1161"
"12490",204,9,195,"GGCTGTGTATTGGCATCAGC","AGCGAGAATAATCAACCAGG","561307.5.peg.2042","1161"
"12491",1074,9,1065,"TCAGCAACTGCTGTATTGTC","AGCGAGAATAATCAACCAGG","561307.5.peg.2042","1161"
"12492",546,9,537,"GTTTGTGCGTTTGCTGCTAC","AGCGAGAATAATCAACCAGG","561307.5.peg.2042","1161"
"12493",214,9,205,"ATTTGCGTTAGGCTGTGTAT","AGCGAGAATAATCAACCAGG","561307.5.peg.2042","1161"
"12494",284,9,275,"GTTGTACTGCTGGTTGTCCT","AGCGAGAATAATCAACCAGG","561307.5.peg.2042","1161"
"12495",2316,9,2307,"GCTGCTTTAGCTGTTGTAGC","AGCGAGAATAATCAACCAGG","561307.5.peg.2042","1161"
"12496",195,9,186,"TTGGCATCAGCTGGTTGTGC","AGCGAGAATAATCAACCAGG","561307.5.peg.2042","1161"
"12497",637,9,628,"CTATTCTCATCTGTTGATA","AGCGAGAATAATCAACCAGG","561307.5.peg.2042","1161"
"12498",333,9,324,"GGTTGTGCTGCTCCTCCTGC","AGCGAGAATAATCAACCAGG","561307.5.peg.2042","1161"
"12499",435,9,426,"CCTTGACCTGCTTGGTTTGC","AGCGAGAATAATCAACCAGG","561307.5.peg.2042","1161"
"12500",1358,9,1349,"TACTGTCTTCATTACCATTA","AGCGAGAATAATCAACCAGG","561307.5.peg.2042","1161"
"12501",267,9,258,"CCTTGGTTGGCAGGTGCAGC","AGCGAGAATAATCAACCAGG","561307.5.peg.2042","1161"
"12502",2796,9,2787,"TCTACTTCCGTATCAGCTGC","AGCGAGAATAATCAACCAGG","561307.5.peg.2042","1161"
"12503",1038,9,1029,"TCTAAACGATCAGCATCAGT","AGCGAGAATAATCAACCAGG","561307.5.peg.2042","1161"
"12504",510,9,501,"GCTGCTGCTGGAGCATTCGC","AGCGAGAATAATCAACCAGG","561307.5.peg.2042","1161"
"12505",314,9,305,"CTGGATTAGCCTGTCCACCT","AGCGAGAATAATCAACCAGG","561307.5.peg.2042","1161"
"12506",1314,9,1305,"TTAACGTAAGTTACACCTTG","AGCGAGAATAATCAACCAGG","561307.5.peg.2042","1161"
"12507",280,9,271,"TACTGCTGGTTGTCCTTGGT","AGCGAGAATAATCAACCAGG","561307.5.peg.2042","1161"
"12508",294,9,285,"TGGTTTGCTGGTTGTACTGC","AGCGAGAATAATCAACCAGG","561307.5.peg.2042","1161"
"12509",3013,9,3004,"TGCATCCGATTTCTTAGTTG","AGCGAGAATAATCAACCAGG","561307.5.peg.2042","1161"
"12510",276,9,267,"GCTGGTTGTCCTTGGTTGGC","AGCGAGAATAATCAACCAGG","561307.5.peg.2042","1161"
"12511",2126,9,2117,"GTTTACGAGTTGTAACTGCT","AGCGAGAATAATCAACCAGG","561307.5.peg.2042","1161"
"12512",146,9,137,"CTGCTGCAGACGCTGTTGTC","AGCGAGAATAATCAACCAGG","561307.5.peg.2042","1161"
"12513",3391,9,3382,"TGTATGTGCTGCATCTATTG","AGCGAGAATAATCAACCAGG","561307.5.peg.2042","1161"
"12514",417,9,408,"GCCGGTGTTGCTTGATTTCC","AGCGAGAATAATCAACCAGG","561307.5.peg.2042","1161"
"12515",443,9,434,"GGTTATTTCCTTGACCTGCT","AGCGAGAATAATCAACCAGG","561307.5.peg.2042","1161"
"12516",522,9,513,"GCTGCTGGTTGCGCTGCTGC","AGCGAGAATAATCAACCAGG","561307.5.peg.2042","1161"
"12517",1442,9,1433,"CACGTGCCGTTGTCACACCT","AGCGAGAATAATCAACCAGG","561307.5.peg.2042","1161"
"12518",576,9,567,"TCACCAGTATTGCTAGCATT","AGCGAGAATAATCAACCAGG","561307.5.peg.2042","1161"
"12519",306,9,297,"GCCTGTCCACCTTGGTTTGC","AGCGAGAATAATCAACCAGG","561307.5.peg.2042","1161"
"12520",393,9,384,"TGTGCTTGTGCAGCGTTATT","AGCGAGAATAATCAACCAGG","561307.5.peg.2042","1161"
"12521",1617,9,1608,"TCTGCAGTTAGTGTAACTTC","AGCGAGAATAATCAACCAGG","561307.5.peg.2042","1161"
"12522",225,9,216,"TGAGCACCAGCATTTGCGTT","AGCGAGAATAATCAACCAGG","561307.5.peg.2042","1161"
"12523",255,9,246,"GGTGCAGCTGGCTGTGCTGT","AGCGAGAATAATCAACCAGG","561307.5.peg.2042","1161"
"12524",537,9,528,"TTTGCTGCTACAGGTGCTGC","AGCGAGAATAATCAACCAGG","561307.5.peg.2042","1161"
"12525",354,9,345,"TGTCCAGCTGGTTGTGTATT","AGCGAGAATAATCAACCAGG","561307.5.peg.2042","1161"
"12526",284,12,272,"GTTGTACTGCTGGTTGTCCT","AACAGCGAGAATAATCAACC","561307.5.peg.2042","1161"
"12527",306,12,294,"GCCTGTCCACCTTGGTTTGC","AACAGCGAGAATAATCAACC","561307.5.peg.2042","1161"
"12528",354,12,342,"TGTCCAGCTGGTTGTGTATT","AACAGCGAGAATAATCAACC","561307.5.peg.2042","1161"
"12529",1206,12,1194,"CTTTATTGTTAGTTGCTTT","AACAGCGAGAATAATCAACC","561307.5.peg.2042","1161"
"12530",146,12,134,"CTGCTGCAGACGCTGTTGTC","AACAGCGAGAATAATCAACC","561307.5.peg.2042","1161"
"12531",3391,12,3379,"TGTATGTGCTGCATCTATTG","AACAGCGAGAATAATCAACC","561307.5.peg.2042","1161"
"12532",1314,12,1302,"TTAACGTAAGTTACACCTTG","AACAGCGAGAATAATCAACC","561307.5.peg.2042","1161"
"12533",393,12,381,"TGTGCTTGTGCAGCGTTATT","AACAGCGAGAATAATCAACC","561307.5.peg.2042","1161"
"12534",546,12,534,"GTTTGTGCGTTTGCTGCTAC","AACAGCGAGAATAATCAACC","561307.5.peg.2042","1161"
"12535",1358,12,1346,"TACTGTCTTCATTACCATTA","AACAGCGAGAATAATCAACC","561307.5.peg.2042","1161"
"12536",510,12,498,"GCTGCTGCTGGAGCATTCGC","AACAGCGAGAATAATCAACC","561307.5.peg.2042","1161"
"12537",2796,12,2784,"TCTACTTCCGTATCAGCTGC","AACAGCGAGAATAATCAACC","561307.5.peg.2042","1161"
"12538",443,12,431,"GGTTATTTCCTTGACCTGCT","AACAGCGAGAATAATCAACC","561307.5.peg.2042","1161"
"12539",280,12,268,"TACTGCTGGTTGTCCTTGGT","AACAGCGAGAATAATCAACC","561307.5.peg.2042","1161"
"12540",2316,12,2304,"GCTGCTTTAGCTGTTGTAGC","AACAGCGAGAATAATCAACC","561307.5.peg.2042","1161"
"12541",3013,12,3001,"TGCATCCGATTTCTTAGTTG","AACAGCGAGAATAATCAACC","561307.5.peg.2042","1161"
"12542",637,12,625,"CTATTCTCATCTGTTGATA","AACAGCGAGAATAATCAACC","561307.5.peg.2042","1161"
"12543",267,12,255,"CCTTGGTTGGCAGGTGCAGC","AACAGCGAGAATAATCAACC","561307.5.peg.2042","1161"
"12544",255,12,243,"GGTGCAGCTGGCTGTGCTGT","AACAGCGAGAATAATCAACC","561307.5.peg.2042","1161"
"12545",1074,12,1062,"TCAGCAACTGCTGTATTGTC","AACAGCGAGAATAATCAACC","561307.5.peg.2042","1161"
"12546",333,12,321,"GGTTGTGCTGCTCCTCCTGC","AACAGCGAGAATAATCAACC","561307.5.peg.2042","1161"
"12547",435,12,423,"CCTTGACCTGCTTGGTTTGC","AACAGCGAGAATAATCAACC","561307.5.peg.2042","1161"
"12548",2126,12,2114,"GTTTACGAGTTGTAACTGCT","AACAGCGAGAATAATCAACC","561307.5.peg.2042","1161"
"12549",294,12,282,"TGGTTTGCTGGTTGTACTGC","AACAGCGAGAATAATCAACC","561307.5.peg.2042","1161"
"12550",1038,12,1026,"TCTAAACGATCAGCATCAGT","AACAGCGAGAATAATCAACC","561307.5.peg.2042","1161"
"12551",1617,12,1605,"TCTGCAGTTAGTGTAACTTC","AACAGCGAGAATAATCAACC","561307.5.peg.2042","1161"
"12552",417,12,405,"GCCGGTGTTGCTTGATTTCC","AACAGCGAGAATAATCAACC","561307.5.peg.2042","1161"
"12553",314,12,302,"CTGGATTAGCCTGTCCACCT","AACAGCGAGAATAATCAACC","561307.5.peg.2042","1161"
"12554",204,12,192,"GGCTGTGTATTGGCATCAGC","AACAGCGAGAATAATCAACC","561307.5.peg.2042","1161"
"12555",537,12,525,"TTTGCTGCTACAGGTGCTGC","AACAGCGAGAATAATCAACC","561307.5.peg.2042","1161"
"12556",522,12,510,"GCTGCTGGTTGCGCTGCTGC","AACAGCGAGAATAATCAACC","561307.5.peg.2042","1161"
"12557",576,12,564,"TCACCAGTATTGCTAGCATT","AACAGCGAGAATAATCAACC","561307.5.peg.2042","1161"
"12558",276,12,264,"GCTGGTTGTCCTTGGTTGGC","AACAGCGAGAATAATCAACC","561307.5.peg.2042","1161"
"12559",195,12,183,"TTGGCATCAGCTGGTTGTGC","AACAGCGAGAATAATCAACC","561307.5.peg.2042","1161"
"12560",1442,12,1430,"CACGTGCCGTTGTCACACCT","AACAGCGAGAATAATCAACC","561307.5.peg.2042","1161"
"12561",225,12,213,"TGAGCACCAGCATTTGCGTT","AACAGCGAGAATAATCAACC","561307.5.peg.2042","1161"
"12562",214,12,202,"ATTTGCGTTAGGCTGTGTAT","AACAGCGAGAATAATCAACC","561307.5.peg.2042","1161"
"12563",2796,35,2761,"TCTACTTCCGTATCAGCTGC","AATTCATTAAGTCATCCTCC","561307.5.peg.2042","1161"
"12564",435,35,400,"CCTTGACCTGCTTGGTTTGC","AATTCATTAAGTCATCCTCC","561307.5.peg.2042","1161"
"12565",3013,35,2978,"TGCATCCGATTTCTTAGTTG","AATTCATTAAGTCATCCTCC","561307.5.peg.2042","1161"
"12566",284,35,249,"GTTGTACTGCTGGTTGTCCT","AATTCATTAAGTCATCCTCC","561307.5.peg.2042","1161"
"12567",225,35,190,"TGAGCACCAGCATTTGCGTT","AATTCATTAAGTCATCCTCC","561307.5.peg.2042","1161"
"12568",510,35,475,"GCTGCTGCTGGAGCATTCGC","AATTCATTAAGTCATCCTCC","561307.5.peg.2042","1161"
"12569",354,35,319,"TGTCCAGCTGGTTGTGTATT","AATTCATTAAGTCATCCTCC","561307.5.peg.2042","1161"
"12570",267,35,232,"CCTTGGTTGGCAGGTGCAGC","AATTCATTAAGTCATCCTCC","561307.5.peg.2042","1161"
"12571",537,35,502,"TTTGCTGCTACAGGTGCTGC","AATTCATTAAGTCATCCTCC","561307.5.peg.2042","1161"
"12572",1617,35,1582,"TCTGCAGTTAGTGTAACTTC","AATTCATTAAGTCATCCTCC","561307.5.peg.2042","1161"
"12573",280,35,245,"TACTGCTGGTTGTCCTTGGT","AATTCATTAAGTCATCCTCC","561307.5.peg.2042","1161"
"12574",294,35,259,"TGGTTTGCTGGTTGTACTGC","AATTCATTAAGTCATCCTCC","561307.5.peg.2042","1161"
"12575",1038,35,1003,"TCTAAACGATCAGCATCAGT","AATTCATTAAGTCATCCTCC","561307.5.peg.2042","1161"
"12576",393,35,358,"TGTGCTTGTGCAGCGTTATT","AATTCATTAAGTCATCCTCC","561307.5.peg.2042","1161"
"12577",576,35,541,"TCACCAGTATTGCTAGCATT","AATTCATTAAGTCATCCTCC","561307.5.peg.2042","1161"
"12578",546,35,511,"GTTTGTGCGTTTGCTGCTAC","AATTCATTAAGTCATCCTCC","561307.5.peg.2042","1161"
"12579",255,35,220,"GGTGCAGCTGGCTGTGCTGT","AATTCATTAAGTCATCCTCC","561307.5.peg.2042","1161"
"12580",276,35,241,"GCTGGTTGTCCTTGGTTGGC","AATTCATTAAGTCATCCTCC","561307.5.peg.2042","1161"
"12581",195,35,160,"TTGGCATCAGCTGGTTGTGC","AATTCATTAAGTCATCCTCC","561307.5.peg.2042","1161"
"12582",306,35,271,"GCCTGTCCACCTTGGTTTGC","AATTCATTAAGTCATCCTCC","561307.5.peg.2042","1161"
"12583",2316,35,2281,"GCTGCTTTAGCTGTTGTAGC","AATTCATTAAGTCATCCTCC","561307.5.peg.2042","1161"
"12584",204,35,169,"GGCTGTGTATTGGCATCAGC","AATTCATTAAGTCATCCTCC","561307.5.peg.2042","1161"
"12585",1358,35,1323,"TACTGTCTTCATTACCATTA","AATTCATTAAGTCATCCTCC","561307.5.peg.2042","1161"
"12586",443,35,408,"GGTTATTTCCTTGACCTGCT","AATTCATTAAGTCATCCTCC","561307.5.peg.2042","1161"
"12587",417,35,382,"GCCGGTGTTGCTTGATTTCC","AATTCATTAAGTCATCCTCC","561307.5.peg.2042","1161"
"12588",3391,35,3356,"TGTATGTGCTGCATCTATTG","AATTCATTAAGTCATCCTCC","561307.5.peg.2042","1161"
"12589",1314,35,1279,"TTAACGTAAGTTACACCTTG","AATTCATTAAGTCATCCTCC","561307.5.peg.2042","1161"
"12590",1206,35,1171,"CTTTATTGTTAGTTGCTTT","AATTCATTAAGTCATCCTCC","561307.5.peg.2042","1161"
"12591",522,35,487,"GCTGCTGGTTGCGCTGCTGC","AATTCATTAAGTCATCCTCC","561307.5.peg.2042","1161"
"12592",1442,35,1407,"CACGTGCCGTTGTCACACCT","AATTCATTAAGTCATCCTCC","561307.5.peg.2042","1161"
"12593",333,35,298,"GGTTGTGCTGCTCCTCCTGC","AATTCATTAAGTCATCCTCC","561307.5.peg.2042","1161"
"12594",314,35,279,"CTGGATTAGCCTGTCCACCT","AATTCATTAAGTCATCCTCC","561307.5.peg.2042","1161"
"12595",214,35,179,"ATTTGCGTTAGGCTGTGTAT","AATTCATTAAGTCATCCTCC","561307.5.peg.2042","1161"
"12596",146,35,111,"CTGCTGCAGACGCTGTTGTC","AATTCATTAAGTCATCCTCC","561307.5.peg.2042","1161"
"12597",637,35,602,"CTATTCTCATCTGTTGATA","AATTCATTAAGTCATCCTCC","561307.5.peg.2042","1161"
"12598",1074,35,1039,"TCAGCAACTGCTGTATTGTC","AATTCATTAAGTCATCCTCC","561307.5.peg.2042","1161"
"12599",2126,35,2091,"GTTTACGAGTTGTAACTGCT","AATTCATTAAGTCATCCTCC","561307.5.peg.2042","1161"
"12600",306,146,160,"GCCTGTCCACCTTGGTTTGC","CTGCTGCAGACGCTGTTGTC","561307.5.peg.2042","1161"
"12601",435,146,289,"CCTTGACCTGCTTGGTTTGC","CTGCTGCAGACGCTGTTGTC","561307.5.peg.2042","1161"
"12602",314,146,168,"CTGGATTAGCCTGTCCACCT","CTGCTGCAGACGCTGTTGTC","561307.5.peg.2042","1161"
"12603",1314,146,1168,"TTAACGTAAGTTACACCTTG","CTGCTGCAGACGCTGTTGTC","561307.5.peg.2042","1161"
"12604",9,146,137,"AGCGAGAATAATCAACCAGG","CTGCTGCAGACGCTGTTGTC","561307.5.peg.2042","1161"
"12605",255,146,109,"GGTGCAGCTGGCTGTGCTGT","CTGCTGCAGACGCTGTTGTC","561307.5.peg.2042","1161"
"12606",294,146,148,"TGGTTTGCTGGTTGTACTGC","CTGCTGCAGACGCTGTTGTC","561307.5.peg.2042","1161"
"12607",537,146,391,"TTTGCTGCTACAGGTGCTGC","CTGCTGCAGACGCTGTTGTC","561307.5.peg.2042","1161"
"12608",522,146,376,"GCTGCTGGTTGCGCTGCTGC","CTGCTGCAGACGCTGTTGTC","561307.5.peg.2042","1161"
"12609",267,146,121,"CCTTGGTTGGCAGGTGCAGC","CTGCTGCAGACGCTGTTGTC","561307.5.peg.2042","1161"
"12610",3391,146,3245,"TGTATGTGCTGCATCTATTG","CTGCTGCAGACGCTGTTGTC","561307.5.peg.2042","1161"
"12611",546,146,400,"GTTTGTGCGTTTGCTGCTAC","CTGCTGCAGACGCTGTTGTC","561307.5.peg.2042","1161"
"12612",35,146,111,"AATTCATTAAGTCATCCTCC","CTGCTGCAGACGCTGTTGTC","561307.5.peg.2042","1161"
"12613",3013,146,2867,"TGCATCCGATTTCTTAGTTG","CTGCTGCAGACGCTGTTGTC","561307.5.peg.2042","1161"
"12614",1358,146,1212,"TACTGTCTTCATTACCATTA","CTGCTGCAGACGCTGTTGTC","561307.5.peg.2042","1161"
"12615",1442,146,1296,"CACGTGCCGTTGTCACACCT","CTGCTGCAGACGCTGTTGTC","561307.5.peg.2042","1161"
"12616",280,146,134,"TACTGCTGGTTGTCCTTGGT","CTGCTGCAGACGCTGTTGTC","561307.5.peg.2042","1161"
"12617",2796,146,2650,"TCTACTTCCGTATCAGCTGC","CTGCTGCAGACGCTGTTGTC","561307.5.peg.2042","1161"
"12618",284,146,138,"GTTGTACTGCTGGTTGTCCT","CTGCTGCAGACGCTGTTGTC","561307.5.peg.2042","1161"
"12619",1206,146,1060,"CTTTATTGTTAGTTGCTTT","CTGCTGCAGACGCTGTTGTC","561307.5.peg.2042","1161"
"12620",354,146,208,"TGTCCAGCTGGTTGTGTATT","CTGCTGCAGACGCTGTTGTC","561307.5.peg.2042","1161"
"12621",2316,146,2170,"GCTGCTTTAGCTGTTGTAGC","CTGCTGCAGACGCTGTTGTC","561307.5.peg.2042","1161"
"12622",1617,146,1471,"TCTGCAGTTAGTGTAACTTC","CTGCTGCAGACGCTGTTGTC","561307.5.peg.2042","1161"
"12623",2126,146,1980,"GTTTACGAGTTGTAACTGCT","CTGCTGCAGACGCTGTTGTC","561307.5.peg.2042","1161"
"12624",576,146,430,"TCACCAGTATTGCTAGCATT","CTGCTGCAGACGCTGTTGTC","561307.5.peg.2042","1161"
"12625",1074,146,928,"TCAGCAACTGCTGTATTGTC","CTGCTGCAGACGCTGTTGTC","561307.5.peg.2042","1161"
"12626",393,146,247,"TGTGCTTGTGCAGCGTTATT","CTGCTGCAGACGCTGTTGTC","561307.5.peg.2042","1161"
"12627",637,146,491,"CTATTCTCATCTGTTGATA","CTGCTGCAGACGCTGTTGTC","561307.5.peg.2042","1161"
"12628",510,146,364,"GCTGCTGCTGGAGCATTCGC","CTGCTGCAGACGCTGTTGTC","561307.5.peg.2042","1161"
"12629",417,146,271,"GCCGGTGTTGCTTGATTTCC","CTGCTGCAGACGCTGTTGTC","561307.5.peg.2042","1161"
"12630",1038,146,892,"TCTAAACGATCAGCATCAGT","CTGCTGCAGACGCTGTTGTC","561307.5.peg.2042","1161"
"12631",443,146,297,"GGTTATTTCCTTGACCTGCT","CTGCTGCAGACGCTGTTGTC","561307.5.peg.2042","1161"
"12632",12,146,134,"AACAGCGAGAATAATCAACC","CTGCTGCAGACGCTGTTGTC","561307.5.peg.2042","1161"
"12633",276,146,130,"GCTGGTTGTCCTTGGTTGGC","CTGCTGCAGACGCTGTTGTC","561307.5.peg.2042","1161"
"12634",333,146,187,"GGTTGTGCTGCTCCTCCTGC","CTGCTGCAGACGCTGTTGTC","561307.5.peg.2042","1161"
"12635",522,195,327,"GCTGCTGGTTGCGCTGCTGC","TTGGCATCAGCTGGTTGTGC","561307.5.peg.2042","1161"
"12636",354,195,159,"TGTCCAGCTGGTTGTGTATT","TTGGCATCAGCTGGTTGTGC","561307.5.peg.2042","1161"
"12637",435,195,240,"CCTTGACCTGCTTGGTTTGC","TTGGCATCAGCTGGTTGTGC","561307.5.peg.2042","1161"
"12638",1358,195,1163,"TACTGTCTTCATTACCATTA","TTGGCATCAGCTGGTTGTGC","561307.5.peg.2042","1161"
"12639",1074,195,879,"TCAGCAACTGCTGTATTGTC","TTGGCATCAGCTGGTTGTGC","561307.5.peg.2042","1161"
"12640",2796,195,2601,"TCTACTTCCGTATCAGCTGC","TTGGCATCAGCTGGTTGTGC","561307.5.peg.2042","1161"
"12641",510,195,315,"GCTGCTGCTGGAGCATTCGC","TTGGCATCAGCTGGTTGTGC","561307.5.peg.2042","1161"
"12642",443,195,248,"GGTTATTTCCTTGACCTGCT","TTGGCATCAGCTGGTTGTGC","561307.5.peg.2042","1161"
"12643",2126,195,1931,"GTTTACGAGTTGTAACTGCT","TTGGCATCAGCTGGTTGTGC","561307.5.peg.2042","1161"
"12644",1617,195,1422,"TCTGCAGTTAGTGTAACTTC","TTGGCATCAGCTGGTTGTGC","561307.5.peg.2042","1161"
"12645",1314,195,1119,"TTAACGTAAGTTACACCTTG","TTGGCATCAGCTGGTTGTGC","561307.5.peg.2042","1161"
"12646",3391,195,3196,"TGTATGTGCTGCATCTATTG","TTGGCATCAGCTGGTTGTGC","561307.5.peg.2042","1161"
"12647",1442,195,1247,"CACGTGCCGTTGTCACACCT","TTGGCATCAGCTGGTTGTGC","561307.5.peg.2042","1161"
"12648",393,195,198,"TGTGCTTGTGCAGCGTTATT","TTGGCATCAGCTGGTTGTGC","561307.5.peg.2042","1161"
"12649",12,195,183,"AACAGCGAGAATAATCAACC","TTGGCATCAGCTGGTTGTGC","561307.5.peg.2042","1161"
"12650",637,195,442,"CTATTCTCATCTGTTGATA","TTGGCATCAGCTGGTTGTGC","561307.5.peg.2042","1161"
"12651",333,195,138,"GGTTGTGCTGCTCCTCCTGC","TTGGCATCAGCTGGTTGTGC","561307.5.peg.2042","1161"
"12652",1038,195,843,"TCTAAACGATCAGCATCAGT","TTGGCATCAGCTGGTTGTGC","561307.5.peg.2042","1161"
"12653",1206,195,1011,"CTTTATTGTTAGTTGCTTT","TTGGCATCAGCTGGTTGTGC","561307.5.peg.2042","1161"
"12654",537,195,342,"TTTGCTGCTACAGGTGCTGC","TTGGCATCAGCTGGTTGTGC","561307.5.peg.2042","1161"
"12655",546,195,351,"GTTTGTGCGTTTGCTGCTAC","TTGGCATCAGCTGGTTGTGC","561307.5.peg.2042","1161"
"12656",35,195,160,"AATTCATTAAGTCATCCTCC","TTGGCATCAGCTGGTTGTGC","561307.5.peg.2042","1161"
"12657",2316,195,2121,"GCTGCTTTAGCTGTTGTAGC","TTGGCATCAGCTGGTTGTGC","561307.5.peg.2042","1161"
"12658",9,195,186,"AGCGAGAATAATCAACCAGG","TTGGCATCAGCTGGTTGTGC","561307.5.peg.2042","1161"
"12659",417,195,222,"GCCGGTGTTGCTTGATTTCC","TTGGCATCAGCTGGTTGTGC","561307.5.peg.2042","1161"
"12660",576,195,381,"TCACCAGTATTGCTAGCATT","TTGGCATCAGCTGGTTGTGC","561307.5.peg.2042","1161"
"12661",306,195,111,"GCCTGTCCACCTTGGTTTGC","TTGGCATCAGCTGGTTGTGC","561307.5.peg.2042","1161"
"12662",3013,195,2818,"TGCATCCGATTTCTTAGTTG","TTGGCATCAGCTGGTTGTGC","561307.5.peg.2042","1161"
"12663",314,195,119,"CTGGATTAGCCTGTCCACCT","TTGGCATCAGCTGGTTGTGC","561307.5.peg.2042","1161"
"12664",354,204,150,"TGTCCAGCTGGTTGTGTATT","GGCTGTGTATTGGCATCAGC","561307.5.peg.2042","1161"
"12665",443,204,239,"GGTTATTTCCTTGACCTGCT","GGCTGTGTATTGGCATCAGC","561307.5.peg.2042","1161"
"12666",2126,204,1922,"GTTTACGAGTTGTAACTGCT","GGCTGTGTATTGGCATCAGC","561307.5.peg.2042","1161"
"12667",393,204,189,"TGTGCTTGTGCAGCGTTATT","GGCTGTGTATTGGCATCAGC","561307.5.peg.2042","1161"
"12668",1206,204,1002,"CTTTATTGTTAGTTGCTTT","GGCTGTGTATTGGCATCAGC","561307.5.peg.2042","1161"
"12669",1074,204,870,"TCAGCAACTGCTGTATTGTC","GGCTGTGTATTGGCATCAGC","561307.5.peg.2042","1161"
"12670",35,204,169,"AATTCATTAAGTCATCCTCC","GGCTGTGTATTGGCATCAGC","561307.5.peg.2042","1161"
"12671",537,204,333,"TTTGCTGCTACAGGTGCTGC","GGCTGTGTATTGGCATCAGC","561307.5.peg.2042","1161"
"12672",1617,204,1413,"TCTGCAGTTAGTGTAACTTC","GGCTGTGTATTGGCATCAGC","561307.5.peg.2042","1161"
"12673",1358,204,1154,"TACTGTCTTCATTACCATTA","GGCTGTGTATTGGCATCAGC","561307.5.peg.2042","1161"
"12674",637,204,433,"CTATTCTCATCTGTTGATA","GGCTGTGTATTGGCATCAGC","561307.5.peg.2042","1161"
"12675",9,204,195,"AGCGAGAATAATCAACCAGG","GGCTGTGTATTGGCATCAGC","561307.5.peg.2042","1161"
"12676",12,204,192,"AACAGCGAGAATAATCAACC","GGCTGTGTATTGGCATCAGC","561307.5.peg.2042","1161"
"12677",333,204,129,"GGTTGTGCTGCTCCTCCTGC","GGCTGTGTATTGGCATCAGC","561307.5.peg.2042","1161"
"12678",1442,204,1238,"CACGTGCCGTTGTCACACCT","GGCTGTGTATTGGCATCAGC","561307.5.peg.2042","1161"
"12679",1038,204,834,"TCTAAACGATCAGCATCAGT","GGCTGTGTATTGGCATCAGC","561307.5.peg.2042","1161"
"12680",546,204,342,"GTTTGTGCGTTTGCTGCTAC","GGCTGTGTATTGGCATCAGC","561307.5.peg.2042","1161"
"12681",417,204,213,"GCCGGTGTTGCTTGATTTCC","GGCTGTGTATTGGCATCAGC","561307.5.peg.2042","1161"
"12682",435,204,231,"CCTTGACCTGCTTGGTTTGC","GGCTGTGTATTGGCATCAGC","561307.5.peg.2042","1161"
"12683",1314,204,1110,"TTAACGTAAGTTACACCTTG","GGCTGTGTATTGGCATCAGC","561307.5.peg.2042","1161"
"12684",3013,204,2809,"TGCATCCGATTTCTTAGTTG","GGCTGTGTATTGGCATCAGC","561307.5.peg.2042","1161"
"12685",2796,204,2592,"TCTACTTCCGTATCAGCTGC","GGCTGTGTATTGGCATCAGC","561307.5.peg.2042","1161"
"12686",522,204,318,"GCTGCTGGTTGCGCTGCTGC","GGCTGTGTATTGGCATCAGC","561307.5.peg.2042","1161"
"12687",306,204,102,"GCCTGTCCACCTTGGTTTGC","GGCTGTGTATTGGCATCAGC","561307.5.peg.2042","1161"
"12688",576,204,372,"TCACCAGTATTGCTAGCATT","GGCTGTGTATTGGCATCAGC","561307.5.peg.2042","1161"
"12689",3391,204,3187,"TGTATGTGCTGCATCTATTG","GGCTGTGTATTGGCATCAGC","561307.5.peg.2042","1161"
"12690",510,204,306,"GCTGCTGCTGGAGCATTCGC","GGCTGTGTATTGGCATCAGC","561307.5.peg.2042","1161"
"12691",2316,204,2112,"GCTGCTTTAGCTGTTGTAGC","GGCTGTGTATTGGCATCAGC","561307.5.peg.2042","1161"
"12692",314,204,110,"CTGGATTAGCCTGTCCACCT","GGCTGTGTATTGGCATCAGC","561307.5.peg.2042","1161"
"12693",35,214,179,"AATTCATTAAGTCATCCTCC","ATTTGCGTTAGGCTGTGTAT","561307.5.peg.2042","1161"
"12694",3391,214,3177,"TGTATGTGCTGCATCTATTG","ATTTGCGTTAGGCTGTGTAT","561307.5.peg.2042","1161"
"12695",354,214,140,"TGTCCAGCTGGTTGTGTATT","ATTTGCGTTAGGCTGTGTAT","561307.5.peg.2042","1161"
"12696",576,214,362,"TCACCAGTATTGCTAGCATT","ATTTGCGTTAGGCTGTGTAT","561307.5.peg.2042","1161"
"12697",2126,214,1912,"GTTTACGAGTTGTAACTGCT","ATTTGCGTTAGGCTGTGTAT","561307.5.peg.2042","1161"
"12698",1206,214,992,"CTTTATTGTTAGTTGCTTT","ATTTGCGTTAGGCTGTGTAT","561307.5.peg.2042","1161"
"12699",1038,214,824,"TCTAAACGATCAGCATCAGT","ATTTGCGTTAGGCTGTGTAT","561307.5.peg.2042","1161"
"12700",510,214,296,"GCTGCTGCTGGAGCATTCGC","ATTTGCGTTAGGCTGTGTAT","561307.5.peg.2042","1161"
"12701",393,214,179,"TGTGCTTGTGCAGCGTTATT","ATTTGCGTTAGGCTGTGTAT","561307.5.peg.2042","1161"
"12702",637,214,423,"CTATTCTCATCTGTTGATA","ATTTGCGTTAGGCTGTGTAT","561307.5.peg.2042","1161"
"12703",1442,214,1228,"CACGTGCCGTTGTCACACCT","ATTTGCGTTAGGCTGTGTAT","561307.5.peg.2042","1161"
"12704",1074,214,860,"TCAGCAACTGCTGTATTGTC","ATTTGCGTTAGGCTGTGTAT","561307.5.peg.2042","1161"
"12705",9,214,205,"AGCGAGAATAATCAACCAGG","ATTTGCGTTAGGCTGTGTAT","561307.5.peg.2042","1161"
"12706",1314,214,1100,"TTAACGTAAGTTACACCTTG","ATTTGCGTTAGGCTGTGTAT","561307.5.peg.2042","1161"
"12707",435,214,221,"CCTTGACCTGCTTGGTTTGC","ATTTGCGTTAGGCTGTGTAT","561307.5.peg.2042","1161"
"12708",314,214,100,"CTGGATTAGCCTGTCCACCT","ATTTGCGTTAGGCTGTGTAT","561307.5.peg.2042","1161"
"12709",522,214,308,"GCTGCTGGTTGCGCTGCTGC","ATTTGCGTTAGGCTGTGTAT","561307.5.peg.2042","1161"
"12710",417,214,203,"GCCGGTGTTGCTTGATTTCC","ATTTGCGTTAGGCTGTGTAT","561307.5.peg.2042","1161"
"12711",2316,214,2102,"GCTGCTTTAGCTGTTGTAGC","ATTTGCGTTAGGCTGTGTAT","561307.5.peg.2042","1161"
"12712",1358,214,1144,"TACTGTCTTCATTACCATTA","ATTTGCGTTAGGCTGTGTAT","561307.5.peg.2042","1161"
"12713",12,214,202,"AACAGCGAGAATAATCAACC","ATTTGCGTTAGGCTGTGTAT","561307.5.peg.2042","1161"
"12714",443,214,229,"GGTTATTTCCTTGACCTGCT","ATTTGCGTTAGGCTGTGTAT","561307.5.peg.2042","1161"
"12715",537,214,323,"TTTGCTGCTACAGGTGCTGC","ATTTGCGTTAGGCTGTGTAT","561307.5.peg.2042","1161"
"12716",333,214,119,"GGTTGTGCTGCTCCTCCTGC","ATTTGCGTTAGGCTGTGTAT","561307.5.peg.2042","1161"
"12717",3013,214,2799,"TGCATCCGATTTCTTAGTTG","ATTTGCGTTAGGCTGTGTAT","561307.5.peg.2042","1161"
"12718",1617,214,1403,"TCTGCAGTTAGTGTAACTTC","ATTTGCGTTAGGCTGTGTAT","561307.5.peg.2042","1161"
"12719",546,214,332,"GTTTGTGCGTTTGCTGCTAC","ATTTGCGTTAGGCTGTGTAT","561307.5.peg.2042","1161"
"12720",2796,214,2582,"TCTACTTCCGTATCAGCTGC","ATTTGCGTTAGGCTGTGTAT","561307.5.peg.2042","1161"
"12721",537,225,312,"TTTGCTGCTACAGGTGCTGC","TGAGCACCAGCATTTGCGTT","561307.5.peg.2042","1161"
"12722",417,225,192,"GCCGGTGTTGCTTGATTTCC","TGAGCACCAGCATTTGCGTT","561307.5.peg.2042","1161"
"12723",354,225,129,"TGTCCAGCTGGTTGTGTATT","TGAGCACCAGCATTTGCGTT","561307.5.peg.2042","1161"
"12724",1617,225,1392,"TCTGCAGTTAGTGTAACTTC","TGAGCACCAGCATTTGCGTT","561307.5.peg.2042","1161"
"12725",510,225,285,"GCTGCTGCTGGAGCATTCGC","TGAGCACCAGCATTTGCGTT","561307.5.peg.2042","1161"
"12726",393,225,168,"TGTGCTTGTGCAGCGTTATT","TGAGCACCAGCATTTGCGTT","561307.5.peg.2042","1161"
"12727",1358,225,1133,"TACTGTCTTCATTACCATTA","TGAGCACCAGCATTTGCGTT","561307.5.peg.2042","1161"
"12728",522,225,297,"GCTGCTGGTTGCGCTGCTGC","TGAGCACCAGCATTTGCGTT","561307.5.peg.2042","1161"
"12729",9,225,216,"AGCGAGAATAATCAACCAGG","TGAGCACCAGCATTTGCGTT","561307.5.peg.2042","1161"
"12730",443,225,218,"GGTTATTTCCTTGACCTGCT","TGAGCACCAGCATTTGCGTT","561307.5.peg.2042","1161"
"12731",35,225,190,"AATTCATTAAGTCATCCTCC","TGAGCACCAGCATTTGCGTT","561307.5.peg.2042","1161"
"12732",1442,225,1217,"CACGTGCCGTTGTCACACCT","TGAGCACCAGCATTTGCGTT","561307.5.peg.2042","1161"
"12733",3013,225,2788,"TGCATCCGATTTCTTAGTTG","TGAGCACCAGCATTTGCGTT","561307.5.peg.2042","1161"
"12734",1038,225,813,"TCTAAACGATCAGCATCAGT","TGAGCACCAGCATTTGCGTT","561307.5.peg.2042","1161"
"12735",576,225,351,"TCACCAGTATTGCTAGCATT","TGAGCACCAGCATTTGCGTT","561307.5.peg.2042","1161"
"12736",637,225,412,"CTATTCTCATCTGTTGATA","TGAGCACCAGCATTTGCGTT","561307.5.peg.2042","1161"
"12737",1206,225,981,"CTTTATTGTTAGTTGCTTT","TGAGCACCAGCATTTGCGTT","561307.5.peg.2042","1161"
"12738",1314,225,1089,"TTAACGTAAGTTACACCTTG","TGAGCACCAGCATTTGCGTT","561307.5.peg.2042","1161"
"12739",435,225,210,"CCTTGACCTGCTTGGTTTGC","TGAGCACCAGCATTTGCGTT","561307.5.peg.2042","1161"
"12740",1074,225,849,"TCAGCAACTGCTGTATTGTC","TGAGCACCAGCATTTGCGTT","561307.5.peg.2042","1161"
"12741",2796,225,2571,"TCTACTTCCGTATCAGCTGC","TGAGCACCAGCATTTGCGTT","561307.5.peg.2042","1161"
"12742",12,225,213,"AACAGCGAGAATAATCAACC","TGAGCACCAGCATTTGCGTT","561307.5.peg.2042","1161"
"12743",2126,225,1901,"GTTTACGAGTTGTAACTGCT","TGAGCACCAGCATTTGCGTT","561307.5.peg.2042","1161"
"12744",333,225,108,"GGTTGTGCTGCTCCTCCTGC","TGAGCACCAGCATTTGCGTT","561307.5.peg.2042","1161"
"12745",2316,225,2091,"GCTGCTTTAGCTGTTGTAGC","TGAGCACCAGCATTTGCGTT","561307.5.peg.2042","1161"
"12746",3391,225,3166,"TGTATGTGCTGCATCTATTG","TGAGCACCAGCATTTGCGTT","561307.5.peg.2042","1161"
"12747",546,225,321,"GTTTGTGCGTTTGCTGCTAC","TGAGCACCAGCATTTGCGTT","561307.5.peg.2042","1161"
"12748",537,255,282,"TTTGCTGCTACAGGTGCTGC","GGTGCAGCTGGCTGTGCTGT","561307.5.peg.2042","1161"
"12749",417,255,162,"GCCGGTGTTGCTTGATTTCC","GGTGCAGCTGGCTGTGCTGT","561307.5.peg.2042","1161"
"12750",1038,255,783,"TCTAAACGATCAGCATCAGT","GGTGCAGCTGGCTGTGCTGT","561307.5.peg.2042","1161"
"12751",393,255,138,"TGTGCTTGTGCAGCGTTATT","GGTGCAGCTGGCTGTGCTGT","561307.5.peg.2042","1161"
"12752",35,255,220,"AATTCATTAAGTCATCCTCC","GGTGCAGCTGGCTGTGCTGT","561307.5.peg.2042","1161"
"12753",1314,255,1059,"TTAACGTAAGTTACACCTTG","GGTGCAGCTGGCTGTGCTGT","561307.5.peg.2042","1161"
"12754",435,255,180,"CCTTGACCTGCTTGGTTTGC","GGTGCAGCTGGCTGTGCTGT","561307.5.peg.2042","1161"
"12755",146,255,109,"CTGCTGCAGACGCTGTTGTC","GGTGCAGCTGGCTGTGCTGT","561307.5.peg.2042","1161"
"12756",1358,255,1103,"TACTGTCTTCATTACCATTA","GGTGCAGCTGGCTGTGCTGT","561307.5.peg.2042","1161"
"12757",12,255,243,"AACAGCGAGAATAATCAACC","GGTGCAGCTGGCTGTGCTGT","561307.5.peg.2042","1161"
"12758",1617,255,1362,"TCTGCAGTTAGTGTAACTTC","GGTGCAGCTGGCTGTGCTGT","561307.5.peg.2042","1161"
"12759",2796,255,2541,"TCTACTTCCGTATCAGCTGC","GGTGCAGCTGGCTGTGCTGT","561307.5.peg.2042","1161"
"12760",546,255,291,"GTTTGTGCGTTTGCTGCTAC","GGTGCAGCTGGCTGTGCTGT","561307.5.peg.2042","1161"
"12761",1206,255,951,"CTTTATTGTTAGTTGCTTT","GGTGCAGCTGGCTGTGCTGT","561307.5.peg.2042","1161"
"12762",2126,255,1871,"GTTTACGAGTTGTAACTGCT","GGTGCAGCTGGCTGTGCTGT","561307.5.peg.2042","1161"
"12763",1074,255,819,"TCAGCAACTGCTGTATTGTC","GGTGCAGCTGGCTGTGCTGT","561307.5.peg.2042","1161"
"12764",522,255,267,"GCTGCTGGTTGCGCTGCTGC","GGTGCAGCTGGCTGTGCTGT","561307.5.peg.2042","1161"
"12765",637,255,382,"CTATTCTCATCTGTTGATA","GGTGCAGCTGGCTGTGCTGT","561307.5.peg.2042","1161"
"12766",576,255,321,"TCACCAGTATTGCTAGCATT","GGTGCAGCTGGCTGTGCTGT","561307.5.peg.2042","1161"
"12767",1442,255,1187,"CACGTGCCGTTGTCACACCT","GGTGCAGCTGGCTGTGCTGT","561307.5.peg.2042","1161"
"12768",3013,255,2758,"TGCATCCGATTTCTTAGTTG","GGTGCAGCTGGCTGTGCTGT","561307.5.peg.2042","1161"
"12769",2316,255,2061,"GCTGCTTTAGCTGTTGTAGC","GGTGCAGCTGGCTGTGCTGT","561307.5.peg.2042","1161"
"12770",443,255,188,"GGTTATTTCCTTGACCTGCT","GGTGCAGCTGGCTGTGCTGT","561307.5.peg.2042","1161"
"12771",510,255,255,"GCTGCTGCTGGAGCATTCGC","GGTGCAGCTGGCTGTGCTGT","561307.5.peg.2042","1161"
"12772",3391,255,3136,"TGTATGTGCTGCATCTATTG","GGTGCAGCTGGCTGTGCTGT","561307.5.peg.2042","1161"
"12773",9,255,246,"AGCGAGAATAATCAACCAGG","GGTGCAGCTGGCTGTGCTGT","561307.5.peg.2042","1161"
"12774",637,267,370,"CTATTCTCATCTGTTGATA","CCTTGGTTGGCAGGTGCAGC","561307.5.peg.2042","1161"
"12775",537,267,270,"TTTGCTGCTACAGGTGCTGC","CCTTGGTTGGCAGGTGCAGC","561307.5.peg.2042","1161"
"12776",2796,267,2529,"TCTACTTCCGTATCAGCTGC","CCTTGGTTGGCAGGTGCAGC","561307.5.peg.2042","1161"
"12777",435,267,168,"CCTTGACCTGCTTGGTTTGC","CCTTGGTTGGCAGGTGCAGC","561307.5.peg.2042","1161"
"12778",443,267,176,"GGTTATTTCCTTGACCTGCT","CCTTGGTTGGCAGGTGCAGC","561307.5.peg.2042","1161"
"12779",417,267,150,"GCCGGTGTTGCTTGATTTCC","CCTTGGTTGGCAGGTGCAGC","561307.5.peg.2042","1161"
"12780",1206,267,939,"CTTTATTGTTAGTTGCTTT","CCTTGGTTGGCAGGTGCAGC","561307.5.peg.2042","1161"
"12781",576,267,309,"TCACCAGTATTGCTAGCATT","CCTTGGTTGGCAGGTGCAGC","561307.5.peg.2042","1161"
"12782",1038,267,771,"TCTAAACGATCAGCATCAGT","CCTTGGTTGGCAGGTGCAGC","561307.5.peg.2042","1161"
"12783",510,267,243,"GCTGCTGCTGGAGCATTCGC","CCTTGGTTGGCAGGTGCAGC","561307.5.peg.2042","1161"
"12784",1074,267,807,"TCAGCAACTGCTGTATTGTC","CCTTGGTTGGCAGGTGCAGC","561307.5.peg.2042","1161"
"12785",393,267,126,"TGTGCTTGTGCAGCGTTATT","CCTTGGTTGGCAGGTGCAGC","561307.5.peg.2042","1161"
"12786",1314,267,1047,"TTAACGTAAGTTACACCTTG","CCTTGGTTGGCAGGTGCAGC","561307.5.peg.2042","1161"
"12787",146,267,121,"CTGCTGCAGACGCTGTTGTC","CCTTGGTTGGCAGGTGCAGC","561307.5.peg.2042","1161"
"12788",522,267,255,"GCTGCTGGTTGCGCTGCTGC","CCTTGGTTGGCAGGTGCAGC","561307.5.peg.2042","1161"
"12789",1358,267,1091,"TACTGTCTTCATTACCATTA","CCTTGGTTGGCAGGTGCAGC","561307.5.peg.2042","1161"
"12790",35,267,232,"AATTCATTAAGTCATCCTCC","CCTTGGTTGGCAGGTGCAGC","561307.5.peg.2042","1161"
"12791",2126,267,1859,"GTTTACGAGTTGTAACTGCT","CCTTGGTTGGCAGGTGCAGC","561307.5.peg.2042","1161"
"12792",2316,267,2049,"GCTGCTTTAGCTGTTGTAGC","CCTTGGTTGGCAGGTGCAGC","561307.5.peg.2042","1161"
"12793",546,267,279,"GTTTGTGCGTTTGCTGCTAC","CCTTGGTTGGCAGGTGCAGC","561307.5.peg.2042","1161"
"12794",1442,267,1175,"CACGTGCCGTTGTCACACCT","CCTTGGTTGGCAGGTGCAGC","561307.5.peg.2042","1161"
"12795",12,267,255,"AACAGCGAGAATAATCAACC","CCTTGGTTGGCAGGTGCAGC","561307.5.peg.2042","1161"
"12796",3013,267,2746,"TGCATCCGATTTCTTAGTTG","CCTTGGTTGGCAGGTGCAGC","561307.5.peg.2042","1161"
"12797",1617,267,1350,"TCTGCAGTTAGTGTAACTTC","CCTTGGTTGGCAGGTGCAGC","561307.5.peg.2042","1161"
"12798",3391,267,3124,"TGTATGTGCTGCATCTATTG","CCTTGGTTGGCAGGTGCAGC","561307.5.peg.2042","1161"
"12799",9,267,258,"AGCGAGAATAATCAACCAGG","CCTTGGTTGGCAGGTGCAGC","561307.5.peg.2042","1161"
"12800",2126,276,1850,"GTTTACGAGTTGTAACTGCT","GCTGGTTGTCCTTGGTTGGC","561307.5.peg.2042","1161"
"12801",1206,276,930,"CTTTATTGTTAGTTGCTTT","GCTGGTTGTCCTTGGTTGGC","561307.5.peg.2042","1161"
"12802",12,276,264,"AACAGCGAGAATAATCAACC","GCTGGTTGTCCTTGGTTGGC","561307.5.peg.2042","1161"
"12803",1038,276,762,"TCTAAACGATCAGCATCAGT","GCTGGTTGTCCTTGGTTGGC","561307.5.peg.2042","1161"
"12804",2316,276,2040,"GCTGCTTTAGCTGTTGTAGC","GCTGGTTGTCCTTGGTTGGC","561307.5.peg.2042","1161"
"12805",1358,276,1082,"TACTGTCTTCATTACCATTA","GCTGGTTGTCCTTGGTTGGC","561307.5.peg.2042","1161"
"12806",146,276,130,"CTGCTGCAGACGCTGTTGTC","GCTGGTTGTCCTTGGTTGGC","561307.5.peg.2042","1161"
"12807",435,276,159,"CCTTGACCTGCTTGGTTTGC","GCTGGTTGTCCTTGGTTGGC","561307.5.peg.2042","1161"
"12808",443,276,167,"GGTTATTTCCTTGACCTGCT","GCTGGTTGTCCTTGGTTGGC","561307.5.peg.2042","1161"
"12809",393,276,117,"TGTGCTTGTGCAGCGTTATT","GCTGGTTGTCCTTGGTTGGC","561307.5.peg.2042","1161"
"12810",35,276,241,"AATTCATTAAGTCATCCTCC","GCTGGTTGTCCTTGGTTGGC","561307.5.peg.2042","1161"
"12811",1617,276,1341,"TCTGCAGTTAGTGTAACTTC","GCTGGTTGTCCTTGGTTGGC","561307.5.peg.2042","1161"
"12812",546,276,270,"GTTTGTGCGTTTGCTGCTAC","GCTGGTTGTCCTTGGTTGGC","561307.5.peg.2042","1161"
"12813",510,276,234,"GCTGCTGCTGGAGCATTCGC","GCTGGTTGTCCTTGGTTGGC","561307.5.peg.2042","1161"
"12814",576,276,300,"TCACCAGTATTGCTAGCATT","GCTGGTTGTCCTTGGTTGGC","561307.5.peg.2042","1161"
"12815",1442,276,1166,"CACGTGCCGTTGTCACACCT","GCTGGTTGTCCTTGGTTGGC","561307.5.peg.2042","1161"
"12816",3013,276,2737,"TGCATCCGATTTCTTAGTTG","GCTGGTTGTCCTTGGTTGGC","561307.5.peg.2042","1161"
"12817",417,276,141,"GCCGGTGTTGCTTGATTTCC","GCTGGTTGTCCTTGGTTGGC","561307.5.peg.2042","1161"
"12818",522,276,246,"GCTGCTGGTTGCGCTGCTGC","GCTGGTTGTCCTTGGTTGGC","561307.5.peg.2042","1161"
"12819",3391,276,3115,"TGTATGTGCTGCATCTATTG","GCTGGTTGTCCTTGGTTGGC","561307.5.peg.2042","1161"
"12820",2796,276,2520,"TCTACTTCCGTATCAGCTGC","GCTGGTTGTCCTTGGTTGGC","561307.5.peg.2042","1161"
"12821",9,276,267,"AGCGAGAATAATCAACCAGG","GCTGGTTGTCCTTGGTTGGC","561307.5.peg.2042","1161"
"12822",1074,276,798,"TCAGCAACTGCTGTATTGTC","GCTGGTTGTCCTTGGTTGGC","561307.5.peg.2042","1161"
"12823",1314,276,1038,"TTAACGTAAGTTACACCTTG","GCTGGTTGTCCTTGGTTGGC","561307.5.peg.2042","1161"
"12824",637,276,361,"CTATTCTCATCTGTTGATA","GCTGGTTGTCCTTGGTTGGC","561307.5.peg.2042","1161"
"12825",537,276,261,"TTTGCTGCTACAGGTGCTGC","GCTGGTTGTCCTTGGTTGGC","561307.5.peg.2042","1161"
"12826",443,280,163,"GGTTATTTCCTTGACCTGCT","TACTGCTGGTTGTCCTTGGT","561307.5.peg.2042","1161"
"12827",510,280,230,"GCTGCTGCTGGAGCATTCGC","TACTGCTGGTTGTCCTTGGT","561307.5.peg.2042","1161"
"12828",417,280,137,"GCCGGTGTTGCTTGATTTCC","TACTGCTGGTTGTCCTTGGT","561307.5.peg.2042","1161"
"12829",3013,280,2733,"TGCATCCGATTTCTTAGTTG","TACTGCTGGTTGTCCTTGGT","561307.5.peg.2042","1161"
"12830",1358,280,1078,"TACTGTCTTCATTACCATTA","TACTGCTGGTTGTCCTTGGT","561307.5.peg.2042","1161"
"12831",12,280,268,"AACAGCGAGAATAATCAACC","TACTGCTGGTTGTCCTTGGT","561307.5.peg.2042","1161"
"12832",3391,280,3111,"TGTATGTGCTGCATCTATTG","TACTGCTGGTTGTCCTTGGT","561307.5.peg.2042","1161"
"12833",522,280,242,"GCTGCTGGTTGCGCTGCTGC","TACTGCTGGTTGTCCTTGGT","561307.5.peg.2042","1161"
"12834",9,280,271,"AGCGAGAATAATCAACCAGG","TACTGCTGGTTGTCCTTGGT","561307.5.peg.2042","1161"
"12835",546,280,266,"GTTTGTGCGTTTGCTGCTAC","TACTGCTGGTTGTCCTTGGT","561307.5.peg.2042","1161"
"12836",35,280,245,"AATTCATTAAGTCATCCTCC","TACTGCTGGTTGTCCTTGGT","561307.5.peg.2042","1161"
"12837",637,280,357,"CTATTCTCATCTGTTGATA","TACTGCTGGTTGTCCTTGGT","561307.5.peg.2042","1161"
"12838",1038,280,758,"TCTAAACGATCAGCATCAGT","TACTGCTGGTTGTCCTTGGT","561307.5.peg.2042","1161"
"12839",537,280,257,"TTTGCTGCTACAGGTGCTGC","TACTGCTGGTTGTCCTTGGT","561307.5.peg.2042","1161"
"12840",1442,280,1162,"CACGTGCCGTTGTCACACCT","TACTGCTGGTTGTCCTTGGT","561307.5.peg.2042","1161"
"12841",1074,280,794,"TCAGCAACTGCTGTATTGTC","TACTGCTGGTTGTCCTTGGT","561307.5.peg.2042","1161"
"12842",146,280,134,"CTGCTGCAGACGCTGTTGTC","TACTGCTGGTTGTCCTTGGT","561307.5.peg.2042","1161"
"12843",393,280,113,"TGTGCTTGTGCAGCGTTATT","TACTGCTGGTTGTCCTTGGT","561307.5.peg.2042","1161"
"12844",2796,280,2516,"TCTACTTCCGTATCAGCTGC","TACTGCTGGTTGTCCTTGGT","561307.5.peg.2042","1161"
"12845",2126,280,1846,"GTTTACGAGTTGTAACTGCT","TACTGCTGGTTGTCCTTGGT","561307.5.peg.2042","1161"
"12846",576,280,296,"TCACCAGTATTGCTAGCATT","TACTGCTGGTTGTCCTTGGT","561307.5.peg.2042","1161"
"12847",2316,280,2036,"GCTGCTTTAGCTGTTGTAGC","TACTGCTGGTTGTCCTTGGT","561307.5.peg.2042","1161"
"12848",1206,280,926,"CTTTATTGTTAGTTGCTTT","TACTGCTGGTTGTCCTTGGT","561307.5.peg.2042","1161"
"12849",1617,280,1337,"TCTGCAGTTAGTGTAACTTC","TACTGCTGGTTGTCCTTGGT","561307.5.peg.2042","1161"
"12850",435,280,155,"CCTTGACCTGCTTGGTTTGC","TACTGCTGGTTGTCCTTGGT","561307.5.peg.2042","1161"
"12851",1314,280,1034,"TTAACGTAAGTTACACCTTG","TACTGCTGGTTGTCCTTGGT","561307.5.peg.2042","1161"
"12852",510,284,226,"GCTGCTGCTGGAGCATTCGC","GTTGTACTGCTGGTTGTCCT","561307.5.peg.2042","1161"
"12853",522,284,238,"GCTGCTGGTTGCGCTGCTGC","GTTGTACTGCTGGTTGTCCT","561307.5.peg.2042","1161"
"12854",1038,284,754,"TCTAAACGATCAGCATCAGT","GTTGTACTGCTGGTTGTCCT","561307.5.peg.2042","1161"
"12855",1206,284,922,"CTTTATTGTTAGTTGCTTT","GTTGTACTGCTGGTTGTCCT","561307.5.peg.2042","1161"
"12856",443,284,159,"GGTTATTTCCTTGACCTGCT","GTTGTACTGCTGGTTGTCCT","561307.5.peg.2042","1161"
"12857",393,284,109,"TGTGCTTGTGCAGCGTTATT","GTTGTACTGCTGGTTGTCCT","561307.5.peg.2042","1161"
"12858",12,284,272,"AACAGCGAGAATAATCAACC","GTTGTACTGCTGGTTGTCCT","561307.5.peg.2042","1161"
"12859",1314,284,1030,"TTAACGTAAGTTACACCTTG","GTTGTACTGCTGGTTGTCCT","561307.5.peg.2042","1161"
"12860",1617,284,1333,"TCTGCAGTTAGTGTAACTTC","GTTGTACTGCTGGTTGTCCT","561307.5.peg.2042","1161"
"12861",2796,284,2512,"TCTACTTCCGTATCAGCTGC","GTTGTACTGCTGGTTGTCCT","561307.5.peg.2042","1161"
"12862",435,284,151,"CCTTGACCTGCTTGGTTTGC","GTTGTACTGCTGGTTGTCCT","561307.5.peg.2042","1161"
"12863",3013,284,2729,"TGCATCCGATTTCTTAGTTG","GTTGTACTGCTGGTTGTCCT","561307.5.peg.2042","1161"
"12864",417,284,133,"GCCGGTGTTGCTTGATTTCC","GTTGTACTGCTGGTTGTCCT","561307.5.peg.2042","1161"
"12865",637,284,353,"CTATTCTCATCTGTTGATA","GTTGTACTGCTGGTTGTCCT","561307.5.peg.2042","1161"
"12866",1442,284,1158,"CACGTGCCGTTGTCACACCT","GTTGTACTGCTGGTTGTCCT","561307.5.peg.2042","1161"
"12867",35,284,249,"AATTCATTAAGTCATCCTCC","GTTGTACTGCTGGTTGTCCT","561307.5.peg.2042","1161"
"12868",546,284,262,"GTTTGTGCGTTTGCTGCTAC","GTTGTACTGCTGGTTGTCCT","561307.5.peg.2042","1161"
"12869",1074,284,790,"TCAGCAACTGCTGTATTGTC","GTTGTACTGCTGGTTGTCCT","561307.5.peg.2042","1161"
"12870",146,284,138,"CTGCTGCAGACGCTGTTGTC","GTTGTACTGCTGGTTGTCCT","561307.5.peg.2042","1161"
"12871",2316,284,2032,"GCTGCTTTAGCTGTTGTAGC","GTTGTACTGCTGGTTGTCCT","561307.5.peg.2042","1161"
"12872",3391,284,3107,"TGTATGTGCTGCATCTATTG","GTTGTACTGCTGGTTGTCCT","561307.5.peg.2042","1161"
"12873",576,284,292,"TCACCAGTATTGCTAGCATT","GTTGTACTGCTGGTTGTCCT","561307.5.peg.2042","1161"
"12874",9,284,275,"AGCGAGAATAATCAACCAGG","GTTGTACTGCTGGTTGTCCT","561307.5.peg.2042","1161"
"12875",537,284,253,"TTTGCTGCTACAGGTGCTGC","GTTGTACTGCTGGTTGTCCT","561307.5.peg.2042","1161"
"12876",1358,284,1074,"TACTGTCTTCATTACCATTA","GTTGTACTGCTGGTTGTCCT","561307.5.peg.2042","1161"
"12877",2126,284,1842,"GTTTACGAGTTGTAACTGCT","GTTGTACTGCTGGTTGTCCT","561307.5.peg.2042","1161"
"12878",1358,294,1064,"TACTGTCTTCATTACCATTA","TGGTTTGCTGGTTGTACTGC","561307.5.peg.2042","1161"
"12879",9,294,285,"AGCGAGAATAATCAACCAGG","TGGTTTGCTGGTTGTACTGC","561307.5.peg.2042","1161"
"12880",2126,294,1832,"GTTTACGAGTTGTAACTGCT","TGGTTTGCTGGTTGTACTGC","561307.5.peg.2042","1161"
"12881",3391,294,3097,"TGTATGTGCTGCATCTATTG","TGGTTTGCTGGTTGTACTGC","561307.5.peg.2042","1161"
"12882",146,294,148,"CTGCTGCAGACGCTGTTGTC","TGGTTTGCTGGTTGTACTGC","561307.5.peg.2042","1161"
"12883",2316,294,2022,"GCTGCTTTAGCTGTTGTAGC","TGGTTTGCTGGTTGTACTGC","561307.5.peg.2042","1161"
"12884",443,294,149,"GGTTATTTCCTTGACCTGCT","TGGTTTGCTGGTTGTACTGC","561307.5.peg.2042","1161"
"12885",576,294,282,"TCACCAGTATTGCTAGCATT","TGGTTTGCTGGTTGTACTGC","561307.5.peg.2042","1161"
"12886",1206,294,912,"CTTTATTGTTAGTTGCTTT","TGGTTTGCTGGTTGTACTGC","561307.5.peg.2042","1161"
"12887",2796,294,2502,"TCTACTTCCGTATCAGCTGC","TGGTTTGCTGGTTGTACTGC","561307.5.peg.2042","1161"
"12888",1617,294,1323,"TCTGCAGTTAGTGTAACTTC","TGGTTTGCTGGTTGTACTGC","561307.5.peg.2042","1161"
"12889",3013,294,2719,"TGCATCCGATTTCTTAGTTG","TGGTTTGCTGGTTGTACTGC","561307.5.peg.2042","1161"
"12890",537,294,243,"TTTGCTGCTACAGGTGCTGC","TGGTTTGCTGGTTGTACTGC","561307.5.peg.2042","1161"
"12891",417,294,123,"GCCGGTGTTGCTTGATTTCC","TGGTTTGCTGGTTGTACTGC","561307.5.peg.2042","1161"
"12892",35,294,259,"AATTCATTAAGTCATCCTCC","TGGTTTGCTGGTTGTACTGC","561307.5.peg.2042","1161"
"12893",522,294,228,"GCTGCTGGTTGCGCTGCTGC","TGGTTTGCTGGTTGTACTGC","561307.5.peg.2042","1161"
"12894",1314,294,1020,"TTAACGTAAGTTACACCTTG","TGGTTTGCTGGTTGTACTGC","561307.5.peg.2042","1161"
"12895",1038,294,744,"TCTAAACGATCAGCATCAGT","TGGTTTGCTGGTTGTACTGC","561307.5.peg.2042","1161"
"12896",637,294,343,"CTATTCTCATCTGTTGATA","TGGTTTGCTGGTTGTACTGC","561307.5.peg.2042","1161"
"12897",12,294,282,"AACAGCGAGAATAATCAACC","TGGTTTGCTGGTTGTACTGC","561307.5.peg.2042","1161"
"12898",510,294,216,"GCTGCTGCTGGAGCATTCGC","TGGTTTGCTGGTTGTACTGC","561307.5.peg.2042","1161"
"12899",546,294,252,"GTTTGTGCGTTTGCTGCTAC","TGGTTTGCTGGTTGTACTGC","561307.5.peg.2042","1161"
"12900",435,294,141,"CCTTGACCTGCTTGGTTTGC","TGGTTTGCTGGTTGTACTGC","561307.5.peg.2042","1161"
"12901",1074,294,780,"TCAGCAACTGCTGTATTGTC","TGGTTTGCTGGTTGTACTGC","561307.5.peg.2042","1161"
"12902",1442,294,1148,"CACGTGCCGTTGTCACACCT","TGGTTTGCTGGTTGTACTGC","561307.5.peg.2042","1161"
"12903",522,306,216,"GCTGCTGGTTGCGCTGCTGC","GCCTGTCCACCTTGGTTTGC","561307.5.peg.2042","1161"
"12904",3013,306,2707,"TGCATCCGATTTCTTAGTTG","GCCTGTCCACCTTGGTTTGC","561307.5.peg.2042","1161"
"12905",435,306,129,"CCTTGACCTGCTTGGTTTGC","GCCTGTCCACCTTGGTTTGC","561307.5.peg.2042","1161"
"12906",1038,306,732,"TCTAAACGATCAGCATCAGT","GCCTGTCCACCTTGGTTTGC","561307.5.peg.2042","1161"
"12907",546,306,240,"GTTTGTGCGTTTGCTGCTAC","GCCTGTCCACCTTGGTTTGC","561307.5.peg.2042","1161"
"12908",537,306,231,"TTTGCTGCTACAGGTGCTGC","GCCTGTCCACCTTGGTTTGC","561307.5.peg.2042","1161"
"12909",12,306,294,"AACAGCGAGAATAATCAACC","GCCTGTCCACCTTGGTTTGC","561307.5.peg.2042","1161"
"12910",1442,306,1136,"CACGTGCCGTTGTCACACCT","GCCTGTCCACCTTGGTTTGC","561307.5.peg.2042","1161"
"12911",1206,306,900,"CTTTATTGTTAGTTGCTTT","GCCTGTCCACCTTGGTTTGC","561307.5.peg.2042","1161"
"12912",1358,306,1052,"TACTGTCTTCATTACCATTA","GCCTGTCCACCTTGGTTTGC","561307.5.peg.2042","1161"
"12913",9,306,297,"AGCGAGAATAATCAACCAGG","GCCTGTCCACCTTGGTTTGC","561307.5.peg.2042","1161"
"12914",1074,306,768,"TCAGCAACTGCTGTATTGTC","GCCTGTCCACCTTGGTTTGC","561307.5.peg.2042","1161"
"12915",637,306,331,"CTATTCTCATCTGTTGATA","GCCTGTCCACCTTGGTTTGC","561307.5.peg.2042","1161"
"12916",204,306,102,"GGCTGTGTATTGGCATCAGC","GCCTGTCCACCTTGGTTTGC","561307.5.peg.2042","1161"
"12917",3391,306,3085,"TGTATGTGCTGCATCTATTG","GCCTGTCCACCTTGGTTTGC","561307.5.peg.2042","1161"
"12918",2316,306,2010,"GCTGCTTTAGCTGTTGTAGC","GCCTGTCCACCTTGGTTTGC","561307.5.peg.2042","1161"
"12919",2126,306,1820,"GTTTACGAGTTGTAACTGCT","GCCTGTCCACCTTGGTTTGC","561307.5.peg.2042","1161"
"12920",1314,306,1008,"TTAACGTAAGTTACACCTTG","GCCTGTCCACCTTGGTTTGC","561307.5.peg.2042","1161"
"12921",1617,306,1311,"TCTGCAGTTAGTGTAACTTC","GCCTGTCCACCTTGGTTTGC","561307.5.peg.2042","1161"
"12922",510,306,204,"GCTGCTGCTGGAGCATTCGC","GCCTGTCCACCTTGGTTTGC","561307.5.peg.2042","1161"
"12923",443,306,137,"GGTTATTTCCTTGACCTGCT","GCCTGTCCACCTTGGTTTGC","561307.5.peg.2042","1161"
"12924",2796,306,2490,"TCTACTTCCGTATCAGCTGC","GCCTGTCCACCTTGGTTTGC","561307.5.peg.2042","1161"
"12925",146,306,160,"CTGCTGCAGACGCTGTTGTC","GCCTGTCCACCTTGGTTTGC","561307.5.peg.2042","1161"
"12926",195,306,111,"TTGGCATCAGCTGGTTGTGC","GCCTGTCCACCTTGGTTTGC","561307.5.peg.2042","1161"
"12927",576,306,270,"TCACCAGTATTGCTAGCATT","GCCTGTCCACCTTGGTTTGC","561307.5.peg.2042","1161"
"12928",417,306,111,"GCCGGTGTTGCTTGATTTCC","GCCTGTCCACCTTGGTTTGC","561307.5.peg.2042","1161"
"12929",35,306,271,"AATTCATTAAGTCATCCTCC","GCCTGTCCACCTTGGTTTGC","561307.5.peg.2042","1161"
"12930",1442,314,1128,"CACGTGCCGTTGTCACACCT","CTGGATTAGCCTGTCCACCT","561307.5.peg.2042","1161"
"12931",214,314,100,"ATTTGCGTTAGGCTGTGTAT","CTGGATTAGCCTGTCCACCT","561307.5.peg.2042","1161"
"12932",35,314,279,"AATTCATTAAGTCATCCTCC","CTGGATTAGCCTGTCCACCT","561307.5.peg.2042","1161"
"12933",576,314,262,"TCACCAGTATTGCTAGCATT","CTGGATTAGCCTGTCCACCT","561307.5.peg.2042","1161"
"12934",2126,314,1812,"GTTTACGAGTTGTAACTGCT","CTGGATTAGCCTGTCCACCT","561307.5.peg.2042","1161"
"12935",146,314,168,"CTGCTGCAGACGCTGTTGTC","CTGGATTAGCCTGTCCACCT","561307.5.peg.2042","1161"
"12936",2316,314,2002,"GCTGCTTTAGCTGTTGTAGC","CTGGATTAGCCTGTCCACCT","561307.5.peg.2042","1161"
"12937",637,314,323,"CTATTCTCATCTGTTGATA","CTGGATTAGCCTGTCCACCT","561307.5.peg.2042","1161"
"12938",522,314,208,"GCTGCTGGTTGCGCTGCTGC","CTGGATTAGCCTGTCCACCT","561307.5.peg.2042","1161"
"12939",3013,314,2699,"TGCATCCGATTTCTTAGTTG","CTGGATTAGCCTGTCCACCT","561307.5.peg.2042","1161"
"12940",1314,314,1000,"TTAACGTAAGTTACACCTTG","CTGGATTAGCCTGTCCACCT","561307.5.peg.2042","1161"
"12941",537,314,223,"TTTGCTGCTACAGGTGCTGC","CTGGATTAGCCTGTCCACCT","561307.5.peg.2042","1161"
"12942",443,314,129,"GGTTATTTCCTTGACCTGCT","CTGGATTAGCCTGTCCACCT","561307.5.peg.2042","1161"
"12943",3391,314,3077,"TGTATGTGCTGCATCTATTG","CTGGATTAGCCTGTCCACCT","561307.5.peg.2042","1161"
"12944",1617,314,1303,"TCTGCAGTTAGTGTAACTTC","CTGGATTAGCCTGTCCACCT","561307.5.peg.2042","1161"
"12945",417,314,103,"GCCGGTGTTGCTTGATTTCC","CTGGATTAGCCTGTCCACCT","561307.5.peg.2042","1161"
"12946",1206,314,892,"CTTTATTGTTAGTTGCTTT","CTGGATTAGCCTGTCCACCT","561307.5.peg.2042","1161"
"12947",2796,314,2482,"TCTACTTCCGTATCAGCTGC","CTGGATTAGCCTGTCCACCT","561307.5.peg.2042","1161"
"12948",510,314,196,"GCTGCTGCTGGAGCATTCGC","CTGGATTAGCCTGTCCACCT","561307.5.peg.2042","1161"
"12949",546,314,232,"GTTTGTGCGTTTGCTGCTAC","CTGGATTAGCCTGTCCACCT","561307.5.peg.2042","1161"
"12950",12,314,302,"AACAGCGAGAATAATCAACC","CTGGATTAGCCTGTCCACCT","561307.5.peg.2042","1161"
"12951",1358,314,1044,"TACTGTCTTCATTACCATTA","CTGGATTAGCCTGTCCACCT","561307.5.peg.2042","1161"
"12952",204,314,110,"GGCTGTGTATTGGCATCAGC","CTGGATTAGCCTGTCCACCT","561307.5.peg.2042","1161"
"12953",435,314,121,"CCTTGACCTGCTTGGTTTGC","CTGGATTAGCCTGTCCACCT","561307.5.peg.2042","1161"
"12954",195,314,119,"TTGGCATCAGCTGGTTGTGC","CTGGATTAGCCTGTCCACCT","561307.5.peg.2042","1161"
"12955",1074,314,760,"TCAGCAACTGCTGTATTGTC","CTGGATTAGCCTGTCCACCT","561307.5.peg.2042","1161"
"12956",9,314,305,"AGCGAGAATAATCAACCAGG","CTGGATTAGCCTGTCCACCT","561307.5.peg.2042","1161"
"12957",1038,314,724,"TCTAAACGATCAGCATCAGT","CTGGATTAGCCTGTCCACCT","561307.5.peg.2042","1161"
"12958",204,333,129,"GGCTGTGTATTGGCATCAGC","GGTTGTGCTGCTCCTCCTGC","561307.5.peg.2042","1161"
"12959",3013,333,2680,"TGCATCCGATTTCTTAGTTG","GGTTGTGCTGCTCCTCCTGC","561307.5.peg.2042","1161"
"12960",146,333,187,"CTGCTGCAGACGCTGTTGTC","GGTTGTGCTGCTCCTCCTGC","561307.5.peg.2042","1161"
"12961",2126,333,1793,"GTTTACGAGTTGTAACTGCT","GGTTGTGCTGCTCCTCCTGC","561307.5.peg.2042","1161"
"12962",637,333,304,"CTATTCTCATCTGTTGATA","GGTTGTGCTGCTCCTCCTGC","561307.5.peg.2042","1161"
"12963",1206,333,873,"CTTTATTGTTAGTTGCTTT","GGTTGTGCTGCTCCTCCTGC","561307.5.peg.2042","1161"
"12964",35,333,298,"AATTCATTAAGTCATCCTCC","GGTTGTGCTGCTCCTCCTGC","561307.5.peg.2042","1161"
"12965",214,333,119,"ATTTGCGTTAGGCTGTGTAT","GGTTGTGCTGCTCCTCCTGC","561307.5.peg.2042","1161"
"12966",1314,333,981,"TTAACGTAAGTTACACCTTG","GGTTGTGCTGCTCCTCCTGC","561307.5.peg.2042","1161"
"12967",3391,333,3058,"TGTATGTGCTGCATCTATTG","GGTTGTGCTGCTCCTCCTGC","561307.5.peg.2042","1161"
"12968",2796,333,2463,"TCTACTTCCGTATCAGCTGC","GGTTGTGCTGCTCCTCCTGC","561307.5.peg.2042","1161"
"12969",537,333,204,"TTTGCTGCTACAGGTGCTGC","GGTTGTGCTGCTCCTCCTGC","561307.5.peg.2042","1161"
"12970",443,333,110,"GGTTATTTCCTTGACCTGCT","GGTTGTGCTGCTCCTCCTGC","561307.5.peg.2042","1161"
"12971",1617,333,1284,"TCTGCAGTTAGTGTAACTTC","GGTTGTGCTGCTCCTCCTGC","561307.5.peg.2042","1161"
"12972",225,333,108,"TGAGCACCAGCATTTGCGTT","GGTTGTGCTGCTCCTCCTGC","561307.5.peg.2042","1161"
"12973",9,333,324,"AGCGAGAATAATCAACCAGG","GGTTGTGCTGCTCCTCCTGC","561307.5.peg.2042","1161"
"12974",1358,333,1025,"TACTGTCTTCATTACCATTA","GGTTGTGCTGCTCCTCCTGC","561307.5.peg.2042","1161"
"12975",522,333,189,"GCTGCTGGTTGCGCTGCTGC","GGTTGTGCTGCTCCTCCTGC","561307.5.peg.2042","1161"
"12976",435,333,102,"CCTTGACCTGCTTGGTTTGC","GGTTGTGCTGCTCCTCCTGC","561307.5.peg.2042","1161"
"12977",510,333,177,"GCTGCTGCTGGAGCATTCGC","GGTTGTGCTGCTCCTCCTGC","561307.5.peg.2042","1161"
"12978",1038,333,705,"TCTAAACGATCAGCATCAGT","GGTTGTGCTGCTCCTCCTGC","561307.5.peg.2042","1161"
"12979",1074,333,741,"TCAGCAACTGCTGTATTGTC","GGTTGTGCTGCTCCTCCTGC","561307.5.peg.2042","1161"
"12980",2316,333,1983,"GCTGCTTTAGCTGTTGTAGC","GGTTGTGCTGCTCCTCCTGC","561307.5.peg.2042","1161"
"12981",12,333,321,"AACAGCGAGAATAATCAACC","GGTTGTGCTGCTCCTCCTGC","561307.5.peg.2042","1161"
"12982",546,333,213,"GTTTGTGCGTTTGCTGCTAC","GGTTGTGCTGCTCCTCCTGC","561307.5.peg.2042","1161"
"12983",1442,333,1109,"CACGTGCCGTTGTCACACCT","GGTTGTGCTGCTCCTCCTGC","561307.5.peg.2042","1161"
"12984",576,333,243,"TCACCAGTATTGCTAGCATT","GGTTGTGCTGCTCCTCCTGC","561307.5.peg.2042","1161"
"12985",195,333,138,"TTGGCATCAGCTGGTTGTGC","GGTTGTGCTGCTCCTCCTGC","561307.5.peg.2042","1161"
"12986",2126,354,1772,"GTTTACGAGTTGTAACTGCT","TGTCCAGCTGGTTGTGTATT","561307.5.peg.2042","1161"
"12987",146,354,208,"CTGCTGCAGACGCTGTTGTC","TGTCCAGCTGGTTGTGTATT","561307.5.peg.2042","1161"
"12988",195,354,159,"TTGGCATCAGCTGGTTGTGC","TGTCCAGCTGGTTGTGTATT","561307.5.peg.2042","1161"
"12989",9,354,345,"AGCGAGAATAATCAACCAGG","TGTCCAGCTGGTTGTGTATT","561307.5.peg.2042","1161"
"12990",2796,354,2442,"TCTACTTCCGTATCAGCTGC","TGTCCAGCTGGTTGTGTATT","561307.5.peg.2042","1161"
"12991",510,354,156,"GCTGCTGCTGGAGCATTCGC","TGTCCAGCTGGTTGTGTATT","561307.5.peg.2042","1161"
"12992",1617,354,1263,"TCTGCAGTTAGTGTAACTTC","TGTCCAGCTGGTTGTGTATT","561307.5.peg.2042","1161"
"12993",204,354,150,"GGCTGTGTATTGGCATCAGC","TGTCCAGCTGGTTGTGTATT","561307.5.peg.2042","1161"
"12994",3391,354,3037,"TGTATGTGCTGCATCTATTG","TGTCCAGCTGGTTGTGTATT","561307.5.peg.2042","1161"
"12995",537,354,183,"TTTGCTGCTACAGGTGCTGC","TGTCCAGCTGGTTGTGTATT","561307.5.peg.2042","1161"
"12996",12,354,342,"AACAGCGAGAATAATCAACC","TGTCCAGCTGGTTGTGTATT","561307.5.peg.2042","1161"
"12997",1314,354,960,"TTAACGTAAGTTACACCTTG","TGTCCAGCTGGTTGTGTATT","561307.5.peg.2042","1161"
"12998",3013,354,2659,"TGCATCCGATTTCTTAGTTG","TGTCCAGCTGGTTGTGTATT","561307.5.peg.2042","1161"
"12999",2316,354,1962,"GCTGCTTTAGCTGTTGTAGC","TGTCCAGCTGGTTGTGTATT","561307.5.peg.2042","1161"
"13000",637,354,283,"CTATTCTCATCTGTTGATA","TGTCCAGCTGGTTGTGTATT","561307.5.peg.2042","1161"
"13001",1442,354,1088,"CACGTGCCGTTGTCACACCT","TGTCCAGCTGGTTGTGTATT","561307.5.peg.2042","1161"
"13002",1206,354,852,"CTTTATTGTTAGTTGCTTT","TGTCCAGCTGGTTGTGTATT","561307.5.peg.2042","1161"
"13003",1358,354,1004,"TACTGTCTTCATTACCATTA","TGTCCAGCTGGTTGTGTATT","561307.5.peg.2042","1161"
"13004",1074,354,720,"TCAGCAACTGCTGTATTGTC","TGTCCAGCTGGTTGTGTATT","561307.5.peg.2042","1161"
"13005",522,354,168,"GCTGCTGGTTGCGCTGCTGC","TGTCCAGCTGGTTGTGTATT","561307.5.peg.2042","1161"
"13006",214,354,140,"ATTTGCGTTAGGCTGTGTAT","TGTCCAGCTGGTTGTGTATT","561307.5.peg.2042","1161"
"13007",225,354,129,"TGAGCACCAGCATTTGCGTT","TGTCCAGCTGGTTGTGTATT","561307.5.peg.2042","1161"
"13008",35,354,319,"AATTCATTAAGTCATCCTCC","TGTCCAGCTGGTTGTGTATT","561307.5.peg.2042","1161"
"13009",576,354,222,"TCACCAGTATTGCTAGCATT","TGTCCAGCTGGTTGTGTATT","561307.5.peg.2042","1161"
"13010",546,354,192,"GTTTGTGCGTTTGCTGCTAC","TGTCCAGCTGGTTGTGTATT","561307.5.peg.2042","1161"
"13011",1038,354,684,"TCTAAACGATCAGCATCAGT","TGTCCAGCTGGTTGTGTATT","561307.5.peg.2042","1161"
"13012",1038,393,645,"TCTAAACGATCAGCATCAGT","TGTGCTTGTGCAGCGTTATT","561307.5.peg.2042","1161"
"13013",576,393,183,"TCACCAGTATTGCTAGCATT","TGTGCTTGTGCAGCGTTATT","561307.5.peg.2042","1161"
"13014",546,393,153,"GTTTGTGCGTTTGCTGCTAC","TGTGCTTGTGCAGCGTTATT","561307.5.peg.2042","1161"
"13015",276,393,117,"GCTGGTTGTCCTTGGTTGGC","TGTGCTTGTGCAGCGTTATT","561307.5.peg.2042","1161"
"13016",225,393,168,"TGAGCACCAGCATTTGCGTT","TGTGCTTGTGCAGCGTTATT","561307.5.peg.2042","1161"
"13017",522,393,129,"GCTGCTGGTTGCGCTGCTGC","TGTGCTTGTGCAGCGTTATT","561307.5.peg.2042","1161"
"13018",637,393,244,"CTATTCTCATCTGTTGATA","TGTGCTTGTGCAGCGTTATT","561307.5.peg.2042","1161"
"13019",3013,393,2620,"TGCATCCGATTTCTTAGTTG","TGTGCTTGTGCAGCGTTATT","561307.5.peg.2042","1161"
"13020",9,393,384,"AGCGAGAATAATCAACCAGG","TGTGCTTGTGCAGCGTTATT","561307.5.peg.2042","1161"
"13021",1206,393,813,"CTTTATTGTTAGTTGCTTT","TGTGCTTGTGCAGCGTTATT","561307.5.peg.2042","1161"
"13022",204,393,189,"GGCTGTGTATTGGCATCAGC","TGTGCTTGTGCAGCGTTATT","561307.5.peg.2042","1161"
"13023",280,393,113,"TACTGCTGGTTGTCCTTGGT","TGTGCTTGTGCAGCGTTATT","561307.5.peg.2042","1161"
"13024",3391,393,2998,"TGTATGTGCTGCATCTATTG","TGTGCTTGTGCAGCGTTATT","561307.5.peg.2042","1161"
"13025",12,393,381,"AACAGCGAGAATAATCAACC","TGTGCTTGTGCAGCGTTATT","561307.5.peg.2042","1161"
"13026",2796,393,2403,"TCTACTTCCGTATCAGCTGC","TGTGCTTGTGCAGCGTTATT","561307.5.peg.2042","1161"
"13027",195,393,198,"TTGGCATCAGCTGGTTGTGC","TGTGCTTGTGCAGCGTTATT","561307.5.peg.2042","1161"
"13028",255,393,138,"GGTGCAGCTGGCTGTGCTGT","TGTGCTTGTGCAGCGTTATT","561307.5.peg.2042","1161"
"13029",1074,393,681,"TCAGCAACTGCTGTATTGTC","TGTGCTTGTGCAGCGTTATT","561307.5.peg.2042","1161"
"13030",1442,393,1049,"CACGTGCCGTTGTCACACCT","TGTGCTTGTGCAGCGTTATT","561307.5.peg.2042","1161"
"13031",510,393,117,"GCTGCTGCTGGAGCATTCGC","TGTGCTTGTGCAGCGTTATT","561307.5.peg.2042","1161"
"13032",214,393,179,"ATTTGCGTTAGGCTGTGTAT","TGTGCTTGTGCAGCGTTATT","561307.5.peg.2042","1161"
"13033",1358,393,965,"TACTGTCTTCATTACCATTA","TGTGCTTGTGCAGCGTTATT","561307.5.peg.2042","1161"
"13034",1617,393,1224,"TCTGCAGTTAGTGTAACTTC","TGTGCTTGTGCAGCGTTATT","561307.5.peg.2042","1161"
"13035",2126,393,1733,"GTTTACGAGTTGTAACTGCT","TGTGCTTGTGCAGCGTTATT","561307.5.peg.2042","1161"
"13036",2316,393,1923,"GCTGCTTTAGCTGTTGTAGC","TGTGCTTGTGCAGCGTTATT","561307.5.peg.2042","1161"
"13037",146,393,247,"CTGCTGCAGACGCTGTTGTC","TGTGCTTGTGCAGCGTTATT","561307.5.peg.2042","1161"
"13038",284,393,109,"GTTGTACTGCTGGTTGTCCT","TGTGCTTGTGCAGCGTTATT","561307.5.peg.2042","1161"
"13039",537,393,144,"TTTGCTGCTACAGGTGCTGC","TGTGCTTGTGCAGCGTTATT","561307.5.peg.2042","1161"
"13040",35,393,358,"AATTCATTAAGTCATCCTCC","TGTGCTTGTGCAGCGTTATT","561307.5.peg.2042","1161"
"13041",1314,393,921,"TTAACGTAAGTTACACCTTG","TGTGCTTGTGCAGCGTTATT","561307.5.peg.2042","1161"
"13042",267,393,126,"CCTTGGTTGGCAGGTGCAGC","TGTGCTTGTGCAGCGTTATT","561307.5.peg.2042","1161"
"13043",204,417,213,"GGCTGTGTATTGGCATCAGC","GCCGGTGTTGCTTGATTTCC","561307.5.peg.2042","1161"
"13044",522,417,105,"GCTGCTGGTTGCGCTGCTGC","GCCGGTGTTGCTTGATTTCC","561307.5.peg.2042","1161"
"13045",1314,417,897,"TTAACGTAAGTTACACCTTG","GCCGGTGTTGCTTGATTTCC","561307.5.peg.2042","1161"
"13046",214,417,203,"ATTTGCGTTAGGCTGTGTAT","GCCGGTGTTGCTTGATTTCC","561307.5.peg.2042","1161"
"13047",12,417,405,"AACAGCGAGAATAATCAACC","GCCGGTGTTGCTTGATTTCC","561307.5.peg.2042","1161"
"13048",306,417,111,"GCCTGTCCACCTTGGTTTGC","GCCGGTGTTGCTTGATTTCC","561307.5.peg.2042","1161"
"13049",1074,417,657,"TCAGCAACTGCTGTATTGTC","GCCGGTGTTGCTTGATTTCC","561307.5.peg.2042","1161"
"13050",637,417,220,"CTATTCTCATCTGTTGATA","GCCGGTGTTGCTTGATTTCC","561307.5.peg.2042","1161"
"13051",276,417,141,"GCTGGTTGTCCTTGGTTGGC","GCCGGTGTTGCTTGATTTCC","561307.5.peg.2042","1161"
"13052",576,417,159,"TCACCAGTATTGCTAGCATT","GCCGGTGTTGCTTGATTTCC","561307.5.peg.2042","1161"
"13053",546,417,129,"GTTTGTGCGTTTGCTGCTAC","GCCGGTGTTGCTTGATTTCC","561307.5.peg.2042","1161"
"13054",195,417,222,"TTGGCATCAGCTGGTTGTGC","GCCGGTGTTGCTTGATTTCC","561307.5.peg.2042","1161"
"13055",1358,417,941,"TACTGTCTTCATTACCATTA","GCCGGTGTTGCTTGATTTCC","561307.5.peg.2042","1161"
"13056",1617,417,1200,"TCTGCAGTTAGTGTAACTTC","GCCGGTGTTGCTTGATTTCC","561307.5.peg.2042","1161"
"13057",294,417,123,"TGGTTTGCTGGTTGTACTGC","GCCGGTGTTGCTTGATTTCC","561307.5.peg.2042","1161"
"13058",3013,417,2596,"TGCATCCGATTTCTTAGTTG","GCCGGTGTTGCTTGATTTCC","561307.5.peg.2042","1161"
"13059",280,417,137,"TACTGCTGGTTGTCCTTGGT","GCCGGTGTTGCTTGATTTCC","561307.5.peg.2042","1161"
"13060",537,417,120,"TTTGCTGCTACAGGTGCTGC","GCCGGTGTTGCTTGATTTCC","561307.5.peg.2042","1161"
"13061",225,417,192,"TGAGCACCAGCATTTGCGTT","GCCGGTGTTGCTTGATTTCC","561307.5.peg.2042","1161"
"13062",1038,417,621,"TCTAAACGATCAGCATCAGT","GCCGGTGTTGCTTGATTTCC","561307.5.peg.2042","1161"
"13063",314,417,103,"CTGGATTAGCCTGTCCACCT","GCCGGTGTTGCTTGATTTCC","561307.5.peg.2042","1161"
"13064",255,417,162,"GGTGCAGCTGGCTGTGCTGT","GCCGGTGTTGCTTGATTTCC","561307.5.peg.2042","1161"
"13065",1442,417,1025,"CACGTGCCGTTGTCACACCT","GCCGGTGTTGCTTGATTTCC","561307.5.peg.2042","1161"
"13066",146,417,271,"CTGCTGCAGACGCTGTTGTC","GCCGGTGTTGCTTGATTTCC","561307.5.peg.2042","1161"
"13067",2316,417,1899,"GCTGCTTTAGCTGTTGTAGC","GCCGGTGTTGCTTGATTTCC","561307.5.peg.2042","1161"
"13068",3391,417,2974,"TGTATGTGCTGCATCTATTG","GCCGGTGTTGCTTGATTTCC","561307.5.peg.2042","1161"
"13069",35,417,382,"AATTCATTAAGTCATCCTCC","GCCGGTGTTGCTTGATTTCC","561307.5.peg.2042","1161"
"13070",267,417,150,"CCTTGGTTGGCAGGTGCAGC","GCCGGTGTTGCTTGATTTCC","561307.5.peg.2042","1161"
"13071",1206,417,789,"CTTTATTGTTAGTTGCTTT","GCCGGTGTTGCTTGATTTCC","561307.5.peg.2042","1161"
"13072",2796,417,2379,"TCTACTTCCGTATCAGCTGC","GCCGGTGTTGCTTGATTTCC","561307.5.peg.2042","1161"
"13073",9,417,408,"AGCGAGAATAATCAACCAGG","GCCGGTGTTGCTTGATTTCC","561307.5.peg.2042","1161"
"13074",284,417,133,"GTTGTACTGCTGGTTGTCCT","GCCGGTGTTGCTTGATTTCC","561307.5.peg.2042","1161"
"13075",2126,417,1709,"GTTTACGAGTTGTAACTGCT","GCCGGTGTTGCTTGATTTCC","561307.5.peg.2042","1161"
"13076",225,435,210,"TGAGCACCAGCATTTGCGTT","CCTTGACCTGCTTGGTTTGC","561307.5.peg.2042","1161"
"13077",1314,435,879,"TTAACGTAAGTTACACCTTG","CCTTGACCTGCTTGGTTTGC","561307.5.peg.2042","1161"
"13078",3391,435,2956,"TGTATGTGCTGCATCTATTG","CCTTGACCTGCTTGGTTTGC","561307.5.peg.2042","1161"
"13079",306,435,129,"GCCTGTCCACCTTGGTTTGC","CCTTGACCTGCTTGGTTTGC","561307.5.peg.2042","1161"
"13080",204,435,231,"GGCTGTGTATTGGCATCAGC","CCTTGACCTGCTTGGTTTGC","561307.5.peg.2042","1161"
"13081",12,435,423,"AACAGCGAGAATAATCAACC","CCTTGACCTGCTTGGTTTGC","561307.5.peg.2042","1161"
"13082",267,435,168,"CCTTGGTTGGCAGGTGCAGC","CCTTGACCTGCTTGGTTTGC","561307.5.peg.2042","1161"
"13083",146,435,289,"CTGCTGCAGACGCTGTTGTC","CCTTGACCTGCTTGGTTTGC","561307.5.peg.2042","1161"
"13084",255,435,180,"GGTGCAGCTGGCTGTGCTGT","CCTTGACCTGCTTGGTTTGC","561307.5.peg.2042","1161"
"13085",537,435,102,"TTTGCTGCTACAGGTGCTGC","CCTTGACCTGCTTGGTTTGC","561307.5.peg.2042","1161"
"13086",2796,435,2361,"TCTACTTCCGTATCAGCTGC","CCTTGACCTGCTTGGTTTGC","561307.5.peg.2042","1161"
"13087",284,435,151,"GTTGTACTGCTGGTTGTCCT","CCTTGACCTGCTTGGTTTGC","561307.5.peg.2042","1161"
"13088",1074,435,639,"TCAGCAACTGCTGTATTGTC","CCTTGACCTGCTTGGTTTGC","561307.5.peg.2042","1161"
"13089",35,435,400,"AATTCATTAAGTCATCCTCC","CCTTGACCTGCTTGGTTTGC","561307.5.peg.2042","1161"
"13090",637,435,202,"CTATTCTCATCTGTTGATA","CCTTGACCTGCTTGGTTTGC","561307.5.peg.2042","1161"
"13091",1617,435,1182,"TCTGCAGTTAGTGTAACTTC","CCTTGACCTGCTTGGTTTGC","561307.5.peg.2042","1161"
"13092",3013,435,2578,"TGCATCCGATTTCTTAGTTG","CCTTGACCTGCTTGGTTTGC","561307.5.peg.2042","1161"
"13093",1206,435,771,"CTTTATTGTTAGTTGCTTT","CCTTGACCTGCTTGGTTTGC","561307.5.peg.2042","1161"
"13094",1442,435,1007,"CACGTGCCGTTGTCACACCT","CCTTGACCTGCTTGGTTTGC","561307.5.peg.2042","1161"
"13095",294,435,141,"TGGTTTGCTGGTTGTACTGC","CCTTGACCTGCTTGGTTTGC","561307.5.peg.2042","1161"
"13096",314,435,121,"CTGGATTAGCCTGTCCACCT","CCTTGACCTGCTTGGTTTGC","561307.5.peg.2042","1161"
"13097",2126,435,1691,"GTTTACGAGTTGTAACTGCT","CCTTGACCTGCTTGGTTTGC","561307.5.peg.2042","1161"
"13098",195,435,240,"TTGGCATCAGCTGGTTGTGC","CCTTGACCTGCTTGGTTTGC","561307.5.peg.2042","1161"
"13099",9,435,426,"AGCGAGAATAATCAACCAGG","CCTTGACCTGCTTGGTTTGC","561307.5.peg.2042","1161"
"13100",1038,435,603,"TCTAAACGATCAGCATCAGT","CCTTGACCTGCTTGGTTTGC","561307.5.peg.2042","1161"
"13101",280,435,155,"TACTGCTGGTTGTCCTTGGT","CCTTGACCTGCTTGGTTTGC","561307.5.peg.2042","1161"
"13102",2316,435,1881,"GCTGCTTTAGCTGTTGTAGC","CCTTGACCTGCTTGGTTTGC","561307.5.peg.2042","1161"
"13103",546,435,111,"GTTTGTGCGTTTGCTGCTAC","CCTTGACCTGCTTGGTTTGC","561307.5.peg.2042","1161"
"13104",1358,435,923,"TACTGTCTTCATTACCATTA","CCTTGACCTGCTTGGTTTGC","561307.5.peg.2042","1161"
"13105",576,435,141,"TCACCAGTATTGCTAGCATT","CCTTGACCTGCTTGGTTTGC","561307.5.peg.2042","1161"
"13106",214,435,221,"ATTTGCGTTAGGCTGTGTAT","CCTTGACCTGCTTGGTTTGC","561307.5.peg.2042","1161"
"13107",276,435,159,"GCTGGTTGTCCTTGGTTGGC","CCTTGACCTGCTTGGTTTGC","561307.5.peg.2042","1161"
"13108",333,435,102,"GGTTGTGCTGCTCCTCCTGC","CCTTGACCTGCTTGGTTTGC","561307.5.peg.2042","1161"
"13109",546,443,103,"GTTTGTGCGTTTGCTGCTAC","GGTTATTTCCTTGACCTGCT","561307.5.peg.2042","1161"
"13110",576,443,133,"TCACCAGTATTGCTAGCATT","GGTTATTTCCTTGACCTGCT","561307.5.peg.2042","1161"
"13111",35,443,408,"AATTCATTAAGTCATCCTCC","GGTTATTTCCTTGACCTGCT","561307.5.peg.2042","1161"
"13112",1206,443,763,"CTTTATTGTTAGTTGCTTT","GGTTATTTCCTTGACCTGCT","561307.5.peg.2042","1161"
"13113",204,443,239,"GGCTGTGTATTGGCATCAGC","GGTTATTTCCTTGACCTGCT","561307.5.peg.2042","1161"
"13114",3391,443,2948,"TGTATGTGCTGCATCTATTG","GGTTATTTCCTTGACCTGCT","561307.5.peg.2042","1161"
"13115",255,443,188,"GGTGCAGCTGGCTGTGCTGT","GGTTATTTCCTTGACCTGCT","561307.5.peg.2042","1161"
"13116",637,443,194,"CTATTCTCATCTGTTGATA","GGTTATTTCCTTGACCTGCT","561307.5.peg.2042","1161"
"13117",1358,443,915,"TACTGTCTTCATTACCATTA","GGTTATTTCCTTGACCTGCT","561307.5.peg.2042","1161"
"13118",2796,443,2353,"TCTACTTCCGTATCAGCTGC","GGTTATTTCCTTGACCTGCT","561307.5.peg.2042","1161"
"13119",306,443,137,"GCCTGTCCACCTTGGTTTGC","GGTTATTTCCTTGACCTGCT","561307.5.peg.2042","1161"
"13120",2126,443,1683,"GTTTACGAGTTGTAACTGCT","GGTTATTTCCTTGACCTGCT","561307.5.peg.2042","1161"
"13121",333,443,110,"GGTTGTGCTGCTCCTCCTGC","GGTTATTTCCTTGACCTGCT","561307.5.peg.2042","1161"
"13122",280,443,163,"TACTGCTGGTTGTCCTTGGT","GGTTATTTCCTTGACCTGCT","561307.5.peg.2042","1161"
"13123",1074,443,631,"TCAGCAACTGCTGTATTGTC","GGTTATTTCCTTGACCTGCT","561307.5.peg.2042","1161"
"13124",195,443,248,"TTGGCATCAGCTGGTTGTGC","GGTTATTTCCTTGACCTGCT","561307.5.peg.2042","1161"
"13125",294,443,149,"TGGTTTGCTGGTTGTACTGC","GGTTATTTCCTTGACCTGCT","561307.5.peg.2042","1161"
"13126",214,443,229,"ATTTGCGTTAGGCTGTGTAT","GGTTATTTCCTTGACCTGCT","561307.5.peg.2042","1161"
"13127",1038,443,595,"TCTAAACGATCAGCATCAGT","GGTTATTTCCTTGACCTGCT","561307.5.peg.2042","1161"
"13128",267,443,176,"CCTTGGTTGGCAGGTGCAGC","GGTTATTTCCTTGACCTGCT","561307.5.peg.2042","1161"
"13129",2316,443,1873,"GCTGCTTTAGCTGTTGTAGC","GGTTATTTCCTTGACCTGCT","561307.5.peg.2042","1161"
"13130",9,443,434,"AGCGAGAATAATCAACCAGG","GGTTATTTCCTTGACCTGCT","561307.5.peg.2042","1161"
"13131",225,443,218,"TGAGCACCAGCATTTGCGTT","GGTTATTTCCTTGACCTGCT","561307.5.peg.2042","1161"
"13132",1314,443,871,"TTAACGTAAGTTACACCTTG","GGTTATTTCCTTGACCTGCT","561307.5.peg.2042","1161"
"13133",1617,443,1174,"TCTGCAGTTAGTGTAACTTC","GGTTATTTCCTTGACCTGCT","561307.5.peg.2042","1161"
"13134",1442,443,999,"CACGTGCCGTTGTCACACCT","GGTTATTTCCTTGACCTGCT","561307.5.peg.2042","1161"
"13135",146,443,297,"CTGCTGCAGACGCTGTTGTC","GGTTATTTCCTTGACCTGCT","561307.5.peg.2042","1161"
"13136",314,443,129,"CTGGATTAGCCTGTCCACCT","GGTTATTTCCTTGACCTGCT","561307.5.peg.2042","1161"
"13137",276,443,167,"GCTGGTTGTCCTTGGTTGGC","GGTTATTTCCTTGACCTGCT","561307.5.peg.2042","1161"
"13138",284,443,159,"GTTGTACTGCTGGTTGTCCT","GGTTATTTCCTTGACCTGCT","561307.5.peg.2042","1161"
"13139",12,443,431,"AACAGCGAGAATAATCAACC","GGTTATTTCCTTGACCTGCT","561307.5.peg.2042","1161"
"13140",3013,443,2570,"TGCATCCGATTTCTTAGTTG","GGTTATTTCCTTGACCTGCT","561307.5.peg.2042","1161"
"13141",204,510,306,"GGCTGTGTATTGGCATCAGC","GCTGCTGCTGGAGCATTCGC","561307.5.peg.2042","1161"
"13142",195,510,315,"TTGGCATCAGCTGGTTGTGC","GCTGCTGCTGGAGCATTCGC","561307.5.peg.2042","1161"
"13143",1074,510,564,"TCAGCAACTGCTGTATTGTC","GCTGCTGCTGGAGCATTCGC","561307.5.peg.2042","1161"
"13144",267,510,243,"CCTTGGTTGGCAGGTGCAGC","GCTGCTGCTGGAGCATTCGC","561307.5.peg.2042","1161"
"13145",3013,510,2503,"TGCATCCGATTTCTTAGTTG","GCTGCTGCTGGAGCATTCGC","561307.5.peg.2042","1161"
"13146",1038,510,528,"TCTAAACGATCAGCATCAGT","GCTGCTGCTGGAGCATTCGC","561307.5.peg.2042","1161"
"13147",1358,510,848,"TACTGTCTTCATTACCATTA","GCTGCTGCTGGAGCATTCGC","561307.5.peg.2042","1161"
"13148",255,510,255,"GGTGCAGCTGGCTGTGCTGT","GCTGCTGCTGGAGCATTCGC","561307.5.peg.2042","1161"
"13149",1442,510,932,"CACGTGCCGTTGTCACACCT","GCTGCTGCTGGAGCATTCGC","561307.5.peg.2042","1161"
"13150",294,510,216,"TGGTTTGCTGGTTGTACTGC","GCTGCTGCTGGAGCATTCGC","561307.5.peg.2042","1161"
"13151",314,510,196,"CTGGATTAGCCTGTCCACCT","GCTGCTGCTGGAGCATTCGC","561307.5.peg.2042","1161"
"13152",280,510,230,"TACTGCTGGTTGTCCTTGGT","GCTGCTGCTGGAGCATTCGC","561307.5.peg.2042","1161"
"13153",1314,510,804,"TTAACGTAAGTTACACCTTG","GCTGCTGCTGGAGCATTCGC","561307.5.peg.2042","1161"
"13154",2796,510,2286,"TCTACTTCCGTATCAGCTGC","GCTGCTGCTGGAGCATTCGC","561307.5.peg.2042","1161"
"13155",2126,510,1616,"GTTTACGAGTTGTAACTGCT","GCTGCTGCTGGAGCATTCGC","561307.5.peg.2042","1161"
"13156",354,510,156,"TGTCCAGCTGGTTGTGTATT","GCTGCTGCTGGAGCATTCGC","561307.5.peg.2042","1161"
"13157",276,510,234,"GCTGGTTGTCCTTGGTTGGC","GCTGCTGCTGGAGCATTCGC","561307.5.peg.2042","1161"
"13158",214,510,296,"ATTTGCGTTAGGCTGTGTAT","GCTGCTGCTGGAGCATTCGC","561307.5.peg.2042","1161"
"13159",2316,510,1806,"GCTGCTTTAGCTGTTGTAGC","GCTGCTGCTGGAGCATTCGC","561307.5.peg.2042","1161"
"13160",306,510,204,"GCCTGTCCACCTTGGTTTGC","GCTGCTGCTGGAGCATTCGC","561307.5.peg.2042","1161"
"13161",1206,510,696,"CTTTATTGTTAGTTGCTTT","GCTGCTGCTGGAGCATTCGC","561307.5.peg.2042","1161"
"13162",284,510,226,"GTTGTACTGCTGGTTGTCCT","GCTGCTGCTGGAGCATTCGC","561307.5.peg.2042","1161"
"13163",146,510,364,"CTGCTGCAGACGCTGTTGTC","GCTGCTGCTGGAGCATTCGC","561307.5.peg.2042","1161"
"13164",1617,510,1107,"TCTGCAGTTAGTGTAACTTC","GCTGCTGCTGGAGCATTCGC","561307.5.peg.2042","1161"
"13165",3391,510,2881,"TGTATGTGCTGCATCTATTG","GCTGCTGCTGGAGCATTCGC","561307.5.peg.2042","1161"
"13166",9,510,501,"AGCGAGAATAATCAACCAGG","GCTGCTGCTGGAGCATTCGC","561307.5.peg.2042","1161"
"13167",35,510,475,"AATTCATTAAGTCATCCTCC","GCTGCTGCTGGAGCATTCGC","561307.5.peg.2042","1161"
"13168",637,510,127,"CTATTCTCATCTGTTGATA","GCTGCTGCTGGAGCATTCGC","561307.5.peg.2042","1161"
"13169",12,510,498,"AACAGCGAGAATAATCAACC","GCTGCTGCTGGAGCATTCGC","561307.5.peg.2042","1161"
"13170",333,510,177,"GGTTGTGCTGCTCCTCCTGC","GCTGCTGCTGGAGCATTCGC","561307.5.peg.2042","1161"
"13171",225,510,285,"TGAGCACCAGCATTTGCGTT","GCTGCTGCTGGAGCATTCGC","561307.5.peg.2042","1161"
"13172",393,510,117,"TGTGCTTGTGCAGCGTTATT","GCTGCTGCTGGAGCATTCGC","561307.5.peg.2042","1161"
"13173",1442,522,920,"CACGTGCCGTTGTCACACCT","GCTGCTGGTTGCGCTGCTGC","561307.5.peg.2042","1161"
"13174",3391,522,2869,"TGTATGTGCTGCATCTATTG","GCTGCTGGTTGCGCTGCTGC","561307.5.peg.2042","1161"
"13175",225,522,297,"TGAGCACCAGCATTTGCGTT","GCTGCTGGTTGCGCTGCTGC","561307.5.peg.2042","1161"
"13176",3013,522,2491,"TGCATCCGATTTCTTAGTTG","GCTGCTGGTTGCGCTGCTGC","561307.5.peg.2042","1161"
"13177",35,522,487,"AATTCATTAAGTCATCCTCC","GCTGCTGGTTGCGCTGCTGC","561307.5.peg.2042","1161"
"13178",314,522,208,"CTGGATTAGCCTGTCCACCT","GCTGCTGGTTGCGCTGCTGC","561307.5.peg.2042","1161"
"13179",2126,522,1604,"GTTTACGAGTTGTAACTGCT","GCTGCTGGTTGCGCTGCTGC","561307.5.peg.2042","1161"
"13180",284,522,238,"GTTGTACTGCTGGTTGTCCT","GCTGCTGGTTGCGCTGCTGC","561307.5.peg.2042","1161"
"13181",393,522,129,"TGTGCTTGTGCAGCGTTATT","GCTGCTGGTTGCGCTGCTGC","561307.5.peg.2042","1161"
"13182",306,522,216,"GCCTGTCCACCTTGGTTTGC","GCTGCTGGTTGCGCTGCTGC","561307.5.peg.2042","1161"
"13183",214,522,308,"ATTTGCGTTAGGCTGTGTAT","GCTGCTGGTTGCGCTGCTGC","561307.5.peg.2042","1161"
"13184",1074,522,552,"TCAGCAACTGCTGTATTGTC","GCTGCTGGTTGCGCTGCTGC","561307.5.peg.2042","1161"
"13185",280,522,242,"TACTGCTGGTTGTCCTTGGT","GCTGCTGGTTGCGCTGCTGC","561307.5.peg.2042","1161"
"13186",637,522,115,"CTATTCTCATCTGTTGATA","GCTGCTGGTTGCGCTGCTGC","561307.5.peg.2042","1161"
"13187",276,522,246,"GCTGGTTGTCCTTGGTTGGC","GCTGCTGGTTGCGCTGCTGC","561307.5.peg.2042","1161"
"13188",2316,522,1794,"GCTGCTTTAGCTGTTGTAGC","GCTGCTGGTTGCGCTGCTGC","561307.5.peg.2042","1161"
"13189",2796,522,2274,"TCTACTTCCGTATCAGCTGC","GCTGCTGGTTGCGCTGCTGC","561307.5.peg.2042","1161"
"13190",1314,522,792,"TTAACGTAAGTTACACCTTG","GCTGCTGGTTGCGCTGCTGC","561307.5.peg.2042","1161"
"13191",9,522,513,"AGCGAGAATAATCAACCAGG","GCTGCTGGTTGCGCTGCTGC","561307.5.peg.2042","1161"
"13192",146,522,376,"CTGCTGCAGACGCTGTTGTC","GCTGCTGGTTGCGCTGCTGC","561307.5.peg.2042","1161"
"13193",255,522,267,"GGTGCAGCTGGCTGTGCTGT","GCTGCTGGTTGCGCTGCTGC","561307.5.peg.2042","1161"
"13194",1358,522,836,"TACTGTCTTCATTACCATTA","GCTGCTGGTTGCGCTGCTGC","561307.5.peg.2042","1161"
"13195",417,522,105,"GCCGGTGTTGCTTGATTTCC","GCTGCTGGTTGCGCTGCTGC","561307.5.peg.2042","1161"
"13196",1206,522,684,"CTTTATTGTTAGTTGCTTT","GCTGCTGGTTGCGCTGCTGC","561307.5.peg.2042","1161"
"13197",354,522,168,"TGTCCAGCTGGTTGTGTATT","GCTGCTGGTTGCGCTGCTGC","561307.5.peg.2042","1161"
"13198",204,522,318,"GGCTGTGTATTGGCATCAGC","GCTGCTGGTTGCGCTGCTGC","561307.5.peg.2042","1161"
"13199",267,522,255,"CCTTGGTTGGCAGGTGCAGC","GCTGCTGGTTGCGCTGCTGC","561307.5.peg.2042","1161"
"13200",294,522,228,"TGGTTTGCTGGTTGTACTGC","GCTGCTGGTTGCGCTGCTGC","561307.5.peg.2042","1161"
"13201",1617,522,1095,"TCTGCAGTTAGTGTAACTTC","GCTGCTGGTTGCGCTGCTGC","561307.5.peg.2042","1161"
"13202",1038,522,516,"TCTAAACGATCAGCATCAGT","GCTGCTGGTTGCGCTGCTGC","561307.5.peg.2042","1161"
"13203",12,522,510,"AACAGCGAGAATAATCAACC","GCTGCTGGTTGCGCTGCTGC","561307.5.peg.2042","1161"
"13204",333,522,189,"GGTTGTGCTGCTCCTCCTGC","GCTGCTGGTTGCGCTGCTGC","561307.5.peg.2042","1161"
"13205",195,522,327,"TTGGCATCAGCTGGTTGTGC","GCTGCTGGTTGCGCTGCTGC","561307.5.peg.2042","1161"
"13206",276,537,261,"GCTGGTTGTCCTTGGTTGGC","TTTGCTGCTACAGGTGCTGC","561307.5.peg.2042","1161"
"13207",1038,537,501,"TCTAAACGATCAGCATCAGT","TTTGCTGCTACAGGTGCTGC","561307.5.peg.2042","1161"
"13208",417,537,120,"GCCGGTGTTGCTTGATTTCC","TTTGCTGCTACAGGTGCTGC","561307.5.peg.2042","1161"
"13209",195,537,342,"TTGGCATCAGCTGGTTGTGC","TTTGCTGCTACAGGTGCTGC","561307.5.peg.2042","1161"
"13210",354,537,183,"TGTCCAGCTGGTTGTGTATT","TTTGCTGCTACAGGTGCTGC","561307.5.peg.2042","1161"
"13211",204,537,333,"GGCTGTGTATTGGCATCAGC","TTTGCTGCTACAGGTGCTGC","561307.5.peg.2042","1161"
"13212",1617,537,1080,"TCTGCAGTTAGTGTAACTTC","TTTGCTGCTACAGGTGCTGC","561307.5.peg.2042","1161"
"13213",393,537,144,"TGTGCTTGTGCAGCGTTATT","TTTGCTGCTACAGGTGCTGC","561307.5.peg.2042","1161"
"13214",267,537,270,"CCTTGGTTGGCAGGTGCAGC","TTTGCTGCTACAGGTGCTGC","561307.5.peg.2042","1161"
"13215",294,537,243,"TGGTTTGCTGGTTGTACTGC","TTTGCTGCTACAGGTGCTGC","561307.5.peg.2042","1161"
"13216",284,537,253,"GTTGTACTGCTGGTTGTCCT","TTTGCTGCTACAGGTGCTGC","561307.5.peg.2042","1161"
"13217",1314,537,777,"TTAACGTAAGTTACACCTTG","TTTGCTGCTACAGGTGCTGC","561307.5.peg.2042","1161"
"13218",146,537,391,"CTGCTGCAGACGCTGTTGTC","TTTGCTGCTACAGGTGCTGC","561307.5.peg.2042","1161"
"13219",1074,537,537,"TCAGCAACTGCTGTATTGTC","TTTGCTGCTACAGGTGCTGC","561307.5.peg.2042","1161"
"13220",35,537,502,"AATTCATTAAGTCATCCTCC","TTTGCTGCTACAGGTGCTGC","561307.5.peg.2042","1161"
"13221",9,537,528,"AGCGAGAATAATCAACCAGG","TTTGCTGCTACAGGTGCTGC","561307.5.peg.2042","1161"
"13222",3013,537,2476,"TGCATCCGATTTCTTAGTTG","TTTGCTGCTACAGGTGCTGC","561307.5.peg.2042","1161"
"13223",3391,537,2854,"TGTATGTGCTGCATCTATTG","TTTGCTGCTACAGGTGCTGC","561307.5.peg.2042","1161"
"13224",225,537,312,"TGAGCACCAGCATTTGCGTT","TTTGCTGCTACAGGTGCTGC","561307.5.peg.2042","1161"
"13225",255,537,282,"GGTGCAGCTGGCTGTGCTGT","TTTGCTGCTACAGGTGCTGC","561307.5.peg.2042","1161"
"13226",306,537,231,"GCCTGTCCACCTTGGTTTGC","TTTGCTGCTACAGGTGCTGC","561307.5.peg.2042","1161"
"13227",280,537,257,"TACTGCTGGTTGTCCTTGGT","TTTGCTGCTACAGGTGCTGC","561307.5.peg.2042","1161"
"13228",2126,537,1589,"GTTTACGAGTTGTAACTGCT","TTTGCTGCTACAGGTGCTGC","561307.5.peg.2042","1161"
"13229",637,537,100,"CTATTCTCATCTGTTGATA","TTTGCTGCTACAGGTGCTGC","561307.5.peg.2042","1161"
"13230",12,537,525,"AACAGCGAGAATAATCAACC","TTTGCTGCTACAGGTGCTGC","561307.5.peg.2042","1161"
"13231",214,537,323,"ATTTGCGTTAGGCTGTGTAT","TTTGCTGCTACAGGTGCTGC","561307.5.peg.2042","1161"
"13232",314,537,223,"CTGGATTAGCCTGTCCACCT","TTTGCTGCTACAGGTGCTGC","561307.5.peg.2042","1161"
"13233",435,537,102,"CCTTGACCTGCTTGGTTTGC","TTTGCTGCTACAGGTGCTGC","561307.5.peg.2042","1161"
"13234",2316,537,1779,"GCTGCTTTAGCTGTTGTAGC","TTTGCTGCTACAGGTGCTGC","561307.5.peg.2042","1161"
"13235",1442,537,905,"CACGTGCCGTTGTCACACCT","TTTGCTGCTACAGGTGCTGC","561307.5.peg.2042","1161"
"13236",333,537,204,"GGTTGTGCTGCTCCTCCTGC","TTTGCTGCTACAGGTGCTGC","561307.5.peg.2042","1161"
"13237",1358,537,821,"TACTGTCTTCATTACCATTA","TTTGCTGCTACAGGTGCTGC","561307.5.peg.2042","1161"
"13238",2796,537,2259,"TCTACTTCCGTATCAGCTGC","TTTGCTGCTACAGGTGCTGC","561307.5.peg.2042","1161"
"13239",1206,537,669,"CTTTATTGTTAGTTGCTTT","TTTGCTGCTACAGGTGCTGC","561307.5.peg.2042","1161"
"13240",3013,546,2467,"TGCATCCGATTTCTTAGTTG","GTTTGTGCGTTTGCTGCTAC","561307.5.peg.2042","1161"
"13241",267,546,279,"CCTTGGTTGGCAGGTGCAGC","GTTTGTGCGTTTGCTGCTAC","561307.5.peg.2042","1161"
"13242",195,546,351,"TTGGCATCAGCTGGTTGTGC","GTTTGTGCGTTTGCTGCTAC","561307.5.peg.2042","1161"
"13243",12,546,534,"AACAGCGAGAATAATCAACC","GTTTGTGCGTTTGCTGCTAC","561307.5.peg.2042","1161"
"13244",2796,546,2250,"TCTACTTCCGTATCAGCTGC","GTTTGTGCGTTTGCTGCTAC","561307.5.peg.2042","1161"
"13245",2126,546,1580,"GTTTACGAGTTGTAACTGCT","GTTTGTGCGTTTGCTGCTAC","561307.5.peg.2042","1161"
"13246",393,546,153,"TGTGCTTGTGCAGCGTTATT","GTTTGTGCGTTTGCTGCTAC","561307.5.peg.2042","1161"
"13247",3391,546,2845,"TGTATGTGCTGCATCTATTG","GTTTGTGCGTTTGCTGCTAC","561307.5.peg.2042","1161"
"13248",1442,546,896,"CACGTGCCGTTGTCACACCT","GTTTGTGCGTTTGCTGCTAC","561307.5.peg.2042","1161"
"13249",225,546,321,"TGAGCACCAGCATTTGCGTT","GTTTGTGCGTTTGCTGCTAC","561307.5.peg.2042","1161"
"13250",443,546,103,"GGTTATTTCCTTGACCTGCT","GTTTGTGCGTTTGCTGCTAC","561307.5.peg.2042","1161"
"13251",333,546,213,"GGTTGTGCTGCTCCTCCTGC","GTTTGTGCGTTTGCTGCTAC","561307.5.peg.2042","1161"
"13252",204,546,342,"GGCTGTGTATTGGCATCAGC","GTTTGTGCGTTTGCTGCTAC","561307.5.peg.2042","1161"
"13253",146,546,400,"CTGCTGCAGACGCTGTTGTC","GTTTGTGCGTTTGCTGCTAC","561307.5.peg.2042","1161"
"13254",1206,546,660,"CTTTATTGTTAGTTGCTTT","GTTTGTGCGTTTGCTGCTAC","561307.5.peg.2042","1161"
"13255",1358,546,812,"TACTGTCTTCATTACCATTA","GTTTGTGCGTTTGCTGCTAC","561307.5.peg.2042","1161"
"13256",1038,546,492,"TCTAAACGATCAGCATCAGT","GTTTGTGCGTTTGCTGCTAC","561307.5.peg.2042","1161"
"13257",284,546,262,"GTTGTACTGCTGGTTGTCCT","GTTTGTGCGTTTGCTGCTAC","561307.5.peg.2042","1161"
"13258",306,546,240,"GCCTGTCCACCTTGGTTTGC","GTTTGTGCGTTTGCTGCTAC","561307.5.peg.2042","1161"
"13259",255,546,291,"GGTGCAGCTGGCTGTGCTGT","GTTTGTGCGTTTGCTGCTAC","561307.5.peg.2042","1161"
"13260",276,546,270,"GCTGGTTGTCCTTGGTTGGC","GTTTGTGCGTTTGCTGCTAC","561307.5.peg.2042","1161"
"13261",1074,546,528,"TCAGCAACTGCTGTATTGTC","GTTTGTGCGTTTGCTGCTAC","561307.5.peg.2042","1161"
"13262",435,546,111,"CCTTGACCTGCTTGGTTTGC","GTTTGTGCGTTTGCTGCTAC","561307.5.peg.2042","1161"
"13263",9,546,537,"AGCGAGAATAATCAACCAGG","GTTTGTGCGTTTGCTGCTAC","561307.5.peg.2042","1161"
"13264",35,546,511,"AATTCATTAAGTCATCCTCC","GTTTGTGCGTTTGCTGCTAC","561307.5.peg.2042","1161"
"13265",280,546,266,"TACTGCTGGTTGTCCTTGGT","GTTTGTGCGTTTGCTGCTAC","561307.5.peg.2042","1161"
"13266",354,546,192,"TGTCCAGCTGGTTGTGTATT","GTTTGTGCGTTTGCTGCTAC","561307.5.peg.2042","1161"
"13267",1314,546,768,"TTAACGTAAGTTACACCTTG","GTTTGTGCGTTTGCTGCTAC","561307.5.peg.2042","1161"
"13268",417,546,129,"GCCGGTGTTGCTTGATTTCC","GTTTGTGCGTTTGCTGCTAC","561307.5.peg.2042","1161"
"13269",1617,546,1071,"TCTGCAGTTAGTGTAACTTC","GTTTGTGCGTTTGCTGCTAC","561307.5.peg.2042","1161"
"13270",294,546,252,"TGGTTTGCTGGTTGTACTGC","GTTTGTGCGTTTGCTGCTAC","561307.5.peg.2042","1161"
"13271",314,546,232,"CTGGATTAGCCTGTCCACCT","GTTTGTGCGTTTGCTGCTAC","561307.5.peg.2042","1161"
"13272",2316,546,1770,"GCTGCTTTAGCTGTTGTAGC","GTTTGTGCGTTTGCTGCTAC","561307.5.peg.2042","1161"
"13273",214,546,332,"ATTTGCGTTAGGCTGTGTAT","GTTTGTGCGTTTGCTGCTAC","561307.5.peg.2042","1161"
"13274",12,576,564,"AACAGCGAGAATAATCAACC","TCACCAGTATTGCTAGCATT","561307.5.peg.2042","1161"
"13275",393,576,183,"TGTGCTTGTGCAGCGTTATT","TCACCAGTATTGCTAGCATT","561307.5.peg.2042","1161"
"13276",9,576,567,"AGCGAGAATAATCAACCAGG","TCACCAGTATTGCTAGCATT","561307.5.peg.2042","1161"
"13277",1074,576,498,"TCAGCAACTGCTGTATTGTC","TCACCAGTATTGCTAGCATT","561307.5.peg.2042","1161"
"13278",255,576,321,"GGTGCAGCTGGCTGTGCTGT","TCACCAGTATTGCTAGCATT","561307.5.peg.2042","1161"
"13279",3013,576,2437,"TGCATCCGATTTCTTAGTTG","TCACCAGTATTGCTAGCATT","561307.5.peg.2042","1161"
"13280",146,576,430,"CTGCTGCAGACGCTGTTGTC","TCACCAGTATTGCTAGCATT","561307.5.peg.2042","1161"
"13281",354,576,222,"TGTCCAGCTGGTTGTGTATT","TCACCAGTATTGCTAGCATT","561307.5.peg.2042","1161"
"13282",1358,576,782,"TACTGTCTTCATTACCATTA","TCACCAGTATTGCTAGCATT","561307.5.peg.2042","1161"
"13283",1038,576,462,"TCTAAACGATCAGCATCAGT","TCACCAGTATTGCTAGCATT","561307.5.peg.2042","1161"
"13284",1206,576,630,"CTTTATTGTTAGTTGCTTT","TCACCAGTATTGCTAGCATT","561307.5.peg.2042","1161"
"13285",443,576,133,"GGTTATTTCCTTGACCTGCT","TCACCAGTATTGCTAGCATT","561307.5.peg.2042","1161"
"13286",435,576,141,"CCTTGACCTGCTTGGTTTGC","TCACCAGTATTGCTAGCATT","561307.5.peg.2042","1161"
"13287",204,576,372,"GGCTGTGTATTGGCATCAGC","TCACCAGTATTGCTAGCATT","561307.5.peg.2042","1161"
"13288",2796,576,2220,"TCTACTTCCGTATCAGCTGC","TCACCAGTATTGCTAGCATT","561307.5.peg.2042","1161"
"13289",306,576,270,"GCCTGTCCACCTTGGTTTGC","TCACCAGTATTGCTAGCATT","561307.5.peg.2042","1161"
"13290",2316,576,1740,"GCTGCTTTAGCTGTTGTAGC","TCACCAGTATTGCTAGCATT","561307.5.peg.2042","1161"
"13291",267,576,309,"CCTTGGTTGGCAGGTGCAGC","TCACCAGTATTGCTAGCATT","561307.5.peg.2042","1161"
"13292",1442,576,866,"CACGTGCCGTTGTCACACCT","TCACCAGTATTGCTAGCATT","561307.5.peg.2042","1161"
"13293",1314,576,738,"TTAACGTAAGTTACACCTTG","TCACCAGTATTGCTAGCATT","561307.5.peg.2042","1161"
"13294",35,576,541,"AATTCATTAAGTCATCCTCC","TCACCAGTATTGCTAGCATT","561307.5.peg.2042","1161"
"13295",284,576,292,"GTTGTACTGCTGGTTGTCCT","TCACCAGTATTGCTAGCATT","561307.5.peg.2042","1161"
"13296",294,576,282,"TGGTTTGCTGGTTGTACTGC","TCACCAGTATTGCTAGCATT","561307.5.peg.2042","1161"
"13297",3391,576,2815,"TGTATGTGCTGCATCTATTG","TCACCAGTATTGCTAGCATT","561307.5.peg.2042","1161"
"13298",417,576,159,"GCCGGTGTTGCTTGATTTCC","TCACCAGTATTGCTAGCATT","561307.5.peg.2042","1161"
"13299",333,576,243,"GGTTGTGCTGCTCCTCCTGC","TCACCAGTATTGCTAGCATT","561307.5.peg.2042","1161"
"13300",276,576,300,"GCTGGTTGTCCTTGGTTGGC","TCACCAGTATTGCTAGCATT","561307.5.peg.2042","1161"
"13301",214,576,362,"ATTTGCGTTAGGCTGTGTAT","TCACCAGTATTGCTAGCATT","561307.5.peg.2042","1161"
"13302",195,576,381,"TTGGCATCAGCTGGTTGTGC","TCACCAGTATTGCTAGCATT","561307.5.peg.2042","1161"
"13303",1617,576,1041,"TCTGCAGTTAGTGTAACTTC","TCACCAGTATTGCTAGCATT","561307.5.peg.2042","1161"
"13304",2126,576,1550,"GTTTACGAGTTGTAACTGCT","TCACCAGTATTGCTAGCATT","561307.5.peg.2042","1161"
"13305",225,576,351,"TGAGCACCAGCATTTGCGTT","TCACCAGTATTGCTAGCATT","561307.5.peg.2042","1161"
"13306",280,576,296,"TACTGCTGGTTGTCCTTGGT","TCACCAGTATTGCTAGCATT","561307.5.peg.2042","1161"
"13307",314,576,262,"CTGGATTAGCCTGTCCACCT","TCACCAGTATTGCTAGCATT","561307.5.peg.2042","1161"
"13308",537,637,100,"TTTGCTGCTACAGGTGCTGC","CTATTCTCATCTGTTGATA","561307.5.peg.2042","1161"
"13309",2126,637,1489,"GTTTACGAGTTGTAACTGCT","CTATTCTCATCTGTTGATA","561307.5.peg.2042","1161"
"13310",1314,637,677,"TTAACGTAAGTTACACCTTG","CTATTCTCATCTGTTGATA","561307.5.peg.2042","1161"
"13311",510,637,127,"GCTGCTGCTGGAGCATTCGC","CTATTCTCATCTGTTGATA","561307.5.peg.2042","1161"
"13312",276,637,361,"GCTGGTTGTCCTTGGTTGGC","CTATTCTCATCTGTTGATA","561307.5.peg.2042","1161"
"13313",333,637,304,"GGTTGTGCTGCTCCTCCTGC","CTATTCTCATCTGTTGATA","561307.5.peg.2042","1161"
"13314",3391,637,2754,"TGTATGTGCTGCATCTATTG","CTATTCTCATCTGTTGATA","561307.5.peg.2042","1161"
"13315",214,637,423,"ATTTGCGTTAGGCTGTGTAT","CTATTCTCATCTGTTGATA","561307.5.peg.2042","1161"
"13316",255,637,382,"GGTGCAGCTGGCTGTGCTGT","CTATTCTCATCTGTTGATA","561307.5.peg.2042","1161"
"13317",1617,637,980,"TCTGCAGTTAGTGTAACTTC","CTATTCTCATCTGTTGATA","561307.5.peg.2042","1161"
"13318",2796,637,2159,"TCTACTTCCGTATCAGCTGC","CTATTCTCATCTGTTGATA","561307.5.peg.2042","1161"
"13319",522,637,115,"GCTGCTGGTTGCGCTGCTGC","CTATTCTCATCTGTTGATA","561307.5.peg.2042","1161"
"13320",393,637,244,"TGTGCTTGTGCAGCGTTATT","CTATTCTCATCTGTTGATA","561307.5.peg.2042","1161"
"13321",195,637,442,"TTGGCATCAGCTGGTTGTGC","CTATTCTCATCTGTTGATA","561307.5.peg.2042","1161"
"13322",306,637,331,"GCCTGTCCACCTTGGTTTGC","CTATTCTCATCTGTTGATA","561307.5.peg.2042","1161"
"13323",12,637,625,"AACAGCGAGAATAATCAACC","CTATTCTCATCTGTTGATA","561307.5.peg.2042","1161"
"13324",1358,637,721,"TACTGTCTTCATTACCATTA","CTATTCTCATCTGTTGATA","561307.5.peg.2042","1161"
"13325",294,637,343,"TGGTTTGCTGGTTGTACTGC","CTATTCTCATCTGTTGATA","561307.5.peg.2042","1161"
"13326",1442,637,805,"CACGTGCCGTTGTCACACCT","CTATTCTCATCTGTTGATA","561307.5.peg.2042","1161"
"13327",204,637,433,"GGCTGTGTATTGGCATCAGC","CTATTCTCATCTGTTGATA","561307.5.peg.2042","1161"
"13328",146,637,491,"CTGCTGCAGACGCTGTTGTC","CTATTCTCATCTGTTGATA","561307.5.peg.2042","1161"
"13329",267,637,370,"CCTTGGTTGGCAGGTGCAGC","CTATTCTCATCTGTTGATA","561307.5.peg.2042","1161"
"13330",284,637,353,"GTTGTACTGCTGGTTGTCCT","CTATTCTCATCTGTTGATA","561307.5.peg.2042","1161"
"13331",280,637,357,"TACTGCTGGTTGTCCTTGGT","CTATTCTCATCTGTTGATA","561307.5.peg.2042","1161"
"13332",417,637,220,"GCCGGTGTTGCTTGATTTCC","CTATTCTCATCTGTTGATA","561307.5.peg.2042","1161"
"13333",2316,637,1679,"GCTGCTTTAGCTGTTGTAGC","CTATTCTCATCTGTTGATA","561307.5.peg.2042","1161"
"13334",1038,637,401,"TCTAAACGATCAGCATCAGT","CTATTCTCATCTGTTGATA","561307.5.peg.2042","1161"
"13335",354,637,283,"TGTCCAGCTGGTTGTGTATT","CTATTCTCATCTGTTGATA","561307.5.peg.2042","1161"
"13336",1074,637,437,"TCAGCAACTGCTGTATTGTC","CTATTCTCATCTGTTGATA","561307.5.peg.2042","1161"
"13337",225,637,412,"TGAGCACCAGCATTTGCGTT","CTATTCTCATCTGTTGATA","561307.5.peg.2042","1161"
"13338",3013,637,2376,"TGCATCCGATTTCTTAGTTG","CTATTCTCATCTGTTGATA","561307.5.peg.2042","1161"
"13339",35,637,602,"AATTCATTAAGTCATCCTCC","CTATTCTCATCTGTTGATA","561307.5.peg.2042","1161"
"13340",443,637,194,"GGTTATTTCCTTGACCTGCT","CTATTCTCATCTGTTGATA","561307.5.peg.2042","1161"
"13341",314,637,323,"CTGGATTAGCCTGTCCACCT","CTATTCTCATCTGTTGATA","561307.5.peg.2042","1161"
"13342",1206,637,569,"CTTTATTGTTAGTTGCTTT","CTATTCTCATCTGTTGATA","561307.5.peg.2042","1161"
"13343",9,637,628,"AGCGAGAATAATCAACCAGG","CTATTCTCATCTGTTGATA","561307.5.peg.2042","1161"
"13344",435,637,202,"CCTTGACCTGCTTGGTTTGC","CTATTCTCATCTGTTGATA","561307.5.peg.2042","1161"
"13345",2126,1038,1088,"GTTTACGAGTTGTAACTGCT","TCTAAACGATCAGCATCAGT","561307.5.peg.2042","1161"
"13346",280,1038,758,"TACTGCTGGTTGTCCTTGGT","TCTAAACGATCAGCATCAGT","561307.5.peg.2042","1161"
"13347",637,1038,401,"CTATTCTCATCTGTTGATA","TCTAAACGATCAGCATCAGT","561307.5.peg.2042","1161"
"13348",9,1038,1029,"AGCGAGAATAATCAACCAGG","TCTAAACGATCAGCATCAGT","561307.5.peg.2042","1161"
"13349",255,1038,783,"GGTGCAGCTGGCTGTGCTGT","TCTAAACGATCAGCATCAGT","561307.5.peg.2042","1161"
"13350",443,1038,595,"GGTTATTTCCTTGACCTGCT","TCTAAACGATCAGCATCAGT","561307.5.peg.2042","1161"
"13351",195,1038,843,"TTGGCATCAGCTGGTTGTGC","TCTAAACGATCAGCATCAGT","561307.5.peg.2042","1161"
"13352",1206,1038,168,"CTTTATTGTTAGTTGCTTT","TCTAAACGATCAGCATCAGT","561307.5.peg.2042","1161"
"13353",522,1038,516,"GCTGCTGGTTGCGCTGCTGC","TCTAAACGATCAGCATCAGT","561307.5.peg.2042","1161"
"13354",537,1038,501,"TTTGCTGCTACAGGTGCTGC","TCTAAACGATCAGCATCAGT","561307.5.peg.2042","1161"
"13355",146,1038,892,"CTGCTGCAGACGCTGTTGTC","TCTAAACGATCAGCATCAGT","561307.5.peg.2042","1161"
"13356",35,1038,1003,"AATTCATTAAGTCATCCTCC","TCTAAACGATCAGCATCAGT","561307.5.peg.2042","1161"
"13357",1617,1038,579,"TCTGCAGTTAGTGTAACTTC","TCTAAACGATCAGCATCAGT","561307.5.peg.2042","1161"
"13358",294,1038,744,"TGGTTTGCTGGTTGTACTGC","TCTAAACGATCAGCATCAGT","561307.5.peg.2042","1161"
"13359",435,1038,603,"CCTTGACCTGCTTGGTTTGC","TCTAAACGATCAGCATCAGT","561307.5.peg.2042","1161"
"13360",225,1038,813,"TGAGCACCAGCATTTGCGTT","TCTAAACGATCAGCATCAGT","561307.5.peg.2042","1161"
"13361",1442,1038,404,"CACGTGCCGTTGTCACACCT","TCTAAACGATCAGCATCAGT","561307.5.peg.2042","1161"
"13362",306,1038,732,"GCCTGTCCACCTTGGTTTGC","TCTAAACGATCAGCATCAGT","561307.5.peg.2042","1161"
"13363",3391,1038,2353,"TGTATGTGCTGCATCTATTG","TCTAAACGATCAGCATCAGT","561307.5.peg.2042","1161"
"13364",284,1038,754,"GTTGTACTGCTGGTTGTCCT","TCTAAACGATCAGCATCAGT","561307.5.peg.2042","1161"
"13365",204,1038,834,"GGCTGTGTATTGGCATCAGC","TCTAAACGATCAGCATCAGT","561307.5.peg.2042","1161"
"13366",12,1038,1026,"AACAGCGAGAATAATCAACC","TCTAAACGATCAGCATCAGT","561307.5.peg.2042","1161"
"13367",3013,1038,1975,"TGCATCCGATTTCTTAGTTG","TCTAAACGATCAGCATCAGT","561307.5.peg.2042","1161"
"13368",354,1038,684,"TGTCCAGCTGGTTGTGTATT","TCTAAACGATCAGCATCAGT","561307.5.peg.2042","1161"
"13369",1358,1038,320,"TACTGTCTTCATTACCATTA","TCTAAACGATCAGCATCAGT","561307.5.peg.2042","1161"
"13370",576,1038,462,"TCACCAGTATTGCTAGCATT","TCTAAACGATCAGCATCAGT","561307.5.peg.2042","1161"
"13371",1314,1038,276,"TTAACGTAAGTTACACCTTG","TCTAAACGATCAGCATCAGT","561307.5.peg.2042","1161"
"13372",267,1038,771,"CCTTGGTTGGCAGGTGCAGC","TCTAAACGATCAGCATCAGT","561307.5.peg.2042","1161"
"13373",333,1038,705,"GGTTGTGCTGCTCCTCCTGC","TCTAAACGATCAGCATCAGT","561307.5.peg.2042","1161"
"13374",417,1038,621,"GCCGGTGTTGCTTGATTTCC","TCTAAACGATCAGCATCAGT","561307.5.peg.2042","1161"
"13375",2796,1038,1758,"TCTACTTCCGTATCAGCTGC","TCTAAACGATCAGCATCAGT","561307.5.peg.2042","1161"
"13376",546,1038,492,"GTTTGTGCGTTTGCTGCTAC","TCTAAACGATCAGCATCAGT","561307.5.peg.2042","1161"
"13377",276,1038,762,"GCTGGTTGTCCTTGGTTGGC","TCTAAACGATCAGCATCAGT","561307.5.peg.2042","1161"
"13378",2316,1038,1278,"GCTGCTTTAGCTGTTGTAGC","TCTAAACGATCAGCATCAGT","561307.5.peg.2042","1161"
"13379",314,1038,724,"CTGGATTAGCCTGTCCACCT","TCTAAACGATCAGCATCAGT","561307.5.peg.2042","1161"
"13380",214,1038,824,"ATTTGCGTTAGGCTGTGTAT","TCTAAACGATCAGCATCAGT","561307.5.peg.2042","1161"
"13381",510,1038,528,"GCTGCTGCTGGAGCATTCGC","TCTAAACGATCAGCATCAGT","561307.5.peg.2042","1161"
"13382",393,1038,645,"TGTGCTTGTGCAGCGTTATT","TCTAAACGATCAGCATCAGT","561307.5.peg.2042","1161"
"13383",333,1074,741,"GGTTGTGCTGCTCCTCCTGC","TCAGCAACTGCTGTATTGTC","561307.5.peg.2042","1161"
"13384",1442,1074,368,"CACGTGCCGTTGTCACACCT","TCAGCAACTGCTGTATTGTC","561307.5.peg.2042","1161"
"13385",443,1074,631,"GGTTATTTCCTTGACCTGCT","TCAGCAACTGCTGTATTGTC","561307.5.peg.2042","1161"
"13386",35,1074,1039,"AATTCATTAAGTCATCCTCC","TCAGCAACTGCTGTATTGTC","561307.5.peg.2042","1161"
"13387",417,1074,657,"GCCGGTGTTGCTTGATTTCC","TCAGCAACTGCTGTATTGTC","561307.5.peg.2042","1161"
"13388",2796,1074,1722,"TCTACTTCCGTATCAGCTGC","TCAGCAACTGCTGTATTGTC","561307.5.peg.2042","1161"
"13389",255,1074,819,"GGTGCAGCTGGCTGTGCTGT","TCAGCAACTGCTGTATTGTC","561307.5.peg.2042","1161"
"13390",284,1074,790,"GTTGTACTGCTGGTTGTCCT","TCAGCAACTGCTGTATTGTC","561307.5.peg.2042","1161"
"13391",214,1074,860,"ATTTGCGTTAGGCTGTGTAT","TCAGCAACTGCTGTATTGTC","561307.5.peg.2042","1161"
"13392",537,1074,537,"TTTGCTGCTACAGGTGCTGC","TCAGCAACTGCTGTATTGTC","561307.5.peg.2042","1161"
"13393",354,1074,720,"TGTCCAGCTGGTTGTGTATT","TCAGCAACTGCTGTATTGTC","561307.5.peg.2042","1161"
"13394",1206,1074,132,"CTTTATTGTTAGTTGCTTT","TCAGCAACTGCTGTATTGTC","561307.5.peg.2042","1161"
"13395",306,1074,768,"GCCTGTCCACCTTGGTTTGC","TCAGCAACTGCTGTATTGTC","561307.5.peg.2042","1161"
"13396",314,1074,760,"CTGGATTAGCCTGTCCACCT","TCAGCAACTGCTGTATTGTC","561307.5.peg.2042","1161"
"13397",276,1074,798,"GCTGGTTGTCCTTGGTTGGC","TCAGCAACTGCTGTATTGTC","561307.5.peg.2042","1161"
"13398",204,1074,870,"GGCTGTGTATTGGCATCAGC","TCAGCAACTGCTGTATTGTC","561307.5.peg.2042","1161"
"13399",267,1074,807,"CCTTGGTTGGCAGGTGCAGC","TCAGCAACTGCTGTATTGTC","561307.5.peg.2042","1161"
"13400",522,1074,552,"GCTGCTGGTTGCGCTGCTGC","TCAGCAACTGCTGTATTGTC","561307.5.peg.2042","1161"
"13401",146,1074,928,"CTGCTGCAGACGCTGTTGTC","TCAGCAACTGCTGTATTGTC","561307.5.peg.2042","1161"
"13402",9,1074,1065,"AGCGAGAATAATCAACCAGG","TCAGCAACTGCTGTATTGTC","561307.5.peg.2042","1161"
"13403",1314,1074,240,"TTAACGTAAGTTACACCTTG","TCAGCAACTGCTGTATTGTC","561307.5.peg.2042","1161"
"13404",637,1074,437,"CTATTCTCATCTGTTGATA","TCAGCAACTGCTGTATTGTC","561307.5.peg.2042","1161"
"13405",195,1074,879,"TTGGCATCAGCTGGTTGTGC","TCAGCAACTGCTGTATTGTC","561307.5.peg.2042","1161"
"13406",1617,1074,543,"TCTGCAGTTAGTGTAACTTC","TCAGCAACTGCTGTATTGTC","561307.5.peg.2042","1161"
"13407",12,1074,1062,"AACAGCGAGAATAATCAACC","TCAGCAACTGCTGTATTGTC","561307.5.peg.2042","1161"
"13408",3391,1074,2317,"TGTATGTGCTGCATCTATTG","TCAGCAACTGCTGTATTGTC","561307.5.peg.2042","1161"
"13409",225,1074,849,"TGAGCACCAGCATTTGCGTT","TCAGCAACTGCTGTATTGTC","561307.5.peg.2042","1161"
"13410",576,1074,498,"TCACCAGTATTGCTAGCATT","TCAGCAACTGCTGTATTGTC","561307.5.peg.2042","1161"
"13411",2316,1074,1242,"GCTGCTTTAGCTGTTGTAGC","TCAGCAACTGCTGTATTGTC","561307.5.peg.2042","1161"
"13412",1358,1074,284,"TACTGTCTTCATTACCATTA","TCAGCAACTGCTGTATTGTC","561307.5.peg.2042","1161"
"13413",435,1074,639,"CCTTGACCTGCTTGGTTTGC","TCAGCAACTGCTGTATTGTC","561307.5.peg.2042","1161"
"13414",3013,1074,1939,"TGCATCCGATTTCTTAGTTG","TCAGCAACTGCTGTATTGTC","561307.5.peg.2042","1161"
"13415",294,1074,780,"TGGTTTGCTGGTTGTACTGC","TCAGCAACTGCTGTATTGTC","561307.5.peg.2042","1161"
"13416",280,1074,794,"TACTGCTGGTTGTCCTTGGT","TCAGCAACTGCTGTATTGTC","561307.5.peg.2042","1161"
"13417",510,1074,564,"GCTGCTGCTGGAGCATTCGC","TCAGCAACTGCTGTATTGTC","561307.5.peg.2042","1161"
"13418",2126,1074,1052,"GTTTACGAGTTGTAACTGCT","TCAGCAACTGCTGTATTGTC","561307.5.peg.2042","1161"
"13419",393,1074,681,"TGTGCTTGTGCAGCGTTATT","TCAGCAACTGCTGTATTGTC","561307.5.peg.2042","1161"
"13420",546,1074,528,"GTTTGTGCGTTTGCTGCTAC","TCAGCAACTGCTGTATTGTC","561307.5.peg.2042","1161"
"13421",576,1206,630,"TCACCAGTATTGCTAGCATT","CTTTATTGTTAGTTGCTTT","561307.5.peg.2042","1161"
"13422",35,1206,1171,"AATTCATTAAGTCATCCTCC","CTTTATTGTTAGTTGCTTT","561307.5.peg.2042","1161"
"13423",1038,1206,168,"TCTAAACGATCAGCATCAGT","CTTTATTGTTAGTTGCTTT","561307.5.peg.2042","1161"
"13424",435,1206,771,"CCTTGACCTGCTTGGTTTGC","CTTTATTGTTAGTTGCTTT","561307.5.peg.2042","1161"
"13425",280,1206,926,"TACTGCTGGTTGTCCTTGGT","CTTTATTGTTAGTTGCTTT","561307.5.peg.2042","1161"
"13426",294,1206,912,"TGGTTTGCTGGTTGTACTGC","CTTTATTGTTAGTTGCTTT","561307.5.peg.2042","1161"
"13427",3391,1206,2185,"TGTATGTGCTGCATCTATTG","CTTTATTGTTAGTTGCTTT","561307.5.peg.2042","1161"
"13428",537,1206,669,"TTTGCTGCTACAGGTGCTGC","CTTTATTGTTAGTTGCTTT","561307.5.peg.2042","1161"
"13429",1358,1206,152,"TACTGTCTTCATTACCATTA","CTTTATTGTTAGTTGCTTT","561307.5.peg.2042","1161"
"13430",546,1206,660,"GTTTGTGCGTTTGCTGCTAC","CTTTATTGTTAGTTGCTTT","561307.5.peg.2042","1161"
"13431",314,1206,892,"CTGGATTAGCCTGTCCACCT","CTTTATTGTTAGTTGCTTT","561307.5.peg.2042","1161"
"13432",2316,1206,1110,"GCTGCTTTAGCTGTTGTAGC","CTTTATTGTTAGTTGCTTT","561307.5.peg.2042","1161"
"13433",204,1206,1002,"GGCTGTGTATTGGCATCAGC","CTTTATTGTTAGTTGCTTT","561307.5.peg.2042","1161"
"13434",1314,1206,108,"TTAACGTAAGTTACACCTTG","CTTTATTGTTAGTTGCTTT","561307.5.peg.2042","1161"
"13435",306,1206,900,"GCCTGTCCACCTTGGTTTGC","CTTTATTGTTAGTTGCTTT","561307.5.peg.2042","1161"
"13436",214,1206,992,"ATTTGCGTTAGGCTGTGTAT","CTTTATTGTTAGTTGCTTT","561307.5.peg.2042","1161"
"13437",284,1206,922,"GTTGTACTGCTGGTTGTCCT","CTTTATTGTTAGTTGCTTT","561307.5.peg.2042","1161"
"13438",276,1206,930,"GCTGGTTGTCCTTGGTTGGC","CTTTATTGTTAGTTGCTTT","561307.5.peg.2042","1161"
"13439",3013,1206,1807,"TGCATCCGATTTCTTAGTTG","CTTTATTGTTAGTTGCTTT","561307.5.peg.2042","1161"
"13440",1074,1206,132,"TCAGCAACTGCTGTATTGTC","CTTTATTGTTAGTTGCTTT","561307.5.peg.2042","1161"
"13441",637,1206,569,"CTATTCTCATCTGTTGATA","CTTTATTGTTAGTTGCTTT","561307.5.peg.2042","1161"
"13442",12,1206,1194,"AACAGCGAGAATAATCAACC","CTTTATTGTTAGTTGCTTT","561307.5.peg.2042","1161"
"13443",255,1206,951,"GGTGCAGCTGGCTGTGCTGT","CTTTATTGTTAGTTGCTTT","561307.5.peg.2042","1161"
"13444",333,1206,873,"GGTTGTGCTGCTCCTCCTGC","CTTTATTGTTAGTTGCTTT","561307.5.peg.2042","1161"
"13445",1442,1206,236,"CACGTGCCGTTGTCACACCT","CTTTATTGTTAGTTGCTTT","561307.5.peg.2042","1161"
"13446",1617,1206,411,"TCTGCAGTTAGTGTAACTTC","CTTTATTGTTAGTTGCTTT","561307.5.peg.2042","1161"
"13447",2796,1206,1590,"TCTACTTCCGTATCAGCTGC","CTTTATTGTTAGTTGCTTT","561307.5.peg.2042","1161"
"13448",354,1206,852,"TGTCCAGCTGGTTGTGTATT","CTTTATTGTTAGTTGCTTT","561307.5.peg.2042","1161"
"13449",146,1206,1060,"CTGCTGCAGACGCTGTTGTC","CTTTATTGTTAGTTGCTTT","561307.5.peg.2042","1161"
"13450",510,1206,696,"GCTGCTGCTGGAGCATTCGC","CTTTATTGTTAGTTGCTTT","561307.5.peg.2042","1161"
"13451",2126,1206,920,"GTTTACGAGTTGTAACTGCT","CTTTATTGTTAGTTGCTTT","561307.5.peg.2042","1161"
"13452",522,1206,684,"GCTGCTGGTTGCGCTGCTGC","CTTTATTGTTAGTTGCTTT","561307.5.peg.2042","1161"
"13453",9,1206,1197,"AGCGAGAATAATCAACCAGG","CTTTATTGTTAGTTGCTTT","561307.5.peg.2042","1161"
"13454",195,1206,1011,"TTGGCATCAGCTGGTTGTGC","CTTTATTGTTAGTTGCTTT","561307.5.peg.2042","1161"
"13455",443,1206,763,"GGTTATTTCCTTGACCTGCT","CTTTATTGTTAGTTGCTTT","561307.5.peg.2042","1161"
"13456",393,1206,813,"TGTGCTTGTGCAGCGTTATT","CTTTATTGTTAGTTGCTTT","561307.5.peg.2042","1161"
"13457",225,1206,981,"TGAGCACCAGCATTTGCGTT","CTTTATTGTTAGTTGCTTT","561307.5.peg.2042","1161"
"13458",417,1206,789,"GCCGGTGTTGCTTGATTTCC","CTTTATTGTTAGTTGCTTT","561307.5.peg.2042","1161"
"13459",267,1206,939,"CCTTGGTTGGCAGGTGCAGC","CTTTATTGTTAGTTGCTTT","561307.5.peg.2042","1161"
"13460",435,1314,879,"CCTTGACCTGCTTGGTTTGC","TTAACGTAAGTTACACCTTG","561307.5.peg.2042","1161"
"13461",195,1314,1119,"TTGGCATCAGCTGGTTGTGC","TTAACGTAAGTTACACCTTG","561307.5.peg.2042","1161"
"13462",314,1314,1000,"CTGGATTAGCCTGTCCACCT","TTAACGTAAGTTACACCTTG","561307.5.peg.2042","1161"
"13463",333,1314,981,"GGTTGTGCTGCTCCTCCTGC","TTAACGTAAGTTACACCTTG","561307.5.peg.2042","1161"
"13464",522,1314,792,"GCTGCTGGTTGCGCTGCTGC","TTAACGTAAGTTACACCTTG","561307.5.peg.2042","1161"
"13465",12,1314,1302,"AACAGCGAGAATAATCAACC","TTAACGTAAGTTACACCTTG","561307.5.peg.2042","1161"
"13466",225,1314,1089,"TGAGCACCAGCATTTGCGTT","TTAACGTAAGTTACACCTTG","561307.5.peg.2042","1161"
"13467",443,1314,871,"GGTTATTTCCTTGACCTGCT","TTAACGTAAGTTACACCTTG","561307.5.peg.2042","1161"
"13468",276,1314,1038,"GCTGGTTGTCCTTGGTTGGC","TTAACGTAAGTTACACCTTG","561307.5.peg.2042","1161"
"13469",146,1314,1168,"CTGCTGCAGACGCTGTTGTC","TTAACGTAAGTTACACCTTG","561307.5.peg.2042","1161"
"13470",284,1314,1030,"GTTGTACTGCTGGTTGTCCT","TTAACGTAAGTTACACCTTG","561307.5.peg.2042","1161"
"13471",537,1314,777,"TTTGCTGCTACAGGTGCTGC","TTAACGTAAGTTACACCTTG","561307.5.peg.2042","1161"
"13472",546,1314,768,"GTTTGTGCGTTTGCTGCTAC","TTAACGTAAGTTACACCTTG","561307.5.peg.2042","1161"
"13473",354,1314,960,"TGTCCAGCTGGTTGTGTATT","TTAACGTAAGTTACACCTTG","561307.5.peg.2042","1161"
"13474",417,1314,897,"GCCGGTGTTGCTTGATTTCC","TTAACGTAAGTTACACCTTG","561307.5.peg.2042","1161"
"13475",1074,1314,240,"TCAGCAACTGCTGTATTGTC","TTAACGTAAGTTACACCTTG","561307.5.peg.2042","1161"
"13476",35,1314,1279,"AATTCATTAAGTCATCCTCC","TTAACGTAAGTTACACCTTG","561307.5.peg.2042","1161"
"13477",1206,1314,108,"CTTTATTGTTAGTTGCTTT","TTAACGTAAGTTACACCTTG","561307.5.peg.2042","1161"
"13478",510,1314,804,"GCTGCTGCTGGAGCATTCGC","TTAACGTAAGTTACACCTTG","561307.5.peg.2042","1161"
"13479",2126,1314,812,"GTTTACGAGTTGTAACTGCT","TTAACGTAAGTTACACCTTG","561307.5.peg.2042","1161"
"13480",393,1314,921,"TGTGCTTGTGCAGCGTTATT","TTAACGTAAGTTACACCTTG","561307.5.peg.2042","1161"
"13481",306,1314,1008,"GCCTGTCCACCTTGGTTTGC","TTAACGTAAGTTACACCTTG","561307.5.peg.2042","1161"
"13482",255,1314,1059,"GGTGCAGCTGGCTGTGCTGT","TTAACGTAAGTTACACCTTG","561307.5.peg.2042","1161"
"13483",2796,1314,1482,"TCTACTTCCGTATCAGCTGC","TTAACGTAAGTTACACCTTG","561307.5.peg.2042","1161"
"13484",204,1314,1110,"GGCTGTGTATTGGCATCAGC","TTAACGTAAGTTACACCTTG","561307.5.peg.2042","1161"
"13485",637,1314,677,"CTATTCTCATCTGTTGATA","TTAACGTAAGTTACACCTTG","561307.5.peg.2042","1161"
"13486",294,1314,1020,"TGGTTTGCTGGTTGTACTGC","TTAACGTAAGTTACACCTTG","561307.5.peg.2042","1161"
"13487",1038,1314,276,"TCTAAACGATCAGCATCAGT","TTAACGTAAGTTACACCTTG","561307.5.peg.2042","1161"
"13488",1617,1314,303,"TCTGCAGTTAGTGTAACTTC","TTAACGTAAGTTACACCTTG","561307.5.peg.2042","1161"
"13489",2316,1314,1002,"GCTGCTTTAGCTGTTGTAGC","TTAACGTAAGTTACACCTTG","561307.5.peg.2042","1161"
"13490",214,1314,1100,"ATTTGCGTTAGGCTGTGTAT","TTAACGTAAGTTACACCTTG","561307.5.peg.2042","1161"
"13491",280,1314,1034,"TACTGCTGGTTGTCCTTGGT","TTAACGTAAGTTACACCTTG","561307.5.peg.2042","1161"
"13492",267,1314,1047,"CCTTGGTTGGCAGGTGCAGC","TTAACGTAAGTTACACCTTG","561307.5.peg.2042","1161"
"13493",3391,1314,2077,"TGTATGTGCTGCATCTATTG","TTAACGTAAGTTACACCTTG","561307.5.peg.2042","1161"
"13494",576,1314,738,"TCACCAGTATTGCTAGCATT","TTAACGTAAGTTACACCTTG","561307.5.peg.2042","1161"
"13495",1442,1314,128,"CACGTGCCGTTGTCACACCT","TTAACGTAAGTTACACCTTG","561307.5.peg.2042","1161"
"13496",9,1314,1305,"AGCGAGAATAATCAACCAGG","TTAACGTAAGTTACACCTTG","561307.5.peg.2042","1161"
"13497",3013,1314,1699,"TGCATCCGATTTCTTAGTTG","TTAACGTAAGTTACACCTTG","561307.5.peg.2042","1161"
"13498",435,1358,923,"CCTTGACCTGCTTGGTTTGC","TACTGTCTTCATTACCATTA","561307.5.peg.2042","1161"
"13499",522,1358,836,"GCTGCTGGTTGCGCTGCTGC","TACTGTCTTCATTACCATTA","561307.5.peg.2042","1161"
"13500",443,1358,915,"GGTTATTTCCTTGACCTGCT","TACTGTCTTCATTACCATTA","561307.5.peg.2042","1161"
"13501",255,1358,1103,"GGTGCAGCTGGCTGTGCTGT","TACTGTCTTCATTACCATTA","561307.5.peg.2042","1161"
"13502",537,1358,821,"TTTGCTGCTACAGGTGCTGC","TACTGTCTTCATTACCATTA","561307.5.peg.2042","1161"
"13503",12,1358,1346,"AACAGCGAGAATAATCAACC","TACTGTCTTCATTACCATTA","561307.5.peg.2042","1161"
"13504",637,1358,721,"CTATTCTCATCTGTTGATA","TACTGTCTTCATTACCATTA","561307.5.peg.2042","1161"
"13505",1074,1358,284,"TCAGCAACTGCTGTATTGTC","TACTGTCTTCATTACCATTA","561307.5.peg.2042","1161"
"13506",546,1358,812,"GTTTGTGCGTTTGCTGCTAC","TACTGTCTTCATTACCATTA","561307.5.peg.2042","1161"
"13507",9,1358,1349,"AGCGAGAATAATCAACCAGG","TACTGTCTTCATTACCATTA","561307.5.peg.2042","1161"
"13508",214,1358,1144,"ATTTGCGTTAGGCTGTGTAT","TACTGTCTTCATTACCATTA","561307.5.peg.2042","1161"
"13509",2796,1358,1438,"TCTACTTCCGTATCAGCTGC","TACTGTCTTCATTACCATTA","561307.5.peg.2042","1161"
"13510",276,1358,1082,"GCTGGTTGTCCTTGGTTGGC","TACTGTCTTCATTACCATTA","561307.5.peg.2042","1161"
"13511",3013,1358,1655,"TGCATCCGATTTCTTAGTTG","TACTGTCTTCATTACCATTA","561307.5.peg.2042","1161"
"13512",314,1358,1044,"CTGGATTAGCCTGTCCACCT","TACTGTCTTCATTACCATTA","561307.5.peg.2042","1161"
"13513",510,1358,848,"GCTGCTGCTGGAGCATTCGC","TACTGTCTTCATTACCATTA","561307.5.peg.2042","1161"
"13514",2126,1358,768,"GTTTACGAGTTGTAACTGCT","TACTGTCTTCATTACCATTA","561307.5.peg.2042","1161"
"13515",333,1358,1025,"GGTTGTGCTGCTCCTCCTGC","TACTGTCTTCATTACCATTA","561307.5.peg.2042","1161"
"13516",393,1358,965,"TGTGCTTGTGCAGCGTTATT","TACTGTCTTCATTACCATTA","561307.5.peg.2042","1161"
"13517",280,1358,1078,"TACTGCTGGTTGTCCTTGGT","TACTGTCTTCATTACCATTA","561307.5.peg.2042","1161"
"13518",3391,1358,2033,"TGTATGTGCTGCATCTATTG","TACTGTCTTCATTACCATTA","561307.5.peg.2042","1161"
"13519",294,1358,1064,"TGGTTTGCTGGTTGTACTGC","TACTGTCTTCATTACCATTA","561307.5.peg.2042","1161"
"13520",354,1358,1004,"TGTCCAGCTGGTTGTGTATT","TACTGTCTTCATTACCATTA","561307.5.peg.2042","1161"
"13521",195,1358,1163,"TTGGCATCAGCTGGTTGTGC","TACTGTCTTCATTACCATTA","561307.5.peg.2042","1161"
"13522",576,1358,782,"TCACCAGTATTGCTAGCATT","TACTGTCTTCATTACCATTA","561307.5.peg.2042","1161"
"13523",306,1358,1052,"GCCTGTCCACCTTGGTTTGC","TACTGTCTTCATTACCATTA","561307.5.peg.2042","1161"
"13524",267,1358,1091,"CCTTGGTTGGCAGGTGCAGC","TACTGTCTTCATTACCATTA","561307.5.peg.2042","1161"
"13525",225,1358,1133,"TGAGCACCAGCATTTGCGTT","TACTGTCTTCATTACCATTA","561307.5.peg.2042","1161"
"13526",1038,1358,320,"TCTAAACGATCAGCATCAGT","TACTGTCTTCATTACCATTA","561307.5.peg.2042","1161"
"13527",35,1358,1323,"AATTCATTAAGTCATCCTCC","TACTGTCTTCATTACCATTA","561307.5.peg.2042","1161"
"13528",1617,1358,259,"TCTGCAGTTAGTGTAACTTC","TACTGTCTTCATTACCATTA","561307.5.peg.2042","1161"
"13529",417,1358,941,"GCCGGTGTTGCTTGATTTCC","TACTGTCTTCATTACCATTA","561307.5.peg.2042","1161"
"13530",204,1358,1154,"GGCTGTGTATTGGCATCAGC","TACTGTCTTCATTACCATTA","561307.5.peg.2042","1161"
"13531",1206,1358,152,"CTTTATTGTTAGTTGCTTT","TACTGTCTTCATTACCATTA","561307.5.peg.2042","1161"
"13532",2316,1358,958,"GCTGCTTTAGCTGTTGTAGC","TACTGTCTTCATTACCATTA","561307.5.peg.2042","1161"
"13533",284,1358,1074,"GTTGTACTGCTGGTTGTCCT","TACTGTCTTCATTACCATTA","561307.5.peg.2042","1161"
"13534",146,1358,1212,"CTGCTGCAGACGCTGTTGTC","TACTGTCTTCATTACCATTA","561307.5.peg.2042","1161"
"13535",443,1442,999,"GGTTATTTCCTTGACCTGCT","CACGTGCCGTTGTCACACCT","561307.5.peg.2042","1161"
"13536",1074,1442,368,"TCAGCAACTGCTGTATTGTC","CACGTGCCGTTGTCACACCT","561307.5.peg.2042","1161"
"13537",225,1442,1217,"TGAGCACCAGCATTTGCGTT","CACGTGCCGTTGTCACACCT","561307.5.peg.2042","1161"
"13538",2796,1442,1354,"TCTACTTCCGTATCAGCTGC","CACGTGCCGTTGTCACACCT","561307.5.peg.2042","1161"
"13539",267,1442,1175,"CCTTGGTTGGCAGGTGCAGC","CACGTGCCGTTGTCACACCT","561307.5.peg.2042","1161"
"13540",146,1442,1296,"CTGCTGCAGACGCTGTTGTC","CACGTGCCGTTGTCACACCT","561307.5.peg.2042","1161"
"13541",393,1442,1049,"TGTGCTTGTGCAGCGTTATT","CACGTGCCGTTGTCACACCT","561307.5.peg.2042","1161"
"13542",3013,1442,1571,"TGCATCCGATTTCTTAGTTG","CACGTGCCGTTGTCACACCT","561307.5.peg.2042","1161"
"13543",333,1442,1109,"GGTTGTGCTGCTCCTCCTGC","CACGTGCCGTTGTCACACCT","561307.5.peg.2042","1161"
"13544",1038,1442,404,"TCTAAACGATCAGCATCAGT","CACGTGCCGTTGTCACACCT","561307.5.peg.2042","1161"
"13545",637,1442,805,"CTATTCTCATCTGTTGATA","CACGTGCCGTTGTCACACCT","561307.5.peg.2042","1161"
"13546",546,1442,896,"GTTTGTGCGTTTGCTGCTAC","CACGTGCCGTTGTCACACCT","561307.5.peg.2042","1161"
"13547",214,1442,1228,"ATTTGCGTTAGGCTGTGTAT","CACGTGCCGTTGTCACACCT","561307.5.peg.2042","1161"
"13548",1617,1442,175,"TCTGCAGTTAGTGTAACTTC","CACGTGCCGTTGTCACACCT","561307.5.peg.2042","1161"
"13549",9,1442,1433,"AGCGAGAATAATCAACCAGG","CACGTGCCGTTGTCACACCT","561307.5.peg.2042","1161"
"13550",2126,1442,684,"GTTTACGAGTTGTAACTGCT","CACGTGCCGTTGTCACACCT","561307.5.peg.2042","1161"
"13551",35,1442,1407,"AATTCATTAAGTCATCCTCC","CACGTGCCGTTGTCACACCT","561307.5.peg.2042","1161"
"13552",417,1442,1025,"GCCGGTGTTGCTTGATTTCC","CACGTGCCGTTGTCACACCT","561307.5.peg.2042","1161"
"13553",255,1442,1187,"GGTGCAGCTGGCTGTGCTGT","CACGTGCCGTTGTCACACCT","561307.5.peg.2042","1161"
"13554",354,1442,1088,"TGTCCAGCTGGTTGTGTATT","CACGTGCCGTTGTCACACCT","561307.5.peg.2042","1161"
"13555",195,1442,1247,"TTGGCATCAGCTGGTTGTGC","CACGTGCCGTTGTCACACCT","561307.5.peg.2042","1161"
"13556",576,1442,866,"TCACCAGTATTGCTAGCATT","CACGTGCCGTTGTCACACCT","561307.5.peg.2042","1161"
"13557",1206,1442,236,"CTTTATTGTTAGTTGCTTT","CACGTGCCGTTGTCACACCT","561307.5.peg.2042","1161"
"13558",204,1442,1238,"GGCTGTGTATTGGCATCAGC","CACGTGCCGTTGTCACACCT","561307.5.peg.2042","1161"
"13559",280,1442,1162,"TACTGCTGGTTGTCCTTGGT","CACGTGCCGTTGTCACACCT","561307.5.peg.2042","1161"
"13560",1314,1442,128,"TTAACGTAAGTTACACCTTG","CACGTGCCGTTGTCACACCT","561307.5.peg.2042","1161"
"13561",276,1442,1166,"GCTGGTTGTCCTTGGTTGGC","CACGTGCCGTTGTCACACCT","561307.5.peg.2042","1161"
"13562",522,1442,920,"GCTGCTGGTTGCGCTGCTGC","CACGTGCCGTTGTCACACCT","561307.5.peg.2042","1161"
"13563",3391,1442,1949,"TGTATGTGCTGCATCTATTG","CACGTGCCGTTGTCACACCT","561307.5.peg.2042","1161"
"13564",510,1442,932,"GCTGCTGCTGGAGCATTCGC","CACGTGCCGTTGTCACACCT","561307.5.peg.2042","1161"
"13565",284,1442,1158,"GTTGTACTGCTGGTTGTCCT","CACGTGCCGTTGTCACACCT","561307.5.peg.2042","1161"
"13566",435,1442,1007,"CCTTGACCTGCTTGGTTTGC","CACGTGCCGTTGTCACACCT","561307.5.peg.2042","1161"
"13567",306,1442,1136,"GCCTGTCCACCTTGGTTTGC","CACGTGCCGTTGTCACACCT","561307.5.peg.2042","1161"
"13568",537,1442,905,"TTTGCTGCTACAGGTGCTGC","CACGTGCCGTTGTCACACCT","561307.5.peg.2042","1161"
"13569",314,1442,1128,"CTGGATTAGCCTGTCCACCT","CACGTGCCGTTGTCACACCT","561307.5.peg.2042","1161"
"13570",12,1442,1430,"AACAGCGAGAATAATCAACC","CACGTGCCGTTGTCACACCT","561307.5.peg.2042","1161"
"13571",294,1442,1148,"TGGTTTGCTGGTTGTACTGC","CACGTGCCGTTGTCACACCT","561307.5.peg.2042","1161"
"13572",2316,1442,874,"GCTGCTTTAGCTGTTGTAGC","CACGTGCCGTTGTCACACCT","561307.5.peg.2042","1161"
"13573",1314,1617,303,"TTAACGTAAGTTACACCTTG","TCTGCAGTTAGTGTAACTTC","561307.5.peg.2042","1161"
"13574",2316,1617,699,"GCTGCTTTAGCTGTTGTAGC","TCTGCAGTTAGTGTAACTTC","561307.5.peg.2042","1161"
"13575",1358,1617,259,"TACTGTCTTCATTACCATTA","TCTGCAGTTAGTGTAACTTC","561307.5.peg.2042","1161"
"13576",276,1617,1341,"GCTGGTTGTCCTTGGTTGGC","TCTGCAGTTAGTGTAACTTC","561307.5.peg.2042","1161"
"13577",637,1617,980,"CTATTCTCATCTGTTGATA","TCTGCAGTTAGTGTAACTTC","561307.5.peg.2042","1161"
"13578",267,1617,1350,"CCTTGGTTGGCAGGTGCAGC","TCTGCAGTTAGTGTAACTTC","561307.5.peg.2042","1161"
"13579",306,1617,1311,"GCCTGTCCACCTTGGTTTGC","TCTGCAGTTAGTGTAACTTC","561307.5.peg.2042","1161"
"13580",510,1617,1107,"GCTGCTGCTGGAGCATTCGC","TCTGCAGTTAGTGTAACTTC","561307.5.peg.2042","1161"
"13581",435,1617,1182,"CCTTGACCTGCTTGGTTTGC","TCTGCAGTTAGTGTAACTTC","561307.5.peg.2042","1161"
"13582",1206,1617,411,"CTTTATTGTTAGTTGCTTT","TCTGCAGTTAGTGTAACTTC","561307.5.peg.2042","1161"
"13583",576,1617,1041,"TCACCAGTATTGCTAGCATT","TCTGCAGTTAGTGTAACTTC","561307.5.peg.2042","1161"
"13584",294,1617,1323,"TGGTTTGCTGGTTGTACTGC","TCTGCAGTTAGTGTAACTTC","561307.5.peg.2042","1161"
"13585",12,1617,1605,"AACAGCGAGAATAATCAACC","TCTGCAGTTAGTGTAACTTC","561307.5.peg.2042","1161"
"13586",417,1617,1200,"GCCGGTGTTGCTTGATTTCC","TCTGCAGTTAGTGTAACTTC","561307.5.peg.2042","1161"
"13587",314,1617,1303,"CTGGATTAGCCTGTCCACCT","TCTGCAGTTAGTGTAACTTC","561307.5.peg.2042","1161"
"13588",284,1617,1333,"GTTGTACTGCTGGTTGTCCT","TCTGCAGTTAGTGTAACTTC","561307.5.peg.2042","1161"
"13589",354,1617,1263,"TGTCCAGCTGGTTGTGTATT","TCTGCAGTTAGTGTAACTTC","561307.5.peg.2042","1161"
"13590",393,1617,1224,"TGTGCTTGTGCAGCGTTATT","TCTGCAGTTAGTGTAACTTC","561307.5.peg.2042","1161"
"13591",1074,1617,543,"TCAGCAACTGCTGTATTGTC","TCTGCAGTTAGTGTAACTTC","561307.5.peg.2042","1161"
"13592",2796,1617,1179,"TCTACTTCCGTATCAGCTGC","TCTGCAGTTAGTGTAACTTC","561307.5.peg.2042","1161"
"13593",443,1617,1174,"GGTTATTTCCTTGACCTGCT","TCTGCAGTTAGTGTAACTTC","561307.5.peg.2042","1161"
"13594",1442,1617,175,"CACGTGCCGTTGTCACACCT","TCTGCAGTTAGTGTAACTTC","561307.5.peg.2042","1161"
"13595",1038,1617,579,"TCTAAACGATCAGCATCAGT","TCTGCAGTTAGTGTAACTTC","561307.5.peg.2042","1161"
"13596",195,1617,1422,"TTGGCATCAGCTGGTTGTGC","TCTGCAGTTAGTGTAACTTC","561307.5.peg.2042","1161"
"13597",214,1617,1403,"ATTTGCGTTAGGCTGTGTAT","TCTGCAGTTAGTGTAACTTC","561307.5.peg.2042","1161"
"13598",225,1617,1392,"TGAGCACCAGCATTTGCGTT","TCTGCAGTTAGTGTAACTTC","561307.5.peg.2042","1161"
"13599",280,1617,1337,"TACTGCTGGTTGTCCTTGGT","TCTGCAGTTAGTGTAACTTC","561307.5.peg.2042","1161"
"13600",255,1617,1362,"GGTGCAGCTGGCTGTGCTGT","TCTGCAGTTAGTGTAACTTC","561307.5.peg.2042","1161"
"13601",333,1617,1284,"GGTTGTGCTGCTCCTCCTGC","TCTGCAGTTAGTGTAACTTC","561307.5.peg.2042","1161"
"13602",2126,1617,509,"GTTTACGAGTTGTAACTGCT","TCTGCAGTTAGTGTAACTTC","561307.5.peg.2042","1161"
"13603",146,1617,1471,"CTGCTGCAGACGCTGTTGTC","TCTGCAGTTAGTGTAACTTC","561307.5.peg.2042","1161"
"13604",3391,1617,1774,"TGTATGTGCTGCATCTATTG","TCTGCAGTTAGTGTAACTTC","561307.5.peg.2042","1161"
"13605",522,1617,1095,"GCTGCTGGTTGCGCTGCTGC","TCTGCAGTTAGTGTAACTTC","561307.5.peg.2042","1161"
"13606",204,1617,1413,"GGCTGTGTATTGGCATCAGC","TCTGCAGTTAGTGTAACTTC","561307.5.peg.2042","1161"
"13607",537,1617,1080,"TTTGCTGCTACAGGTGCTGC","TCTGCAGTTAGTGTAACTTC","561307.5.peg.2042","1161"
"13608",546,1617,1071,"GTTTGTGCGTTTGCTGCTAC","TCTGCAGTTAGTGTAACTTC","561307.5.peg.2042","1161"
"13609",9,1617,1608,"AGCGAGAATAATCAACCAGG","TCTGCAGTTAGTGTAACTTC","561307.5.peg.2042","1161"
"13610",35,1617,1582,"AATTCATTAAGTCATCCTCC","TCTGCAGTTAGTGTAACTTC","561307.5.peg.2042","1161"
"13611",3013,1617,1396,"TGCATCCGATTTCTTAGTTG","TCTGCAGTTAGTGTAACTTC","561307.5.peg.2042","1161"
"13612",1206,2126,920,"CTTTATTGTTAGTTGCTTT","GTTTACGAGTTGTAACTGCT","561307.5.peg.2042","1161"
"13613",443,2126,1683,"GGTTATTTCCTTGACCTGCT","GTTTACGAGTTGTAACTGCT","561307.5.peg.2042","1161"
"13614",314,2126,1812,"CTGGATTAGCCTGTCCACCT","GTTTACGAGTTGTAACTGCT","561307.5.peg.2042","1161"
"13615",1442,2126,684,"CACGTGCCGTTGTCACACCT","GTTTACGAGTTGTAACTGCT","561307.5.peg.2042","1161"
"13616",146,2126,1980,"CTGCTGCAGACGCTGTTGTC","GTTTACGAGTTGTAACTGCT","561307.5.peg.2042","1161"
"13617",12,2126,2114,"AACAGCGAGAATAATCAACC","GTTTACGAGTTGTAACTGCT","561307.5.peg.2042","1161"
"13618",3391,2126,1265,"TGTATGTGCTGCATCTATTG","GTTTACGAGTTGTAACTGCT","561307.5.peg.2042","1161"
"13619",214,2126,1912,"ATTTGCGTTAGGCTGTGTAT","GTTTACGAGTTGTAACTGCT","561307.5.peg.2042","1161"
"13620",1314,2126,812,"TTAACGTAAGTTACACCTTG","GTTTACGAGTTGTAACTGCT","561307.5.peg.2042","1161"
"13621",510,2126,1616,"GCTGCTGCTGGAGCATTCGC","GTTTACGAGTTGTAACTGCT","561307.5.peg.2042","1161"
"13622",267,2126,1859,"CCTTGGTTGGCAGGTGCAGC","GTTTACGAGTTGTAACTGCT","561307.5.peg.2042","1161"
"13623",306,2126,1820,"GCCTGTCCACCTTGGTTTGC","GTTTACGAGTTGTAACTGCT","561307.5.peg.2042","1161"
"13624",1617,2126,509,"TCTGCAGTTAGTGTAACTTC","GTTTACGAGTTGTAACTGCT","561307.5.peg.2042","1161"
"13625",393,2126,1733,"TGTGCTTGTGCAGCGTTATT","GTTTACGAGTTGTAACTGCT","561307.5.peg.2042","1161"
"13626",1038,2126,1088,"TCTAAACGATCAGCATCAGT","GTTTACGAGTTGTAACTGCT","561307.5.peg.2042","1161"
"13627",204,2126,1922,"GGCTGTGTATTGGCATCAGC","GTTTACGAGTTGTAACTGCT","561307.5.peg.2042","1161"
"13628",2316,2126,190,"GCTGCTTTAGCTGTTGTAGC","GTTTACGAGTTGTAACTGCT","561307.5.peg.2042","1161"
"13629",9,2126,2117,"AGCGAGAATAATCAACCAGG","GTTTACGAGTTGTAACTGCT","561307.5.peg.2042","1161"
"13630",225,2126,1901,"TGAGCACCAGCATTTGCGTT","GTTTACGAGTTGTAACTGCT","561307.5.peg.2042","1161"
"13631",280,2126,1846,"TACTGCTGGTTGTCCTTGGT","GTTTACGAGTTGTAACTGCT","561307.5.peg.2042","1161"
"13632",276,2126,1850,"GCTGGTTGTCCTTGGTTGGC","GTTTACGAGTTGTAACTGCT","561307.5.peg.2042","1161"
"13633",255,2126,1871,"GGTGCAGCTGGCTGTGCTGT","GTTTACGAGTTGTAACTGCT","561307.5.peg.2042","1161"
"13634",522,2126,1604,"GCTGCTGGTTGCGCTGCTGC","GTTTACGAGTTGTAACTGCT","561307.5.peg.2042","1161"
"13635",546,2126,1580,"GTTTGTGCGTTTGCTGCTAC","GTTTACGAGTTGTAACTGCT","561307.5.peg.2042","1161"
"13636",417,2126,1709,"GCCGGTGTTGCTTGATTTCC","GTTTACGAGTTGTAACTGCT","561307.5.peg.2042","1161"
"13637",35,2126,2091,"AATTCATTAAGTCATCCTCC","GTTTACGAGTTGTAACTGCT","561307.5.peg.2042","1161"
"13638",195,2126,1931,"TTGGCATCAGCTGGTTGTGC","GTTTACGAGTTGTAACTGCT","561307.5.peg.2042","1161"
"13639",537,2126,1589,"TTTGCTGCTACAGGTGCTGC","GTTTACGAGTTGTAACTGCT","561307.5.peg.2042","1161"
"13640",333,2126,1793,"GGTTGTGCTGCTCCTCCTGC","GTTTACGAGTTGTAACTGCT","561307.5.peg.2042","1161"
"13641",576,2126,1550,"TCACCAGTATTGCTAGCATT","GTTTACGAGTTGTAACTGCT","561307.5.peg.2042","1161"
"13642",1358,2126,768,"TACTGTCTTCATTACCATTA","GTTTACGAGTTGTAACTGCT","561307.5.peg.2042","1161"
"13643",354,2126,1772,"TGTCCAGCTGGTTGTGTATT","GTTTACGAGTTGTAACTGCT","561307.5.peg.2042","1161"
"13644",2796,2126,670,"TCTACTTCCGTATCAGCTGC","GTTTACGAGTTGTAACTGCT","561307.5.peg.2042","1161"
"13645",435,2126,1691,"CCTTGACCTGCTTGGTTTGC","GTTTACGAGTTGTAACTGCT","561307.5.peg.2042","1161"
"13646",3013,2126,887,"TGCATCCGATTTCTTAGTTG","GTTTACGAGTTGTAACTGCT","561307.5.peg.2042","1161"
"13647",284,2126,1842,"GTTGTACTGCTGGTTGTCCT","GTTTACGAGTTGTAACTGCT","561307.5.peg.2042","1161"
"13648",294,2126,1832,"TGGTTTGCTGGTTGTACTGC","GTTTACGAGTTGTAACTGCT","561307.5.peg.2042","1161"
"13649",1074,2126,1052,"TCAGCAACTGCTGTATTGTC","GTTTACGAGTTGTAACTGCT","561307.5.peg.2042","1161"
"13650",637,2126,1489,"CTATTCTCATCTGTTGATA","GTTTACGAGTTGTAACTGCT","561307.5.peg.2042","1161"
"13651",280,2316,2036,"TACTGCTGGTTGTCCTTGGT","GCTGCTTTAGCTGTTGTAGC","561307.5.peg.2042","1161"
"13652",204,2316,2112,"GGCTGTGTATTGGCATCAGC","GCTGCTTTAGCTGTTGTAGC","561307.5.peg.2042","1161"
"13653",354,2316,1962,"TGTCCAGCTGGTTGTGTATT","GCTGCTTTAGCTGTTGTAGC","561307.5.peg.2042","1161"
"13654",1314,2316,1002,"TTAACGTAAGTTACACCTTG","GCTGCTTTAGCTGTTGTAGC","561307.5.peg.2042","1161"
"13655",510,2316,1806,"GCTGCTGCTGGAGCATTCGC","GCTGCTTTAGCTGTTGTAGC","561307.5.peg.2042","1161"
"13656",2126,2316,190,"GTTTACGAGTTGTAACTGCT","GCTGCTTTAGCTGTTGTAGC","561307.5.peg.2042","1161"
"13657",3391,2316,1075,"TGTATGTGCTGCATCTATTG","GCTGCTTTAGCTGTTGTAGC","561307.5.peg.2042","1161"
"13658",1358,2316,958,"TACTGTCTTCATTACCATTA","GCTGCTTTAGCTGTTGTAGC","561307.5.peg.2042","1161"
"13659",333,2316,1983,"GGTTGTGCTGCTCCTCCTGC","GCTGCTTTAGCTGTTGTAGC","561307.5.peg.2042","1161"
"13660",146,2316,2170,"CTGCTGCAGACGCTGTTGTC","GCTGCTTTAGCTGTTGTAGC","561307.5.peg.2042","1161"
"13661",443,2316,1873,"GGTTATTTCCTTGACCTGCT","GCTGCTTTAGCTGTTGTAGC","561307.5.peg.2042","1161"
"13662",1442,2316,874,"CACGTGCCGTTGTCACACCT","GCTGCTTTAGCTGTTGTAGC","561307.5.peg.2042","1161"
"13663",3013,2316,697,"TGCATCCGATTTCTTAGTTG","GCTGCTTTAGCTGTTGTAGC","561307.5.peg.2042","1161"
"13664",522,2316,1794,"GCTGCTGGTTGCGCTGCTGC","GCTGCTTTAGCTGTTGTAGC","561307.5.peg.2042","1161"
"13665",1038,2316,1278,"TCTAAACGATCAGCATCAGT","GCTGCTTTAGCTGTTGTAGC","561307.5.peg.2042","1161"
"13666",435,2316,1881,"CCTTGACCTGCTTGGTTTGC","GCTGCTTTAGCTGTTGTAGC","561307.5.peg.2042","1161"
"13667",12,2316,2304,"AACAGCGAGAATAATCAACC","GCTGCTTTAGCTGTTGTAGC","561307.5.peg.2042","1161"
"13668",225,2316,2091,"TGAGCACCAGCATTTGCGTT","GCTGCTTTAGCTGTTGTAGC","561307.5.peg.2042","1161"
"13669",276,2316,2040,"GCTGGTTGTCCTTGGTTGGC","GCTGCTTTAGCTGTTGTAGC","561307.5.peg.2042","1161"
"13670",306,2316,2010,"GCCTGTCCACCTTGGTTTGC","GCTGCTTTAGCTGTTGTAGC","561307.5.peg.2042","1161"
"13671",537,2316,1779,"TTTGCTGCTACAGGTGCTGC","GCTGCTTTAGCTGTTGTAGC","561307.5.peg.2042","1161"
"13672",267,2316,2049,"CCTTGGTTGGCAGGTGCAGC","GCTGCTTTAGCTGTTGTAGC","561307.5.peg.2042","1161"
"13673",637,2316,1679,"CTATTCTCATCTGTTGATA","GCTGCTTTAGCTGTTGTAGC","561307.5.peg.2042","1161"
"13674",393,2316,1923,"TGTGCTTGTGCAGCGTTATT","GCTGCTTTAGCTGTTGTAGC","561307.5.peg.2042","1161"
"13675",314,2316,2002,"CTGGATTAGCCTGTCCACCT","GCTGCTTTAGCTGTTGTAGC","561307.5.peg.2042","1161"
"13676",2796,2316,480,"TCTACTTCCGTATCAGCTGC","GCTGCTTTAGCTGTTGTAGC","561307.5.peg.2042","1161"
"13677",255,2316,2061,"GGTGCAGCTGGCTGTGCTGT","GCTGCTTTAGCTGTTGTAGC","561307.5.peg.2042","1161"
"13678",1206,2316,1110,"CTTTATTGTTAGTTGCTTT","GCTGCTTTAGCTGTTGTAGC","561307.5.peg.2042","1161"
"13679",294,2316,2022,"TGGTTTGCTGGTTGTACTGC","GCTGCTTTAGCTGTTGTAGC","561307.5.peg.2042","1161"
"13680",576,2316,1740,"TCACCAGTATTGCTAGCATT","GCTGCTTTAGCTGTTGTAGC","561307.5.peg.2042","1161"
"13681",1074,2316,1242,"TCAGCAACTGCTGTATTGTC","GCTGCTTTAGCTGTTGTAGC","561307.5.peg.2042","1161"
"13682",35,2316,2281,"AATTCATTAAGTCATCCTCC","GCTGCTTTAGCTGTTGTAGC","561307.5.peg.2042","1161"
"13683",195,2316,2121,"TTGGCATCAGCTGGTTGTGC","GCTGCTTTAGCTGTTGTAGC","561307.5.peg.2042","1161"
"13684",417,2316,1899,"GCCGGTGTTGCTTGATTTCC","GCTGCTTTAGCTGTTGTAGC","561307.5.peg.2042","1161"
"13685",546,2316,1770,"GTTTGTGCGTTTGCTGCTAC","GCTGCTTTAGCTGTTGTAGC","561307.5.peg.2042","1161"
"13686",1617,2316,699,"TCTGCAGTTAGTGTAACTTC","GCTGCTTTAGCTGTTGTAGC","561307.5.peg.2042","1161"
"13687",284,2316,2032,"GTTGTACTGCTGGTTGTCCT","GCTGCTTTAGCTGTTGTAGC","561307.5.peg.2042","1161"
"13688",214,2316,2102,"ATTTGCGTTAGGCTGTGTAT","GCTGCTTTAGCTGTTGTAGC","561307.5.peg.2042","1161"
"13689",9,2316,2307,"AGCGAGAATAATCAACCAGG","GCTGCTTTAGCTGTTGTAGC","561307.5.peg.2042","1161"
"13690",9,2796,2787,"AGCGAGAATAATCAACCAGG","TCTACTTCCGTATCAGCTGC","561307.5.peg.2042","1161"
"13691",284,2796,2512,"GTTGTACTGCTGGTTGTCCT","TCTACTTCCGTATCAGCTGC","561307.5.peg.2042","1161"
"13692",393,2796,2403,"TGTGCTTGTGCAGCGTTATT","TCTACTTCCGTATCAGCTGC","561307.5.peg.2042","1161"
"13693",537,2796,2259,"TTTGCTGCTACAGGTGCTGC","TCTACTTCCGTATCAGCTGC","561307.5.peg.2042","1161"
"13694",443,2796,2353,"GGTTATTTCCTTGACCTGCT","TCTACTTCCGTATCAGCTGC","561307.5.peg.2042","1161"
"13695",3013,2796,217,"TGCATCCGATTTCTTAGTTG","TCTACTTCCGTATCAGCTGC","561307.5.peg.2042","1161"
"13696",314,2796,2482,"CTGGATTAGCCTGTCCACCT","TCTACTTCCGTATCAGCTGC","561307.5.peg.2042","1161"
"13697",576,2796,2220,"TCACCAGTATTGCTAGCATT","TCTACTTCCGTATCAGCTGC","561307.5.peg.2042","1161"
"13698",522,2796,2274,"GCTGCTGGTTGCGCTGCTGC","TCTACTTCCGTATCAGCTGC","561307.5.peg.2042","1161"
"13699",333,2796,2463,"GGTTGTGCTGCTCCTCCTGC","TCTACTTCCGTATCAGCTGC","561307.5.peg.2042","1161"
"13700",12,2796,2784,"AACAGCGAGAATAATCAACC","TCTACTTCCGTATCAGCTGC","561307.5.peg.2042","1161"
"13701",276,2796,2520,"GCTGGTTGTCCTTGGTTGGC","TCTACTTCCGTATCAGCTGC","561307.5.peg.2042","1161"
"13702",195,2796,2601,"TTGGCATCAGCTGGTTGTGC","TCTACTTCCGTATCAGCTGC","561307.5.peg.2042","1161"
"13703",1038,2796,1758,"TCTAAACGATCAGCATCAGT","TCTACTTCCGTATCAGCTGC","561307.5.peg.2042","1161"
"13704",435,2796,2361,"CCTTGACCTGCTTGGTTTGC","TCTACTTCCGTATCAGCTGC","561307.5.peg.2042","1161"
"13705",204,2796,2592,"GGCTGTGTATTGGCATCAGC","TCTACTTCCGTATCAGCTGC","561307.5.peg.2042","1161"
"13706",294,2796,2502,"TGGTTTGCTGGTTGTACTGC","TCTACTTCCGTATCAGCTGC","561307.5.peg.2042","1161"
"13707",1617,2796,1179,"TCTGCAGTTAGTGTAACTTC","TCTACTTCCGTATCAGCTGC","561307.5.peg.2042","1161"
"13708",255,2796,2541,"GGTGCAGCTGGCTGTGCTGT","TCTACTTCCGTATCAGCTGC","561307.5.peg.2042","1161"
"13709",2316,2796,480,"GCTGCTTTAGCTGTTGTAGC","TCTACTTCCGTATCAGCTGC","561307.5.peg.2042","1161"
"13710",1074,2796,1722,"TCAGCAACTGCTGTATTGTC","TCTACTTCCGTATCAGCTGC","561307.5.peg.2042","1161"
"13711",35,2796,2761,"AATTCATTAAGTCATCCTCC","TCTACTTCCGTATCAGCTGC","561307.5.peg.2042","1161"
"13712",146,2796,2650,"CTGCTGCAGACGCTGTTGTC","TCTACTTCCGTATCAGCTGC","561307.5.peg.2042","1161"
"13713",354,2796,2442,"TGTCCAGCTGGTTGTGTATT","TCTACTTCCGTATCAGCTGC","561307.5.peg.2042","1161"
"13714",510,2796,2286,"GCTGCTGCTGGAGCATTCGC","TCTACTTCCGTATCAGCTGC","561307.5.peg.2042","1161"
"13715",1358,2796,1438,"TACTGTCTTCATTACCATTA","TCTACTTCCGTATCAGCTGC","561307.5.peg.2042","1161"
"13716",2126,2796,670,"GTTTACGAGTTGTAACTGCT","TCTACTTCCGTATCAGCTGC","561307.5.peg.2042","1161"
"13717",267,2796,2529,"CCTTGGTTGGCAGGTGCAGC","TCTACTTCCGTATCAGCTGC","561307.5.peg.2042","1161"
"13718",546,2796,2250,"GTTTGTGCGTTTGCTGCTAC","TCTACTTCCGTATCAGCTGC","561307.5.peg.2042","1161"
"13719",214,2796,2582,"ATTTGCGTTAGGCTGTGTAT","TCTACTTCCGTATCAGCTGC","561307.5.peg.2042","1161"
"13720",1206,2796,1590,"CTTTATTGTTAGTTGCTTT","TCTACTTCCGTATCAGCTGC","561307.5.peg.2042","1161"
"13721",280,2796,2516,"TACTGCTGGTTGTCCTTGGT","TCTACTTCCGTATCAGCTGC","561307.5.peg.2042","1161"
"13722",306,2796,2490,"GCCTGTCCACCTTGGTTTGC","TCTACTTCCGTATCAGCTGC","561307.5.peg.2042","1161"
"13723",1314,2796,1482,"TTAACGTAAGTTACACCTTG","TCTACTTCCGTATCAGCTGC","561307.5.peg.2042","1161"
"13724",3391,2796,595,"TGTATGTGCTGCATCTATTG","TCTACTTCCGTATCAGCTGC","561307.5.peg.2042","1161"
"13725",225,2796,2571,"TGAGCACCAGCATTTGCGTT","TCTACTTCCGTATCAGCTGC","561307.5.peg.2042","1161"
"13726",1442,2796,1354,"CACGTGCCGTTGTCACACCT","TCTACTTCCGTATCAGCTGC","561307.5.peg.2042","1161"
"13727",637,2796,2159,"CTATTCTCATCTGTTGATA","TCTACTTCCGTATCAGCTGC","561307.5.peg.2042","1161"
"13728",417,2796,2379,"GCCGGTGTTGCTTGATTTCC","TCTACTTCCGTATCAGCTGC","561307.5.peg.2042","1161"
"13729",417,3013,2596,"GCCGGTGTTGCTTGATTTCC","TGCATCCGATTTCTTAGTTG","561307.5.peg.2042","1161"
"13730",276,3013,2737,"GCTGGTTGTCCTTGGTTGGC","TGCATCCGATTTCTTAGTTG","561307.5.peg.2042","1161"
"13731",12,3013,3001,"AACAGCGAGAATAATCAACC","TGCATCCGATTTCTTAGTTG","561307.5.peg.2042","1161"
"13732",9,3013,3004,"AGCGAGAATAATCAACCAGG","TGCATCCGATTTCTTAGTTG","561307.5.peg.2042","1161"
"13733",225,3013,2788,"TGAGCACCAGCATTTGCGTT","TGCATCCGATTTCTTAGTTG","561307.5.peg.2042","1161"
"13734",214,3013,2799,"ATTTGCGTTAGGCTGTGTAT","TGCATCCGATTTCTTAGTTG","561307.5.peg.2042","1161"
"13735",1617,3013,1396,"TCTGCAGTTAGTGTAACTTC","TGCATCCGATTTCTTAGTTG","561307.5.peg.2042","1161"
"13736",546,3013,2467,"GTTTGTGCGTTTGCTGCTAC","TGCATCCGATTTCTTAGTTG","561307.5.peg.2042","1161"
"13737",2126,3013,887,"GTTTACGAGTTGTAACTGCT","TGCATCCGATTTCTTAGTTG","561307.5.peg.2042","1161"
"13738",1038,3013,1975,"TCTAAACGATCAGCATCAGT","TGCATCCGATTTCTTAGTTG","561307.5.peg.2042","1161"
"13739",284,3013,2729,"GTTGTACTGCTGGTTGTCCT","TGCATCCGATTTCTTAGTTG","561307.5.peg.2042","1161"
"13740",280,3013,2733,"TACTGCTGGTTGTCCTTGGT","TGCATCCGATTTCTTAGTTG","561307.5.peg.2042","1161"
"13741",393,3013,2620,"TGTGCTTGTGCAGCGTTATT","TGCATCCGATTTCTTAGTTG","561307.5.peg.2042","1161"
"13742",522,3013,2491,"GCTGCTGGTTGCGCTGCTGC","TGCATCCGATTTCTTAGTTG","561307.5.peg.2042","1161"
"13743",2316,3013,697,"GCTGCTTTAGCTGTTGTAGC","TGCATCCGATTTCTTAGTTG","561307.5.peg.2042","1161"
"13744",306,3013,2707,"GCCTGTCCACCTTGGTTTGC","TGCATCCGATTTCTTAGTTG","561307.5.peg.2042","1161"
"13745",3391,3013,378,"TGTATGTGCTGCATCTATTG","TGCATCCGATTTCTTAGTTG","561307.5.peg.2042","1161"
"13746",1074,3013,1939,"TCAGCAACTGCTGTATTGTC","TGCATCCGATTTCTTAGTTG","561307.5.peg.2042","1161"
"13747",267,3013,2746,"CCTTGGTTGGCAGGTGCAGC","TGCATCCGATTTCTTAGTTG","561307.5.peg.2042","1161"
"13748",1206,3013,1807,"CTTTATTGTTAGTTGCTTT","TGCATCCGATTTCTTAGTTG","561307.5.peg.2042","1161"
"13749",35,3013,2978,"AATTCATTAAGTCATCCTCC","TGCATCCGATTTCTTAGTTG","561307.5.peg.2042","1161"
"13750",333,3013,2680,"GGTTGTGCTGCTCCTCCTGC","TGCATCCGATTTCTTAGTTG","561307.5.peg.2042","1161"
"13751",294,3013,2719,"TGGTTTGCTGGTTGTACTGC","TGCATCCGATTTCTTAGTTG","561307.5.peg.2042","1161"
"13752",354,3013,2659,"TGTCCAGCTGGTTGTGTATT","TGCATCCGATTTCTTAGTTG","561307.5.peg.2042","1161"
"13753",1358,3013,1655,"TACTGTCTTCATTACCATTA","TGCATCCGATTTCTTAGTTG","561307.5.peg.2042","1161"
"13754",146,3013,2867,"CTGCTGCAGACGCTGTTGTC","TGCATCCGATTTCTTAGTTG","561307.5.peg.2042","1161"
"13755",1442,3013,1571,"CACGTGCCGTTGTCACACCT","TGCATCCGATTTCTTAGTTG","561307.5.peg.2042","1161"
"13756",637,3013,2376,"CTATTCTCATCTGTTGATA","TGCATCCGATTTCTTAGTTG","561307.5.peg.2042","1161"
"13757",255,3013,2758,"GGTGCAGCTGGCTGTGCTGT","TGCATCCGATTTCTTAGTTG","561307.5.peg.2042","1161"
"13758",510,3013,2503,"GCTGCTGCTGGAGCATTCGC","TGCATCCGATTTCTTAGTTG","561307.5.peg.2042","1161"
"13759",576,3013,2437,"TCACCAGTATTGCTAGCATT","TGCATCCGATTTCTTAGTTG","561307.5.peg.2042","1161"
"13760",314,3013,2699,"CTGGATTAGCCTGTCCACCT","TGCATCCGATTTCTTAGTTG","561307.5.peg.2042","1161"
"13761",2796,3013,217,"TCTACTTCCGTATCAGCTGC","TGCATCCGATTTCTTAGTTG","561307.5.peg.2042","1161"
"13762",1314,3013,1699,"TTAACGTAAGTTACACCTTG","TGCATCCGATTTCTTAGTTG","561307.5.peg.2042","1161"
"13763",537,3013,2476,"TTTGCTGCTACAGGTGCTGC","TGCATCCGATTTCTTAGTTG","561307.5.peg.2042","1161"
"13764",435,3013,2578,"CCTTGACCTGCTTGGTTTGC","TGCATCCGATTTCTTAGTTG","561307.5.peg.2042","1161"
"13765",204,3013,2809,"GGCTGTGTATTGGCATCAGC","TGCATCCGATTTCTTAGTTG","561307.5.peg.2042","1161"
"13766",195,3013,2818,"TTGGCATCAGCTGGTTGTGC","TGCATCCGATTTCTTAGTTG","561307.5.peg.2042","1161"
"13767",443,3013,2570,"GGTTATTTCCTTGACCTGCT","TGCATCCGATTTCTTAGTTG","561307.5.peg.2042","1161"
"13768",637,3391,2754,"CTATTCTCATCTGTTGATA","TGTATGTGCTGCATCTATTG","561307.5.peg.2042","1161"
"13769",1617,3391,1774,"TCTGCAGTTAGTGTAACTTC","TGTATGTGCTGCATCTATTG","561307.5.peg.2042","1161"
"13770",1074,3391,2317,"TCAGCAACTGCTGTATTGTC","TGTATGTGCTGCATCTATTG","561307.5.peg.2042","1161"
"13771",2796,3391,595,"TCTACTTCCGTATCAGCTGC","TGTATGTGCTGCATCTATTG","561307.5.peg.2042","1161"
"13772",393,3391,2998,"TGTGCTTGTGCAGCGTTATT","TGTATGTGCTGCATCTATTG","561307.5.peg.2042","1161"
"13773",195,3391,3196,"TTGGCATCAGCTGGTTGTGC","TGTATGTGCTGCATCTATTG","561307.5.peg.2042","1161"
"13774",306,3391,3085,"GCCTGTCCACCTTGGTTTGC","TGTATGTGCTGCATCTATTG","561307.5.peg.2042","1161"
"13775",522,3391,2869,"GCTGCTGGTTGCGCTGCTGC","TGTATGTGCTGCATCTATTG","561307.5.peg.2042","1161"
"13776",1358,3391,2033,"TACTGTCTTCATTACCATTA","TGTATGTGCTGCATCTATTG","561307.5.peg.2042","1161"
"13777",2316,3391,1075,"GCTGCTTTAGCTGTTGTAGC","TGTATGTGCTGCATCTATTG","561307.5.peg.2042","1161"
"13778",294,3391,3097,"TGGTTTGCTGGTTGTACTGC","TGTATGTGCTGCATCTATTG","561307.5.peg.2042","1161"
"13779",443,3391,2948,"GGTTATTTCCTTGACCTGCT","TGTATGTGCTGCATCTATTG","561307.5.peg.2042","1161"
"13780",35,3391,3356,"AATTCATTAAGTCATCCTCC","TGTATGTGCTGCATCTATTG","561307.5.peg.2042","1161"
"13781",3013,3391,378,"TGCATCCGATTTCTTAGTTG","TGTATGTGCTGCATCTATTG","561307.5.peg.2042","1161"
"13782",280,3391,3111,"TACTGCTGGTTGTCCTTGGT","TGTATGTGCTGCATCTATTG","561307.5.peg.2042","1161"
"13783",204,3391,3187,"GGCTGTGTATTGGCATCAGC","TGTATGTGCTGCATCTATTG","561307.5.peg.2042","1161"
"13784",314,3391,3077,"CTGGATTAGCCTGTCCACCT","TGTATGTGCTGCATCTATTG","561307.5.peg.2042","1161"
"13785",354,3391,3037,"TGTCCAGCTGGTTGTGTATT","TGTATGTGCTGCATCTATTG","561307.5.peg.2042","1161"
"13786",1314,3391,2077,"TTAACGTAAGTTACACCTTG","TGTATGTGCTGCATCTATTG","561307.5.peg.2042","1161"
"13787",435,3391,2956,"CCTTGACCTGCTTGGTTTGC","TGTATGTGCTGCATCTATTG","561307.5.peg.2042","1161"
"13788",2126,3391,1265,"GTTTACGAGTTGTAACTGCT","TGTATGTGCTGCATCTATTG","561307.5.peg.2042","1161"
"13789",267,3391,3124,"CCTTGGTTGGCAGGTGCAGC","TGTATGTGCTGCATCTATTG","561307.5.peg.2042","1161"
"13790",255,3391,3136,"GGTGCAGCTGGCTGTGCTGT","TGTATGTGCTGCATCTATTG","561307.5.peg.2042","1161"
"13791",417,3391,2974,"GCCGGTGTTGCTTGATTTCC","TGTATGTGCTGCATCTATTG","561307.5.peg.2042","1161"
"13792",276,3391,3115,"GCTGGTTGTCCTTGGTTGGC","TGTATGTGCTGCATCTATTG","561307.5.peg.2042","1161"
"13793",1038,3391,2353,"TCTAAACGATCAGCATCAGT","TGTATGTGCTGCATCTATTG","561307.5.peg.2042","1161"
"13794",546,3391,2845,"GTTTGTGCGTTTGCTGCTAC","TGTATGTGCTGCATCTATTG","561307.5.peg.2042","1161"
"13795",1442,3391,1949,"CACGTGCCGTTGTCACACCT","TGTATGTGCTGCATCTATTG","561307.5.peg.2042","1161"
"13796",9,3391,3382,"AGCGAGAATAATCAACCAGG","TGTATGTGCTGCATCTATTG","561307.5.peg.2042","1161"
"13797",146,3391,3245,"CTGCTGCAGACGCTGTTGTC","TGTATGTGCTGCATCTATTG","561307.5.peg.2042","1161"
"13798",510,3391,2881,"GCTGCTGCTGGAGCATTCGC","TGTATGTGCTGCATCTATTG","561307.5.peg.2042","1161"
"13799",537,3391,2854,"TTTGCTGCTACAGGTGCTGC","TGTATGTGCTGCATCTATTG","561307.5.peg.2042","1161"
"13800",214,3391,3177,"ATTTGCGTTAGGCTGTGTAT","TGTATGTGCTGCATCTATTG","561307.5.peg.2042","1161"
"13801",12,3391,3379,"AACAGCGAGAATAATCAACC","TGTATGTGCTGCATCTATTG","561307.5.peg.2042","1161"
"13802",576,3391,2815,"TCACCAGTATTGCTAGCATT","TGTATGTGCTGCATCTATTG","561307.5.peg.2042","1161"
"13803",284,3391,3107,"GTTGTACTGCTGGTTGTCCT","TGTATGTGCTGCATCTATTG","561307.5.peg.2042","1161"
"13804",225,3391,3166,"TGAGCACCAGCATTTGCGTT","TGTATGTGCTGCATCTATTG","561307.5.peg.2042","1161"
"13805",333,3391,3058,"GGTTGTGCTGCTCCTCCTGC","TGTATGTGCTGCATCTATTG","561307.5.peg.2042","1161"
"13806",1206,3391,2185,"CTTTATTGTTAGTTGCTTT","TGTATGTGCTGCATCTATTG","561307.5.peg.2042","1161"
"13807",261,11,250,"GCTTGTTTCAACGCTTCAGA","ATTAAACAAGTATTCGAGG","561307.5.peg.2043","1162"
"13808",458,11,447,"ATGAATATTGTTACCAAGA","ATTAAACAAGTATTCGAGG","561307.5.peg.2043","1162"
"13809",11,261,250,"ATTAAACAAGTATTCGAGG","GCTTGTTTCAACGCTTCAGA","561307.5.peg.2043","1162"
"13810",458,261,197,"ATGAATATTGTTACCAAGA","GCTTGTTTCAACGCTTCAGA","561307.5.peg.2043","1162"
"13811",11,458,447,"ATTAAACAAGTATTCGAGG","ATGAATATTGTTACCAAGA","561307.5.peg.2043","1162"
"13812",261,458,197,"GCTTGTTTCAACGCTTCAGA","ATGAATATTGTTACCAAGA","561307.5.peg.2043","1162"
"13813",699,46,653,"CTTGATTCGGTAAGTTGGTA","ACGTGTACTCAATAACATGG","561307.5.peg.2045","1164"
"13814",694,46,648,"TTCGGTAAGTTGGTAGGGTA","ACGTGTACTCAATAACATGG","561307.5.peg.2045","1164"
"13815",704,46,658,"ATAACTTGATTCGGTAAGT","ACGTGTACTCAATAACATGG","561307.5.peg.2045","1164"
"13816",1080,46,1034,"GCTTGCAAACGATTGATTGC","ACGTGTACTCAATAACATGG","561307.5.peg.2045","1164"
"13817",917,46,871,"TTCGTTTAGCTCCACGTAAA","ACGTGTACTCAATAACATGG","561307.5.peg.2045","1164"
"13818",740,46,694,"GTGAAATGGAGAGCACGATA","ACGTGTACTCAATAACATGG","561307.5.peg.2045","1164"
"13819",626,46,580,"CTAAGTCAACAAAGTCTTTG","ACGTGTACTCAATAACATGG","561307.5.peg.2045","1164"
"13820",413,46,367,"CTAACATCTTTGCTAAAGTC","ACGTGTACTCAATAACATGG","561307.5.peg.2045","1164"
"13821",686,46,640,"GTTGGTAGGGTAAGGCACTT","ACGTGTACTCAATAACATGG","561307.5.peg.2045","1164"
"13822",304,46,258,"CTCTTCAACAGATAAGTCAA","ACGTGTACTCAATAACATGG","561307.5.peg.2045","1164"
"13823",361,46,315,"ATATTGTTTAACTGGCTCCT","ACGTGTACTCAATAACATGG","561307.5.peg.2045","1164"
"13824",686,49,637,"GTTGGTAGGGTAAGGCACTT","TTCACGTGTACTCAATAACA","561307.5.peg.2045","1164"
"13825",917,49,868,"TTCGTTTAGCTCCACGTAAA","TTCACGTGTACTCAATAACA","561307.5.peg.2045","1164"
"13826",413,49,364,"CTAACATCTTTGCTAAAGTC","TTCACGTGTACTCAATAACA","561307.5.peg.2045","1164"
"13827",361,49,312,"ATATTGTTTAACTGGCTCCT","TTCACGTGTACTCAATAACA","561307.5.peg.2045","1164"
"13828",740,49,691,"GTGAAATGGAGAGCACGATA","TTCACGTGTACTCAATAACA","561307.5.peg.2045","1164"
"13829",304,49,255,"CTCTTCAACAGATAAGTCAA","TTCACGTGTACTCAATAACA","561307.5.peg.2045","1164"
"13830",704,49,655,"ATAACTTGATTCGGTAAGT","TTCACGTGTACTCAATAACA","561307.5.peg.2045","1164"
"13831",694,49,645,"TTCGGTAAGTTGGTAGGGTA","TTCACGTGTACTCAATAACA","561307.5.peg.2045","1164"
"13832",699,49,650,"CTTGATTCGGTAAGTTGGTA","TTCACGTGTACTCAATAACA","561307.5.peg.2045","1164"
"13833",626,49,577,"CTAAGTCAACAAAGTCTTTG","TTCACGTGTACTCAATAACA","561307.5.peg.2045","1164"
"13834",1080,49,1031,"GCTTGCAAACGATTGATTGC","TTCACGTGTACTCAATAACA","561307.5.peg.2045","1164"
"13835",740,85,655,"GTGAAATGGAGAGCACGATA","ACCGTGGTACTTAATCAATA","561307.5.peg.2045","1164"
"13836",304,85,219,"CTCTTCAACAGATAAGTCAA","ACCGTGGTACTTAATCAATA","561307.5.peg.2045","1164"
"13837",413,85,328,"CTAACATCTTTGCTAAAGTC","ACCGTGGTACTTAATCAATA","561307.5.peg.2045","1164"
"13838",694,85,609,"TTCGGTAAGTTGGTAGGGTA","ACCGTGGTACTTAATCAATA","561307.5.peg.2045","1164"
"13839",626,85,541,"CTAAGTCAACAAAGTCTTTG","ACCGTGGTACTTAATCAATA","561307.5.peg.2045","1164"
"13840",699,85,614,"CTTGATTCGGTAAGTTGGTA","ACCGTGGTACTTAATCAATA","561307.5.peg.2045","1164"
"13841",361,85,276,"ATATTGTTTAACTGGCTCCT","ACCGTGGTACTTAATCAATA","561307.5.peg.2045","1164"
"13842",686,85,601,"GTTGGTAGGGTAAGGCACTT","ACCGTGGTACTTAATCAATA","561307.5.peg.2045","1164"
"13843",1080,85,995,"GCTTGCAAACGATTGATTGC","ACCGTGGTACTTAATCAATA","561307.5.peg.2045","1164"
"13844",917,85,832,"TTCGTTTAGCTCCACGTAAA","ACCGTGGTACTTAATCAATA","561307.5.peg.2045","1164"
"13845",704,85,619,"ATAACTTGATTCGGTAAGT","ACCGTGGTACTTAATCAATA","561307.5.peg.2045","1164"
"13846",699,101,598,"CTTGATTCGGTAAGTTGGTA","GTATAGTGATATATTGACCG","561307.5.peg.2045","1164"
"13847",694,101,593,"TTCGGTAAGTTGGTAGGGTA","GTATAGTGATATATTGACCG","561307.5.peg.2045","1164"
"13848",704,101,603,"ATAACTTGATTCGGTAAGT","GTATAGTGATATATTGACCG","561307.5.peg.2045","1164"
"13849",740,101,639,"GTGAAATGGAGAGCACGATA","GTATAGTGATATATTGACCG","561307.5.peg.2045","1164"
"13850",413,101,312,"CTAACATCTTTGCTAAAGTC","GTATAGTGATATATTGACCG","561307.5.peg.2045","1164"
"13851",917,101,816,"TTCGTTTAGCTCCACGTAAA","GTATAGTGATATATTGACCG","561307.5.peg.2045","1164"
"13852",626,101,525,"CTAAGTCAACAAAGTCTTTG","GTATAGTGATATATTGACCG","561307.5.peg.2045","1164"
"13853",361,101,260,"ATATTGTTTAACTGGCTCCT","GTATAGTGATATATTGACCG","561307.5.peg.2045","1164"
"13854",686,101,585,"GTTGGTAGGGTAAGGCACTT","GTATAGTGATATATTGACCG","561307.5.peg.2045","1164"
"13855",304,101,203,"CTCTTCAACAGATAAGTCAA","GTATAGTGATATATTGACCG","561307.5.peg.2045","1164"
"13856",1080,101,979,"GCTTGCAAACGATTGATTGC","GTATAGTGATATATTGACCG","561307.5.peg.2045","1164"
"13857",626,304,322,"CTAAGTCAACAAAGTCTTTG","CTCTTCAACAGATAAGTCAA","561307.5.peg.2045","1164"
"13858",740,304,436,"GTGAAATGGAGAGCACGATA","CTCTTCAACAGATAAGTCAA","561307.5.peg.2045","1164"
"13859",46,304,258,"ACGTGTACTCAATAACATGG","CTCTTCAACAGATAAGTCAA","561307.5.peg.2045","1164"
"13860",49,304,255,"TTCACGTGTACTCAATAACA","CTCTTCAACAGATAAGTCAA","561307.5.peg.2045","1164"
"13861",101,304,203,"GTATAGTGATATATTGACCG","CTCTTCAACAGATAAGTCAA","561307.5.peg.2045","1164"
"13862",699,304,395,"CTTGATTCGGTAAGTTGGTA","CTCTTCAACAGATAAGTCAA","561307.5.peg.2045","1164"
"13863",413,304,109,"CTAACATCTTTGCTAAAGTC","CTCTTCAACAGATAAGTCAA","561307.5.peg.2045","1164"
"13864",917,304,613,"TTCGTTTAGCTCCACGTAAA","CTCTTCAACAGATAAGTCAA","561307.5.peg.2045","1164"
"13865",1080,304,776,"GCTTGCAAACGATTGATTGC","CTCTTCAACAGATAAGTCAA","561307.5.peg.2045","1164"
"13866",694,304,390,"TTCGGTAAGTTGGTAGGGTA","CTCTTCAACAGATAAGTCAA","561307.5.peg.2045","1164"
"13867",704,304,400,"ATAACTTGATTCGGTAAGT","CTCTTCAACAGATAAGTCAA","561307.5.peg.2045","1164"
"13868",686,304,382,"GTTGGTAGGGTAAGGCACTT","CTCTTCAACAGATAAGTCAA","561307.5.peg.2045","1164"
"13869",85,304,219,"ACCGTGGTACTTAATCAATA","CTCTTCAACAGATAAGTCAA","561307.5.peg.2045","1164"
"13870",46,361,315,"ACGTGTACTCAATAACATGG","ATATTGTTTAACTGGCTCCT","561307.5.peg.2045","1164"
"13871",740,361,379,"GTGAAATGGAGAGCACGATA","ATATTGTTTAACTGGCTCCT","561307.5.peg.2045","1164"
"13872",917,361,556,"TTCGTTTAGCTCCACGTAAA","ATATTGTTTAACTGGCTCCT","561307.5.peg.2045","1164"
"13873",686,361,325,"GTTGGTAGGGTAAGGCACTT","ATATTGTTTAACTGGCTCCT","561307.5.peg.2045","1164"
"13874",101,361,260,"GTATAGTGATATATTGACCG","ATATTGTTTAACTGGCTCCT","561307.5.peg.2045","1164"
"13875",704,361,343,"ATAACTTGATTCGGTAAGT","ATATTGTTTAACTGGCTCCT","561307.5.peg.2045","1164"
"13876",699,361,338,"CTTGATTCGGTAAGTTGGTA","ATATTGTTTAACTGGCTCCT","561307.5.peg.2045","1164"
"13877",626,361,265,"CTAAGTCAACAAAGTCTTTG","ATATTGTTTAACTGGCTCCT","561307.5.peg.2045","1164"
"13878",85,361,276,"ACCGTGGTACTTAATCAATA","ATATTGTTTAACTGGCTCCT","561307.5.peg.2045","1164"
"13879",49,361,312,"TTCACGTGTACTCAATAACA","ATATTGTTTAACTGGCTCCT","561307.5.peg.2045","1164"
"13880",694,361,333,"TTCGGTAAGTTGGTAGGGTA","ATATTGTTTAACTGGCTCCT","561307.5.peg.2045","1164"
"13881",1080,361,719,"GCTTGCAAACGATTGATTGC","ATATTGTTTAACTGGCTCCT","561307.5.peg.2045","1164"
"13882",46,413,367,"ACGTGTACTCAATAACATGG","CTAACATCTTTGCTAAAGTC","561307.5.peg.2045","1164"
"13883",740,413,327,"GTGAAATGGAGAGCACGATA","CTAACATCTTTGCTAAAGTC","561307.5.peg.2045","1164"
"13884",686,413,273,"GTTGGTAGGGTAAGGCACTT","CTAACATCTTTGCTAAAGTC","561307.5.peg.2045","1164"
"13885",1080,413,667,"GCTTGCAAACGATTGATTGC","CTAACATCTTTGCTAAAGTC","561307.5.peg.2045","1164"
"13886",85,413,328,"ACCGTGGTACTTAATCAATA","CTAACATCTTTGCTAAAGTC","561307.5.peg.2045","1164"
"13887",694,413,281,"TTCGGTAAGTTGGTAGGGTA","CTAACATCTTTGCTAAAGTC","561307.5.peg.2045","1164"
"13888",626,413,213,"CTAAGTCAACAAAGTCTTTG","CTAACATCTTTGCTAAAGTC","561307.5.peg.2045","1164"
"13889",917,413,504,"TTCGTTTAGCTCCACGTAAA","CTAACATCTTTGCTAAAGTC","561307.5.peg.2045","1164"
"13890",699,413,286,"CTTGATTCGGTAAGTTGGTA","CTAACATCTTTGCTAAAGTC","561307.5.peg.2045","1164"
"13891",101,413,312,"GTATAGTGATATATTGACCG","CTAACATCTTTGCTAAAGTC","561307.5.peg.2045","1164"
"13892",704,413,291,"ATAACTTGATTCGGTAAGT","CTAACATCTTTGCTAAAGTC","561307.5.peg.2045","1164"
"13893",304,413,109,"CTCTTCAACAGATAAGTCAA","CTAACATCTTTGCTAAAGTC","561307.5.peg.2045","1164"
"13894",49,413,364,"TTCACGTGTACTCAATAACA","CTAACATCTTTGCTAAAGTC","561307.5.peg.2045","1164"
"13895",361,626,265,"ATATTGTTTAACTGGCTCCT","CTAAGTCAACAAAGTCTTTG","561307.5.peg.2045","1164"
"13896",740,626,114,"GTGAAATGGAGAGCACGATA","CTAAGTCAACAAAGTCTTTG","561307.5.peg.2045","1164"
"13897",49,626,577,"TTCACGTGTACTCAATAACA","CTAAGTCAACAAAGTCTTTG","561307.5.peg.2045","1164"
"13898",101,626,525,"GTATAGTGATATATTGACCG","CTAAGTCAACAAAGTCTTTG","561307.5.peg.2045","1164"
"13899",304,626,322,"CTCTTCAACAGATAAGTCAA","CTAAGTCAACAAAGTCTTTG","561307.5.peg.2045","1164"
"13900",46,626,580,"ACGTGTACTCAATAACATGG","CTAAGTCAACAAAGTCTTTG","561307.5.peg.2045","1164"
"13901",917,626,291,"TTCGTTTAGCTCCACGTAAA","CTAAGTCAACAAAGTCTTTG","561307.5.peg.2045","1164"
"13902",85,626,541,"ACCGTGGTACTTAATCAATA","CTAAGTCAACAAAGTCTTTG","561307.5.peg.2045","1164"
"13903",413,626,213,"CTAACATCTTTGCTAAAGTC","CTAAGTCAACAAAGTCTTTG","561307.5.peg.2045","1164"
"13904",1080,626,454,"GCTTGCAAACGATTGATTGC","CTAAGTCAACAAAGTCTTTG","561307.5.peg.2045","1164"
"13905",361,686,325,"ATATTGTTTAACTGGCTCCT","GTTGGTAGGGTAAGGCACTT","561307.5.peg.2045","1164"
"13906",1080,686,394,"GCTTGCAAACGATTGATTGC","GTTGGTAGGGTAAGGCACTT","561307.5.peg.2045","1164"
"13907",917,686,231,"TTCGTTTAGCTCCACGTAAA","GTTGGTAGGGTAAGGCACTT","561307.5.peg.2045","1164"
"13908",304,686,382,"CTCTTCAACAGATAAGTCAA","GTTGGTAGGGTAAGGCACTT","561307.5.peg.2045","1164"
"13909",101,686,585,"GTATAGTGATATATTGACCG","GTTGGTAGGGTAAGGCACTT","561307.5.peg.2045","1164"
"13910",85,686,601,"ACCGTGGTACTTAATCAATA","GTTGGTAGGGTAAGGCACTT","561307.5.peg.2045","1164"
"13911",413,686,273,"CTAACATCTTTGCTAAAGTC","GTTGGTAGGGTAAGGCACTT","561307.5.peg.2045","1164"
"13912",49,686,637,"TTCACGTGTACTCAATAACA","GTTGGTAGGGTAAGGCACTT","561307.5.peg.2045","1164"
"13913",46,686,640,"ACGTGTACTCAATAACATGG","GTTGGTAGGGTAAGGCACTT","561307.5.peg.2045","1164"
"13914",85,694,609,"ACCGTGGTACTTAATCAATA","TTCGGTAAGTTGGTAGGGTA","561307.5.peg.2045","1164"
"13915",1080,694,386,"GCTTGCAAACGATTGATTGC","TTCGGTAAGTTGGTAGGGTA","561307.5.peg.2045","1164"
"13916",413,694,281,"CTAACATCTTTGCTAAAGTC","TTCGGTAAGTTGGTAGGGTA","561307.5.peg.2045","1164"
"13917",361,694,333,"ATATTGTTTAACTGGCTCCT","TTCGGTAAGTTGGTAGGGTA","561307.5.peg.2045","1164"
"13918",101,694,593,"GTATAGTGATATATTGACCG","TTCGGTAAGTTGGTAGGGTA","561307.5.peg.2045","1164"
"13919",46,694,648,"ACGTGTACTCAATAACATGG","TTCGGTAAGTTGGTAGGGTA","561307.5.peg.2045","1164"
"13920",49,694,645,"TTCACGTGTACTCAATAACA","TTCGGTAAGTTGGTAGGGTA","561307.5.peg.2045","1164"
"13921",917,694,223,"TTCGTTTAGCTCCACGTAAA","TTCGGTAAGTTGGTAGGGTA","561307.5.peg.2045","1164"
"13922",304,694,390,"CTCTTCAACAGATAAGTCAA","TTCGGTAAGTTGGTAGGGTA","561307.5.peg.2045","1164"
"13923",101,699,598,"GTATAGTGATATATTGACCG","CTTGATTCGGTAAGTTGGTA","561307.5.peg.2045","1164"
"13924",304,699,395,"CTCTTCAACAGATAAGTCAA","CTTGATTCGGTAAGTTGGTA","561307.5.peg.2045","1164"
"13925",46,699,653,"ACGTGTACTCAATAACATGG","CTTGATTCGGTAAGTTGGTA","561307.5.peg.2045","1164"
"13926",49,699,650,"TTCACGTGTACTCAATAACA","CTTGATTCGGTAAGTTGGTA","561307.5.peg.2045","1164"
"13927",413,699,286,"CTAACATCTTTGCTAAAGTC","CTTGATTCGGTAAGTTGGTA","561307.5.peg.2045","1164"
"13928",85,699,614,"ACCGTGGTACTTAATCAATA","CTTGATTCGGTAAGTTGGTA","561307.5.peg.2045","1164"
"13929",1080,699,381,"GCTTGCAAACGATTGATTGC","CTTGATTCGGTAAGTTGGTA","561307.5.peg.2045","1164"
"13930",361,699,338,"ATATTGTTTAACTGGCTCCT","CTTGATTCGGTAAGTTGGTA","561307.5.peg.2045","1164"
"13931",917,699,218,"TTCGTTTAGCTCCACGTAAA","CTTGATTCGGTAAGTTGGTA","561307.5.peg.2045","1164"
"13932",304,704,400,"CTCTTCAACAGATAAGTCAA","ATAACTTGATTCGGTAAGT","561307.5.peg.2045","1164"
"13933",361,704,343,"ATATTGTTTAACTGGCTCCT","ATAACTTGATTCGGTAAGT","561307.5.peg.2045","1164"
"13934",917,704,213,"TTCGTTTAGCTCCACGTAAA","ATAACTTGATTCGGTAAGT","561307.5.peg.2045","1164"
"13935",101,704,603,"GTATAGTGATATATTGACCG","ATAACTTGATTCGGTAAGT","561307.5.peg.2045","1164"
"13936",49,704,655,"TTCACGTGTACTCAATAACA","ATAACTTGATTCGGTAAGT","561307.5.peg.2045","1164"
"13937",85,704,619,"ACCGTGGTACTTAATCAATA","ATAACTTGATTCGGTAAGT","561307.5.peg.2045","1164"
"13938",413,704,291,"CTAACATCTTTGCTAAAGTC","ATAACTTGATTCGGTAAGT","561307.5.peg.2045","1164"
"13939",46,704,658,"ACGTGTACTCAATAACATGG","ATAACTTGATTCGGTAAGT","561307.5.peg.2045","1164"
"13940",1080,704,376,"GCTTGCAAACGATTGATTGC","ATAACTTGATTCGGTAAGT","561307.5.peg.2045","1164"
"13941",413,740,327,"CTAACATCTTTGCTAAAGTC","GTGAAATGGAGAGCACGATA","561307.5.peg.2045","1164"
"13942",46,740,694,"ACGTGTACTCAATAACATGG","GTGAAATGGAGAGCACGATA","561307.5.peg.2045","1164"
"13943",626,740,114,"CTAAGTCAACAAAGTCTTTG","GTGAAATGGAGAGCACGATA","561307.5.peg.2045","1164"
"13944",101,740,639,"GTATAGTGATATATTGACCG","GTGAAATGGAGAGCACGATA","561307.5.peg.2045","1164"
"13945",361,740,379,"ATATTGTTTAACTGGCTCCT","GTGAAATGGAGAGCACGATA","561307.5.peg.2045","1164"
"13946",49,740,691,"TTCACGTGTACTCAATAACA","GTGAAATGGAGAGCACGATA","561307.5.peg.2045","1164"
"13947",917,740,177,"TTCGTTTAGCTCCACGTAAA","GTGAAATGGAGAGCACGATA","561307.5.peg.2045","1164"
"13948",304,740,436,"CTCTTCAACAGATAAGTCAA","GTGAAATGGAGAGCACGATA","561307.5.peg.2045","1164"
"13949",85,740,655,"ACCGTGGTACTTAATCAATA","GTGAAATGGAGAGCACGATA","561307.5.peg.2045","1164"
"13950",1080,740,340,"GCTTGCAAACGATTGATTGC","GTGAAATGGAGAGCACGATA","561307.5.peg.2045","1164"
"13951",413,917,504,"CTAACATCTTTGCTAAAGTC","TTCGTTTAGCTCCACGTAAA","561307.5.peg.2045","1164"
"13952",101,917,816,"GTATAGTGATATATTGACCG","TTCGTTTAGCTCCACGTAAA","561307.5.peg.2045","1164"
"13953",704,917,213,"ATAACTTGATTCGGTAAGT","TTCGTTTAGCTCCACGTAAA","561307.5.peg.2045","1164"
"13954",304,917,613,"CTCTTCAACAGATAAGTCAA","TTCGTTTAGCTCCACGTAAA","561307.5.peg.2045","1164"
"13955",740,917,177,"GTGAAATGGAGAGCACGATA","TTCGTTTAGCTCCACGTAAA","561307.5.peg.2045","1164"
"13956",694,917,223,"TTCGGTAAGTTGGTAGGGTA","TTCGTTTAGCTCCACGTAAA","561307.5.peg.2045","1164"
"13957",699,917,218,"CTTGATTCGGTAAGTTGGTA","TTCGTTTAGCTCCACGTAAA","561307.5.peg.2045","1164"
"13958",46,917,871,"ACGTGTACTCAATAACATGG","TTCGTTTAGCTCCACGTAAA","561307.5.peg.2045","1164"
"13959",686,917,231,"GTTGGTAGGGTAAGGCACTT","TTCGTTTAGCTCCACGTAAA","561307.5.peg.2045","1164"
"13960",626,917,291,"CTAAGTCAACAAAGTCTTTG","TTCGTTTAGCTCCACGTAAA","561307.5.peg.2045","1164"
"13961",49,917,868,"TTCACGTGTACTCAATAACA","TTCGTTTAGCTCCACGTAAA","561307.5.peg.2045","1164"
"13962",85,917,832,"ACCGTGGTACTTAATCAATA","TTCGTTTAGCTCCACGTAAA","561307.5.peg.2045","1164"
"13963",1080,917,163,"GCTTGCAAACGATTGATTGC","TTCGTTTAGCTCCACGTAAA","561307.5.peg.2045","1164"
"13964",361,917,556,"ATATTGTTTAACTGGCTCCT","TTCGTTTAGCTCCACGTAAA","561307.5.peg.2045","1164"
"13965",304,1080,776,"CTCTTCAACAGATAAGTCAA","GCTTGCAAACGATTGATTGC","561307.5.peg.2045","1164"
"13966",917,1080,163,"TTCGTTTAGCTCCACGTAAA","GCTTGCAAACGATTGATTGC","561307.5.peg.2045","1164"
"13967",361,1080,719,"ATATTGTTTAACTGGCTCCT","GCTTGCAAACGATTGATTGC","561307.5.peg.2045","1164"
"13968",101,1080,979,"GTATAGTGATATATTGACCG","GCTTGCAAACGATTGATTGC","561307.5.peg.2045","1164"
"13969",46,1080,1034,"ACGTGTACTCAATAACATGG","GCTTGCAAACGATTGATTGC","561307.5.peg.2045","1164"
"13970",740,1080,340,"GTGAAATGGAGAGCACGATA","GCTTGCAAACGATTGATTGC","561307.5.peg.2045","1164"
"13971",413,1080,667,"CTAACATCTTTGCTAAAGTC","GCTTGCAAACGATTGATTGC","561307.5.peg.2045","1164"
"13972",626,1080,454,"CTAAGTCAACAAAGTCTTTG","GCTTGCAAACGATTGATTGC","561307.5.peg.2045","1164"
"13973",694,1080,386,"TTCGGTAAGTTGGTAGGGTA","GCTTGCAAACGATTGATTGC","561307.5.peg.2045","1164"
"13974",704,1080,376,"ATAACTTGATTCGGTAAGT","GCTTGCAAACGATTGATTGC","561307.5.peg.2045","1164"
"13975",49,1080,1031,"TTCACGTGTACTCAATAACA","GCTTGCAAACGATTGATTGC","561307.5.peg.2045","1164"
"13976",686,1080,394,"GTTGGTAGGGTAAGGCACTT","GCTTGCAAACGATTGATTGC","561307.5.peg.2045","1164"
"13977",85,1080,995,"ACCGTGGTACTTAATCAATA","GCTTGCAAACGATTGATTGC","561307.5.peg.2045","1164"
"13978",699,1080,381,"CTTGATTCGGTAAGTTGGTA","GCTTGCAAACGATTGATTGC","561307.5.peg.2045","1164"
"13979",409,129,280,"TCTAGGTTGAATCAATTGGT","GCGATGAAAGCGCCAATGTT","561307.5.peg.2046","1165"
"13980",381,129,252,"TTCATTAACCAACCAACAAG","GCGATGAAAGCGCCAATGTT","561307.5.peg.2046","1165"
"13981",666,129,537,"GCAGCTTGATCTGCACCAAG","GCGATGAAAGCGCCAATGTT","561307.5.peg.2046","1165"
"13982",584,129,455,"AATACTTACAAGTGGAAGT","GCGATGAAAGCGCCAATGTT","561307.5.peg.2046","1165"
"13983",728,129,599,"AGATACCTAAACCTGGTCCA","GCGATGAAAGCGCCAATGTT","561307.5.peg.2046","1165"
"13984",245,129,116,"CACTAAATGCGATCAATAAT","GCGATGAAAGCGCCAATGTT","561307.5.peg.2046","1165"
"13985",650,129,521,"CAAGCGGTGTGAATACACCA","GCGATGAAAGCGCCAATGTT","561307.5.peg.2046","1165"
"13986",735,129,606,"GCAAGTAAGATACCTAAACC","GCGATGAAAGCGCCAATGTT","561307.5.peg.2046","1165"
"13987",666,245,421,"GCAGCTTGATCTGCACCAAG","CACTAAATGCGATCAATAAT","561307.5.peg.2046","1165"
"13988",409,245,164,"TCTAGGTTGAATCAATTGGT","CACTAAATGCGATCAATAAT","561307.5.peg.2046","1165"
"13989",735,245,490,"GCAAGTAAGATACCTAAACC","CACTAAATGCGATCAATAAT","561307.5.peg.2046","1165"
"13990",381,245,136,"TTCATTAACCAACCAACAAG","CACTAAATGCGATCAATAAT","561307.5.peg.2046","1165"
"13991",584,245,339,"AATACTTACAAGTGGAAGT","CACTAAATGCGATCAATAAT","561307.5.peg.2046","1165"
"13992",728,245,483,"AGATACCTAAACCTGGTCCA","CACTAAATGCGATCAATAAT","561307.5.peg.2046","1165"
"13993",129,245,116,"GCGATGAAAGCGCCAATGTT","CACTAAATGCGATCAATAAT","561307.5.peg.2046","1165"
"13994",650,245,405,"CAAGCGGTGTGAATACACCA","CACTAAATGCGATCAATAAT","561307.5.peg.2046","1165"
"13995",728,381,347,"AGATACCTAAACCTGGTCCA","TTCATTAACCAACCAACAAG","561307.5.peg.2046","1165"
"13996",735,381,354,"GCAAGTAAGATACCTAAACC","TTCATTAACCAACCAACAAG","561307.5.peg.2046","1165"
"13997",584,381,203,"AATACTTACAAGTGGAAGT","TTCATTAACCAACCAACAAG","561307.5.peg.2046","1165"
"13998",650,381,269,"CAAGCGGTGTGAATACACCA","TTCATTAACCAACCAACAAG","561307.5.peg.2046","1165"
"13999",666,381,285,"GCAGCTTGATCTGCACCAAG","TTCATTAACCAACCAACAAG","561307.5.peg.2046","1165"
"14000",129,381,252,"GCGATGAAAGCGCCAATGTT","TTCATTAACCAACCAACAAG","561307.5.peg.2046","1165"
"14001",245,381,136,"CACTAAATGCGATCAATAAT","TTCATTAACCAACCAACAAG","561307.5.peg.2046","1165"
"14002",129,409,280,"GCGATGAAAGCGCCAATGTT","TCTAGGTTGAATCAATTGGT","561307.5.peg.2046","1165"
"14003",666,409,257,"GCAGCTTGATCTGCACCAAG","TCTAGGTTGAATCAATTGGT","561307.5.peg.2046","1165"
"14004",245,409,164,"CACTAAATGCGATCAATAAT","TCTAGGTTGAATCAATTGGT","561307.5.peg.2046","1165"
"14005",584,409,175,"AATACTTACAAGTGGAAGT","TCTAGGTTGAATCAATTGGT","561307.5.peg.2046","1165"
"14006",728,409,319,"AGATACCTAAACCTGGTCCA","TCTAGGTTGAATCAATTGGT","561307.5.peg.2046","1165"
"14007",735,409,326,"GCAAGTAAGATACCTAAACC","TCTAGGTTGAATCAATTGGT","561307.5.peg.2046","1165"
"14008",650,409,241,"CAAGCGGTGTGAATACACCA","TCTAGGTTGAATCAATTGGT","561307.5.peg.2046","1165"
"14009",129,584,455,"GCGATGAAAGCGCCAATGTT","AATACTTACAAGTGGAAGT","561307.5.peg.2046","1165"
"14010",245,584,339,"CACTAAATGCGATCAATAAT","AATACTTACAAGTGGAAGT","561307.5.peg.2046","1165"
"14011",381,584,203,"TTCATTAACCAACCAACAAG","AATACTTACAAGTGGAAGT","561307.5.peg.2046","1165"
"14012",735,584,151,"GCAAGTAAGATACCTAAACC","AATACTTACAAGTGGAAGT","561307.5.peg.2046","1165"
"14013",409,584,175,"TCTAGGTTGAATCAATTGGT","AATACTTACAAGTGGAAGT","561307.5.peg.2046","1165"
"14014",728,584,144,"AGATACCTAAACCTGGTCCA","AATACTTACAAGTGGAAGT","561307.5.peg.2046","1165"
"14015",129,650,521,"GCGATGAAAGCGCCAATGTT","CAAGCGGTGTGAATACACCA","561307.5.peg.2046","1165"
"14016",381,650,269,"TTCATTAACCAACCAACAAG","CAAGCGGTGTGAATACACCA","561307.5.peg.2046","1165"
"14017",409,650,241,"TCTAGGTTGAATCAATTGGT","CAAGCGGTGTGAATACACCA","561307.5.peg.2046","1165"
"14018",245,650,405,"CACTAAATGCGATCAATAAT","CAAGCGGTGTGAATACACCA","561307.5.peg.2046","1165"
"14019",381,666,285,"TTCATTAACCAACCAACAAG","GCAGCTTGATCTGCACCAAG","561307.5.peg.2046","1165"
"14020",129,666,537,"GCGATGAAAGCGCCAATGTT","GCAGCTTGATCTGCACCAAG","561307.5.peg.2046","1165"
"14021",409,666,257,"TCTAGGTTGAATCAATTGGT","GCAGCTTGATCTGCACCAAG","561307.5.peg.2046","1165"
"14022",245,666,421,"CACTAAATGCGATCAATAAT","GCAGCTTGATCTGCACCAAG","561307.5.peg.2046","1165"
"14023",584,728,144,"AATACTTACAAGTGGAAGT","AGATACCTAAACCTGGTCCA","561307.5.peg.2046","1165"
"14024",409,728,319,"TCTAGGTTGAATCAATTGGT","AGATACCTAAACCTGGTCCA","561307.5.peg.2046","1165"
"14025",129,728,599,"GCGATGAAAGCGCCAATGTT","AGATACCTAAACCTGGTCCA","561307.5.peg.2046","1165"
"14026",245,728,483,"CACTAAATGCGATCAATAAT","AGATACCTAAACCTGGTCCA","561307.5.peg.2046","1165"
"14027",381,728,347,"TTCATTAACCAACCAACAAG","AGATACCTAAACCTGGTCCA","561307.5.peg.2046","1165"
"14028",129,735,606,"GCGATGAAAGCGCCAATGTT","GCAAGTAAGATACCTAAACC","561307.5.peg.2046","1165"
"14029",245,735,490,"CACTAAATGCGATCAATAAT","GCAAGTAAGATACCTAAACC","561307.5.peg.2046","1165"
"14030",381,735,354,"TTCATTAACCAACCAACAAG","GCAAGTAAGATACCTAAACC","561307.5.peg.2046","1165"
"14031",584,735,151,"AATACTTACAAGTGGAAGT","GCAAGTAAGATACCTAAACC","561307.5.peg.2046","1165"
"14032",409,735,326,"TCTAGGTTGAATCAATTGGT","GCAAGTAAGATACCTAAACC","561307.5.peg.2046","1165"
"14033",309,12,297,"CGGCCATTTGATGATTGATG","CGCGTACTATTCCAATATGG","561307.5.peg.2047","1166"
"14034",831,12,819,"ATAATACGACGCATTACTGC","CGCGTACTATTCCAATATGG","561307.5.peg.2047","1166"
"14035",246,12,234,"CGTGTGTGACCGATTCCAAC","CGCGTACTATTCCAATATGG","561307.5.peg.2047","1166"
"14036",926,12,914,"CTGCTGCAATAACGTAAATG","CGCGTACTATTCCAATATGG","561307.5.peg.2047","1166"
"14037",12,246,234,"CGCGTACTATTCCAATATGG","CGTGTGTGACCGATTCCAAC","561307.5.peg.2047","1166"
"14038",831,246,585,"ATAATACGACGCATTACTGC","CGTGTGTGACCGATTCCAAC","561307.5.peg.2047","1166"
"14039",926,246,680,"CTGCTGCAATAACGTAAATG","CGTGTGTGACCGATTCCAAC","561307.5.peg.2047","1166"
"14040",12,309,297,"CGCGTACTATTCCAATATGG","CGGCCATTTGATGATTGATG","561307.5.peg.2047","1166"
"14041",831,309,522,"ATAATACGACGCATTACTGC","CGGCCATTTGATGATTGATG","561307.5.peg.2047","1166"
"14042",926,309,617,"CTGCTGCAATAACGTAAATG","CGGCCATTTGATGATTGATG","561307.5.peg.2047","1166"
"14043",309,831,522,"CGGCCATTTGATGATTGATG","ATAATACGACGCATTACTGC","561307.5.peg.2047","1166"
"14044",12,831,819,"CGCGTACTATTCCAATATGG","ATAATACGACGCATTACTGC","561307.5.peg.2047","1166"
"14045",246,831,585,"CGTGTGTGACCGATTCCAAC","ATAATACGACGCATTACTGC","561307.5.peg.2047","1166"
"14046",12,926,914,"CGCGTACTATTCCAATATGG","CTGCTGCAATAACGTAAATG","561307.5.peg.2047","1166"
"14047",246,926,680,"CGTGTGTGACCGATTCCAAC","CTGCTGCAATAACGTAAATG","561307.5.peg.2047","1166"
"14048",309,926,617,"CGGCCATTTGATGATTGATG","CTGCTGCAATAACGTAAATG","561307.5.peg.2047","1166"
"14049",207,10,197,"TTAACAGTTCCAGATGTTGC","AGTATGGAGTAGCAATAAAG","561307.5.peg.2048","1167"
"14050",246,10,236,"GCAGAATACCCTACCTTGCC","AGTATGGAGTAGCAATAAAG","561307.5.peg.2048","1167"
"14051",207,45,162,"TTAACAGTTCCAGATGTTGC","CTAATTGAATTAACATGCG","561307.5.peg.2048","1167"
"14052",246,45,201,"GCAGAATACCCTACCTTGCC","CTAATTGAATTAACATGCG","561307.5.peg.2048","1167"
"14053",10,207,197,"AGTATGGAGTAGCAATAAAG","TTAACAGTTCCAGATGTTGC","561307.5.peg.2048","1167"
"14054",45,207,162,"CTAATTGAATTAACATGCG","TTAACAGTTCCAGATGTTGC","561307.5.peg.2048","1167"
"14055",10,246,236,"AGTATGGAGTAGCAATAAAG","GCAGAATACCCTACCTTGCC","561307.5.peg.2048","1167"
"14056",45,246,201,"CTAATTGAATTAACATGCG","GCAGAATACCCTACCTTGCC","561307.5.peg.2048","1167"
"14057",240,9,231,"GAACTATGCGTCAATAAAGC","CAAACAATGAAAGAGACTGT","561307.5.peg.205","1169"
"14058",417,9,408,"GCCATGCTTCCTACACCAGT","CAAACAATGAAAGAGACTGT","561307.5.peg.205","1169"
"14059",9,240,231,"CAAACAATGAAAGAGACTGT","GAACTATGCGTCAATAAAGC","561307.5.peg.205","1169"
"14060",417,240,177,"GCCATGCTTCCTACACCAGT","GAACTATGCGTCAATAAAGC","561307.5.peg.205","1169"
"14061",9,417,408,"CAAACAATGAAAGAGACTGT","GCCATGCTTCCTACACCAGT","561307.5.peg.205","1169"
"14062",240,417,177,"GAACTATGCGTCAATAAAGC","GCCATGCTTCCTACACCAGT","561307.5.peg.205","1169"
"14063",539,167,372,"TGTAATAGCAATACCAATC","TTTGTGCATACTTAGCAAGC","561307.5.peg.2052","1172"
"14064",539,222,317,"TGTAATAGCAATACCAATC","TTAAATATGCATCTACTGG","561307.5.peg.2052","1172"
"14065",167,539,372,"TTTGTGCATACTTAGCAAGC","TGTAATAGCAATACCAATC","561307.5.peg.2052","1172"
"14066",222,539,317,"TTAAATATGCATCTACTGG","TGTAATAGCAATACCAATC","561307.5.peg.2052","1172"
"14067",176,9,167,"GTAATGCCAAGCTGTTAGCA","AGGATGATTCGCGTGATGTA","561307.5.peg.2053","1173"
"14068",212,9,203,"AGAATGTGTCGCTAAACATA","AGGATGATTCGCGTGATGTA","561307.5.peg.2053","1173"
"14069",9,176,167,"AGGATGATTCGCGTGATGTA","GTAATGCCAAGCTGTTAGCA","561307.5.peg.2053","1173"
"14070",9,212,203,"AGGATGATTCGCGTGATGTA","AGAATGTGTCGCTAAACATA","561307.5.peg.2053","1173"
"14071",116,4,112,"CACGATGTTCTGACCAAATA","TGATACAACTGGGGGAATGT","561307.5.peg.2057","1177"
"14072",432,4,428,"ATAGTATGTACTGTTCCTGC","TGATACAACTGGGGGAATGT","561307.5.peg.2057","1177"
"14073",116,14,102,"CACGATGTTCTGACCAAATA","ATTAGACAATGATACAACT","561307.5.peg.2057","1177"
"14074",432,14,418,"ATAGTATGTACTGTTCCTGC","ATTAGACAATGATACAACT","561307.5.peg.2057","1177"
"14075",432,63,369,"ATAGTATGTACTGTTCCTGC","ATAATCTCGCTCGTACCATT","561307.5.peg.2057","1177"
"14076",4,116,112,"TGATACAACTGGGGGAATGT","CACGATGTTCTGACCAAATA","561307.5.peg.2057","1177"
"14077",14,116,102,"ATTAGACAATGATACAACT","CACGATGTTCTGACCAAATA","561307.5.peg.2057","1177"
"14078",432,116,316,"ATAGTATGTACTGTTCCTGC","CACGATGTTCTGACCAAATA","561307.5.peg.2057","1177"
"14079",4,432,428,"TGATACAACTGGGGGAATGT","ATAGTATGTACTGTTCCTGC","561307.5.peg.2057","1177"
"14080",63,432,369,"ATAATCTCGCTCGTACCATT","ATAGTATGTACTGTTCCTGC","561307.5.peg.2057","1177"
"14081",14,432,418,"ATTAGACAATGATACAACT","ATAGTATGTACTGTTCCTGC","561307.5.peg.2057","1177"
"14082",116,432,316,"CACGATGTTCTGACCAAATA","ATAGTATGTACTGTTCCTGC","561307.5.peg.2057","1177"
"14083",678,95,583,"CTATTTGTTCTACCAGGAAT","ACGGTTCATTATGATTCCAA","561307.5.peg.2059","1179"
"14084",507,95,412,"AAATCGTATATTGGTTTCC","ACGGTTCATTATGATTCCAA","561307.5.peg.2059","1179"
"14085",675,95,580,"TTTGTTCTACCAGGAATTGG","ACGGTTCATTATGATTCCAA","561307.5.peg.2059","1179"
"14086",507,114,393,"AAATCGTATATTGGTTTCC","AAAGCTGTTTGTCCTACTAA","561307.5.peg.2059","1179"
"14087",675,114,561,"TTTGTTCTACCAGGAATTGG","AAAGCTGTTTGTCCTACTAA","561307.5.peg.2059","1179"
"14088",678,114,564,"CTATTTGTTCTACCAGGAAT","AAAGCTGTTTGTCCTACTAA","561307.5.peg.2059","1179"
"14089",507,161,346,"AAATCGTATATTGGTTTCC","ACGCTCTAAATCCTTGAGAT","561307.5.peg.2059","1179"
"14090",675,161,514,"TTTGTTCTACCAGGAATTGG","ACGCTCTAAATCCTTGAGAT","561307.5.peg.2059","1179"
"14091",678,161,517,"CTATTTGTTCTACCAGGAAT","ACGCTCTAAATCCTTGAGAT","561307.5.peg.2059","1179"
"14092",161,507,346,"ACGCTCTAAATCCTTGAGAT","AAATCGTATATTGGTTTCC","561307.5.peg.2059","1179"
"14093",114,507,393,"AAAGCTGTTTGTCCTACTAA","AAATCGTATATTGGTTTCC","561307.5.peg.2059","1179"
"14094",95,507,412,"ACGGTTCATTATGATTCCAA","AAATCGTATATTGGTTTCC","561307.5.peg.2059","1179"
"14095",675,507,168,"TTTGTTCTACCAGGAATTGG","AAATCGTATATTGGTTTCC","561307.5.peg.2059","1179"
"14096",678,507,171,"CTATTTGTTCTACCAGGAAT","AAATCGTATATTGGTTTCC","561307.5.peg.2059","1179"
"14097",95,675,580,"ACGGTTCATTATGATTCCAA","TTTGTTCTACCAGGAATTGG","561307.5.peg.2059","1179"
"14098",161,675,514,"ACGCTCTAAATCCTTGAGAT","TTTGTTCTACCAGGAATTGG","561307.5.peg.2059","1179"
"14099",114,675,561,"AAAGCTGTTTGTCCTACTAA","TTTGTTCTACCAGGAATTGG","561307.5.peg.2059","1179"
"14100",507,675,168,"AAATCGTATATTGGTTTCC","TTTGTTCTACCAGGAATTGG","561307.5.peg.2059","1179"
"14101",95,678,583,"ACGGTTCATTATGATTCCAA","CTATTTGTTCTACCAGGAAT","561307.5.peg.2059","1179"
"14102",114,678,564,"AAAGCTGTTTGTCCTACTAA","CTATTTGTTCTACCAGGAAT","561307.5.peg.2059","1179"
"14103",507,678,171,"AAATCGTATATTGGTTTCC","CTATTTGTTCTACCAGGAAT","561307.5.peg.2059","1179"
"14104",161,678,517,"ACGCTCTAAATCCTTGAGAT","CTATTTGTTCTACCAGGAAT","561307.5.peg.2059","1179"
"14105",402,188,214,"GGCAATGTTACTACTAAAGC","GTCTAAATTCGATTCGTTCA","561307.5.peg.206","1180"
"14106",188,402,214,"GTCTAAATTCGATTCGTTCA","GGCAATGTTACTACTAAAGC","561307.5.peg.206","1180"
"14107",547,150,397,"AGTACCAGTAACATCCCTTA","AAACTTGATGCTTGGTAATC","561307.5.peg.2064","1185"
"14108",547,158,389,"AGTACCAGTAACATCCCTTA","CCATTGCTAAACTTGATGCT","561307.5.peg.2064","1185"
"14109",150,547,397,"AAACTTGATGCTTGGTAATC","AGTACCAGTAACATCCCTTA","561307.5.peg.2064","1185"
"14110",158,547,389,"CCATTGCTAAACTTGATGCT","AGTACCAGTAACATCCCTTA","561307.5.peg.2064","1185"
"14111",207,103,104,"TGTTCTAATGAATGTAGTCC","TCCCGCTAATCTAATAAATG","561307.5.peg.2066","1187"
"14112",207,105,102,"TGTTCTAATGAATGTAGTCC","GTTCCCGCTAATCTAATAAA","561307.5.peg.2066","1187"
"14113",103,207,104,"TCCCGCTAATCTAATAAATG","TGTTCTAATGAATGTAGTCC","561307.5.peg.2066","1187"
"14114",105,207,102,"GTTCCCGCTAATCTAATAAA","TGTTCTAATGAATGTAGTCC","561307.5.peg.2066","1187"
"14115",309,135,174,"CCACAAGCATGACCCAATCC","TTTCTTCATTACCAAGTTC","561307.5.peg.2067","1188"
"14116",392,135,257,"CGACTACTTTACCACCAATT","TTTCTTCATTACCAAGTTC","561307.5.peg.2067","1188"
"14117",392,214,178,"CGACTACTTTACCACCAATT","AGTTGCATGCCCAGCAATCT","561307.5.peg.2067","1188"
"14118",135,309,174,"TTTCTTCATTACCAAGTTC","CCACAAGCATGACCCAATCC","561307.5.peg.2067","1188"
"14119",135,392,257,"TTTCTTCATTACCAAGTTC","CGACTACTTTACCACCAATT","561307.5.peg.2067","1188"
"14120",214,392,178,"AGTTGCATGCCCAGCAATCT","CGACTACTTTACCACCAATT","561307.5.peg.2067","1188"
"14121",144,6,138,"TGTTCGTCCGGTTTCAACCA","ATGCGCATTTGAAAGGGAAT","561307.5.peg.2068","1189"
"14122",585,6,579,"ACGCCATAGCCACCTGCTGT","ATGCGCATTTGAAAGGGAAT","561307.5.peg.2068","1189"
"14123",468,6,462,"AACTTCCCATTTGTCCATTC","ATGCGCATTTGAAAGGGAAT","561307.5.peg.2068","1189"
"14124",216,6,210,"CTAGCTTCGTGAACAATAAC","ATGCGCATTTGAAAGGGAAT","561307.5.peg.2068","1189"
"14125",126,6,120,"CATGGATTCGATATATACGA","ATGCGCATTTGAAAGGGAAT","561307.5.peg.2068","1189"
"14126",570,6,564,"GCTGTCGGAAGATCATCTCC","ATGCGCATTTGAAAGGGAAT","561307.5.peg.2068","1189"
"14127",554,6,548,"CTCCCGGCTTAATTACTAAC","ATGCGCATTTGAAAGGGAAT","561307.5.peg.2068","1189"
"14128",156,6,150,"AAATTAGATTGATGTTCGTC","ATGCGCATTTGAAAGGGAAT","561307.5.peg.2068","1189"
"14129",570,12,558,"GCTGTCGGAAGATCATCTCC","AAGAGCATGCGCATTTGAAA","561307.5.peg.2068","1189"
"14130",156,12,144,"AAATTAGATTGATGTTCGTC","AAGAGCATGCGCATTTGAAA","561307.5.peg.2068","1189"
"14131",216,12,204,"CTAGCTTCGTGAACAATAAC","AAGAGCATGCGCATTTGAAA","561307.5.peg.2068","1189"
"14132",554,12,542,"CTCCCGGCTTAATTACTAAC","AAGAGCATGCGCATTTGAAA","561307.5.peg.2068","1189"
"14133",144,12,132,"TGTTCGTCCGGTTTCAACCA","AAGAGCATGCGCATTTGAAA","561307.5.peg.2068","1189"
"14134",585,12,573,"ACGCCATAGCCACCTGCTGT","AAGAGCATGCGCATTTGAAA","561307.5.peg.2068","1189"
"14135",126,12,114,"CATGGATTCGATATATACGA","AAGAGCATGCGCATTTGAAA","561307.5.peg.2068","1189"
"14136",468,12,456,"AACTTCCCATTTGTCCATTC","AAGAGCATGCGCATTTGAAA","561307.5.peg.2068","1189"
"14137",216,72,144,"CTAGCTTCGTGAACAATAAC","AATCACTTAACGTTAAGTT","561307.5.peg.2068","1189"
"14138",585,72,513,"ACGCCATAGCCACCTGCTGT","AATCACTTAACGTTAAGTT","561307.5.peg.2068","1189"
"14139",570,72,498,"GCTGTCGGAAGATCATCTCC","AATCACTTAACGTTAAGTT","561307.5.peg.2068","1189"
"14140",554,72,482,"CTCCCGGCTTAATTACTAAC","AATCACTTAACGTTAAGTT","561307.5.peg.2068","1189"
"14141",468,72,396,"AACTTCCCATTTGTCCATTC","AATCACTTAACGTTAAGTT","561307.5.peg.2068","1189"
"14142",6,126,120,"ATGCGCATTTGAAAGGGAAT","CATGGATTCGATATATACGA","561307.5.peg.2068","1189"
"14143",12,126,114,"AAGAGCATGCGCATTTGAAA","CATGGATTCGATATATACGA","561307.5.peg.2068","1189"
"14144",570,126,444,"GCTGTCGGAAGATCATCTCC","CATGGATTCGATATATACGA","561307.5.peg.2068","1189"
"14145",468,126,342,"AACTTCCCATTTGTCCATTC","CATGGATTCGATATATACGA","561307.5.peg.2068","1189"
"14146",585,126,459,"ACGCCATAGCCACCTGCTGT","CATGGATTCGATATATACGA","561307.5.peg.2068","1189"
"14147",554,126,428,"CTCCCGGCTTAATTACTAAC","CATGGATTCGATATATACGA","561307.5.peg.2068","1189"
"14148",6,144,138,"ATGCGCATTTGAAAGGGAAT","TGTTCGTCCGGTTTCAACCA","561307.5.peg.2068","1189"
"14149",554,144,410,"CTCCCGGCTTAATTACTAAC","TGTTCGTCCGGTTTCAACCA","561307.5.peg.2068","1189"
"14150",468,144,324,"AACTTCCCATTTGTCCATTC","TGTTCGTCCGGTTTCAACCA","561307.5.peg.2068","1189"
"14151",570,144,426,"GCTGTCGGAAGATCATCTCC","TGTTCGTCCGGTTTCAACCA","561307.5.peg.2068","1189"
"14152",12,144,132,"AAGAGCATGCGCATTTGAAA","TGTTCGTCCGGTTTCAACCA","561307.5.peg.2068","1189"
"14153",585,144,441,"ACGCCATAGCCACCTGCTGT","TGTTCGTCCGGTTTCAACCA","561307.5.peg.2068","1189"
"14154",12,156,144,"AAGAGCATGCGCATTTGAAA","AAATTAGATTGATGTTCGTC","561307.5.peg.2068","1189"
"14155",468,156,312,"AACTTCCCATTTGTCCATTC","AAATTAGATTGATGTTCGTC","561307.5.peg.2068","1189"
"14156",6,156,150,"ATGCGCATTTGAAAGGGAAT","AAATTAGATTGATGTTCGTC","561307.5.peg.2068","1189"
"14157",554,156,398,"CTCCCGGCTTAATTACTAAC","AAATTAGATTGATGTTCGTC","561307.5.peg.2068","1189"
"14158",570,156,414,"GCTGTCGGAAGATCATCTCC","AAATTAGATTGATGTTCGTC","561307.5.peg.2068","1189"
"14159",585,156,429,"ACGCCATAGCCACCTGCTGT","AAATTAGATTGATGTTCGTC","561307.5.peg.2068","1189"
"14160",12,216,204,"AAGAGCATGCGCATTTGAAA","CTAGCTTCGTGAACAATAAC","561307.5.peg.2068","1189"
"14161",570,216,354,"GCTGTCGGAAGATCATCTCC","CTAGCTTCGTGAACAATAAC","561307.5.peg.2068","1189"
"14162",585,216,369,"ACGCCATAGCCACCTGCTGT","CTAGCTTCGTGAACAATAAC","561307.5.peg.2068","1189"
"14163",72,216,144,"AATCACTTAACGTTAAGTT","CTAGCTTCGTGAACAATAAC","561307.5.peg.2068","1189"
"14164",554,216,338,"CTCCCGGCTTAATTACTAAC","CTAGCTTCGTGAACAATAAC","561307.5.peg.2068","1189"
"14165",468,216,252,"AACTTCCCATTTGTCCATTC","CTAGCTTCGTGAACAATAAC","561307.5.peg.2068","1189"
"14166",6,216,210,"ATGCGCATTTGAAAGGGAAT","CTAGCTTCGTGAACAATAAC","561307.5.peg.2068","1189"
"14167",12,468,456,"AAGAGCATGCGCATTTGAAA","AACTTCCCATTTGTCCATTC","561307.5.peg.2068","1189"
"14168",585,468,117,"ACGCCATAGCCACCTGCTGT","AACTTCCCATTTGTCCATTC","561307.5.peg.2068","1189"
"14169",156,468,312,"AAATTAGATTGATGTTCGTC","AACTTCCCATTTGTCCATTC","561307.5.peg.2068","1189"
"14170",216,468,252,"CTAGCTTCGTGAACAATAAC","AACTTCCCATTTGTCCATTC","561307.5.peg.2068","1189"
"14171",570,468,102,"GCTGTCGGAAGATCATCTCC","AACTTCCCATTTGTCCATTC","561307.5.peg.2068","1189"
"14172",6,468,462,"ATGCGCATTTGAAAGGGAAT","AACTTCCCATTTGTCCATTC","561307.5.peg.2068","1189"
"14173",72,468,396,"AATCACTTAACGTTAAGTT","AACTTCCCATTTGTCCATTC","561307.5.peg.2068","1189"
"14174",144,468,324,"TGTTCGTCCGGTTTCAACCA","AACTTCCCATTTGTCCATTC","561307.5.peg.2068","1189"
"14175",126,468,342,"CATGGATTCGATATATACGA","AACTTCCCATTTGTCCATTC","561307.5.peg.2068","1189"
"14176",72,554,482,"AATCACTTAACGTTAAGTT","CTCCCGGCTTAATTACTAAC","561307.5.peg.2068","1189"
"14177",126,554,428,"CATGGATTCGATATATACGA","CTCCCGGCTTAATTACTAAC","561307.5.peg.2068","1189"
"14178",144,554,410,"TGTTCGTCCGGTTTCAACCA","CTCCCGGCTTAATTACTAAC","561307.5.peg.2068","1189"
"14179",6,554,548,"ATGCGCATTTGAAAGGGAAT","CTCCCGGCTTAATTACTAAC","561307.5.peg.2068","1189"
"14180",12,554,542,"AAGAGCATGCGCATTTGAAA","CTCCCGGCTTAATTACTAAC","561307.5.peg.2068","1189"
"14181",216,554,338,"CTAGCTTCGTGAACAATAAC","CTCCCGGCTTAATTACTAAC","561307.5.peg.2068","1189"
"14182",156,554,398,"AAATTAGATTGATGTTCGTC","CTCCCGGCTTAATTACTAAC","561307.5.peg.2068","1189"
"14183",72,570,498,"AATCACTTAACGTTAAGTT","GCTGTCGGAAGATCATCTCC","561307.5.peg.2068","1189"
"14184",12,570,558,"AAGAGCATGCGCATTTGAAA","GCTGTCGGAAGATCATCTCC","561307.5.peg.2068","1189"
"14185",216,570,354,"CTAGCTTCGTGAACAATAAC","GCTGTCGGAAGATCATCTCC","561307.5.peg.2068","1189"
"14186",156,570,414,"AAATTAGATTGATGTTCGTC","GCTGTCGGAAGATCATCTCC","561307.5.peg.2068","1189"
"14187",126,570,444,"CATGGATTCGATATATACGA","GCTGTCGGAAGATCATCTCC","561307.5.peg.2068","1189"
"14188",6,570,564,"ATGCGCATTTGAAAGGGAAT","GCTGTCGGAAGATCATCTCC","561307.5.peg.2068","1189"
"14189",144,570,426,"TGTTCGTCCGGTTTCAACCA","GCTGTCGGAAGATCATCTCC","561307.5.peg.2068","1189"
"14190",468,570,102,"AACTTCCCATTTGTCCATTC","GCTGTCGGAAGATCATCTCC","561307.5.peg.2068","1189"
"14191",72,585,513,"AATCACTTAACGTTAAGTT","ACGCCATAGCCACCTGCTGT","561307.5.peg.2068","1189"
"14192",144,585,441,"TGTTCGTCCGGTTTCAACCA","ACGCCATAGCCACCTGCTGT","561307.5.peg.2068","1189"
"14193",216,585,369,"CTAGCTTCGTGAACAATAAC","ACGCCATAGCCACCTGCTGT","561307.5.peg.2068","1189"
"14194",6,585,579,"ATGCGCATTTGAAAGGGAAT","ACGCCATAGCCACCTGCTGT","561307.5.peg.2068","1189"
"14195",468,585,117,"AACTTCCCATTTGTCCATTC","ACGCCATAGCCACCTGCTGT","561307.5.peg.2068","1189"
"14196",126,585,459,"CATGGATTCGATATATACGA","ACGCCATAGCCACCTGCTGT","561307.5.peg.2068","1189"
"14197",156,585,429,"AAATTAGATTGATGTTCGTC","ACGCCATAGCCACCTGCTGT","561307.5.peg.2068","1189"
"14198",12,585,573,"AAGAGCATGCGCATTTGAAA","ACGCCATAGCCACCTGCTGT","561307.5.peg.2068","1189"
"14199",346,7,339,"GAAATAATGTAGTGACGTAC","TAGACATTAATAATGAGGT","561307.5.peg.2070","1192"
"14200",374,7,367,"CGCCTACACGACGTTGTGAT","TAGACATTAATAATGAGGT","561307.5.peg.2070","1192"
"14201",7,346,339,"TAGACATTAATAATGAGGT","GAAATAATGTAGTGACGTAC","561307.5.peg.2070","1192"
"14202",7,374,367,"TAGACATTAATAATGAGGT","CGCCTACACGACGTTGTGAT","561307.5.peg.2070","1192"
"14203",585,25,560,"TCTCCAGCAGCTTTAATATA","TGACCTCCTAATTATTAAA","561307.5.peg.2073","1195"
"14204",257,25,232,"TTTCGTAATGTCCTAAGTCT","TGACCTCCTAATTATTAAA","561307.5.peg.2073","1195"
"14205",621,25,596,"CTTTAACACTATGTTGTGT","TGACCTCCTAATTATTAAA","561307.5.peg.2073","1195"
"14206",191,25,166,"GATAAGGACTCATTGTACCT","TGACCTCCTAATTATTAAA","561307.5.peg.2073","1195"
"14207",207,25,182,"ATACTTCACCATGTTGATA","TGACCTCCTAATTATTAAA","561307.5.peg.2073","1195"
"14208",666,25,641,"GTTCTTACAACGATTAAGTC","TGACCTCCTAATTATTAAA","561307.5.peg.2073","1195"
"14209",507,25,482,"TGACGAATCGCTTCAATAAA","TGACCTCCTAATTATTAAA","561307.5.peg.2073","1195"
"14210",25,191,166,"TGACCTCCTAATTATTAAA","GATAAGGACTCATTGTACCT","561307.5.peg.2073","1195"
"14211",507,191,316,"TGACGAATCGCTTCAATAAA","GATAAGGACTCATTGTACCT","561307.5.peg.2073","1195"
"14212",585,191,394,"TCTCCAGCAGCTTTAATATA","GATAAGGACTCATTGTACCT","561307.5.peg.2073","1195"
"14213",621,191,430,"CTTTAACACTATGTTGTGT","GATAAGGACTCATTGTACCT","561307.5.peg.2073","1195"
"14214",666,191,475,"GTTCTTACAACGATTAAGTC","GATAAGGACTCATTGTACCT","561307.5.peg.2073","1195"
"14215",585,207,378,"TCTCCAGCAGCTTTAATATA","ATACTTCACCATGTTGATA","561307.5.peg.2073","1195"
"14216",25,207,182,"TGACCTCCTAATTATTAAA","ATACTTCACCATGTTGATA","561307.5.peg.2073","1195"
"14217",507,207,300,"TGACGAATCGCTTCAATAAA","ATACTTCACCATGTTGATA","561307.5.peg.2073","1195"
"14218",621,207,414,"CTTTAACACTATGTTGTGT","ATACTTCACCATGTTGATA","561307.5.peg.2073","1195"
"14219",666,207,459,"GTTCTTACAACGATTAAGTC","ATACTTCACCATGTTGATA","561307.5.peg.2073","1195"
"14220",585,257,328,"TCTCCAGCAGCTTTAATATA","TTTCGTAATGTCCTAAGTCT","561307.5.peg.2073","1195"
"14221",666,257,409,"GTTCTTACAACGATTAAGTC","TTTCGTAATGTCCTAAGTCT","561307.5.peg.2073","1195"
"14222",621,257,364,"CTTTAACACTATGTTGTGT","TTTCGTAATGTCCTAAGTCT","561307.5.peg.2073","1195"
"14223",25,257,232,"TGACCTCCTAATTATTAAA","TTTCGTAATGTCCTAAGTCT","561307.5.peg.2073","1195"
"14224",507,257,250,"TGACGAATCGCTTCAATAAA","TTTCGTAATGTCCTAAGTCT","561307.5.peg.2073","1195"
"14225",25,507,482,"TGACCTCCTAATTATTAAA","TGACGAATCGCTTCAATAAA","561307.5.peg.2073","1195"
"14226",191,507,316,"GATAAGGACTCATTGTACCT","TGACGAATCGCTTCAATAAA","561307.5.peg.2073","1195"
"14227",207,507,300,"ATACTTCACCATGTTGATA","TGACGAATCGCTTCAATAAA","561307.5.peg.2073","1195"
"14228",257,507,250,"TTTCGTAATGTCCTAAGTCT","TGACGAATCGCTTCAATAAA","561307.5.peg.2073","1195"
"14229",621,507,114,"CTTTAACACTATGTTGTGT","TGACGAATCGCTTCAATAAA","561307.5.peg.2073","1195"
"14230",666,507,159,"GTTCTTACAACGATTAAGTC","TGACGAATCGCTTCAATAAA","561307.5.peg.2073","1195"
"14231",207,585,378,"ATACTTCACCATGTTGATA","TCTCCAGCAGCTTTAATATA","561307.5.peg.2073","1195"
"14232",257,585,328,"TTTCGTAATGTCCTAAGTCT","TCTCCAGCAGCTTTAATATA","561307.5.peg.2073","1195"
"14233",25,585,560,"TGACCTCCTAATTATTAAA","TCTCCAGCAGCTTTAATATA","561307.5.peg.2073","1195"
"14234",191,585,394,"GATAAGGACTCATTGTACCT","TCTCCAGCAGCTTTAATATA","561307.5.peg.2073","1195"
"14235",25,621,596,"TGACCTCCTAATTATTAAA","CTTTAACACTATGTTGTGT","561307.5.peg.2073","1195"
"14236",507,621,114,"TGACGAATCGCTTCAATAAA","CTTTAACACTATGTTGTGT","561307.5.peg.2073","1195"
"14237",257,621,364,"TTTCGTAATGTCCTAAGTCT","CTTTAACACTATGTTGTGT","561307.5.peg.2073","1195"
"14238",207,621,414,"ATACTTCACCATGTTGATA","CTTTAACACTATGTTGTGT","561307.5.peg.2073","1195"
"14239",191,621,430,"GATAAGGACTCATTGTACCT","CTTTAACACTATGTTGTGT","561307.5.peg.2073","1195"
"14240",25,666,641,"TGACCTCCTAATTATTAAA","GTTCTTACAACGATTAAGTC","561307.5.peg.2073","1195"
"14241",257,666,409,"TTTCGTAATGTCCTAAGTCT","GTTCTTACAACGATTAAGTC","561307.5.peg.2073","1195"
"14242",507,666,159,"TGACGAATCGCTTCAATAAA","GTTCTTACAACGATTAAGTC","561307.5.peg.2073","1195"
"14243",191,666,475,"GATAAGGACTCATTGTACCT","GTTCTTACAACGATTAAGTC","561307.5.peg.2073","1195"
"14244",207,666,459,"ATACTTCACCATGTTGATA","GTTCTTACAACGATTAAGTC","561307.5.peg.2073","1195"
"14245",131,8,123,"AATTGCTTGAGTGAATTCT","ACGTGCGTAAGCACTCAAGG","561307.5.peg.2075","1197"
"14246",285,8,277,"TGGTCTAAATGGATTGCTAC","ACGTGCGTAAGCACTCAAGG","561307.5.peg.2075","1197"
"14247",131,11,120,"AATTGCTTGAGTGAATTCT","AATACGTGCGTAAGCACTCA","561307.5.peg.2075","1197"
"14248",285,11,274,"TGGTCTAAATGGATTGCTAC","AATACGTGCGTAAGCACTCA","561307.5.peg.2075","1197"
"14249",8,131,123,"ACGTGCGTAAGCACTCAAGG","AATTGCTTGAGTGAATTCT","561307.5.peg.2075","1197"
"14250",285,131,154,"TGGTCTAAATGGATTGCTAC","AATTGCTTGAGTGAATTCT","561307.5.peg.2075","1197"
"14251",11,131,120,"AATACGTGCGTAAGCACTCA","AATTGCTTGAGTGAATTCT","561307.5.peg.2075","1197"
"14252",11,285,274,"AATACGTGCGTAAGCACTCA","TGGTCTAAATGGATTGCTAC","561307.5.peg.2075","1197"
"14253",8,285,277,"ACGTGCGTAAGCACTCAAGG","TGGTCTAAATGGATTGCTAC","561307.5.peg.2075","1197"
"14254",131,285,154,"AATTGCTTGAGTGAATTCT","TGGTCTAAATGGATTGCTAC","561307.5.peg.2075","1197"
"14255",624,393,231,"TTAGCAACATCAACTACTTC","GGCCCAAGTGGACATCCTCC","561307.5.peg.2076","1198"
"14256",624,405,219,"TTAGCAACATCAACTACTTC","TCAATTGGACGTGGCCCAAG","561307.5.peg.2076","1198"
"14257",624,414,210,"TTAGCAACATCAACTACTTC","ATATGTTGATCAATTGGACG","561307.5.peg.2076","1198"
"14258",393,624,231,"GGCCCAAGTGGACATCCTCC","TTAGCAACATCAACTACTTC","561307.5.peg.2076","1198"
"14259",405,624,219,"TCAATTGGACGTGGCCCAAG","TTAGCAACATCAACTACTTC","561307.5.peg.2076","1198"
"14260",414,624,210,"ATATGTTGATCAATTGGACG","TTAGCAACATCAACTACTTC","561307.5.peg.2076","1198"
"14261",428,129,299,"TAACAACTAAATCATCTCCG","CCGATTACTTCTTCGGTTGC","561307.5.peg.2078","1200"
"14262",483,129,354,"TGGTTTGTAGGGAAGTTCCA","CCGATTACTTCTTCGGTTGC","561307.5.peg.2078","1200"
"14263",494,129,365,"TAATGATGTTTGGTTTGTA","CCGATTACTTCTTCGGTTGC","561307.5.peg.2078","1200"
"14264",690,129,561,"AATGACATCATGCGTACTTT","CCGATTACTTCTTCGGTTGC","561307.5.peg.2078","1200"
"14265",428,190,238,"TAACAACTAAATCATCTCCG","AACATCGTCTGCCGCCTCGA","561307.5.peg.2078","1200"
"14266",483,190,293,"TGGTTTGTAGGGAAGTTCCA","AACATCGTCTGCCGCCTCGA","561307.5.peg.2078","1200"
"14267",494,190,304,"TAATGATGTTTGGTTTGTA","AACATCGTCTGCCGCCTCGA","561307.5.peg.2078","1200"
"14268",690,190,500,"AATGACATCATGCGTACTTT","AACATCGTCTGCCGCCTCGA","561307.5.peg.2078","1200"
"14269",483,224,259,"TGGTTTGTAGGGAAGTTCCA","TTTCTTTCACAGATGTATGA","561307.5.peg.2078","1200"
"14270",494,224,270,"TAATGATGTTTGGTTTGTA","TTTCTTTCACAGATGTATGA","561307.5.peg.2078","1200"
"14271",690,224,466,"AATGACATCATGCGTACTTT","TTTCTTTCACAGATGTATGA","561307.5.peg.2078","1200"
"14272",428,224,204,"TAACAACTAAATCATCTCCG","TTTCTTTCACAGATGTATGA","561307.5.peg.2078","1200"
"14273",129,428,299,"CCGATTACTTCTTCGGTTGC","TAACAACTAAATCATCTCCG","561307.5.peg.2078","1200"
"14274",690,428,262,"AATGACATCATGCGTACTTT","TAACAACTAAATCATCTCCG","561307.5.peg.2078","1200"
"14275",190,428,238,"AACATCGTCTGCCGCCTCGA","TAACAACTAAATCATCTCCG","561307.5.peg.2078","1200"
"14276",224,428,204,"TTTCTTTCACAGATGTATGA","TAACAACTAAATCATCTCCG","561307.5.peg.2078","1200"
"14277",129,483,354,"CCGATTACTTCTTCGGTTGC","TGGTTTGTAGGGAAGTTCCA","561307.5.peg.2078","1200"
"14278",190,483,293,"AACATCGTCTGCCGCCTCGA","TGGTTTGTAGGGAAGTTCCA","561307.5.peg.2078","1200"
"14279",224,483,259,"TTTCTTTCACAGATGTATGA","TGGTTTGTAGGGAAGTTCCA","561307.5.peg.2078","1200"
"14280",690,483,207,"AATGACATCATGCGTACTTT","TGGTTTGTAGGGAAGTTCCA","561307.5.peg.2078","1200"
"14281",129,494,365,"CCGATTACTTCTTCGGTTGC","TAATGATGTTTGGTTTGTA","561307.5.peg.2078","1200"
"14282",190,494,304,"AACATCGTCTGCCGCCTCGA","TAATGATGTTTGGTTTGTA","561307.5.peg.2078","1200"
"14283",224,494,270,"TTTCTTTCACAGATGTATGA","TAATGATGTTTGGTTTGTA","561307.5.peg.2078","1200"
"14284",690,494,196,"AATGACATCATGCGTACTTT","TAATGATGTTTGGTTTGTA","561307.5.peg.2078","1200"
"14285",129,690,561,"CCGATTACTTCTTCGGTTGC","AATGACATCATGCGTACTTT","561307.5.peg.2078","1200"
"14286",190,690,500,"AACATCGTCTGCCGCCTCGA","AATGACATCATGCGTACTTT","561307.5.peg.2078","1200"
"14287",224,690,466,"TTTCTTTCACAGATGTATGA","AATGACATCATGCGTACTTT","561307.5.peg.2078","1200"
"14288",428,690,262,"TAACAACTAAATCATCTCCG","AATGACATCATGCGTACTTT","561307.5.peg.2078","1200"
"14289",483,690,207,"TGGTTTGTAGGGAAGTTCCA","AATGACATCATGCGTACTTT","561307.5.peg.2078","1200"
"14290",494,690,196,"TAATGATGTTTGGTTTGTA","AATGACATCATGCGTACTTT","561307.5.peg.2078","1200"
"14291",446,54,392,"TCTTCACTTCTTCTGCGTTA","GGAGATGTACGTTCTCTTTC","561307.5.peg.2079","1201"
"14292",504,54,450,"CTAATTTAATACGCTCATC","GGAGATGTACGTTCTCTTTC","561307.5.peg.2079","1201"
"14293",573,54,519,"CCACGTTGACCTAAACCAAT","GGAGATGTACGTTCTCTTTC","561307.5.peg.2079","1201"
"14294",474,54,420,"GGTGTCAAAGCTTGGAAATG","GGAGATGTACGTTCTCTTTC","561307.5.peg.2079","1201"
"14295",482,54,428,"GATAAAGTGGTGTCAAAGCT","GGAGATGTACGTTCTCTTTC","561307.5.peg.2079","1201"
"14296",495,54,441,"ATACGCTCATCTGGATAAAG","GGAGATGTACGTTCTCTTTC","561307.5.peg.2079","1201"
"14297",446,75,371,"TCTTCACTTCTTCTGCGTTA","TCGTGGAATGATTCATACTG","561307.5.peg.2079","1201"
"14298",482,75,407,"GATAAAGTGGTGTCAAAGCT","TCGTGGAATGATTCATACTG","561307.5.peg.2079","1201"
"14299",573,75,498,"CCACGTTGACCTAAACCAAT","TCGTGGAATGATTCATACTG","561307.5.peg.2079","1201"
"14300",495,75,420,"ATACGCTCATCTGGATAAAG","TCGTGGAATGATTCATACTG","561307.5.peg.2079","1201"
"14301",504,75,429,"CTAATTTAATACGCTCATC","TCGTGGAATGATTCATACTG","561307.5.peg.2079","1201"
"14302",474,75,399,"GGTGTCAAAGCTTGGAAATG","TCGTGGAATGATTCATACTG","561307.5.peg.2079","1201"
"14303",495,92,403,"ATACGCTCATCTGGATAAAG","ATAGTTCTTGTACAATTCG","561307.5.peg.2079","1201"
"14304",482,92,390,"GATAAAGTGGTGTCAAAGCT","ATAGTTCTTGTACAATTCG","561307.5.peg.2079","1201"
"14305",446,92,354,"TCTTCACTTCTTCTGCGTTA","ATAGTTCTTGTACAATTCG","561307.5.peg.2079","1201"
"14306",573,92,481,"CCACGTTGACCTAAACCAAT","ATAGTTCTTGTACAATTCG","561307.5.peg.2079","1201"
"14307",474,92,382,"GGTGTCAAAGCTTGGAAATG","ATAGTTCTTGTACAATTCG","561307.5.peg.2079","1201"
"14308",504,92,412,"CTAATTTAATACGCTCATC","ATAGTTCTTGTACAATTCG","561307.5.peg.2079","1201"
"14309",54,446,392,"GGAGATGTACGTTCTCTTTC","TCTTCACTTCTTCTGCGTTA","561307.5.peg.2079","1201"
"14310",75,446,371,"TCGTGGAATGATTCATACTG","TCTTCACTTCTTCTGCGTTA","561307.5.peg.2079","1201"
"14311",573,446,127,"CCACGTTGACCTAAACCAAT","TCTTCACTTCTTCTGCGTTA","561307.5.peg.2079","1201"
"14312",92,446,354,"ATAGTTCTTGTACAATTCG","TCTTCACTTCTTCTGCGTTA","561307.5.peg.2079","1201"
"14313",54,474,420,"GGAGATGTACGTTCTCTTTC","GGTGTCAAAGCTTGGAAATG","561307.5.peg.2079","1201"
"14314",75,474,399,"TCGTGGAATGATTCATACTG","GGTGTCAAAGCTTGGAAATG","561307.5.peg.2079","1201"
"14315",92,474,382,"ATAGTTCTTGTACAATTCG","GGTGTCAAAGCTTGGAAATG","561307.5.peg.2079","1201"
"14316",54,482,428,"GGAGATGTACGTTCTCTTTC","GATAAAGTGGTGTCAAAGCT","561307.5.peg.2079","1201"
"14317",75,482,407,"TCGTGGAATGATTCATACTG","GATAAAGTGGTGTCAAAGCT","561307.5.peg.2079","1201"
"14318",92,482,390,"ATAGTTCTTGTACAATTCG","GATAAAGTGGTGTCAAAGCT","561307.5.peg.2079","1201"
"14319",75,495,420,"TCGTGGAATGATTCATACTG","ATACGCTCATCTGGATAAAG","561307.5.peg.2079","1201"
"14320",92,495,403,"ATAGTTCTTGTACAATTCG","ATACGCTCATCTGGATAAAG","561307.5.peg.2079","1201"
"14321",54,495,441,"GGAGATGTACGTTCTCTTTC","ATACGCTCATCTGGATAAAG","561307.5.peg.2079","1201"
"14322",54,504,450,"GGAGATGTACGTTCTCTTTC","CTAATTTAATACGCTCATC","561307.5.peg.2079","1201"
"14323",92,504,412,"ATAGTTCTTGTACAATTCG","CTAATTTAATACGCTCATC","561307.5.peg.2079","1201"
"14324",75,504,429,"TCGTGGAATGATTCATACTG","CTAATTTAATACGCTCATC","561307.5.peg.2079","1201"
"14325",92,573,481,"ATAGTTCTTGTACAATTCG","CCACGTTGACCTAAACCAAT","561307.5.peg.2079","1201"
"14326",54,573,519,"GGAGATGTACGTTCTCTTTC","CCACGTTGACCTAAACCAAT","561307.5.peg.2079","1201"
"14327",446,573,127,"TCTTCACTTCTTCTGCGTTA","CCACGTTGACCTAAACCAAT","561307.5.peg.2079","1201"
"14328",75,573,498,"TCGTGGAATGATTCATACTG","CCACGTTGACCTAAACCAAT","561307.5.peg.2079","1201"
"14329",634,507,127,"TGTGTTCAAAGTAAAGTCCA","CCTTCCTTAATACGATAGAC","561307.5.peg.208","1202"
"14330",703,507,196,"AACAGTTCAGTAAATGCAT","CCTTCCTTAATACGATAGAC","561307.5.peg.208","1202"
"14331",507,634,127,"CCTTCCTTAATACGATAGAC","TGTGTTCAAAGTAAAGTCCA","561307.5.peg.208","1202"
"14332",507,703,196,"CCTTCCTTAATACGATAGAC","AACAGTTCAGTAAATGCAT","561307.5.peg.208","1202"
"14333",180,65,115,"TGATATCGATCATCAATCGC","TACATTCTATCCAACCGGAA","561307.5.peg.2081","1204"
"14334",180,70,110,"TGATATCGATCATCAATCGC","TGTAATACATTCTATCCAAC","561307.5.peg.2081","1204"
"14335",65,180,115,"TACATTCTATCCAACCGGAA","TGATATCGATCATCAATCGC","561307.5.peg.2081","1204"
"14336",70,180,110,"TGTAATACATTCTATCCAAC","TGATATCGATCATCAATCGC","561307.5.peg.2081","1204"
"14337",315,8,307,"TAAGCTCTTCTTCAAGATT","TATCACTAGGTGCTACGATA","561307.5.peg.2082","1205"
"14338",113,8,105,"CTGAATCATTTACAACATCT","TATCACTAGGTGCTACGATA","561307.5.peg.2082","1205"
"14339",351,8,343,"TGTCATCATTAGGATCTTT","TATCACTAGGTGCTACGATA","561307.5.peg.2082","1205"
"14340",512,8,504,"AATTTCTTTGTAACCACCA","TATCACTAGGTGCTACGATA","561307.5.peg.2082","1205"
"14341",351,9,342,"TGTCATCATTAGGATCTTT","CCTAGTGATAATAATAAGG","561307.5.peg.2082","1205"
"14342",113,9,104,"CTGAATCATTTACAACATCT","CCTAGTGATAATAATAAGG","561307.5.peg.2082","1205"
"14343",512,9,503,"AATTTCTTTGTAACCACCA","CCTAGTGATAATAATAAGG","561307.5.peg.2082","1205"
"14344",315,9,306,"TAAGCTCTTCTTCAAGATT","CCTAGTGATAATAATAAGG","561307.5.peg.2082","1205"
"14345",351,21,330,"TGTCATCATTAGGATCTTT","CCTCCTTATTATTATCACT","561307.5.peg.2082","1205"
"14346",512,21,491,"AATTTCTTTGTAACCACCA","CCTCCTTATTATTATCACT","561307.5.peg.2082","1205"
"14347",315,21,294,"TAAGCTCTTCTTCAAGATT","CCTCCTTATTATTATCACT","561307.5.peg.2082","1205"
"14348",8,113,105,"TATCACTAGGTGCTACGATA","CTGAATCATTTACAACATCT","561307.5.peg.2082","1205"
"14349",512,113,399,"AATTTCTTTGTAACCACCA","CTGAATCATTTACAACATCT","561307.5.peg.2082","1205"
"14350",9,113,104,"CCTAGTGATAATAATAAGG","CTGAATCATTTACAACATCT","561307.5.peg.2082","1205"
"14351",315,113,202,"TAAGCTCTTCTTCAAGATT","CTGAATCATTTACAACATCT","561307.5.peg.2082","1205"
"14352",351,113,238,"TGTCATCATTAGGATCTTT","CTGAATCATTTACAACATCT","561307.5.peg.2082","1205"
"14353",8,315,307,"TATCACTAGGTGCTACGATA","TAAGCTCTTCTTCAAGATT","561307.5.peg.2082","1205"
"14354",21,315,294,"CCTCCTTATTATTATCACT","TAAGCTCTTCTTCAAGATT","561307.5.peg.2082","1205"
"14355",9,315,306,"CCTAGTGATAATAATAAGG","TAAGCTCTTCTTCAAGATT","561307.5.peg.2082","1205"
"14356",512,315,197,"AATTTCTTTGTAACCACCA","TAAGCTCTTCTTCAAGATT","561307.5.peg.2082","1205"
"14357",113,315,202,"CTGAATCATTTACAACATCT","TAAGCTCTTCTTCAAGATT","561307.5.peg.2082","1205"
"14358",8,351,343,"TATCACTAGGTGCTACGATA","TGTCATCATTAGGATCTTT","561307.5.peg.2082","1205"
"14359",113,351,238,"CTGAATCATTTACAACATCT","TGTCATCATTAGGATCTTT","561307.5.peg.2082","1205"
"14360",9,351,342,"CCTAGTGATAATAATAAGG","TGTCATCATTAGGATCTTT","561307.5.peg.2082","1205"
"14361",512,351,161,"AATTTCTTTGTAACCACCA","TGTCATCATTAGGATCTTT","561307.5.peg.2082","1205"
"14362",21,351,330,"CCTCCTTATTATTATCACT","TGTCATCATTAGGATCTTT","561307.5.peg.2082","1205"
"14363",9,512,503,"CCTAGTGATAATAATAAGG","AATTTCTTTGTAACCACCA","561307.5.peg.2082","1205"
"14364",351,512,161,"TGTCATCATTAGGATCTTT","AATTTCTTTGTAACCACCA","561307.5.peg.2082","1205"
"14365",21,512,491,"CCTCCTTATTATTATCACT","AATTTCTTTGTAACCACCA","561307.5.peg.2082","1205"
"14366",8,512,504,"TATCACTAGGTGCTACGATA","AATTTCTTTGTAACCACCA","561307.5.peg.2082","1205"
"14367",113,512,399,"CTGAATCATTTACAACATCT","AATTTCTTTGTAACCACCA","561307.5.peg.2082","1205"
"14368",315,512,197,"TAAGCTCTTCTTCAAGATT","AATTTCTTTGTAACCACCA","561307.5.peg.2082","1205"
"14369",324,176,148,"ACTTCTTCAGTTTCAGGTCT","TCGGCATATCATCATGCATG","561307.5.peg.2083","1206"
"14370",324,195,129,"ACTTCTTCAGTTTCAGGTCT","AACTTCATAATCATCGCTTT","561307.5.peg.2083","1206"
"14371",176,324,148,"TCGGCATATCATCATGCATG","ACTTCTTCAGTTTCAGGTCT","561307.5.peg.2083","1206"
"14372",195,324,129,"AACTTCATAATCATCGCTTT","ACTTCTTCAGTTTCAGGTCT","561307.5.peg.2083","1206"
"14373",345,236,109,"AATATAAACGAAATAGGGCC","TAAGCGGATTGTCAGATGGA","561307.5.peg.2084","1207"
"14374",435,236,199,"TGTCTACCTACAGAATGGCT","TAAGCGGATTGTCAGATGGA","561307.5.peg.2084","1207"
"14375",492,236,256,"CTACCACTTAAATTAGCACT","TAAGCGGATTGTCAGATGGA","561307.5.peg.2084","1207"
"14376",350,236,114,"ACGGCAATATAAACGAAATA","TAAGCGGATTGTCAGATGGA","561307.5.peg.2084","1207"
"14377",369,236,133,"CATAGATAGCCTAGCTTTAA","TAAGCGGATTGTCAGATGGA","561307.5.peg.2084","1207"
"14378",480,236,244,"TTAGCACTTGGAGCAGCTAG","TAAGCGGATTGTCAGATGGA","561307.5.peg.2084","1207"
"14379",440,236,204,"TAATTGTCTACCTACAGAA","TAAGCGGATTGTCAGATGGA","561307.5.peg.2084","1207"
"14380",350,240,110,"ACGGCAATATAAACGAAATA","ACAATAAGCGGATTGTCAGA","561307.5.peg.2084","1207"
"14381",492,240,252,"CTACCACTTAAATTAGCACT","ACAATAAGCGGATTGTCAGA","561307.5.peg.2084","1207"
"14382",345,240,105,"AATATAAACGAAATAGGGCC","ACAATAAGCGGATTGTCAGA","561307.5.peg.2084","1207"
"14383",435,240,195,"TGTCTACCTACAGAATGGCT","ACAATAAGCGGATTGTCAGA","561307.5.peg.2084","1207"
"14384",480,240,240,"TTAGCACTTGGAGCAGCTAG","ACAATAAGCGGATTGTCAGA","561307.5.peg.2084","1207"
"14385",440,240,200,"TAATTGTCTACCTACAGAA","ACAATAAGCGGATTGTCAGA","561307.5.peg.2084","1207"
"14386",369,240,129,"CATAGATAGCCTAGCTTTAA","ACAATAAGCGGATTGTCAGA","561307.5.peg.2084","1207"
"14387",435,252,183,"TGTCTACCTACAGAATGGCT","CTGTGTATATGAACAATAAG","561307.5.peg.2084","1207"
"14388",480,252,228,"TTAGCACTTGGAGCAGCTAG","CTGTGTATATGAACAATAAG","561307.5.peg.2084","1207"
"14389",369,252,117,"CATAGATAGCCTAGCTTTAA","CTGTGTATATGAACAATAAG","561307.5.peg.2084","1207"
"14390",492,252,240,"CTACCACTTAAATTAGCACT","CTGTGTATATGAACAATAAG","561307.5.peg.2084","1207"
"14391",440,252,188,"TAATTGTCTACCTACAGAA","CTGTGTATATGAACAATAAG","561307.5.peg.2084","1207"
"14392",236,345,109,"TAAGCGGATTGTCAGATGGA","AATATAAACGAAATAGGGCC","561307.5.peg.2084","1207"
"14393",240,345,105,"ACAATAAGCGGATTGTCAGA","AATATAAACGAAATAGGGCC","561307.5.peg.2084","1207"
"14394",480,345,135,"TTAGCACTTGGAGCAGCTAG","AATATAAACGAAATAGGGCC","561307.5.peg.2084","1207"
"14395",492,345,147,"CTACCACTTAAATTAGCACT","AATATAAACGAAATAGGGCC","561307.5.peg.2084","1207"
"14396",236,350,114,"TAAGCGGATTGTCAGATGGA","ACGGCAATATAAACGAAATA","561307.5.peg.2084","1207"
"14397",492,350,142,"CTACCACTTAAATTAGCACT","ACGGCAATATAAACGAAATA","561307.5.peg.2084","1207"
"14398",480,350,130,"TTAGCACTTGGAGCAGCTAG","ACGGCAATATAAACGAAATA","561307.5.peg.2084","1207"
"14399",240,350,110,"ACAATAAGCGGATTGTCAGA","ACGGCAATATAAACGAAATA","561307.5.peg.2084","1207"
"14400",236,369,133,"TAAGCGGATTGTCAGATGGA","CATAGATAGCCTAGCTTTAA","561307.5.peg.2084","1207"
"14401",492,369,123,"CTACCACTTAAATTAGCACT","CATAGATAGCCTAGCTTTAA","561307.5.peg.2084","1207"
"14402",240,369,129,"ACAATAAGCGGATTGTCAGA","CATAGATAGCCTAGCTTTAA","561307.5.peg.2084","1207"
"14403",480,369,111,"TTAGCACTTGGAGCAGCTAG","CATAGATAGCCTAGCTTTAA","561307.5.peg.2084","1207"
"14404",252,369,117,"CTGTGTATATGAACAATAAG","CATAGATAGCCTAGCTTTAA","561307.5.peg.2084","1207"
"14405",236,435,199,"TAAGCGGATTGTCAGATGGA","TGTCTACCTACAGAATGGCT","561307.5.peg.2084","1207"
"14406",252,435,183,"CTGTGTATATGAACAATAAG","TGTCTACCTACAGAATGGCT","561307.5.peg.2084","1207"
"14407",240,435,195,"ACAATAAGCGGATTGTCAGA","TGTCTACCTACAGAATGGCT","561307.5.peg.2084","1207"
"14408",252,440,188,"CTGTGTATATGAACAATAAG","TAATTGTCTACCTACAGAA","561307.5.peg.2084","1207"
"14409",240,440,200,"ACAATAAGCGGATTGTCAGA","TAATTGTCTACCTACAGAA","561307.5.peg.2084","1207"
"14410",236,440,204,"TAAGCGGATTGTCAGATGGA","TAATTGTCTACCTACAGAA","561307.5.peg.2084","1207"
"14411",236,480,244,"TAAGCGGATTGTCAGATGGA","TTAGCACTTGGAGCAGCTAG","561307.5.peg.2084","1207"
"14412",345,480,135,"AATATAAACGAAATAGGGCC","TTAGCACTTGGAGCAGCTAG","561307.5.peg.2084","1207"
"14413",350,480,130,"ACGGCAATATAAACGAAATA","TTAGCACTTGGAGCAGCTAG","561307.5.peg.2084","1207"
"14414",252,480,228,"CTGTGTATATGAACAATAAG","TTAGCACTTGGAGCAGCTAG","561307.5.peg.2084","1207"
"14415",240,480,240,"ACAATAAGCGGATTGTCAGA","TTAGCACTTGGAGCAGCTAG","561307.5.peg.2084","1207"
"14416",369,480,111,"CATAGATAGCCTAGCTTTAA","TTAGCACTTGGAGCAGCTAG","561307.5.peg.2084","1207"
"14417",345,492,147,"AATATAAACGAAATAGGGCC","CTACCACTTAAATTAGCACT","561307.5.peg.2084","1207"
"14418",236,492,256,"TAAGCGGATTGTCAGATGGA","CTACCACTTAAATTAGCACT","561307.5.peg.2084","1207"
"14419",369,492,123,"CATAGATAGCCTAGCTTTAA","CTACCACTTAAATTAGCACT","561307.5.peg.2084","1207"
"14420",350,492,142,"ACGGCAATATAAACGAAATA","CTACCACTTAAATTAGCACT","561307.5.peg.2084","1207"
"14421",252,492,240,"CTGTGTATATGAACAATAAG","CTACCACTTAAATTAGCACT","561307.5.peg.2084","1207"
"14422",240,492,252,"ACAATAAGCGGATTGTCAGA","CTACCACTTAAATTAGCACT","561307.5.peg.2084","1207"
"14423",229,92,137,"TCAGTAAATTGTTGCGATA","TTGCAATACTTTCCGCTAAT","561307.5.peg.2085","1208"
"14424",92,229,137,"TTGCAATACTTTCCGCTAAT","TCAGTAAATTGTTGCGATA","561307.5.peg.2085","1208"
"14425",321,216,105,"TTCGCTTGTGAACCTGAATG","CCACCATAATATCGGCGTCC","561307.5.peg.2087","1210"
"14426",540,216,324,"GCTCCTGCCACAATAAGCTT","CCACCATAATATCGGCGTCC","561307.5.peg.2087","1210"
"14427",540,224,316,"GCTCCTGCCACAATAAGCTT","ACTCACAGCCACCATAATAT","561307.5.peg.2087","1210"
"14428",216,321,105,"CCACCATAATATCGGCGTCC","TTCGCTTGTGAACCTGAATG","561307.5.peg.2087","1210"
"14429",540,321,219,"GCTCCTGCCACAATAAGCTT","TTCGCTTGTGAACCTGAATG","561307.5.peg.2087","1210"
"14430",216,540,324,"CCACCATAATATCGGCGTCC","GCTCCTGCCACAATAAGCTT","561307.5.peg.2087","1210"
"14431",224,540,316,"ACTCACAGCCACCATAATAT","GCTCCTGCCACAATAAGCTT","561307.5.peg.2087","1210"
"14432",321,540,219,"TTCGCTTGTGAACCTGAATG","GCTCCTGCCACAATAAGCTT","561307.5.peg.2087","1210"
"14433",312,15,297,"CCATGTACAAGTACCATGTC","TGGTACTAAATAGAAGAAT","561307.5.peg.2089","1212"
"14434",380,15,365,"CAACGTGTCCAATCGGCACT","TGGTACTAAATAGAAGAAT","561307.5.peg.2089","1212"
"14435",387,15,372,"CCTGCTTCAACGTGTCCAAT","TGGTACTAAATAGAAGAAT","561307.5.peg.2089","1212"
"14436",441,15,426,"AATTGTCTATTCACCTCTTC","TGGTACTAAATAGAAGAAT","561307.5.peg.2089","1212"
"14437",312,67,245,"CCATGTACAAGTACCATGTC","TTCGGGTCTTGTTCCAAATA","561307.5.peg.2089","1212"
"14438",380,67,313,"CAACGTGTCCAATCGGCACT","TTCGGGTCTTGTTCCAAATA","561307.5.peg.2089","1212"
"14439",387,67,320,"CCTGCTTCAACGTGTCCAAT","TTCGGGTCTTGTTCCAAATA","561307.5.peg.2089","1212"
"14440",441,67,374,"AATTGTCTATTCACCTCTTC","TTCGGGTCTTGTTCCAAATA","561307.5.peg.2089","1212"
"14441",312,84,228,"CCATGTACAAGTACCATGTC","GGAGCCATCTTTATGGCTTC","561307.5.peg.2089","1212"
"14442",380,84,296,"CAACGTGTCCAATCGGCACT","GGAGCCATCTTTATGGCTTC","561307.5.peg.2089","1212"
"14443",387,84,303,"CCTGCTTCAACGTGTCCAAT","GGAGCCATCTTTATGGCTTC","561307.5.peg.2089","1212"
"14444",441,84,357,"AATTGTCTATTCACCTCTTC","GGAGCCATCTTTATGGCTTC","561307.5.peg.2089","1212"
"14445",312,105,207,"CCATGTACAAGTACCATGTC","GTTCCAAAGCTTTAACTAA","561307.5.peg.2089","1212"
"14446",380,105,275,"CAACGTGTCCAATCGGCACT","GTTCCAAAGCTTTAACTAA","561307.5.peg.2089","1212"
"14447",387,105,282,"CCTGCTTCAACGTGTCCAAT","GTTCCAAAGCTTTAACTAA","561307.5.peg.2089","1212"
"14448",441,105,336,"AATTGTCTATTCACCTCTTC","GTTCCAAAGCTTTAACTAA","561307.5.peg.2089","1212"
"14449",15,312,297,"TGGTACTAAATAGAAGAAT","CCATGTACAAGTACCATGTC","561307.5.peg.2089","1212"
"14450",441,312,129,"AATTGTCTATTCACCTCTTC","CCATGTACAAGTACCATGTC","561307.5.peg.2089","1212"
"14451",105,312,207,"GTTCCAAAGCTTTAACTAA","CCATGTACAAGTACCATGTC","561307.5.peg.2089","1212"
"14452",67,312,245,"TTCGGGTCTTGTTCCAAATA","CCATGTACAAGTACCATGTC","561307.5.peg.2089","1212"
"14453",84,312,228,"GGAGCCATCTTTATGGCTTC","CCATGTACAAGTACCATGTC","561307.5.peg.2089","1212"
"14454",67,380,313,"TTCGGGTCTTGTTCCAAATA","CAACGTGTCCAATCGGCACT","561307.5.peg.2089","1212"
"14455",15,380,365,"TGGTACTAAATAGAAGAAT","CAACGTGTCCAATCGGCACT","561307.5.peg.2089","1212"
"14456",84,380,296,"GGAGCCATCTTTATGGCTTC","CAACGTGTCCAATCGGCACT","561307.5.peg.2089","1212"
"14457",105,380,275,"GTTCCAAAGCTTTAACTAA","CAACGTGTCCAATCGGCACT","561307.5.peg.2089","1212"
"14458",15,387,372,"TGGTACTAAATAGAAGAAT","CCTGCTTCAACGTGTCCAAT","561307.5.peg.2089","1212"
"14459",67,387,320,"TTCGGGTCTTGTTCCAAATA","CCTGCTTCAACGTGTCCAAT","561307.5.peg.2089","1212"
"14460",84,387,303,"GGAGCCATCTTTATGGCTTC","CCTGCTTCAACGTGTCCAAT","561307.5.peg.2089","1212"
"14461",105,387,282,"GTTCCAAAGCTTTAACTAA","CCTGCTTCAACGTGTCCAAT","561307.5.peg.2089","1212"
"14462",67,441,374,"TTCGGGTCTTGTTCCAAATA","AATTGTCTATTCACCTCTTC","561307.5.peg.2089","1212"
"14463",15,441,426,"TGGTACTAAATAGAAGAAT","AATTGTCTATTCACCTCTTC","561307.5.peg.2089","1212"
"14464",84,441,357,"GGAGCCATCTTTATGGCTTC","AATTGTCTATTCACCTCTTC","561307.5.peg.2089","1212"
"14465",105,441,336,"GTTCCAAAGCTTTAACTAA","AATTGTCTATTCACCTCTTC","561307.5.peg.2089","1212"
"14466",312,441,129,"CCATGTACAAGTACCATGTC","AATTGTCTATTCACCTCTTC","561307.5.peg.2089","1212"
"14467",153,11,142,"CCTGTATCACCATCTGGCAC","TACAGGCAAGAAAGCTTAGG","561307.5.peg.209","1213"
"14468",153,14,139,"CCTGTATCACCATCTGGCAC","TAATACAGGCAAGAAAGCTT","561307.5.peg.209","1213"
"14469",153,28,125,"CCTGTATCACCATCTGGCAC","GGTGTACGTGTGAATAATAC","561307.5.peg.209","1213"
"14470",11,153,142,"TACAGGCAAGAAAGCTTAGG","CCTGTATCACCATCTGGCAC","561307.5.peg.209","1213"
"14471",14,153,139,"TAATACAGGCAAGAAAGCTT","CCTGTATCACCATCTGGCAC","561307.5.peg.209","1213"
"14472",28,153,125,"GGTGTACGTGTGAATAATAC","CCTGTATCACCATCTGGCAC","561307.5.peg.209","1213"
"14473",128,9,119,"AAATGCATGGTGTGTATAA","GATTGATATCAGTCACACGG","561307.5.peg.2090","1214"
"14474",128,12,116,"AAATGCATGGTGTGTATAA","CATGATTGATATCAGTCACA","561307.5.peg.2090","1214"
"14475",9,128,119,"GATTGATATCAGTCACACGG","AAATGCATGGTGTGTATAA","561307.5.peg.2090","1214"
"14476",12,128,116,"CATGATTGATATCAGTCACA","AAATGCATGGTGTGTATAA","561307.5.peg.2090","1214"
"14477",287,64,223,"TCAGCGTTACTGCTAAGAAG","TAAATTCCAACTCACGAGCG","561307.5.peg.2091","1215"
"14478",287,66,221,"TCAGCGTTACTGCTAAGAAG","AATAAATTCCAACTCACGAG","561307.5.peg.2091","1215"
"14479",64,287,223,"TAAATTCCAACTCACGAGCG","TCAGCGTTACTGCTAAGAAG","561307.5.peg.2091","1215"
"14480",66,287,221,"AATAAATTCCAACTCACGAG","TCAGCGTTACTGCTAAGAAG","561307.5.peg.2091","1215"
"14481",282,121,161,"CCTTCAGTAATACCTGTGTA","TACAGTACCTACATCAGTTA","561307.5.peg.2095","1219"
"14482",245,121,124,"CACCCACGTTTGACTCTTCA","TACAGTACCTACATCAGTTA","561307.5.peg.2095","1219"
"14483",390,121,269,"ATCGGTCCTTGTCCATCAAT","TACAGTACCTACATCAGTTA","561307.5.peg.2095","1219"
"14484",378,121,257,"CCATCAATAGGTTGTCCTAA","TACAGTACCTACATCAGTTA","561307.5.peg.2095","1219"
"14485",522,121,401,"TCACGTTGACCTCTACCAAT","TACAGTACCTACATCAGTTA","561307.5.peg.2095","1219"
"14486",765,121,644,"CCCATTGTTACACCTGAATA","TACAGTACCTACATCAGTTA","561307.5.peg.2095","1219"
"14487",378,215,163,"CCATCAATAGGTTGTCCTAA","CTAAACCAAGTACGCCGTTA","561307.5.peg.2095","1219"
"14488",390,215,175,"ATCGGTCCTTGTCCATCAAT","CTAAACCAAGTACGCCGTTA","561307.5.peg.2095","1219"
"14489",765,215,550,"CCCATTGTTACACCTGAATA","CTAAACCAAGTACGCCGTTA","561307.5.peg.2095","1219"
"14490",522,215,307,"TCACGTTGACCTCTACCAAT","CTAAACCAAGTACGCCGTTA","561307.5.peg.2095","1219"
"14491",522,245,277,"TCACGTTGACCTCTACCAAT","CACCCACGTTTGACTCTTCA","561307.5.peg.2095","1219"
"14492",390,245,145,"ATCGGTCCTTGTCCATCAAT","CACCCACGTTTGACTCTTCA","561307.5.peg.2095","1219"
"14493",121,245,124,"TACAGTACCTACATCAGTTA","CACCCACGTTTGACTCTTCA","561307.5.peg.2095","1219"
"14494",378,245,133,"CCATCAATAGGTTGTCCTAA","CACCCACGTTTGACTCTTCA","561307.5.peg.2095","1219"
"14495",765,245,520,"CCCATTGTTACACCTGAATA","CACCCACGTTTGACTCTTCA","561307.5.peg.2095","1219"
"14496",121,282,161,"TACAGTACCTACATCAGTTA","CCTTCAGTAATACCTGTGTA","561307.5.peg.2095","1219"
"14497",390,282,108,"ATCGGTCCTTGTCCATCAAT","CCTTCAGTAATACCTGTGTA","561307.5.peg.2095","1219"
"14498",522,282,240,"TCACGTTGACCTCTACCAAT","CCTTCAGTAATACCTGTGTA","561307.5.peg.2095","1219"
"14499",765,282,483,"CCCATTGTTACACCTGAATA","CCTTCAGTAATACCTGTGTA","561307.5.peg.2095","1219"
"14500",765,378,387,"CCCATTGTTACACCTGAATA","CCATCAATAGGTTGTCCTAA","561307.5.peg.2095","1219"
"14501",522,378,144,"TCACGTTGACCTCTACCAAT","CCATCAATAGGTTGTCCTAA","561307.5.peg.2095","1219"
"14502",121,378,257,"TACAGTACCTACATCAGTTA","CCATCAATAGGTTGTCCTAA","561307.5.peg.2095","1219"
"14503",215,378,163,"CTAAACCAAGTACGCCGTTA","CCATCAATAGGTTGTCCTAA","561307.5.peg.2095","1219"
"14504",245,378,133,"CACCCACGTTTGACTCTTCA","CCATCAATAGGTTGTCCTAA","561307.5.peg.2095","1219"
"14505",215,390,175,"CTAAACCAAGTACGCCGTTA","ATCGGTCCTTGTCCATCAAT","561307.5.peg.2095","1219"
"14506",245,390,145,"CACCCACGTTTGACTCTTCA","ATCGGTCCTTGTCCATCAAT","561307.5.peg.2095","1219"
"14507",282,390,108,"CCTTCAGTAATACCTGTGTA","ATCGGTCCTTGTCCATCAAT","561307.5.peg.2095","1219"
"14508",121,390,269,"TACAGTACCTACATCAGTTA","ATCGGTCCTTGTCCATCAAT","561307.5.peg.2095","1219"
"14509",765,390,375,"CCCATTGTTACACCTGAATA","ATCGGTCCTTGTCCATCAAT","561307.5.peg.2095","1219"
"14510",522,390,132,"TCACGTTGACCTCTACCAAT","ATCGGTCCTTGTCCATCAAT","561307.5.peg.2095","1219"
"14511",215,522,307,"CTAAACCAAGTACGCCGTTA","TCACGTTGACCTCTACCAAT","561307.5.peg.2095","1219"
"14512",765,522,243,"CCCATTGTTACACCTGAATA","TCACGTTGACCTCTACCAAT","561307.5.peg.2095","1219"
"14513",378,522,144,"CCATCAATAGGTTGTCCTAA","TCACGTTGACCTCTACCAAT","561307.5.peg.2095","1219"
"14514",245,522,277,"CACCCACGTTTGACTCTTCA","TCACGTTGACCTCTACCAAT","561307.5.peg.2095","1219"
"14515",390,522,132,"ATCGGTCCTTGTCCATCAAT","TCACGTTGACCTCTACCAAT","561307.5.peg.2095","1219"
"14516",282,522,240,"CCTTCAGTAATACCTGTGTA","TCACGTTGACCTCTACCAAT","561307.5.peg.2095","1219"
"14517",121,522,401,"TACAGTACCTACATCAGTTA","TCACGTTGACCTCTACCAAT","561307.5.peg.2095","1219"
"14518",121,765,644,"TACAGTACCTACATCAGTTA","CCCATTGTTACACCTGAATA","561307.5.peg.2095","1219"
"14519",245,765,520,"CACCCACGTTTGACTCTTCA","CCCATTGTTACACCTGAATA","561307.5.peg.2095","1219"
"14520",390,765,375,"ATCGGTCCTTGTCCATCAAT","CCCATTGTTACACCTGAATA","561307.5.peg.2095","1219"
"14521",522,765,243,"TCACGTTGACCTCTACCAAT","CCCATTGTTACACCTGAATA","561307.5.peg.2095","1219"
"14522",282,765,483,"CCTTCAGTAATACCTGTGTA","CCCATTGTTACACCTGAATA","561307.5.peg.2095","1219"
"14523",378,765,387,"CCATCAATAGGTTGTCCTAA","CCCATTGTTACACCTGAATA","561307.5.peg.2095","1219"
"14524",215,765,550,"CTAAACCAAGTACGCCGTTA","CCCATTGTTACACCTGAATA","561307.5.peg.2095","1219"
"14525",676,13,663,"ATTCATTTGCCCGAATACCA","TAAATATTATTCAAGCGCTG","561307.5.peg.2097","1221"
"14526",408,13,395,"GTTGAAAGTTCATCGAATGC","TAAATATTATTCAAGCGCTG","561307.5.peg.2097","1221"
"14527",136,13,123,"TTTAGGCACATCAATAACCA","TAAATATTATTCAAGCGCTG","561307.5.peg.2097","1221"
"14528",395,13,382,"CGAATGCTGGTGCTTGACGA","TAAATATTATTCAAGCGCTG","561307.5.peg.2097","1221"
"14529",598,13,585,"ACGAGTACGTTCACCTACAC","TAAATATTATTCAAGCGCTG","561307.5.peg.2097","1221"
"14530",383,13,370,"CTTGACGATGGATAGGATCG","TAAATATTATTCAAGCGCTG","561307.5.peg.2097","1221"
"14531",297,13,284,"CCTAATGTTTCGTCACCAAC","TAAATATTATTCAAGCGCTG","561307.5.peg.2097","1221"
"14532",702,13,689,"ACACGCATACGTGCACCAGG","TAAATATTATTCAAGCGCTG","561307.5.peg.2097","1221"
"14533",390,13,377,"GCTGGTGCTTGACGATGGAT","TAAATATTATTCAAGCGCTG","561307.5.peg.2097","1221"
"14534",395,62,333,"CGAATGCTGGTGCTTGACGA","GACCCATAACTTGAGTTACA","561307.5.peg.2097","1221"
"14535",676,62,614,"ATTCATTTGCCCGAATACCA","GACCCATAACTTGAGTTACA","561307.5.peg.2097","1221"
"14536",383,62,321,"CTTGACGATGGATAGGATCG","GACCCATAACTTGAGTTACA","561307.5.peg.2097","1221"
"14537",598,62,536,"ACGAGTACGTTCACCTACAC","GACCCATAACTTGAGTTACA","561307.5.peg.2097","1221"
"14538",408,62,346,"GTTGAAAGTTCATCGAATGC","GACCCATAACTTGAGTTACA","561307.5.peg.2097","1221"
"14539",702,62,640,"ACACGCATACGTGCACCAGG","GACCCATAACTTGAGTTACA","561307.5.peg.2097","1221"
"14540",297,62,235,"CCTAATGTTTCGTCACCAAC","GACCCATAACTTGAGTTACA","561307.5.peg.2097","1221"
"14541",390,62,328,"GCTGGTGCTTGACGATGGAT","GACCCATAACTTGAGTTACA","561307.5.peg.2097","1221"
"14542",390,136,254,"GCTGGTGCTTGACGATGGAT","TTTAGGCACATCAATAACCA","561307.5.peg.2097","1221"
"14543",297,136,161,"CCTAATGTTTCGTCACCAAC","TTTAGGCACATCAATAACCA","561307.5.peg.2097","1221"
"14544",702,136,566,"ACACGCATACGTGCACCAGG","TTTAGGCACATCAATAACCA","561307.5.peg.2097","1221"
"14545",383,136,247,"CTTGACGATGGATAGGATCG","TTTAGGCACATCAATAACCA","561307.5.peg.2097","1221"
"14546",13,136,123,"TAAATATTATTCAAGCGCTG","TTTAGGCACATCAATAACCA","561307.5.peg.2097","1221"
"14547",408,136,272,"GTTGAAAGTTCATCGAATGC","TTTAGGCACATCAATAACCA","561307.5.peg.2097","1221"
"14548",395,136,259,"CGAATGCTGGTGCTTGACGA","TTTAGGCACATCAATAACCA","561307.5.peg.2097","1221"
"14549",676,136,540,"ATTCATTTGCCCGAATACCA","TTTAGGCACATCAATAACCA","561307.5.peg.2097","1221"
"14550",598,136,462,"ACGAGTACGTTCACCTACAC","TTTAGGCACATCAATAACCA","561307.5.peg.2097","1221"
"14551",62,297,235,"GACCCATAACTTGAGTTACA","CCTAATGTTTCGTCACCAAC","561307.5.peg.2097","1221"
"14552",13,297,284,"TAAATATTATTCAAGCGCTG","CCTAATGTTTCGTCACCAAC","561307.5.peg.2097","1221"
"14553",136,297,161,"TTTAGGCACATCAATAACCA","CCTAATGTTTCGTCACCAAC","561307.5.peg.2097","1221"
"14554",676,297,379,"ATTCATTTGCCCGAATACCA","CCTAATGTTTCGTCACCAAC","561307.5.peg.2097","1221"
"14555",702,297,405,"ACACGCATACGTGCACCAGG","CCTAATGTTTCGTCACCAAC","561307.5.peg.2097","1221"
"14556",598,297,301,"ACGAGTACGTTCACCTACAC","CCTAATGTTTCGTCACCAAC","561307.5.peg.2097","1221"
"14557",408,297,111,"GTTGAAAGTTCATCGAATGC","CCTAATGTTTCGTCACCAAC","561307.5.peg.2097","1221"
"14558",13,383,370,"TAAATATTATTCAAGCGCTG","CTTGACGATGGATAGGATCG","561307.5.peg.2097","1221"
"14559",136,383,247,"TTTAGGCACATCAATAACCA","CTTGACGATGGATAGGATCG","561307.5.peg.2097","1221"
"14560",676,383,293,"ATTCATTTGCCCGAATACCA","CTTGACGATGGATAGGATCG","561307.5.peg.2097","1221"
"14561",598,383,215,"ACGAGTACGTTCACCTACAC","CTTGACGATGGATAGGATCG","561307.5.peg.2097","1221"
"14562",62,383,321,"GACCCATAACTTGAGTTACA","CTTGACGATGGATAGGATCG","561307.5.peg.2097","1221"
"14563",702,383,319,"ACACGCATACGTGCACCAGG","CTTGACGATGGATAGGATCG","561307.5.peg.2097","1221"
"14564",62,390,328,"GACCCATAACTTGAGTTACA","GCTGGTGCTTGACGATGGAT","561307.5.peg.2097","1221"
"14565",13,390,377,"TAAATATTATTCAAGCGCTG","GCTGGTGCTTGACGATGGAT","561307.5.peg.2097","1221"
"14566",136,390,254,"TTTAGGCACATCAATAACCA","GCTGGTGCTTGACGATGGAT","561307.5.peg.2097","1221"
"14567",676,390,286,"ATTCATTTGCCCGAATACCA","GCTGGTGCTTGACGATGGAT","561307.5.peg.2097","1221"
"14568",702,390,312,"ACACGCATACGTGCACCAGG","GCTGGTGCTTGACGATGGAT","561307.5.peg.2097","1221"
"14569",598,390,208,"ACGAGTACGTTCACCTACAC","GCTGGTGCTTGACGATGGAT","561307.5.peg.2097","1221"
"14570",62,395,333,"GACCCATAACTTGAGTTACA","CGAATGCTGGTGCTTGACGA","561307.5.peg.2097","1221"
"14571",13,395,382,"TAAATATTATTCAAGCGCTG","CGAATGCTGGTGCTTGACGA","561307.5.peg.2097","1221"
"14572",676,395,281,"ATTCATTTGCCCGAATACCA","CGAATGCTGGTGCTTGACGA","561307.5.peg.2097","1221"
"14573",702,395,307,"ACACGCATACGTGCACCAGG","CGAATGCTGGTGCTTGACGA","561307.5.peg.2097","1221"
"14574",136,395,259,"TTTAGGCACATCAATAACCA","CGAATGCTGGTGCTTGACGA","561307.5.peg.2097","1221"
"14575",598,395,203,"ACGAGTACGTTCACCTACAC","CGAATGCTGGTGCTTGACGA","561307.5.peg.2097","1221"
"14576",62,408,346,"GACCCATAACTTGAGTTACA","GTTGAAAGTTCATCGAATGC","561307.5.peg.2097","1221"
"14577",676,408,268,"ATTCATTTGCCCGAATACCA","GTTGAAAGTTCATCGAATGC","561307.5.peg.2097","1221"
"14578",13,408,395,"TAAATATTATTCAAGCGCTG","GTTGAAAGTTCATCGAATGC","561307.5.peg.2097","1221"
"14579",297,408,111,"CCTAATGTTTCGTCACCAAC","GTTGAAAGTTCATCGAATGC","561307.5.peg.2097","1221"
"14580",598,408,190,"ACGAGTACGTTCACCTACAC","GTTGAAAGTTCATCGAATGC","561307.5.peg.2097","1221"
"14581",136,408,272,"TTTAGGCACATCAATAACCA","GTTGAAAGTTCATCGAATGC","561307.5.peg.2097","1221"
"14582",702,408,294,"ACACGCATACGTGCACCAGG","GTTGAAAGTTCATCGAATGC","561307.5.peg.2097","1221"
"14583",13,598,585,"TAAATATTATTCAAGCGCTG","ACGAGTACGTTCACCTACAC","561307.5.peg.2097","1221"
"14584",383,598,215,"CTTGACGATGGATAGGATCG","ACGAGTACGTTCACCTACAC","561307.5.peg.2097","1221"
"14585",408,598,190,"GTTGAAAGTTCATCGAATGC","ACGAGTACGTTCACCTACAC","561307.5.peg.2097","1221"
"14586",390,598,208,"GCTGGTGCTTGACGATGGAT","ACGAGTACGTTCACCTACAC","561307.5.peg.2097","1221"
"14587",136,598,462,"TTTAGGCACATCAATAACCA","ACGAGTACGTTCACCTACAC","561307.5.peg.2097","1221"
"14588",702,598,104,"ACACGCATACGTGCACCAGG","ACGAGTACGTTCACCTACAC","561307.5.peg.2097","1221"
"14589",297,598,301,"CCTAATGTTTCGTCACCAAC","ACGAGTACGTTCACCTACAC","561307.5.peg.2097","1221"
"14590",395,598,203,"CGAATGCTGGTGCTTGACGA","ACGAGTACGTTCACCTACAC","561307.5.peg.2097","1221"
"14591",62,598,536,"GACCCATAACTTGAGTTACA","ACGAGTACGTTCACCTACAC","561307.5.peg.2097","1221"
"14592",383,676,293,"CTTGACGATGGATAGGATCG","ATTCATTTGCCCGAATACCA","561307.5.peg.2097","1221"
"14593",136,676,540,"TTTAGGCACATCAATAACCA","ATTCATTTGCCCGAATACCA","561307.5.peg.2097","1221"
"14594",62,676,614,"GACCCATAACTTGAGTTACA","ATTCATTTGCCCGAATACCA","561307.5.peg.2097","1221"
"14595",297,676,379,"CCTAATGTTTCGTCACCAAC","ATTCATTTGCCCGAATACCA","561307.5.peg.2097","1221"
"14596",395,676,281,"CGAATGCTGGTGCTTGACGA","ATTCATTTGCCCGAATACCA","561307.5.peg.2097","1221"
"14597",13,676,663,"TAAATATTATTCAAGCGCTG","ATTCATTTGCCCGAATACCA","561307.5.peg.2097","1221"
"14598",390,676,286,"GCTGGTGCTTGACGATGGAT","ATTCATTTGCCCGAATACCA","561307.5.peg.2097","1221"
"14599",408,676,268,"GTTGAAAGTTCATCGAATGC","ATTCATTTGCCCGAATACCA","561307.5.peg.2097","1221"
"14600",136,702,566,"TTTAGGCACATCAATAACCA","ACACGCATACGTGCACCAGG","561307.5.peg.2097","1221"
"14601",408,702,294,"GTTGAAAGTTCATCGAATGC","ACACGCATACGTGCACCAGG","561307.5.peg.2097","1221"
"14602",390,702,312,"GCTGGTGCTTGACGATGGAT","ACACGCATACGTGCACCAGG","561307.5.peg.2097","1221"
"14603",13,702,689,"TAAATATTATTCAAGCGCTG","ACACGCATACGTGCACCAGG","561307.5.peg.2097","1221"
"14604",297,702,405,"CCTAATGTTTCGTCACCAAC","ACACGCATACGTGCACCAGG","561307.5.peg.2097","1221"
"14605",395,702,307,"CGAATGCTGGTGCTTGACGA","ACACGCATACGTGCACCAGG","561307.5.peg.2097","1221"
"14606",598,702,104,"ACGAGTACGTTCACCTACAC","ACACGCATACGTGCACCAGG","561307.5.peg.2097","1221"
"14607",62,702,640,"GACCCATAACTTGAGTTACA","ACACGCATACGTGCACCAGG","561307.5.peg.2097","1221"
"14608",383,702,319,"CTTGACGATGGATAGGATCG","ACACGCATACGTGCACCAGG","561307.5.peg.2097","1221"
"14609",225,87,138,"ATCCAAGCAAAGCCACATAC","GCACCTGCTGCGTATTCATA","561307.5.peg.21","1224"
"14610",87,225,138,"GCACCTGCTGCGTATTCATA","ATCCAAGCAAAGCCACATAC","561307.5.peg.21","1224"
"14611",165,8,157,"GGAACATTAACTAATTTGCT","GTAATAGGAGTTCTAAGTGG","561307.5.peg.2100","1226"
"14612",396,8,388,"CTTCCAATTGCACAACCACC","GTAATAGGAGTTCTAAGTGG","561307.5.peg.2100","1226"
"14613",423,8,415,"CCTTTAATGTGTTGCTCAAT","GTAATAGGAGTTCTAAGTGG","561307.5.peg.2100","1226"
"14614",165,11,154,"GGAACATTAACTAATTTGCT","AAGTAATAGGAGTTCTAAG","561307.5.peg.2100","1226"
"14615",423,11,412,"CCTTTAATGTGTTGCTCAAT","AAGTAATAGGAGTTCTAAG","561307.5.peg.2100","1226"
"14616",396,11,385,"CTTCCAATTGCACAACCACC","AAGTAATAGGAGTTCTAAG","561307.5.peg.2100","1226"
"14617",8,165,157,"GTAATAGGAGTTCTAAGTGG","GGAACATTAACTAATTTGCT","561307.5.peg.2100","1226"
"14618",11,165,154,"AAGTAATAGGAGTTCTAAG","GGAACATTAACTAATTTGCT","561307.5.peg.2100","1226"
"14619",396,165,231,"CTTCCAATTGCACAACCACC","GGAACATTAACTAATTTGCT","561307.5.peg.2100","1226"
"14620",423,165,258,"CCTTTAATGTGTTGCTCAAT","GGAACATTAACTAATTTGCT","561307.5.peg.2100","1226"
"14621",8,396,388,"GTAATAGGAGTTCTAAGTGG","CTTCCAATTGCACAACCACC","561307.5.peg.2100","1226"
"14622",11,396,385,"AAGTAATAGGAGTTCTAAG","CTTCCAATTGCACAACCACC","561307.5.peg.2100","1226"
"14623",165,396,231,"GGAACATTAACTAATTTGCT","CTTCCAATTGCACAACCACC","561307.5.peg.2100","1226"
"14624",8,423,415,"GTAATAGGAGTTCTAAGTGG","CCTTTAATGTGTTGCTCAAT","561307.5.peg.2100","1226"
"14625",165,423,258,"GGAACATTAACTAATTTGCT","CCTTTAATGTGTTGCTCAAT","561307.5.peg.2100","1226"
"14626",11,423,412,"AAGTAATAGGAGTTCTAAG","CCTTTAATGTGTTGCTCAAT","561307.5.peg.2100","1226"
"14627",296,124,172,"CTCCATTAGTACCTGTTGCA","TAAGTCCGCTTCACTTGCAT","561307.5.peg.2104","1230"
"14628",360,124,236,"TGATTAGCTTGAACAGCTGA","TAAGTCCGCTTCACTTGCAT","561307.5.peg.2104","1230"
"14629",360,204,156,"TGATTAGCTTGAACAGCTGA","TTATAAGCCCCAGCTTCAAT","561307.5.peg.2104","1230"
"14630",124,296,172,"TAAGTCCGCTTCACTTGCAT","CTCCATTAGTACCTGTTGCA","561307.5.peg.2104","1230"
"14631",124,360,236,"TAAGTCCGCTTCACTTGCAT","TGATTAGCTTGAACAGCTGA","561307.5.peg.2104","1230"
"14632",204,360,156,"TTATAAGCCCCAGCTTCAAT","TGATTAGCTTGAACAGCTGA","561307.5.peg.2104","1230"
"14633",369,74,295,"ATGTAATGGTCGCCACTTGG","TAATGATTGGCTTTGCAGCT","561307.5.peg.2106","1232"
"14634",369,136,233,"ATGTAATGGTCGCCACTTGG","TGCGTCAGCTCCTATATCTC","561307.5.peg.2106","1232"
"14635",74,369,295,"TAATGATTGGCTTTGCAGCT","ATGTAATGGTCGCCACTTGG","561307.5.peg.2106","1232"
"14636",136,369,233,"TGCGTCAGCTCCTATATCTC","ATGTAATGGTCGCCACTTGG","561307.5.peg.2106","1232"
"14637",300,158,142,"GCTACAGGGTCAAATACAAT","CGGGAGCTTCACTCATTGCA","561307.5.peg.2108","1234"
"14638",314,158,156,"TAGAAGCACCAACAGCTACA","CGGGAGCTTCACTCATTGCA","561307.5.peg.2108","1234"
"14639",158,300,142,"CGGGAGCTTCACTCATTGCA","GCTACAGGGTCAAATACAAT","561307.5.peg.2108","1234"
"14640",158,314,156,"CGGGAGCTTCACTCATTGCA","TAGAAGCACCAACAGCTACA","561307.5.peg.2108","1234"
"14641",175,67,108,"TAACCAAGCCCAGATAGAAT","ATTAGAATGCTTGAGTGCAA","561307.5.peg.2112","1239"
"14642",485,67,418,"CATTACGGATGTCTTGTATT","ATTAGAATGCTTGAGTGCAA","561307.5.peg.2112","1239"
"14643",67,175,108,"ATTAGAATGCTTGAGTGCAA","TAACCAAGCCCAGATAGAAT","561307.5.peg.2112","1239"
"14644",485,175,310,"CATTACGGATGTCTTGTATT","TAACCAAGCCCAGATAGAAT","561307.5.peg.2112","1239"
"14645",67,485,418,"ATTAGAATGCTTGAGTGCAA","CATTACGGATGTCTTGTATT","561307.5.peg.2112","1239"
"14646",175,485,310,"TAACCAAGCCCAGATAGAAT","CATTACGGATGTCTTGTATT","561307.5.peg.2112","1239"
"14647",339,75,264,"ATAGGTGTAATAGGTGACTC","TTGCGAAGCCAATGCTTATC","561307.5.peg.2116","1243"
"14648",395,75,320,"CAGATGGCTGAATACTGATA","TTGCGAAGCCAATGCTTATC","561307.5.peg.2116","1243"
"14649",75,339,264,"TTGCGAAGCCAATGCTTATC","ATAGGTGTAATAGGTGACTC","561307.5.peg.2116","1243"
"14650",75,395,320,"TTGCGAAGCCAATGCTTATC","CAGATGGCTGAATACTGATA","561307.5.peg.2116","1243"
"14651",309,9,300,"AATGGGAATACTGCATCGTA","AAACCCTGATATATCATTGG","561307.5.peg.2117","1244"
"14652",393,9,384,"ATACACCATTTCCTACATA","AAACCCTGATATATCATTGG","561307.5.peg.2117","1244"
"14653",309,12,297,"AATGGGAATACTGCATCGTA","AGCAAACCCTGATATATCAT","561307.5.peg.2117","1244"
"14654",393,12,381,"ATACACCATTTCCTACATA","AGCAAACCCTGATATATCAT","561307.5.peg.2117","1244"
"14655",309,23,286,"AATGGGAATACTGCATCGTA","TTTCCTCCAATGATATATCA","561307.5.peg.2117","1244"
"14656",393,23,370,"ATACACCATTTCCTACATA","TTTCCTCCAATGATATATCA","561307.5.peg.2117","1244"
"14657",9,309,300,"AAACCCTGATATATCATTGG","AATGGGAATACTGCATCGTA","561307.5.peg.2117","1244"
"14658",12,309,297,"AGCAAACCCTGATATATCAT","AATGGGAATACTGCATCGTA","561307.5.peg.2117","1244"
"14659",23,309,286,"TTTCCTCCAATGATATATCA","AATGGGAATACTGCATCGTA","561307.5.peg.2117","1244"
"14660",9,393,384,"AAACCCTGATATATCATTGG","ATACACCATTTCCTACATA","561307.5.peg.2117","1244"
"14661",12,393,381,"AGCAAACCCTGATATATCAT","ATACACCATTTCCTACATA","561307.5.peg.2117","1244"
"14662",23,393,370,"TTTCCTCCAATGATATATCA","ATACACCATTTCCTACATA","561307.5.peg.2117","1244"
"14663",584,365,219,"CTGCAATATCTGGTTGAGCG","CTGTGACGGCAATTACTTTA","561307.5.peg.2118","1245"
"14664",584,379,205,"CTGCAATATCTGGTTGAGCG","TTTACCATTAGACCCTGTGA","561307.5.peg.2118","1245"
"14665",365,584,219,"CTGTGACGGCAATTACTTTA","CTGCAATATCTGGTTGAGCG","561307.5.peg.2118","1245"
"14666",379,584,205,"TTTACCATTAGACCCTGTGA","CTGCAATATCTGGTTGAGCG","561307.5.peg.2118","1245"
"14667",429,149,280,"AAATGGTCGATAACACGCCC","CAATTCCTTGTAACGCATAA","561307.5.peg.2119","1246"
"14668",329,149,180,"CAACTTGGACACCTTGTCCA","CAATTCCTTGTAACGCATAA","561307.5.peg.2119","1246"
"14669",279,149,130,"TGCATTGCCAATTCTCTTGT","CAATTCCTTGTAACGCATAA","561307.5.peg.2119","1246"
"14670",564,149,415,"ATTGTTTGACGTTGTACTGC","CAATTCCTTGTAACGCATAA","561307.5.peg.2119","1246"
"14671",768,149,619,"CCGAATACGATTGCTAATTC","CAATTCCTTGTAACGCATAA","561307.5.peg.2119","1246"
"14672",407,149,258,"GTGTTCCGACTACGATTTGT","CAATTCCTTGTAACGCATAA","561307.5.peg.2119","1246"
"14673",446,149,297,"TAATGTGCGACGATTTAAA","CAATTCCTTGTAACGCATAA","561307.5.peg.2119","1246"
"14674",564,176,388,"ATTGTTTGACGTTGTACTGC","TACCGGTTTGAGCTTGCCCA","561307.5.peg.2119","1246"
"14675",446,176,270,"TAATGTGCGACGATTTAAA","TACCGGTTTGAGCTTGCCCA","561307.5.peg.2119","1246"
"14676",407,176,231,"GTGTTCCGACTACGATTTGT","TACCGGTTTGAGCTTGCCCA","561307.5.peg.2119","1246"
"14677",768,176,592,"CCGAATACGATTGCTAATTC","TACCGGTTTGAGCTTGCCCA","561307.5.peg.2119","1246"
"14678",329,176,153,"CAACTTGGACACCTTGTCCA","TACCGGTTTGAGCTTGCCCA","561307.5.peg.2119","1246"
"14679",279,176,103,"TGCATTGCCAATTCTCTTGT","TACCGGTTTGAGCTTGCCCA","561307.5.peg.2119","1246"
"14680",429,176,253,"AAATGGTCGATAACACGCCC","TACCGGTTTGAGCTTGCCCA","561307.5.peg.2119","1246"
"14681",149,279,130,"CAATTCCTTGTAACGCATAA","TGCATTGCCAATTCTCTTGT","561307.5.peg.2119","1246"
"14682",407,279,128,"GTGTTCCGACTACGATTTGT","TGCATTGCCAATTCTCTTGT","561307.5.peg.2119","1246"
"14683",768,279,489,"CCGAATACGATTGCTAATTC","TGCATTGCCAATTCTCTTGT","561307.5.peg.2119","1246"
"14684",446,279,167,"TAATGTGCGACGATTTAAA","TGCATTGCCAATTCTCTTGT","561307.5.peg.2119","1246"
"14685",176,279,103,"TACCGGTTTGAGCTTGCCCA","TGCATTGCCAATTCTCTTGT","561307.5.peg.2119","1246"
"14686",564,279,285,"ATTGTTTGACGTTGTACTGC","TGCATTGCCAATTCTCTTGT","561307.5.peg.2119","1246"
"14687",429,279,150,"AAATGGTCGATAACACGCCC","TGCATTGCCAATTCTCTTGT","561307.5.peg.2119","1246"
"14688",446,329,117,"TAATGTGCGACGATTTAAA","CAACTTGGACACCTTGTCCA","561307.5.peg.2119","1246"
"14689",564,329,235,"ATTGTTTGACGTTGTACTGC","CAACTTGGACACCTTGTCCA","561307.5.peg.2119","1246"
"14690",176,329,153,"TACCGGTTTGAGCTTGCCCA","CAACTTGGACACCTTGTCCA","561307.5.peg.2119","1246"
"14691",768,329,439,"CCGAATACGATTGCTAATTC","CAACTTGGACACCTTGTCCA","561307.5.peg.2119","1246"
"14692",149,329,180,"CAATTCCTTGTAACGCATAA","CAACTTGGACACCTTGTCCA","561307.5.peg.2119","1246"
"14693",429,329,100,"AAATGGTCGATAACACGCCC","CAACTTGGACACCTTGTCCA","561307.5.peg.2119","1246"
"14694",279,407,128,"TGCATTGCCAATTCTCTTGT","GTGTTCCGACTACGATTTGT","561307.5.peg.2119","1246"
"14695",768,407,361,"CCGAATACGATTGCTAATTC","GTGTTCCGACTACGATTTGT","561307.5.peg.2119","1246"
"14696",149,407,258,"CAATTCCTTGTAACGCATAA","GTGTTCCGACTACGATTTGT","561307.5.peg.2119","1246"
"14697",564,407,157,"ATTGTTTGACGTTGTACTGC","GTGTTCCGACTACGATTTGT","561307.5.peg.2119","1246"
"14698",176,407,231,"TACCGGTTTGAGCTTGCCCA","GTGTTCCGACTACGATTTGT","561307.5.peg.2119","1246"
"14699",149,429,280,"CAATTCCTTGTAACGCATAA","AAATGGTCGATAACACGCCC","561307.5.peg.2119","1246"
"14700",768,429,339,"CCGAATACGATTGCTAATTC","AAATGGTCGATAACACGCCC","561307.5.peg.2119","1246"
"14701",279,429,150,"TGCATTGCCAATTCTCTTGT","AAATGGTCGATAACACGCCC","561307.5.peg.2119","1246"
"14702",564,429,135,"ATTGTTTGACGTTGTACTGC","AAATGGTCGATAACACGCCC","561307.5.peg.2119","1246"
"14703",176,429,253,"TACCGGTTTGAGCTTGCCCA","AAATGGTCGATAACACGCCC","561307.5.peg.2119","1246"
"14704",329,429,100,"CAACTTGGACACCTTGTCCA","AAATGGTCGATAACACGCCC","561307.5.peg.2119","1246"
"14705",329,446,117,"CAACTTGGACACCTTGTCCA","TAATGTGCGACGATTTAAA","561307.5.peg.2119","1246"
"14706",768,446,322,"CCGAATACGATTGCTAATTC","TAATGTGCGACGATTTAAA","561307.5.peg.2119","1246"
"14707",279,446,167,"TGCATTGCCAATTCTCTTGT","TAATGTGCGACGATTTAAA","561307.5.peg.2119","1246"
"14708",176,446,270,"TACCGGTTTGAGCTTGCCCA","TAATGTGCGACGATTTAAA","561307.5.peg.2119","1246"
"14709",149,446,297,"CAATTCCTTGTAACGCATAA","TAATGTGCGACGATTTAAA","561307.5.peg.2119","1246"
"14710",564,446,118,"ATTGTTTGACGTTGTACTGC","TAATGTGCGACGATTTAAA","561307.5.peg.2119","1246"
"14711",176,564,388,"TACCGGTTTGAGCTTGCCCA","ATTGTTTGACGTTGTACTGC","561307.5.peg.2119","1246"
"14712",279,564,285,"TGCATTGCCAATTCTCTTGT","ATTGTTTGACGTTGTACTGC","561307.5.peg.2119","1246"
"14713",329,564,235,"CAACTTGGACACCTTGTCCA","ATTGTTTGACGTTGTACTGC","561307.5.peg.2119","1246"
"14714",149,564,415,"CAATTCCTTGTAACGCATAA","ATTGTTTGACGTTGTACTGC","561307.5.peg.2119","1246"
"14715",446,564,118,"TAATGTGCGACGATTTAAA","ATTGTTTGACGTTGTACTGC","561307.5.peg.2119","1246"
"14716",407,564,157,"GTGTTCCGACTACGATTTGT","ATTGTTTGACGTTGTACTGC","561307.5.peg.2119","1246"
"14717",768,564,204,"CCGAATACGATTGCTAATTC","ATTGTTTGACGTTGTACTGC","561307.5.peg.2119","1246"
"14718",429,564,135,"AAATGGTCGATAACACGCCC","ATTGTTTGACGTTGTACTGC","561307.5.peg.2119","1246"
"14719",407,768,361,"GTGTTCCGACTACGATTTGT","CCGAATACGATTGCTAATTC","561307.5.peg.2119","1246"
"14720",279,768,489,"TGCATTGCCAATTCTCTTGT","CCGAATACGATTGCTAATTC","561307.5.peg.2119","1246"
"14721",149,768,619,"CAATTCCTTGTAACGCATAA","CCGAATACGATTGCTAATTC","561307.5.peg.2119","1246"
"14722",429,768,339,"AAATGGTCGATAACACGCCC","CCGAATACGATTGCTAATTC","561307.5.peg.2119","1246"
"14723",176,768,592,"TACCGGTTTGAGCTTGCCCA","CCGAATACGATTGCTAATTC","561307.5.peg.2119","1246"
"14724",564,768,204,"ATTGTTTGACGTTGTACTGC","CCGAATACGATTGCTAATTC","561307.5.peg.2119","1246"
"14725",446,768,322,"TAATGTGCGACGATTTAAA","CCGAATACGATTGCTAATTC","561307.5.peg.2119","1246"
"14726",329,768,439,"CAACTTGGACACCTTGTCCA","CCGAATACGATTGCTAATTC","561307.5.peg.2119","1246"
"14727",221,11,210,"GTAACTGTTCTGTTAGAAGT","AAAGTCACACAAGCATTGAA","561307.5.peg.212","1247"
"14728",11,221,210,"AAAGTCACACAAGCATTGAA","GTAACTGTTCTGTTAGAAGT","561307.5.peg.212","1247"
"14729",703,3,700,"TTCTTTATCACTCATCAAGT","TGATATTGCTATCGAGGTGA","561307.5.peg.2121","1249"
"14730",522,3,519,"GCGCTCATTATGAAATAGTC","TGATATTGCTATCGAGGTGA","561307.5.peg.2121","1249"
"14731",496,3,493,"ACGTTCTTTAACATGTACAC","TGATATTGCTATCGAGGTGA","561307.5.peg.2121","1249"
"14732",665,3,662,"TCAATGTACGCAGTTCGCTT","TGATATTGCTATCGAGGTGA","561307.5.peg.2121","1249"
"14733",1333,3,1330,"GATGAAGGACCGCGTCCAAA","TGATATTGCTATCGAGGTGA","561307.5.peg.2121","1249"
"14734",311,3,308,"TCGGCGATTCTTCGATTATG","TGATATTGCTATCGAGGTGA","561307.5.peg.2121","1249"
"14735",1182,3,1179,"ATGGCGAAACGTTTGCCTTT","TGATATTGCTATCGAGGTGA","561307.5.peg.2121","1249"
"14736",1173,3,1170,"CGTTTGCCTTTAGGACGATA","TGATATTGCTATCGAGGTGA","561307.5.peg.2121","1249"
"14737",661,3,658,"TGTACGCAGTTCGCTTAGGT","TGATATTGCTATCGAGGTGA","561307.5.peg.2121","1249"
"14738",330,3,327,"TCATCGATAAGTACTATTGT","TGATATTGCTATCGAGGTGA","561307.5.peg.2121","1249"
"14739",759,3,756,"CTAATTGCCACAGCAATATG","TGATATTGCTATCGAGGTGA","561307.5.peg.2121","1249"
"14740",971,3,968,"CTAATCCTAATGCAACGGTT","TGATATTGCTATCGAGGTGA","561307.5.peg.2121","1249"
"14741",207,3,204,"TTTGTTTCATCACGCTGATG","TGATATTGCTATCGAGGTGA","561307.5.peg.2121","1249"
"14742",1173,207,966,"CGTTTGCCTTTAGGACGATA","TTTGTTTCATCACGCTGATG","561307.5.peg.2121","1249"
"14743",496,207,289,"ACGTTCTTTAACATGTACAC","TTTGTTTCATCACGCTGATG","561307.5.peg.2121","1249"
"14744",522,207,315,"GCGCTCATTATGAAATAGTC","TTTGTTTCATCACGCTGATG","561307.5.peg.2121","1249"
"14745",1182,207,975,"ATGGCGAAACGTTTGCCTTT","TTTGTTTCATCACGCTGATG","561307.5.peg.2121","1249"
"14746",759,207,552,"CTAATTGCCACAGCAATATG","TTTGTTTCATCACGCTGATG","561307.5.peg.2121","1249"
"14747",703,207,496,"TTCTTTATCACTCATCAAGT","TTTGTTTCATCACGCTGATG","561307.5.peg.2121","1249"
"14748",330,207,123,"TCATCGATAAGTACTATTGT","TTTGTTTCATCACGCTGATG","561307.5.peg.2121","1249"
"14749",1333,207,1126,"GATGAAGGACCGCGTCCAAA","TTTGTTTCATCACGCTGATG","561307.5.peg.2121","1249"
"14750",311,207,104,"TCGGCGATTCTTCGATTATG","TTTGTTTCATCACGCTGATG","561307.5.peg.2121","1249"
"14751",665,207,458,"TCAATGTACGCAGTTCGCTT","TTTGTTTCATCACGCTGATG","561307.5.peg.2121","1249"
"14752",3,207,204,"TGATATTGCTATCGAGGTGA","TTTGTTTCATCACGCTGATG","561307.5.peg.2121","1249"
"14753",661,207,454,"TGTACGCAGTTCGCTTAGGT","TTTGTTTCATCACGCTGATG","561307.5.peg.2121","1249"
"14754",971,207,764,"CTAATCCTAATGCAACGGTT","TTTGTTTCATCACGCTGATG","561307.5.peg.2121","1249"
"14755",759,311,448,"CTAATTGCCACAGCAATATG","TCGGCGATTCTTCGATTATG","561307.5.peg.2121","1249"
"14756",1173,311,862,"CGTTTGCCTTTAGGACGATA","TCGGCGATTCTTCGATTATG","561307.5.peg.2121","1249"
"14757",3,311,308,"TGATATTGCTATCGAGGTGA","TCGGCGATTCTTCGATTATG","561307.5.peg.2121","1249"
"14758",971,311,660,"CTAATCCTAATGCAACGGTT","TCGGCGATTCTTCGATTATG","561307.5.peg.2121","1249"
"14759",665,311,354,"TCAATGTACGCAGTTCGCTT","TCGGCGATTCTTCGATTATG","561307.5.peg.2121","1249"
"14760",496,311,185,"ACGTTCTTTAACATGTACAC","TCGGCGATTCTTCGATTATG","561307.5.peg.2121","1249"
"14761",207,311,104,"TTTGTTTCATCACGCTGATG","TCGGCGATTCTTCGATTATG","561307.5.peg.2121","1249"
"14762",1182,311,871,"ATGGCGAAACGTTTGCCTTT","TCGGCGATTCTTCGATTATG","561307.5.peg.2121","1249"
"14763",522,311,211,"GCGCTCATTATGAAATAGTC","TCGGCGATTCTTCGATTATG","561307.5.peg.2121","1249"
"14764",661,311,350,"TGTACGCAGTTCGCTTAGGT","TCGGCGATTCTTCGATTATG","561307.5.peg.2121","1249"
"14765",1333,311,1022,"GATGAAGGACCGCGTCCAAA","TCGGCGATTCTTCGATTATG","561307.5.peg.2121","1249"
"14766",703,311,392,"TTCTTTATCACTCATCAAGT","TCGGCGATTCTTCGATTATG","561307.5.peg.2121","1249"
"14767",1182,330,852,"ATGGCGAAACGTTTGCCTTT","TCATCGATAAGTACTATTGT","561307.5.peg.2121","1249"
"14768",3,330,327,"TGATATTGCTATCGAGGTGA","TCATCGATAAGTACTATTGT","561307.5.peg.2121","1249"
"14769",661,330,331,"TGTACGCAGTTCGCTTAGGT","TCATCGATAAGTACTATTGT","561307.5.peg.2121","1249"
"14770",1333,330,1003,"GATGAAGGACCGCGTCCAAA","TCATCGATAAGTACTATTGT","561307.5.peg.2121","1249"
"14771",665,330,335,"TCAATGTACGCAGTTCGCTT","TCATCGATAAGTACTATTGT","561307.5.peg.2121","1249"
"14772",759,330,429,"CTAATTGCCACAGCAATATG","TCATCGATAAGTACTATTGT","561307.5.peg.2121","1249"
"14773",1173,330,843,"CGTTTGCCTTTAGGACGATA","TCATCGATAAGTACTATTGT","561307.5.peg.2121","1249"
"14774",496,330,166,"ACGTTCTTTAACATGTACAC","TCATCGATAAGTACTATTGT","561307.5.peg.2121","1249"
"14775",207,330,123,"TTTGTTTCATCACGCTGATG","TCATCGATAAGTACTATTGT","561307.5.peg.2121","1249"
"14776",522,330,192,"GCGCTCATTATGAAATAGTC","TCATCGATAAGTACTATTGT","561307.5.peg.2121","1249"
"14777",971,330,641,"CTAATCCTAATGCAACGGTT","TCATCGATAAGTACTATTGT","561307.5.peg.2121","1249"
"14778",703,330,373,"TTCTTTATCACTCATCAAGT","TCATCGATAAGTACTATTGT","561307.5.peg.2121","1249"
"14779",1173,496,677,"CGTTTGCCTTTAGGACGATA","ACGTTCTTTAACATGTACAC","561307.5.peg.2121","1249"
"14780",330,496,166,"TCATCGATAAGTACTATTGT","ACGTTCTTTAACATGTACAC","561307.5.peg.2121","1249"
"14781",703,496,207,"TTCTTTATCACTCATCAAGT","ACGTTCTTTAACATGTACAC","561307.5.peg.2121","1249"
"14782",311,496,185,"TCGGCGATTCTTCGATTATG","ACGTTCTTTAACATGTACAC","561307.5.peg.2121","1249"
"14783",1182,496,686,"ATGGCGAAACGTTTGCCTTT","ACGTTCTTTAACATGTACAC","561307.5.peg.2121","1249"
"14784",759,496,263,"CTAATTGCCACAGCAATATG","ACGTTCTTTAACATGTACAC","561307.5.peg.2121","1249"
"14785",207,496,289,"TTTGTTTCATCACGCTGATG","ACGTTCTTTAACATGTACAC","561307.5.peg.2121","1249"
"14786",661,496,165,"TGTACGCAGTTCGCTTAGGT","ACGTTCTTTAACATGTACAC","561307.5.peg.2121","1249"
"14787",1333,496,837,"GATGAAGGACCGCGTCCAAA","ACGTTCTTTAACATGTACAC","561307.5.peg.2121","1249"
"14788",665,496,169,"TCAATGTACGCAGTTCGCTT","ACGTTCTTTAACATGTACAC","561307.5.peg.2121","1249"
"14789",3,496,493,"TGATATTGCTATCGAGGTGA","ACGTTCTTTAACATGTACAC","561307.5.peg.2121","1249"
"14790",971,496,475,"CTAATCCTAATGCAACGGTT","ACGTTCTTTAACATGTACAC","561307.5.peg.2121","1249"
"14791",330,522,192,"TCATCGATAAGTACTATTGT","GCGCTCATTATGAAATAGTC","561307.5.peg.2121","1249"
"14792",665,522,143,"TCAATGTACGCAGTTCGCTT","GCGCTCATTATGAAATAGTC","561307.5.peg.2121","1249"
"14793",1182,522,660,"ATGGCGAAACGTTTGCCTTT","GCGCTCATTATGAAATAGTC","561307.5.peg.2121","1249"
"14794",311,522,211,"TCGGCGATTCTTCGATTATG","GCGCTCATTATGAAATAGTC","561307.5.peg.2121","1249"
"14795",1173,522,651,"CGTTTGCCTTTAGGACGATA","GCGCTCATTATGAAATAGTC","561307.5.peg.2121","1249"
"14796",3,522,519,"TGATATTGCTATCGAGGTGA","GCGCTCATTATGAAATAGTC","561307.5.peg.2121","1249"
"14797",1333,522,811,"GATGAAGGACCGCGTCCAAA","GCGCTCATTATGAAATAGTC","561307.5.peg.2121","1249"
"14798",971,522,449,"CTAATCCTAATGCAACGGTT","GCGCTCATTATGAAATAGTC","561307.5.peg.2121","1249"
"14799",703,522,181,"TTCTTTATCACTCATCAAGT","GCGCTCATTATGAAATAGTC","561307.5.peg.2121","1249"
"14800",661,522,139,"TGTACGCAGTTCGCTTAGGT","GCGCTCATTATGAAATAGTC","561307.5.peg.2121","1249"
"14801",759,522,237,"CTAATTGCCACAGCAATATG","GCGCTCATTATGAAATAGTC","561307.5.peg.2121","1249"
"14802",207,522,315,"TTTGTTTCATCACGCTGATG","GCGCTCATTATGAAATAGTC","561307.5.peg.2121","1249"
"14803",3,661,658,"TGATATTGCTATCGAGGTGA","TGTACGCAGTTCGCTTAGGT","561307.5.peg.2121","1249"
"14804",1182,661,521,"ATGGCGAAACGTTTGCCTTT","TGTACGCAGTTCGCTTAGGT","561307.5.peg.2121","1249"
"14805",1333,661,672,"GATGAAGGACCGCGTCCAAA","TGTACGCAGTTCGCTTAGGT","561307.5.peg.2121","1249"
"14806",971,661,310,"CTAATCCTAATGCAACGGTT","TGTACGCAGTTCGCTTAGGT","561307.5.peg.2121","1249"
"14807",1173,661,512,"CGTTTGCCTTTAGGACGATA","TGTACGCAGTTCGCTTAGGT","561307.5.peg.2121","1249"
"14808",207,661,454,"TTTGTTTCATCACGCTGATG","TGTACGCAGTTCGCTTAGGT","561307.5.peg.2121","1249"
"14809",330,661,331,"TCATCGATAAGTACTATTGT","TGTACGCAGTTCGCTTAGGT","561307.5.peg.2121","1249"
"14810",496,661,165,"ACGTTCTTTAACATGTACAC","TGTACGCAGTTCGCTTAGGT","561307.5.peg.2121","1249"
"14811",522,661,139,"GCGCTCATTATGAAATAGTC","TGTACGCAGTTCGCTTAGGT","561307.5.peg.2121","1249"
"14812",311,661,350,"TCGGCGATTCTTCGATTATG","TGTACGCAGTTCGCTTAGGT","561307.5.peg.2121","1249"
"14813",207,665,458,"TTTGTTTCATCACGCTGATG","TCAATGTACGCAGTTCGCTT","561307.5.peg.2121","1249"
"14814",330,665,335,"TCATCGATAAGTACTATTGT","TCAATGTACGCAGTTCGCTT","561307.5.peg.2121","1249"
"14815",1182,665,517,"ATGGCGAAACGTTTGCCTTT","TCAATGTACGCAGTTCGCTT","561307.5.peg.2121","1249"
"14816",522,665,143,"GCGCTCATTATGAAATAGTC","TCAATGTACGCAGTTCGCTT","561307.5.peg.2121","1249"
"14817",1333,665,668,"GATGAAGGACCGCGTCCAAA","TCAATGTACGCAGTTCGCTT","561307.5.peg.2121","1249"
"14818",3,665,662,"TGATATTGCTATCGAGGTGA","TCAATGTACGCAGTTCGCTT","561307.5.peg.2121","1249"
"14819",1173,665,508,"CGTTTGCCTTTAGGACGATA","TCAATGTACGCAGTTCGCTT","561307.5.peg.2121","1249"
"14820",496,665,169,"ACGTTCTTTAACATGTACAC","TCAATGTACGCAGTTCGCTT","561307.5.peg.2121","1249"
"14821",971,665,306,"CTAATCCTAATGCAACGGTT","TCAATGTACGCAGTTCGCTT","561307.5.peg.2121","1249"
"14822",311,665,354,"TCGGCGATTCTTCGATTATG","TCAATGTACGCAGTTCGCTT","561307.5.peg.2121","1249"
"14823",971,703,268,"CTAATCCTAATGCAACGGTT","TTCTTTATCACTCATCAAGT","561307.5.peg.2121","1249"
"14824",311,703,392,"TCGGCGATTCTTCGATTATG","TTCTTTATCACTCATCAAGT","561307.5.peg.2121","1249"
"14825",1333,703,630,"GATGAAGGACCGCGTCCAAA","TTCTTTATCACTCATCAAGT","561307.5.peg.2121","1249"
"14826",207,703,496,"TTTGTTTCATCACGCTGATG","TTCTTTATCACTCATCAAGT","561307.5.peg.2121","1249"
"14827",1173,703,470,"CGTTTGCCTTTAGGACGATA","TTCTTTATCACTCATCAAGT","561307.5.peg.2121","1249"
"14828",1182,703,479,"ATGGCGAAACGTTTGCCTTT","TTCTTTATCACTCATCAAGT","561307.5.peg.2121","1249"
"14829",330,703,373,"TCATCGATAAGTACTATTGT","TTCTTTATCACTCATCAAGT","561307.5.peg.2121","1249"
"14830",496,703,207,"ACGTTCTTTAACATGTACAC","TTCTTTATCACTCATCAAGT","561307.5.peg.2121","1249"
"14831",3,703,700,"TGATATTGCTATCGAGGTGA","TTCTTTATCACTCATCAAGT","561307.5.peg.2121","1249"
"14832",522,703,181,"GCGCTCATTATGAAATAGTC","TTCTTTATCACTCATCAAGT","561307.5.peg.2121","1249"
"14833",1182,759,423,"ATGGCGAAACGTTTGCCTTT","CTAATTGCCACAGCAATATG","561307.5.peg.2121","1249"
"14834",1173,759,414,"CGTTTGCCTTTAGGACGATA","CTAATTGCCACAGCAATATG","561307.5.peg.2121","1249"
"14835",522,759,237,"GCGCTCATTATGAAATAGTC","CTAATTGCCACAGCAATATG","561307.5.peg.2121","1249"
"14836",496,759,263,"ACGTTCTTTAACATGTACAC","CTAATTGCCACAGCAATATG","561307.5.peg.2121","1249"
"14837",311,759,448,"TCGGCGATTCTTCGATTATG","CTAATTGCCACAGCAATATG","561307.5.peg.2121","1249"
"14838",207,759,552,"TTTGTTTCATCACGCTGATG","CTAATTGCCACAGCAATATG","561307.5.peg.2121","1249"
"14839",330,759,429,"TCATCGATAAGTACTATTGT","CTAATTGCCACAGCAATATG","561307.5.peg.2121","1249"
"14840",3,759,756,"TGATATTGCTATCGAGGTGA","CTAATTGCCACAGCAATATG","561307.5.peg.2121","1249"
"14841",1333,759,574,"GATGAAGGACCGCGTCCAAA","CTAATTGCCACAGCAATATG","561307.5.peg.2121","1249"
"14842",971,759,212,"CTAATCCTAATGCAACGGTT","CTAATTGCCACAGCAATATG","561307.5.peg.2121","1249"
"14843",661,971,310,"TGTACGCAGTTCGCTTAGGT","CTAATCCTAATGCAACGGTT","561307.5.peg.2121","1249"
"14844",207,971,764,"TTTGTTTCATCACGCTGATG","CTAATCCTAATGCAACGGTT","561307.5.peg.2121","1249"
"14845",3,971,968,"TGATATTGCTATCGAGGTGA","CTAATCCTAATGCAACGGTT","561307.5.peg.2121","1249"
"14846",496,971,475,"ACGTTCTTTAACATGTACAC","CTAATCCTAATGCAACGGTT","561307.5.peg.2121","1249"
"14847",1173,971,202,"CGTTTGCCTTTAGGACGATA","CTAATCCTAATGCAACGGTT","561307.5.peg.2121","1249"
"14848",1182,971,211,"ATGGCGAAACGTTTGCCTTT","CTAATCCTAATGCAACGGTT","561307.5.peg.2121","1249"
"14849",311,971,660,"TCGGCGATTCTTCGATTATG","CTAATCCTAATGCAACGGTT","561307.5.peg.2121","1249"
"14850",1333,971,362,"GATGAAGGACCGCGTCCAAA","CTAATCCTAATGCAACGGTT","561307.5.peg.2121","1249"
"14851",703,971,268,"TTCTTTATCACTCATCAAGT","CTAATCCTAATGCAACGGTT","561307.5.peg.2121","1249"
"14852",665,971,306,"TCAATGTACGCAGTTCGCTT","CTAATCCTAATGCAACGGTT","561307.5.peg.2121","1249"
"14853",759,971,212,"CTAATTGCCACAGCAATATG","CTAATCCTAATGCAACGGTT","561307.5.peg.2121","1249"
"14854",330,971,641,"TCATCGATAAGTACTATTGT","CTAATCCTAATGCAACGGTT","561307.5.peg.2121","1249"
"14855",522,971,449,"GCGCTCATTATGAAATAGTC","CTAATCCTAATGCAACGGTT","561307.5.peg.2121","1249"
"14856",311,1173,862,"TCGGCGATTCTTCGATTATG","CGTTTGCCTTTAGGACGATA","561307.5.peg.2121","1249"
"14857",1333,1173,160,"GATGAAGGACCGCGTCCAAA","CGTTTGCCTTTAGGACGATA","561307.5.peg.2121","1249"
"14858",330,1173,843,"TCATCGATAAGTACTATTGT","CGTTTGCCTTTAGGACGATA","561307.5.peg.2121","1249"
"14859",665,1173,508,"TCAATGTACGCAGTTCGCTT","CGTTTGCCTTTAGGACGATA","561307.5.peg.2121","1249"
"14860",207,1173,966,"TTTGTTTCATCACGCTGATG","CGTTTGCCTTTAGGACGATA","561307.5.peg.2121","1249"
"14861",3,1173,1170,"TGATATTGCTATCGAGGTGA","CGTTTGCCTTTAGGACGATA","561307.5.peg.2121","1249"
"14862",759,1173,414,"CTAATTGCCACAGCAATATG","CGTTTGCCTTTAGGACGATA","561307.5.peg.2121","1249"
"14863",496,1173,677,"ACGTTCTTTAACATGTACAC","CGTTTGCCTTTAGGACGATA","561307.5.peg.2121","1249"
"14864",971,1173,202,"CTAATCCTAATGCAACGGTT","CGTTTGCCTTTAGGACGATA","561307.5.peg.2121","1249"
"14865",703,1173,470,"TTCTTTATCACTCATCAAGT","CGTTTGCCTTTAGGACGATA","561307.5.peg.2121","1249"
"14866",661,1173,512,"TGTACGCAGTTCGCTTAGGT","CGTTTGCCTTTAGGACGATA","561307.5.peg.2121","1249"
"14867",522,1173,651,"GCGCTCATTATGAAATAGTC","CGTTTGCCTTTAGGACGATA","561307.5.peg.2121","1249"
"14868",759,1182,423,"CTAATTGCCACAGCAATATG","ATGGCGAAACGTTTGCCTTT","561307.5.peg.2121","1249"
"14869",207,1182,975,"TTTGTTTCATCACGCTGATG","ATGGCGAAACGTTTGCCTTT","561307.5.peg.2121","1249"
"14870",1333,1182,151,"GATGAAGGACCGCGTCCAAA","ATGGCGAAACGTTTGCCTTT","561307.5.peg.2121","1249"
"14871",971,1182,211,"CTAATCCTAATGCAACGGTT","ATGGCGAAACGTTTGCCTTT","561307.5.peg.2121","1249"
"14872",311,1182,871,"TCGGCGATTCTTCGATTATG","ATGGCGAAACGTTTGCCTTT","561307.5.peg.2121","1249"
"14873",522,1182,660,"GCGCTCATTATGAAATAGTC","ATGGCGAAACGTTTGCCTTT","561307.5.peg.2121","1249"
"14874",3,1182,1179,"TGATATTGCTATCGAGGTGA","ATGGCGAAACGTTTGCCTTT","561307.5.peg.2121","1249"
"14875",330,1182,852,"TCATCGATAAGTACTATTGT","ATGGCGAAACGTTTGCCTTT","561307.5.peg.2121","1249"
"14876",665,1182,517,"TCAATGTACGCAGTTCGCTT","ATGGCGAAACGTTTGCCTTT","561307.5.peg.2121","1249"
"14877",496,1182,686,"ACGTTCTTTAACATGTACAC","ATGGCGAAACGTTTGCCTTT","561307.5.peg.2121","1249"
"14878",703,1182,479,"TTCTTTATCACTCATCAAGT","ATGGCGAAACGTTTGCCTTT","561307.5.peg.2121","1249"
"14879",661,1182,521,"TGTACGCAGTTCGCTTAGGT","ATGGCGAAACGTTTGCCTTT","561307.5.peg.2121","1249"
"14880",971,1333,362,"CTAATCCTAATGCAACGGTT","GATGAAGGACCGCGTCCAAA","561307.5.peg.2121","1249"
"14881",665,1333,668,"TCAATGTACGCAGTTCGCTT","GATGAAGGACCGCGTCCAAA","561307.5.peg.2121","1249"
"14882",207,1333,1126,"TTTGTTTCATCACGCTGATG","GATGAAGGACCGCGTCCAAA","561307.5.peg.2121","1249"
"14883",1173,1333,160,"CGTTTGCCTTTAGGACGATA","GATGAAGGACCGCGTCCAAA","561307.5.peg.2121","1249"
"14884",3,1333,1330,"TGATATTGCTATCGAGGTGA","GATGAAGGACCGCGTCCAAA","561307.5.peg.2121","1249"
"14885",703,1333,630,"TTCTTTATCACTCATCAAGT","GATGAAGGACCGCGTCCAAA","561307.5.peg.2121","1249"
"14886",496,1333,837,"ACGTTCTTTAACATGTACAC","GATGAAGGACCGCGTCCAAA","561307.5.peg.2121","1249"
"14887",1182,1333,151,"ATGGCGAAACGTTTGCCTTT","GATGAAGGACCGCGTCCAAA","561307.5.peg.2121","1249"
"14888",759,1333,574,"CTAATTGCCACAGCAATATG","GATGAAGGACCGCGTCCAAA","561307.5.peg.2121","1249"
"14889",661,1333,672,"TGTACGCAGTTCGCTTAGGT","GATGAAGGACCGCGTCCAAA","561307.5.peg.2121","1249"
"14890",311,1333,1022,"TCGGCGATTCTTCGATTATG","GATGAAGGACCGCGTCCAAA","561307.5.peg.2121","1249"
"14891",522,1333,811,"GCGCTCATTATGAAATAGTC","GATGAAGGACCGCGTCCAAA","561307.5.peg.2121","1249"
"14892",330,1333,1003,"TCATCGATAAGTACTATTGT","GATGAAGGACCGCGTCCAAA","561307.5.peg.2121","1249"
"14893",478,329,149,"TCTCAACATCGCTATACAAA","AAACGCTAAATCTATCGAT","561307.5.peg.2122","1250"
"14894",621,329,292,"AAATTAGCATGCAACGTTTG","AAACGCTAAATCTATCGAT","561307.5.peg.2122","1250"
"14895",690,329,361,"TTGATTCAAGTGATGCAAT","AAACGCTAAATCTATCGAT","561307.5.peg.2122","1250"
"14896",621,478,143,"AAATTAGCATGCAACGTTTG","TCTCAACATCGCTATACAAA","561307.5.peg.2122","1250"
"14897",329,478,149,"AAACGCTAAATCTATCGAT","TCTCAACATCGCTATACAAA","561307.5.peg.2122","1250"
"14898",690,478,212,"TTGATTCAAGTGATGCAAT","TCTCAACATCGCTATACAAA","561307.5.peg.2122","1250"
"14899",329,621,292,"AAACGCTAAATCTATCGAT","AAATTAGCATGCAACGTTTG","561307.5.peg.2122","1250"
"14900",478,621,143,"TCTCAACATCGCTATACAAA","AAATTAGCATGCAACGTTTG","561307.5.peg.2122","1250"
"14901",478,690,212,"TCTCAACATCGCTATACAAA","TTGATTCAAGTGATGCAAT","561307.5.peg.2122","1250"
"14902",329,690,361,"AAACGCTAAATCTATCGAT","TTGATTCAAGTGATGCAAT","561307.5.peg.2122","1250"
"14903",496,147,349,"AGTAATTGCAGATTCATCAA","ACCTCAACGACAAACATTAT","561307.5.peg.2123","1251"
"14904",655,147,508,"TCTTTCCGCCCCTTCAACTA","ACCTCAACGACAAACATTAT","561307.5.peg.2123","1251"
"14905",831,147,684,"AACAAACCACCGATTGTCGT","ACCTCAACGACAAACATTAT","561307.5.peg.2123","1251"
"14906",461,147,314,"TTATTACAACGCCATCAGCA","ACCTCAACGACAAACATTAT","561307.5.peg.2123","1251"
"14907",1011,147,864,"TCAAGCATTTGTTGATTCAC","ACCTCAACGACAAACATTAT","561307.5.peg.2123","1251"
"14908",792,147,645,"AACGCAATGAGCATCGCAAT","ACCTCAACGACAAACATTAT","561307.5.peg.2123","1251"
"14909",655,204,451,"TCTTTCCGCCCCTTCAACTA","TAGCTAGTTCCAAATATGTC","561307.5.peg.2123","1251"
"14910",461,204,257,"TTATTACAACGCCATCAGCA","TAGCTAGTTCCAAATATGTC","561307.5.peg.2123","1251"
"14911",496,204,292,"AGTAATTGCAGATTCATCAA","TAGCTAGTTCCAAATATGTC","561307.5.peg.2123","1251"
"14912",1011,204,807,"TCAAGCATTTGTTGATTCAC","TAGCTAGTTCCAAATATGTC","561307.5.peg.2123","1251"
"14913",792,204,588,"AACGCAATGAGCATCGCAAT","TAGCTAGTTCCAAATATGTC","561307.5.peg.2123","1251"
"14914",831,204,627,"AACAAACCACCGATTGTCGT","TAGCTAGTTCCAAATATGTC","561307.5.peg.2123","1251"
"14915",147,461,314,"ACCTCAACGACAAACATTAT","TTATTACAACGCCATCAGCA","561307.5.peg.2123","1251"
"14916",792,461,331,"AACGCAATGAGCATCGCAAT","TTATTACAACGCCATCAGCA","561307.5.peg.2123","1251"
"14917",1011,461,550,"TCAAGCATTTGTTGATTCAC","TTATTACAACGCCATCAGCA","561307.5.peg.2123","1251"
"14918",655,461,194,"TCTTTCCGCCCCTTCAACTA","TTATTACAACGCCATCAGCA","561307.5.peg.2123","1251"
"14919",831,461,370,"AACAAACCACCGATTGTCGT","TTATTACAACGCCATCAGCA","561307.5.peg.2123","1251"
"14920",204,461,257,"TAGCTAGTTCCAAATATGTC","TTATTACAACGCCATCAGCA","561307.5.peg.2123","1251"
"14921",147,496,349,"ACCTCAACGACAAACATTAT","AGTAATTGCAGATTCATCAA","561307.5.peg.2123","1251"
"14922",655,496,159,"TCTTTCCGCCCCTTCAACTA","AGTAATTGCAGATTCATCAA","561307.5.peg.2123","1251"
"14923",204,496,292,"TAGCTAGTTCCAAATATGTC","AGTAATTGCAGATTCATCAA","561307.5.peg.2123","1251"
"14924",792,496,296,"AACGCAATGAGCATCGCAAT","AGTAATTGCAGATTCATCAA","561307.5.peg.2123","1251"
"14925",831,496,335,"AACAAACCACCGATTGTCGT","AGTAATTGCAGATTCATCAA","561307.5.peg.2123","1251"
"14926",1011,496,515,"TCAAGCATTTGTTGATTCAC","AGTAATTGCAGATTCATCAA","561307.5.peg.2123","1251"
"14927",204,655,451,"TAGCTAGTTCCAAATATGTC","TCTTTCCGCCCCTTCAACTA","561307.5.peg.2123","1251"
"14928",147,655,508,"ACCTCAACGACAAACATTAT","TCTTTCCGCCCCTTCAACTA","561307.5.peg.2123","1251"
"14929",792,655,137,"AACGCAATGAGCATCGCAAT","TCTTTCCGCCCCTTCAACTA","561307.5.peg.2123","1251"
"14930",496,655,159,"AGTAATTGCAGATTCATCAA","TCTTTCCGCCCCTTCAACTA","561307.5.peg.2123","1251"
"14931",461,655,194,"TTATTACAACGCCATCAGCA","TCTTTCCGCCCCTTCAACTA","561307.5.peg.2123","1251"
"14932",831,655,176,"AACAAACCACCGATTGTCGT","TCTTTCCGCCCCTTCAACTA","561307.5.peg.2123","1251"
"14933",1011,655,356,"TCAAGCATTTGTTGATTCAC","TCTTTCCGCCCCTTCAACTA","561307.5.peg.2123","1251"
"14934",461,792,331,"TTATTACAACGCCATCAGCA","AACGCAATGAGCATCGCAAT","561307.5.peg.2123","1251"
"14935",204,792,588,"TAGCTAGTTCCAAATATGTC","AACGCAATGAGCATCGCAAT","561307.5.peg.2123","1251"
"14936",147,792,645,"ACCTCAACGACAAACATTAT","AACGCAATGAGCATCGCAAT","561307.5.peg.2123","1251"
"14937",496,792,296,"AGTAATTGCAGATTCATCAA","AACGCAATGAGCATCGCAAT","561307.5.peg.2123","1251"
"14938",655,792,137,"TCTTTCCGCCCCTTCAACTA","AACGCAATGAGCATCGCAAT","561307.5.peg.2123","1251"
"14939",1011,792,219,"TCAAGCATTTGTTGATTCAC","AACGCAATGAGCATCGCAAT","561307.5.peg.2123","1251"
"14940",204,831,627,"TAGCTAGTTCCAAATATGTC","AACAAACCACCGATTGTCGT","561307.5.peg.2123","1251"
"14941",147,831,684,"ACCTCAACGACAAACATTAT","AACAAACCACCGATTGTCGT","561307.5.peg.2123","1251"
"14942",461,831,370,"TTATTACAACGCCATCAGCA","AACAAACCACCGATTGTCGT","561307.5.peg.2123","1251"
"14943",496,831,335,"AGTAATTGCAGATTCATCAA","AACAAACCACCGATTGTCGT","561307.5.peg.2123","1251"
"14944",1011,831,180,"TCAAGCATTTGTTGATTCAC","AACAAACCACCGATTGTCGT","561307.5.peg.2123","1251"
"14945",655,831,176,"TCTTTCCGCCCCTTCAACTA","AACAAACCACCGATTGTCGT","561307.5.peg.2123","1251"
"14946",496,1011,515,"AGTAATTGCAGATTCATCAA","TCAAGCATTTGTTGATTCAC","561307.5.peg.2123","1251"
"14947",461,1011,550,"TTATTACAACGCCATCAGCA","TCAAGCATTTGTTGATTCAC","561307.5.peg.2123","1251"
"14948",147,1011,864,"ACCTCAACGACAAACATTAT","TCAAGCATTTGTTGATTCAC","561307.5.peg.2123","1251"
"14949",655,1011,356,"TCTTTCCGCCCCTTCAACTA","TCAAGCATTTGTTGATTCAC","561307.5.peg.2123","1251"
"14950",792,1011,219,"AACGCAATGAGCATCGCAAT","TCAAGCATTTGTTGATTCAC","561307.5.peg.2123","1251"
"14951",204,1011,807,"TAGCTAGTTCCAAATATGTC","TCAAGCATTTGTTGATTCAC","561307.5.peg.2123","1251"
"14952",831,1011,180,"AACAAACCACCGATTGTCGT","TCAAGCATTTGTTGATTCAC","561307.5.peg.2123","1251"
"14953",255,43,212,"TATTATAATCAACTGCACT","TCTTATCGTATTCATGGTAC","561307.5.peg.2124","1252"
"14954",255,116,139,"TATTATAATCAACTGCACT","CAATTAACGTGATAGCTAAC","561307.5.peg.2124","1252"
"14955",43,255,212,"TCTTATCGTATTCATGGTAC","TATTATAATCAACTGCACT","561307.5.peg.2124","1252"
"14956",116,255,139,"CAATTAACGTGATAGCTAAC","TATTATAATCAACTGCACT","561307.5.peg.2124","1252"
"14957",252,81,171,"CGACAATGATATTGCCATAA","AATACAACAATGCTGACTT","561307.5.peg.2125","1253"
"14958",81,252,171,"AATACAACAATGCTGACTT","CGACAATGATATTGCCATAA","561307.5.peg.2125","1253"
"14959",349,10,339,"GACCCCTTGTGTCATATCAA","AACTATGTCGAATTTGAGAG","561307.5.peg.2126","1254"
"14960",732,10,722,"TCTCTTACAGCCCCGTAAAT","AACTATGTCGAATTTGAGAG","561307.5.peg.2126","1254"
"14961",703,10,693,"AGCTGCTAACGTTACACCAA","AACTATGTCGAATTTGAGAG","561307.5.peg.2126","1254"
"14962",761,10,751,"CATGATTTAGCTTCGACCAT","AACTATGTCGAATTTGAGAG","561307.5.peg.2126","1254"
"14963",414,10,404,"CTTAAGACAATACCATCACT","AACTATGTCGAATTTGAGAG","561307.5.peg.2126","1254"
"14964",694,10,684,"CGTTACACCAATGGCGCCAC","AACTATGTCGAATTTGAGAG","561307.5.peg.2126","1254"
"14965",694,12,682,"CGTTACACCAATGGCGCCAC","AGAACTATGTCGAATTTGAG","561307.5.peg.2126","1254"
"14966",349,12,337,"GACCCCTTGTGTCATATCAA","AGAACTATGTCGAATTTGAG","561307.5.peg.2126","1254"
"14967",414,12,402,"CTTAAGACAATACCATCACT","AGAACTATGTCGAATTTGAG","561307.5.peg.2126","1254"
"14968",761,12,749,"CATGATTTAGCTTCGACCAT","AGAACTATGTCGAATTTGAG","561307.5.peg.2126","1254"
"14969",703,12,691,"AGCTGCTAACGTTACACCAA","AGAACTATGTCGAATTTGAG","561307.5.peg.2126","1254"
"14970",732,12,720,"TCTCTTACAGCCCCGTAAAT","AGAACTATGTCGAATTTGAG","561307.5.peg.2126","1254"
"14971",732,349,383,"TCTCTTACAGCCCCGTAAAT","GACCCCTTGTGTCATATCAA","561307.5.peg.2126","1254"
"14972",10,349,339,"AACTATGTCGAATTTGAGAG","GACCCCTTGTGTCATATCAA","561307.5.peg.2126","1254"
"14973",761,349,412,"CATGATTTAGCTTCGACCAT","GACCCCTTGTGTCATATCAA","561307.5.peg.2126","1254"
"14974",703,349,354,"AGCTGCTAACGTTACACCAA","GACCCCTTGTGTCATATCAA","561307.5.peg.2126","1254"
"14975",694,349,345,"CGTTACACCAATGGCGCCAC","GACCCCTTGTGTCATATCAA","561307.5.peg.2126","1254"
"14976",12,349,337,"AGAACTATGTCGAATTTGAG","GACCCCTTGTGTCATATCAA","561307.5.peg.2126","1254"
"14977",703,414,289,"AGCTGCTAACGTTACACCAA","CTTAAGACAATACCATCACT","561307.5.peg.2126","1254"
"14978",732,414,318,"TCTCTTACAGCCCCGTAAAT","CTTAAGACAATACCATCACT","561307.5.peg.2126","1254"
"14979",10,414,404,"AACTATGTCGAATTTGAGAG","CTTAAGACAATACCATCACT","561307.5.peg.2126","1254"
"14980",694,414,280,"CGTTACACCAATGGCGCCAC","CTTAAGACAATACCATCACT","561307.5.peg.2126","1254"
"14981",12,414,402,"AGAACTATGTCGAATTTGAG","CTTAAGACAATACCATCACT","561307.5.peg.2126","1254"
"14982",761,414,347,"CATGATTTAGCTTCGACCAT","CTTAAGACAATACCATCACT","561307.5.peg.2126","1254"
"14983",10,694,684,"AACTATGTCGAATTTGAGAG","CGTTACACCAATGGCGCCAC","561307.5.peg.2126","1254"
"14984",349,694,345,"GACCCCTTGTGTCATATCAA","CGTTACACCAATGGCGCCAC","561307.5.peg.2126","1254"
"14985",12,694,682,"AGAACTATGTCGAATTTGAG","CGTTACACCAATGGCGCCAC","561307.5.peg.2126","1254"
"14986",414,694,280,"CTTAAGACAATACCATCACT","CGTTACACCAATGGCGCCAC","561307.5.peg.2126","1254"
"14987",10,703,693,"AACTATGTCGAATTTGAGAG","AGCTGCTAACGTTACACCAA","561307.5.peg.2126","1254"
"14988",414,703,289,"CTTAAGACAATACCATCACT","AGCTGCTAACGTTACACCAA","561307.5.peg.2126","1254"
"14989",12,703,691,"AGAACTATGTCGAATTTGAG","AGCTGCTAACGTTACACCAA","561307.5.peg.2126","1254"
"14990",349,703,354,"GACCCCTTGTGTCATATCAA","AGCTGCTAACGTTACACCAA","561307.5.peg.2126","1254"
"14991",349,732,383,"GACCCCTTGTGTCATATCAA","TCTCTTACAGCCCCGTAAAT","561307.5.peg.2126","1254"
"14992",12,732,720,"AGAACTATGTCGAATTTGAG","TCTCTTACAGCCCCGTAAAT","561307.5.peg.2126","1254"
"14993",10,732,722,"AACTATGTCGAATTTGAGAG","TCTCTTACAGCCCCGTAAAT","561307.5.peg.2126","1254"
"14994",414,732,318,"CTTAAGACAATACCATCACT","TCTCTTACAGCCCCGTAAAT","561307.5.peg.2126","1254"
"14995",12,761,749,"AGAACTATGTCGAATTTGAG","CATGATTTAGCTTCGACCAT","561307.5.peg.2126","1254"
"14996",414,761,347,"CTTAAGACAATACCATCACT","CATGATTTAGCTTCGACCAT","561307.5.peg.2126","1254"
"14997",10,761,751,"AACTATGTCGAATTTGAGAG","CATGATTTAGCTTCGACCAT","561307.5.peg.2126","1254"
"14998",349,761,412,"GACCCCTTGTGTCATATCAA","CATGATTTAGCTTCGACCAT","561307.5.peg.2126","1254"
"14999",175,8,167,"TTTAACACTACCTAGTCCAT","AAACGTGTGGGAATTACAGG","561307.5.peg.2129","1257"
"15000",559,8,551,"ATCTCCTGGTTCGTCAGCAC","AAACGTGTGGGAATTACAGG","561307.5.peg.2129","1257"
"15001",366,8,358,"TCTTTCAACCACTGTTTAGA","AAACGTGTGGGAATTACAGG","561307.5.peg.2129","1257"
"15002",347,8,339,"ACGGAACCGTTAAGGCAACT","AAACGTGTGGGAATTACAGG","561307.5.peg.2129","1257"
"15003",8,175,167,"AAACGTGTGGGAATTACAGG","TTTAACACTACCTAGTCCAT","561307.5.peg.2129","1257"
"15004",347,175,172,"ACGGAACCGTTAAGGCAACT","TTTAACACTACCTAGTCCAT","561307.5.peg.2129","1257"
"15005",366,175,191,"TCTTTCAACCACTGTTTAGA","TTTAACACTACCTAGTCCAT","561307.5.peg.2129","1257"
"15006",559,175,384,"ATCTCCTGGTTCGTCAGCAC","TTTAACACTACCTAGTCCAT","561307.5.peg.2129","1257"
"15007",8,347,339,"AAACGTGTGGGAATTACAGG","ACGGAACCGTTAAGGCAACT","561307.5.peg.2129","1257"
"15008",559,347,212,"ATCTCCTGGTTCGTCAGCAC","ACGGAACCGTTAAGGCAACT","561307.5.peg.2129","1257"
"15009",175,347,172,"TTTAACACTACCTAGTCCAT","ACGGAACCGTTAAGGCAACT","561307.5.peg.2129","1257"
"15010",175,366,191,"TTTAACACTACCTAGTCCAT","TCTTTCAACCACTGTTTAGA","561307.5.peg.2129","1257"
"15011",8,366,358,"AAACGTGTGGGAATTACAGG","TCTTTCAACCACTGTTTAGA","561307.5.peg.2129","1257"
"15012",559,366,193,"ATCTCCTGGTTCGTCAGCAC","TCTTTCAACCACTGTTTAGA","561307.5.peg.2129","1257"
"15013",8,559,551,"AAACGTGTGGGAATTACAGG","ATCTCCTGGTTCGTCAGCAC","561307.5.peg.2129","1257"
"15014",347,559,212,"ACGGAACCGTTAAGGCAACT","ATCTCCTGGTTCGTCAGCAC","561307.5.peg.2129","1257"
"15015",175,559,384,"TTTAACACTACCTAGTCCAT","ATCTCCTGGTTCGTCAGCAC","561307.5.peg.2129","1257"
"15016",366,559,193,"TCTTTCAACCACTGTTTAGA","ATCTCCTGGTTCGTCAGCAC","561307.5.peg.2129","1257"
"15017",178,10,168,"AGCTTCACTAACTGCAATCT","GCATGTTAATGAAGGAACGG","561307.5.peg.2135","1264"
"15018",178,13,165,"AGCTTCACTAACTGCAATCT","AATGCATGTTAATGAAGGAA","561307.5.peg.2135","1264"
"15019",10,178,168,"GCATGTTAATGAAGGAACGG","AGCTTCACTAACTGCAATCT","561307.5.peg.2135","1264"
"15020",13,178,165,"AATGCATGTTAATGAAGGAA","AGCTTCACTAACTGCAATCT","561307.5.peg.2135","1264"
"15021",283,87,196,"GGCTTCAAACTTCCGTTCAA","ATCCATTGGTTAATTTGCTC","561307.5.peg.2136","1265"
"15022",315,87,228,"TTGATTTCACCGATTACAGT","ATCCATTGGTTAATTTGCTC","561307.5.peg.2136","1265"
"15023",375,87,288,"CCAATTTCTTTAATACGTCT","ATCCATTGGTTAATTTGCTC","561307.5.peg.2136","1265"
"15024",283,101,182,"GGCTTCAAACTTCCGTTCAA","CTTGGTGTTCTTTAATCCAT","561307.5.peg.2136","1265"
"15025",315,101,214,"TTGATTTCACCGATTACAGT","CTTGGTGTTCTTTAATCCAT","561307.5.peg.2136","1265"
"15026",375,101,274,"CCAATTTCTTTAATACGTCT","CTTGGTGTTCTTTAATCCAT","561307.5.peg.2136","1265"
"15027",87,283,196,"ATCCATTGGTTAATTTGCTC","GGCTTCAAACTTCCGTTCAA","561307.5.peg.2136","1265"
"15028",101,283,182,"CTTGGTGTTCTTTAATCCAT","GGCTTCAAACTTCCGTTCAA","561307.5.peg.2136","1265"
"15029",87,315,228,"ATCCATTGGTTAATTTGCTC","TTGATTTCACCGATTACAGT","561307.5.peg.2136","1265"
"15030",101,315,214,"CTTGGTGTTCTTTAATCCAT","TTGATTTCACCGATTACAGT","561307.5.peg.2136","1265"
"15031",87,375,288,"ATCCATTGGTTAATTTGCTC","CCAATTTCTTTAATACGTCT","561307.5.peg.2136","1265"
"15032",101,375,274,"CTTGGTGTTCTTTAATCCAT","CCAATTTCTTTAATACGTCT","561307.5.peg.2136","1265"
"15033",878,150,728,"GGATTTCACGCTCTATCGAA","TTTCGATACCTCGCAATAAA","561307.5.peg.2137","1266"
"15034",978,150,828,"TTTGTTTACCTTTCATTGG","TTTCGATACCTCGCAATAAA","561307.5.peg.2137","1266"
"15035",684,150,534,"GATTAGCAATGCGTTTAAT","TTTCGATACCTCGCAATAAA","561307.5.peg.2137","1266"
"15036",150,684,534,"TTTCGATACCTCGCAATAAA","GATTAGCAATGCGTTTAAT","561307.5.peg.2137","1266"
"15037",878,684,194,"GGATTTCACGCTCTATCGAA","GATTAGCAATGCGTTTAAT","561307.5.peg.2137","1266"
"15038",978,684,294,"TTTGTTTACCTTTCATTGG","GATTAGCAATGCGTTTAAT","561307.5.peg.2137","1266"
"15039",150,878,728,"TTTCGATACCTCGCAATAAA","GGATTTCACGCTCTATCGAA","561307.5.peg.2137","1266"
"15040",978,878,100,"TTTGTTTACCTTTCATTGG","GGATTTCACGCTCTATCGAA","561307.5.peg.2137","1266"
"15041",684,878,194,"GATTAGCAATGCGTTTAAT","GGATTTCACGCTCTATCGAA","561307.5.peg.2137","1266"
"15042",150,978,828,"TTTCGATACCTCGCAATAAA","TTTGTTTACCTTTCATTGG","561307.5.peg.2137","1266"
"15043",684,978,294,"GATTAGCAATGCGTTTAAT","TTTGTTTACCTTTCATTGG","561307.5.peg.2137","1266"
"15044",878,978,100,"GGATTTCACGCTCTATCGAA","TTTGTTTACCTTTCATTGG","561307.5.peg.2137","1266"
"15045",378,198,180,"AAGTGATATTCCTCATCTGC","CCAGCAGCTCTAATATCAGA","561307.5.peg.2140","1270"
"15046",423,198,225,"TTACGACATCCACATACAAA","CCAGCAGCTCTAATATCAGA","561307.5.peg.2140","1270"
"15047",423,282,141,"TTACGACATCCACATACAAA","ATACGTGCTTTAGCCATGAC","561307.5.peg.2140","1270"
"15048",198,378,180,"CCAGCAGCTCTAATATCAGA","AAGTGATATTCCTCATCTGC","561307.5.peg.2140","1270"
"15049",198,423,225,"CCAGCAGCTCTAATATCAGA","TTACGACATCCACATACAAA","561307.5.peg.2140","1270"
"15050",282,423,141,"ATACGTGCTTTAGCCATGAC","TTACGACATCCACATACAAA","561307.5.peg.2140","1270"
"15051",180,7,173,"AACGTTGTAGACTCGCCACC","AACGTATGCAAGAGCGTGGT","561307.5.peg.2141","1271"
"15052",258,7,251,"CCTGCGCATGTACCAAACAT","AACGTATGCAAGAGCGTGGT","561307.5.peg.2141","1271"
"15053",180,11,169,"AACGTTGTAGACTCGCCACC","GAAGAACGTATGCAAGAGCG","561307.5.peg.2141","1271"
"15054",258,11,247,"CCTGCGCATGTACCAAACAT","GAAGAACGTATGCAAGAGCG","561307.5.peg.2141","1271"
"15055",7,180,173,"AACGTATGCAAGAGCGTGGT","AACGTTGTAGACTCGCCACC","561307.5.peg.2141","1271"
"15056",11,180,169,"GAAGAACGTATGCAAGAGCG","AACGTTGTAGACTCGCCACC","561307.5.peg.2141","1271"
"15057",7,258,251,"AACGTATGCAAGAGCGTGGT","CCTGCGCATGTACCAAACAT","561307.5.peg.2141","1271"
"15058",11,258,247,"GAAGAACGTATGCAAGAGCG","CCTGCGCATGTACCAAACAT","561307.5.peg.2141","1271"
"15059",528,306,222,"AAACGTTGCTTAGGTATGTA","AAGAAGAATGGTGGTTGCTT","561307.5.peg.2142","1272"
"15060",537,306,231,"ATGTGTATAAACGTTGCTT","AAGAAGAATGGTGGTTGCTT","561307.5.peg.2142","1272"
"15061",528,315,213,"AAACGTTGCTTAGGTATGTA","AATACACTGAAGAAGAATGG","561307.5.peg.2142","1272"
"15062",537,315,222,"ATGTGTATAAACGTTGCTT","AATACACTGAAGAAGAATGG","561307.5.peg.2142","1272"
"15063",306,528,222,"AAGAAGAATGGTGGTTGCTT","AAACGTTGCTTAGGTATGTA","561307.5.peg.2142","1272"
"15064",315,528,213,"AATACACTGAAGAAGAATGG","AAACGTTGCTTAGGTATGTA","561307.5.peg.2142","1272"
"15065",306,537,231,"AAGAAGAATGGTGGTTGCTT","ATGTGTATAAACGTTGCTT","561307.5.peg.2142","1272"
"15066",315,537,222,"AATACACTGAAGAAGAATGG","ATGTGTATAAACGTTGCTT","561307.5.peg.2142","1272"
"15067",522,324,198,"ATACCAGTACCTATATTGGT","TTCACTAATACTGCGGCTGC","561307.5.peg.2145","1275"
"15068",526,324,202,"TCTCATACCAGTACCTATAT","TTCACTAATACTGCGGCTGC","561307.5.peg.2145","1275"
"15069",522,331,191,"ATACCAGTACCTATATTGGT","ATCGTCATTCACTAATACTG","561307.5.peg.2145","1275"
"15070",526,331,195,"TCTCATACCAGTACCTATAT","ATCGTCATTCACTAATACTG","561307.5.peg.2145","1275"
"15071",324,522,198,"TTCACTAATACTGCGGCTGC","ATACCAGTACCTATATTGGT","561307.5.peg.2145","1275"
"15072",331,522,191,"ATCGTCATTCACTAATACTG","ATACCAGTACCTATATTGGT","561307.5.peg.2145","1275"
"15073",324,526,202,"TTCACTAATACTGCGGCTGC","TCTCATACCAGTACCTATAT","561307.5.peg.2145","1275"
"15074",331,526,195,"ATCGTCATTCACTAATACTG","TCTCATACCAGTACCTATAT","561307.5.peg.2145","1275"
"15075",531,10,521,"CGAGCTAAACTATCTAAAGT","AGAGAACATATAAAGTAGG","561307.5.peg.2146","1276"
"15076",571,10,561,"AGGATCTAATGTACCGTCTT","AGAGAACATATAAAGTAGG","561307.5.peg.2146","1276"
"15077",1056,10,1046,"GAAGGTTCATCAACTTGTAC","AGAGAACATATAAAGTAGG","561307.5.peg.2146","1276"
"15078",591,10,581,"TCTTTATCACGTCCTATAAC","AGAGAACATATAAAGTAGG","561307.5.peg.2146","1276"
"15079",1074,10,1064,"GCAACTGTATCTACTACTGA","AGAGAACATATAAAGTAGG","561307.5.peg.2146","1276"
"15080",1052,10,1042,"GTTCATCAACTTGTACAGGT","AGAGAACATATAAAGTAGG","561307.5.peg.2146","1276"
"15081",854,10,844,"GGATGACATTACCTGCTTGT","AGAGAACATATAAAGTAGG","561307.5.peg.2146","1276"
"15082",660,10,650,"CCTGGCTCTCCAATAAGCAC","AGAGAACATATAAAGTAGG","561307.5.peg.2146","1276"
"15083",954,10,944,"AATTCACCACGTGCTAATGC","AGAGAACATATAAAGTAGG","561307.5.peg.2146","1276"
"15084",1056,531,525,"GAAGGTTCATCAACTTGTAC","CGAGCTAAACTATCTAAAGT","561307.5.peg.2146","1276"
"15085",10,531,521,"AGAGAACATATAAAGTAGG","CGAGCTAAACTATCTAAAGT","561307.5.peg.2146","1276"
"15086",660,531,129,"CCTGGCTCTCCAATAAGCAC","CGAGCTAAACTATCTAAAGT","561307.5.peg.2146","1276"
"15087",1074,531,543,"GCAACTGTATCTACTACTGA","CGAGCTAAACTATCTAAAGT","561307.5.peg.2146","1276"
"15088",854,531,323,"GGATGACATTACCTGCTTGT","CGAGCTAAACTATCTAAAGT","561307.5.peg.2146","1276"
"15089",954,531,423,"AATTCACCACGTGCTAATGC","CGAGCTAAACTATCTAAAGT","561307.5.peg.2146","1276"
"15090",1052,531,521,"GTTCATCAACTTGTACAGGT","CGAGCTAAACTATCTAAAGT","561307.5.peg.2146","1276"
"15091",954,571,383,"AATTCACCACGTGCTAATGC","AGGATCTAATGTACCGTCTT","561307.5.peg.2146","1276"
"15092",1074,571,503,"GCAACTGTATCTACTACTGA","AGGATCTAATGTACCGTCTT","561307.5.peg.2146","1276"
"15093",854,571,283,"GGATGACATTACCTGCTTGT","AGGATCTAATGTACCGTCTT","561307.5.peg.2146","1276"
"15094",1052,571,481,"GTTCATCAACTTGTACAGGT","AGGATCTAATGTACCGTCTT","561307.5.peg.2146","1276"
"15095",1056,571,485,"GAAGGTTCATCAACTTGTAC","AGGATCTAATGTACCGTCTT","561307.5.peg.2146","1276"
"15096",10,571,561,"AGAGAACATATAAAGTAGG","AGGATCTAATGTACCGTCTT","561307.5.peg.2146","1276"
"15097",10,591,581,"AGAGAACATATAAAGTAGG","TCTTTATCACGTCCTATAAC","561307.5.peg.2146","1276"
"15098",1052,591,461,"GTTCATCAACTTGTACAGGT","TCTTTATCACGTCCTATAAC","561307.5.peg.2146","1276"
"15099",854,591,263,"GGATGACATTACCTGCTTGT","TCTTTATCACGTCCTATAAC","561307.5.peg.2146","1276"
"15100",954,591,363,"AATTCACCACGTGCTAATGC","TCTTTATCACGTCCTATAAC","561307.5.peg.2146","1276"
"15101",1056,591,465,"GAAGGTTCATCAACTTGTAC","TCTTTATCACGTCCTATAAC","561307.5.peg.2146","1276"
"15102",1074,591,483,"GCAACTGTATCTACTACTGA","TCTTTATCACGTCCTATAAC","561307.5.peg.2146","1276"
"15103",1056,660,396,"GAAGGTTCATCAACTTGTAC","CCTGGCTCTCCAATAAGCAC","561307.5.peg.2146","1276"
"15104",10,660,650,"AGAGAACATATAAAGTAGG","CCTGGCTCTCCAATAAGCAC","561307.5.peg.2146","1276"
"15105",854,660,194,"GGATGACATTACCTGCTTGT","CCTGGCTCTCCAATAAGCAC","561307.5.peg.2146","1276"
"15106",954,660,294,"AATTCACCACGTGCTAATGC","CCTGGCTCTCCAATAAGCAC","561307.5.peg.2146","1276"
"15107",1074,660,414,"GCAACTGTATCTACTACTGA","CCTGGCTCTCCAATAAGCAC","561307.5.peg.2146","1276"
"15108",531,660,129,"CGAGCTAAACTATCTAAAGT","CCTGGCTCTCCAATAAGCAC","561307.5.peg.2146","1276"
"15109",1052,660,392,"GTTCATCAACTTGTACAGGT","CCTGGCTCTCCAATAAGCAC","561307.5.peg.2146","1276"
"15110",10,854,844,"AGAGAACATATAAAGTAGG","GGATGACATTACCTGCTTGT","561307.5.peg.2146","1276"
"15111",1074,854,220,"GCAACTGTATCTACTACTGA","GGATGACATTACCTGCTTGT","561307.5.peg.2146","1276"
"15112",1056,854,202,"GAAGGTTCATCAACTTGTAC","GGATGACATTACCTGCTTGT","561307.5.peg.2146","1276"
"15113",571,854,283,"AGGATCTAATGTACCGTCTT","GGATGACATTACCTGCTTGT","561307.5.peg.2146","1276"
"15114",1052,854,198,"GTTCATCAACTTGTACAGGT","GGATGACATTACCTGCTTGT","561307.5.peg.2146","1276"
"15115",591,854,263,"TCTTTATCACGTCCTATAAC","GGATGACATTACCTGCTTGT","561307.5.peg.2146","1276"
"15116",660,854,194,"CCTGGCTCTCCAATAAGCAC","GGATGACATTACCTGCTTGT","561307.5.peg.2146","1276"
"15117",954,854,100,"AATTCACCACGTGCTAATGC","GGATGACATTACCTGCTTGT","561307.5.peg.2146","1276"
"15118",531,854,323,"CGAGCTAAACTATCTAAAGT","GGATGACATTACCTGCTTGT","561307.5.peg.2146","1276"
"15119",10,954,944,"AGAGAACATATAAAGTAGG","AATTCACCACGTGCTAATGC","561307.5.peg.2146","1276"
"15120",660,954,294,"CCTGGCTCTCCAATAAGCAC","AATTCACCACGTGCTAATGC","561307.5.peg.2146","1276"
"15121",854,954,100,"GGATGACATTACCTGCTTGT","AATTCACCACGTGCTAATGC","561307.5.peg.2146","1276"
"15122",1056,954,102,"GAAGGTTCATCAACTTGTAC","AATTCACCACGTGCTAATGC","561307.5.peg.2146","1276"
"15123",1074,954,120,"GCAACTGTATCTACTACTGA","AATTCACCACGTGCTAATGC","561307.5.peg.2146","1276"
"15124",571,954,383,"AGGATCTAATGTACCGTCTT","AATTCACCACGTGCTAATGC","561307.5.peg.2146","1276"
"15125",531,954,423,"CGAGCTAAACTATCTAAAGT","AATTCACCACGTGCTAATGC","561307.5.peg.2146","1276"
"15126",591,954,363,"TCTTTATCACGTCCTATAAC","AATTCACCACGTGCTAATGC","561307.5.peg.2146","1276"
"15127",660,1052,392,"CCTGGCTCTCCAATAAGCAC","GTTCATCAACTTGTACAGGT","561307.5.peg.2146","1276"
"15128",854,1052,198,"GGATGACATTACCTGCTTGT","GTTCATCAACTTGTACAGGT","561307.5.peg.2146","1276"
"15129",531,1052,521,"CGAGCTAAACTATCTAAAGT","GTTCATCAACTTGTACAGGT","561307.5.peg.2146","1276"
"15130",10,1052,1042,"AGAGAACATATAAAGTAGG","GTTCATCAACTTGTACAGGT","561307.5.peg.2146","1276"
"15131",571,1052,481,"AGGATCTAATGTACCGTCTT","GTTCATCAACTTGTACAGGT","561307.5.peg.2146","1276"
"15132",591,1052,461,"TCTTTATCACGTCCTATAAC","GTTCATCAACTTGTACAGGT","561307.5.peg.2146","1276"
"15133",591,1056,465,"TCTTTATCACGTCCTATAAC","GAAGGTTCATCAACTTGTAC","561307.5.peg.2146","1276"
"15134",854,1056,202,"GGATGACATTACCTGCTTGT","GAAGGTTCATCAACTTGTAC","561307.5.peg.2146","1276"
"15135",10,1056,1046,"AGAGAACATATAAAGTAGG","GAAGGTTCATCAACTTGTAC","561307.5.peg.2146","1276"
"15136",954,1056,102,"AATTCACCACGTGCTAATGC","GAAGGTTCATCAACTTGTAC","561307.5.peg.2146","1276"
"15137",531,1056,525,"CGAGCTAAACTATCTAAAGT","GAAGGTTCATCAACTTGTAC","561307.5.peg.2146","1276"
"15138",660,1056,396,"CCTGGCTCTCCAATAAGCAC","GAAGGTTCATCAACTTGTAC","561307.5.peg.2146","1276"
"15139",571,1056,485,"AGGATCTAATGTACCGTCTT","GAAGGTTCATCAACTTGTAC","561307.5.peg.2146","1276"
"15140",571,1074,503,"AGGATCTAATGTACCGTCTT","GCAACTGTATCTACTACTGA","561307.5.peg.2146","1276"
"15141",854,1074,220,"GGATGACATTACCTGCTTGT","GCAACTGTATCTACTACTGA","561307.5.peg.2146","1276"
"15142",531,1074,543,"CGAGCTAAACTATCTAAAGT","GCAACTGTATCTACTACTGA","561307.5.peg.2146","1276"
"15143",591,1074,483,"TCTTTATCACGTCCTATAAC","GCAACTGTATCTACTACTGA","561307.5.peg.2146","1276"
"15144",954,1074,120,"AATTCACCACGTGCTAATGC","GCAACTGTATCTACTACTGA","561307.5.peg.2146","1276"
"15145",10,1074,1064,"AGAGAACATATAAAGTAGG","GCAACTGTATCTACTACTGA","561307.5.peg.2146","1276"
"15146",660,1074,414,"CCTGGCTCTCCAATAAGCAC","GCAACTGTATCTACTACTGA","561307.5.peg.2146","1276"
"15147",252,8,244,"GCTGAATCTGTTAACACTCT","ATTTGTTCAAAGGAAAGTGG","561307.5.peg.2147","1277"
"15148",284,8,276,"CAATACCTCCACCTAATACA","ATTTGTTCAAAGGAAAGTGG","561307.5.peg.2147","1277"
"15149",196,8,188,"TACTTTACCTGCTAATTCCT","ATTTGTTCAAAGGAAAGTGG","561307.5.peg.2147","1277"
"15150",339,8,331,"AACGTTGACTTACCAATACC","ATTTGTTCAAAGGAAAGTGG","561307.5.peg.2147","1277"
"15151",582,8,574,"CCTGGCGCAGAGCTGATTTC","ATTTGTTCAAAGGAAAGTGG","561307.5.peg.2147","1277"
"15152",123,8,115,"TGATTCCAAGCGCCACAATT","ATTTGTTCAAAGGAAAGTGG","561307.5.peg.2147","1277"
"15153",123,11,112,"TGATTCCAAGCGCCACAATT","AGATTTGTTCAAAGGAAAG","561307.5.peg.2147","1277"
"15154",339,11,328,"AACGTTGACTTACCAATACC","AGATTTGTTCAAAGGAAAG","561307.5.peg.2147","1277"
"15155",196,11,185,"TACTTTACCTGCTAATTCCT","AGATTTGTTCAAAGGAAAG","561307.5.peg.2147","1277"
"15156",582,11,571,"CCTGGCGCAGAGCTGATTTC","AGATTTGTTCAAAGGAAAG","561307.5.peg.2147","1277"
"15157",284,11,273,"CAATACCTCCACCTAATACA","AGATTTGTTCAAAGGAAAG","561307.5.peg.2147","1277"
"15158",252,11,241,"GCTGAATCTGTTAACACTCT","AGATTTGTTCAAAGGAAAG","561307.5.peg.2147","1277"
"15159",339,102,237,"AACGTTGACTTACCAATACC","GGACATTTCCCCATCCATTT","561307.5.peg.2147","1277"
"15160",582,102,480,"CCTGGCGCAGAGCTGATTTC","GGACATTTCCCCATCCATTT","561307.5.peg.2147","1277"
"15161",284,102,182,"CAATACCTCCACCTAATACA","GGACATTTCCCCATCCATTT","561307.5.peg.2147","1277"
"15162",252,102,150,"GCTGAATCTGTTAACACTCT","GGACATTTCCCCATCCATTT","561307.5.peg.2147","1277"
"15163",8,123,115,"ATTTGTTCAAAGGAAAGTGG","TGATTCCAAGCGCCACAATT","561307.5.peg.2147","1277"
"15164",252,123,129,"GCTGAATCTGTTAACACTCT","TGATTCCAAGCGCCACAATT","561307.5.peg.2147","1277"
"15165",582,123,459,"CCTGGCGCAGAGCTGATTTC","TGATTCCAAGCGCCACAATT","561307.5.peg.2147","1277"
"15166",11,123,112,"AGATTTGTTCAAAGGAAAG","TGATTCCAAGCGCCACAATT","561307.5.peg.2147","1277"
"15167",284,123,161,"CAATACCTCCACCTAATACA","TGATTCCAAGCGCCACAATT","561307.5.peg.2147","1277"
"15168",339,123,216,"AACGTTGACTTACCAATACC","TGATTCCAAGCGCCACAATT","561307.5.peg.2147","1277"
"15169",582,196,386,"CCTGGCGCAGAGCTGATTTC","TACTTTACCTGCTAATTCCT","561307.5.peg.2147","1277"
"15170",11,196,185,"AGATTTGTTCAAAGGAAAG","TACTTTACCTGCTAATTCCT","561307.5.peg.2147","1277"
"15171",8,196,188,"ATTTGTTCAAAGGAAAGTGG","TACTTTACCTGCTAATTCCT","561307.5.peg.2147","1277"
"15172",339,196,143,"AACGTTGACTTACCAATACC","TACTTTACCTGCTAATTCCT","561307.5.peg.2147","1277"
"15173",102,252,150,"GGACATTTCCCCATCCATTT","GCTGAATCTGTTAACACTCT","561307.5.peg.2147","1277"
"15174",582,252,330,"CCTGGCGCAGAGCTGATTTC","GCTGAATCTGTTAACACTCT","561307.5.peg.2147","1277"
"15175",11,252,241,"AGATTTGTTCAAAGGAAAG","GCTGAATCTGTTAACACTCT","561307.5.peg.2147","1277"
"15176",123,252,129,"TGATTCCAAGCGCCACAATT","GCTGAATCTGTTAACACTCT","561307.5.peg.2147","1277"
"15177",8,252,244,"ATTTGTTCAAAGGAAAGTGG","GCTGAATCTGTTAACACTCT","561307.5.peg.2147","1277"
"15178",8,284,276,"ATTTGTTCAAAGGAAAGTGG","CAATACCTCCACCTAATACA","561307.5.peg.2147","1277"
"15179",102,284,182,"GGACATTTCCCCATCCATTT","CAATACCTCCACCTAATACA","561307.5.peg.2147","1277"
"15180",582,284,298,"CCTGGCGCAGAGCTGATTTC","CAATACCTCCACCTAATACA","561307.5.peg.2147","1277"
"15181",11,284,273,"AGATTTGTTCAAAGGAAAG","CAATACCTCCACCTAATACA","561307.5.peg.2147","1277"
"15182",123,284,161,"TGATTCCAAGCGCCACAATT","CAATACCTCCACCTAATACA","561307.5.peg.2147","1277"
"15183",8,339,331,"ATTTGTTCAAAGGAAAGTGG","AACGTTGACTTACCAATACC","561307.5.peg.2147","1277"
"15184",196,339,143,"TACTTTACCTGCTAATTCCT","AACGTTGACTTACCAATACC","561307.5.peg.2147","1277"
"15185",11,339,328,"AGATTTGTTCAAAGGAAAG","AACGTTGACTTACCAATACC","561307.5.peg.2147","1277"
"15186",582,339,243,"CCTGGCGCAGAGCTGATTTC","AACGTTGACTTACCAATACC","561307.5.peg.2147","1277"
"15187",123,339,216,"TGATTCCAAGCGCCACAATT","AACGTTGACTTACCAATACC","561307.5.peg.2147","1277"
"15188",102,339,237,"GGACATTTCCCCATCCATTT","AACGTTGACTTACCAATACC","561307.5.peg.2147","1277"
"15189",8,582,574,"ATTTGTTCAAAGGAAAGTGG","CCTGGCGCAGAGCTGATTTC","561307.5.peg.2147","1277"
"15190",102,582,480,"GGACATTTCCCCATCCATTT","CCTGGCGCAGAGCTGATTTC","561307.5.peg.2147","1277"
"15191",11,582,571,"AGATTTGTTCAAAGGAAAG","CCTGGCGCAGAGCTGATTTC","561307.5.peg.2147","1277"
"15192",123,582,459,"TGATTCCAAGCGCCACAATT","CCTGGCGCAGAGCTGATTTC","561307.5.peg.2147","1277"
"15193",252,582,330,"GCTGAATCTGTTAACACTCT","CCTGGCGCAGAGCTGATTTC","561307.5.peg.2147","1277"
"15194",339,582,243,"AACGTTGACTTACCAATACC","CCTGGCGCAGAGCTGATTTC","561307.5.peg.2147","1277"
"15195",284,582,298,"CAATACCTCCACCTAATACA","CCTGGCGCAGAGCTGATTTC","561307.5.peg.2147","1277"
"15196",196,582,386,"TACTTTACCTGCTAATTCCT","CCTGGCGCAGAGCTGATTTC","561307.5.peg.2147","1277"
"15197",294,81,213,"TGACGTTCAGATTGACGATA","TGAAGATACCCAGTTGGACT","561307.5.peg.2149","1279"
"15198",435,81,354,"GCATGTTGACCACCATAGCG","TGAAGATACCCAGTTGGACT","561307.5.peg.2149","1279"
"15199",507,81,426,"GGTACTCGGAAACGAATTGA","TGAAGATACCCAGTTGGACT","561307.5.peg.2149","1279"
"15200",294,87,207,"TGACGTTCAGATTGACGATA","CCAATATGAAGATACCCAGT","561307.5.peg.2149","1279"
"15201",507,87,420,"GGTACTCGGAAACGAATTGA","CCAATATGAAGATACCCAGT","561307.5.peg.2149","1279"
"15202",435,87,348,"GCATGTTGACCACCATAGCG","CCAATATGAAGATACCCAGT","561307.5.peg.2149","1279"
"15203",81,294,213,"TGAAGATACCCAGTTGGACT","TGACGTTCAGATTGACGATA","561307.5.peg.2149","1279"
"15204",87,294,207,"CCAATATGAAGATACCCAGT","TGACGTTCAGATTGACGATA","561307.5.peg.2149","1279"
"15205",435,294,141,"GCATGTTGACCACCATAGCG","TGACGTTCAGATTGACGATA","561307.5.peg.2149","1279"
"15206",507,294,213,"GGTACTCGGAAACGAATTGA","TGACGTTCAGATTGACGATA","561307.5.peg.2149","1279"
"15207",81,435,354,"TGAAGATACCCAGTTGGACT","GCATGTTGACCACCATAGCG","561307.5.peg.2149","1279"
"15208",87,435,348,"CCAATATGAAGATACCCAGT","GCATGTTGACCACCATAGCG","561307.5.peg.2149","1279"
"15209",294,435,141,"TGACGTTCAGATTGACGATA","GCATGTTGACCACCATAGCG","561307.5.peg.2149","1279"
"15210",81,507,426,"TGAAGATACCCAGTTGGACT","GGTACTCGGAAACGAATTGA","561307.5.peg.2149","1279"
"15211",294,507,213,"TGACGTTCAGATTGACGATA","GGTACTCGGAAACGAATTGA","561307.5.peg.2149","1279"
"15212",87,507,420,"CCAATATGAAGATACCCAGT","GGTACTCGGAAACGAATTGA","561307.5.peg.2149","1279"
"15213",669,10,659,"GCAGTTTCTCCATTAAAGGG","TTCATACTCGCGGCTATTGA","561307.5.peg.215","1280"
"15214",978,10,968,"ACTTGCGTCGTTTCACGTTT","TTCATACTCGCGGCTATTGA","561307.5.peg.215","1280"
"15215",360,10,350,"ATCGCTGTGTCAACACTTAA","TTCATACTCGCGGCTATTGA","561307.5.peg.215","1280"
"15216",118,10,108,"CGTATCTTCAGCAAGATAAA","TTCATACTCGCGGCTATTGA","561307.5.peg.215","1280"
"15217",1017,10,1007,"TGGAATTGCTGATGATGAGC","TTCATACTCGCGGCTATTGA","561307.5.peg.215","1280"
"15218",978,20,958,"ACTTGCGTCGTTTCACGTTT","TAACGTTACTTTCATACTCG","561307.5.peg.215","1280"
"15219",669,20,649,"GCAGTTTCTCCATTAAAGGG","TAACGTTACTTTCATACTCG","561307.5.peg.215","1280"
"15220",1017,20,997,"TGGAATTGCTGATGATGAGC","TAACGTTACTTTCATACTCG","561307.5.peg.215","1280"
"15221",360,20,340,"ATCGCTGTGTCAACACTTAA","TAACGTTACTTTCATACTCG","561307.5.peg.215","1280"
"15222",10,118,108,"TTCATACTCGCGGCTATTGA","CGTATCTTCAGCAAGATAAA","561307.5.peg.215","1280"
"15223",360,118,242,"ATCGCTGTGTCAACACTTAA","CGTATCTTCAGCAAGATAAA","561307.5.peg.215","1280"
"15224",1017,118,899,"TGGAATTGCTGATGATGAGC","CGTATCTTCAGCAAGATAAA","561307.5.peg.215","1280"
"15225",669,118,551,"GCAGTTTCTCCATTAAAGGG","CGTATCTTCAGCAAGATAAA","561307.5.peg.215","1280"
"15226",978,118,860,"ACTTGCGTCGTTTCACGTTT","CGTATCTTCAGCAAGATAAA","561307.5.peg.215","1280"
"15227",10,360,350,"TTCATACTCGCGGCTATTGA","ATCGCTGTGTCAACACTTAA","561307.5.peg.215","1280"
"15228",20,360,340,"TAACGTTACTTTCATACTCG","ATCGCTGTGTCAACACTTAA","561307.5.peg.215","1280"
"15229",978,360,618,"ACTTGCGTCGTTTCACGTTT","ATCGCTGTGTCAACACTTAA","561307.5.peg.215","1280"
"15230",1017,360,657,"TGGAATTGCTGATGATGAGC","ATCGCTGTGTCAACACTTAA","561307.5.peg.215","1280"
"15231",669,360,309,"GCAGTTTCTCCATTAAAGGG","ATCGCTGTGTCAACACTTAA","561307.5.peg.215","1280"
"15232",118,360,242,"CGTATCTTCAGCAAGATAAA","ATCGCTGTGTCAACACTTAA","561307.5.peg.215","1280"
"15233",360,669,309,"ATCGCTGTGTCAACACTTAA","GCAGTTTCTCCATTAAAGGG","561307.5.peg.215","1280"
"15234",10,669,659,"TTCATACTCGCGGCTATTGA","GCAGTTTCTCCATTAAAGGG","561307.5.peg.215","1280"
"15235",118,669,551,"CGTATCTTCAGCAAGATAAA","GCAGTTTCTCCATTAAAGGG","561307.5.peg.215","1280"
"15236",20,669,649,"TAACGTTACTTTCATACTCG","GCAGTTTCTCCATTAAAGGG","561307.5.peg.215","1280"
"15237",1017,669,348,"TGGAATTGCTGATGATGAGC","GCAGTTTCTCCATTAAAGGG","561307.5.peg.215","1280"
"15238",978,669,309,"ACTTGCGTCGTTTCACGTTT","GCAGTTTCTCCATTAAAGGG","561307.5.peg.215","1280"
"15239",118,978,860,"CGTATCTTCAGCAAGATAAA","ACTTGCGTCGTTTCACGTTT","561307.5.peg.215","1280"
"15240",10,978,968,"TTCATACTCGCGGCTATTGA","ACTTGCGTCGTTTCACGTTT","561307.5.peg.215","1280"
"15241",360,978,618,"ATCGCTGTGTCAACACTTAA","ACTTGCGTCGTTTCACGTTT","561307.5.peg.215","1280"
"15242",669,978,309,"GCAGTTTCTCCATTAAAGGG","ACTTGCGTCGTTTCACGTTT","561307.5.peg.215","1280"
"15243",20,978,958,"TAACGTTACTTTCATACTCG","ACTTGCGTCGTTTCACGTTT","561307.5.peg.215","1280"
"15244",10,1017,1007,"TTCATACTCGCGGCTATTGA","TGGAATTGCTGATGATGAGC","561307.5.peg.215","1280"
"15245",20,1017,997,"TAACGTTACTTTCATACTCG","TGGAATTGCTGATGATGAGC","561307.5.peg.215","1280"
"15246",118,1017,899,"CGTATCTTCAGCAAGATAAA","TGGAATTGCTGATGATGAGC","561307.5.peg.215","1280"
"15247",669,1017,348,"GCAGTTTCTCCATTAAAGGG","TGGAATTGCTGATGATGAGC","561307.5.peg.215","1280"
"15248",360,1017,657,"ATCGCTGTGTCAACACTTAA","TGGAATTGCTGATGATGAGC","561307.5.peg.215","1280"
"15249",384,99,285,"TCCATATGGTCCATTACCCT","TTTACTTTCCCTGGTTCTAT","561307.5.peg.2151","1282"
"15250",612,99,513,"CTATCCCAACTAATCTCGCC","TTTACTTTCCCTGGTTCTAT","561307.5.peg.2151","1282"
"15251",654,99,555,"GAACATTCTATATGCCATCC","TTTACTTTCCCTGGTTCTAT","561307.5.peg.2151","1282"
"15252",635,99,536,"CTGGTCTACCTTCACCAAAT","TTTACTTTCCCTGGTTCTAT","561307.5.peg.2151","1282"
"15253",635,177,458,"CTGGTCTACCTTCACCAAAT","CTACGTCATAATTAATTGC","561307.5.peg.2151","1282"
"15254",612,177,435,"CTATCCCAACTAATCTCGCC","CTACGTCATAATTAATTGC","561307.5.peg.2151","1282"
"15255",384,177,207,"TCCATATGGTCCATTACCCT","CTACGTCATAATTAATTGC","561307.5.peg.2151","1282"
"15256",654,177,477,"GAACATTCTATATGCCATCC","CTACGTCATAATTAATTGC","561307.5.peg.2151","1282"
"15257",99,384,285,"TTTACTTTCCCTGGTTCTAT","TCCATATGGTCCATTACCCT","561307.5.peg.2151","1282"
"15258",612,384,228,"CTATCCCAACTAATCTCGCC","TCCATATGGTCCATTACCCT","561307.5.peg.2151","1282"
"15259",654,384,270,"GAACATTCTATATGCCATCC","TCCATATGGTCCATTACCCT","561307.5.peg.2151","1282"
"15260",177,384,207,"CTACGTCATAATTAATTGC","TCCATATGGTCCATTACCCT","561307.5.peg.2151","1282"
"15261",635,384,251,"CTGGTCTACCTTCACCAAAT","TCCATATGGTCCATTACCCT","561307.5.peg.2151","1282"
"15262",99,612,513,"TTTACTTTCCCTGGTTCTAT","CTATCCCAACTAATCTCGCC","561307.5.peg.2151","1282"
"15263",177,612,435,"CTACGTCATAATTAATTGC","CTATCCCAACTAATCTCGCC","561307.5.peg.2151","1282"
"15264",384,612,228,"TCCATATGGTCCATTACCCT","CTATCCCAACTAATCTCGCC","561307.5.peg.2151","1282"
"15265",99,635,536,"TTTACTTTCCCTGGTTCTAT","CTGGTCTACCTTCACCAAAT","561307.5.peg.2151","1282"
"15266",384,635,251,"TCCATATGGTCCATTACCCT","CTGGTCTACCTTCACCAAAT","561307.5.peg.2151","1282"
"15267",177,635,458,"CTACGTCATAATTAATTGC","CTGGTCTACCTTCACCAAAT","561307.5.peg.2151","1282"
"15268",384,654,270,"TCCATATGGTCCATTACCCT","GAACATTCTATATGCCATCC","561307.5.peg.2151","1282"
"15269",177,654,477,"CTACGTCATAATTAATTGC","GAACATTCTATATGCCATCC","561307.5.peg.2151","1282"
"15270",99,654,555,"TTTACTTTCCCTGGTTCTAT","GAACATTCTATATGCCATCC","561307.5.peg.2151","1282"
"15271",365,243,122,"AAATTGATCCCAAGTTATGT","AGCGCTGCAACACCCTGATG","561307.5.peg.2153","1284"
"15272",397,243,154,"ACCATCAACTCCCGTTGCAT","AGCGCTGCAACACCCTGATG","561307.5.peg.2153","1284"
"15273",397,273,124,"ACCATCAACTCCCGTTGCAT","TCGAAGTCAGCATATTCATA","561307.5.peg.2153","1284"
"15274",243,365,122,"AGCGCTGCAACACCCTGATG","AAATTGATCCCAAGTTATGT","561307.5.peg.2153","1284"
"15275",243,397,154,"AGCGCTGCAACACCCTGATG","ACCATCAACTCCCGTTGCAT","561307.5.peg.2153","1284"
"15276",273,397,124,"TCGAAGTCAGCATATTCATA","ACCATCAACTCCCGTTGCAT","561307.5.peg.2153","1284"
"15277",224,102,122,"ATTCTCTTTCAACACCCGAT","TTTGCAATGGCGCTTAGCGT","561307.5.peg.2154","1285"
"15278",102,224,122,"TTTGCAATGGCGCTTAGCGT","ATTCTCTTTCAACACCCGAT","561307.5.peg.2154","1285"
"15279",111,9,102,"TTAAATAGCTCTTCTTTCGT","ATATGTTCAAAGGATTTGG","561307.5.peg.2157","1288"
"15280",9,111,102,"ATATGTTCAAAGGATTTGG","TTAAATAGCTCTTCTTTCGT","561307.5.peg.2157","1288"
"15281",126,9,117,"ACACCTGCTTGACCTAATGC","ACCACATCACGATATCAAGG","561307.5.peg.2159","1290"
"15282",126,12,114,"ACACCTGCTTGACCTAATGC","GTGACCACATCACGATATCA","561307.5.peg.2159","1290"
"15283",126,13,113,"ACACCTGCTTGACCTAATGC","GATATCGTGATGTGGTCACA","561307.5.peg.2159","1290"
"15284",126,21,105,"ACACCTGCTTGACCTAATGC","ACCTCCTTGATATCGTGATG","561307.5.peg.2159","1290"
"15285",9,126,117,"ACCACATCACGATATCAAGG","ACACCTGCTTGACCTAATGC","561307.5.peg.2159","1290"
"15286",12,126,114,"GTGACCACATCACGATATCA","ACACCTGCTTGACCTAATGC","561307.5.peg.2159","1290"
"15287",13,126,113,"GATATCGTGATGTGGTCACA","ACACCTGCTTGACCTAATGC","561307.5.peg.2159","1290"
"15288",21,126,105,"ACCTCCTTGATATCGTGATG","ACACCTGCTTGACCTAATGC","561307.5.peg.2159","1290"
"15289",173,10,163,"TTGCAACTTCTCCTGCTTTA","AGGAACGACAAGTAGAAACG","561307.5.peg.216","1291"
"15290",173,30,143,"TTGCAACTTCTCCTGCTTTA","GTGGTCAATTAAGAGCAA","561307.5.peg.216","1291"
"15291",10,173,163,"AGGAACGACAAGTAGAAACG","TTGCAACTTCTCCTGCTTTA","561307.5.peg.216","1291"
"15292",30,173,143,"GTGGTCAATTAAGAGCAA","TTGCAACTTCTCCTGCTTTA","561307.5.peg.216","1291"
"15293",188,30,158,"TACGTGTATCAATTCCTAAA","TTTATAGTTCCTCCTTTAG","561307.5.peg.2160","1292"
"15294",218,30,188,"CAACTGCACCACGGATTTGT","TTTATAGTTCCTCCTTTAG","561307.5.peg.2160","1292"
"15295",227,30,197,"TTGGTAATACAACTGCACCA","TTTATAGTTCCTCCTTTAG","561307.5.peg.2160","1292"
"15296",246,30,216,"TGTGATTTACCAGTTCCGTT","TTTATAGTTCCTCCTTTAG","561307.5.peg.2160","1292"
"15297",218,98,120,"CAACTGCACCACGGATTTGT","CAACACTGTAGTGCTGAGTA","561307.5.peg.2160","1292"
"15298",227,98,129,"TTGGTAATACAACTGCACCA","CAACACTGTAGTGCTGAGTA","561307.5.peg.2160","1292"
"15299",246,98,148,"TGTGATTTACCAGTTCCGTT","CAACACTGTAGTGCTGAGTA","561307.5.peg.2160","1292"
"15300",30,188,158,"TTTATAGTTCCTCCTTTAG","TACGTGTATCAATTCCTAAA","561307.5.peg.2160","1292"
"15301",30,218,188,"TTTATAGTTCCTCCTTTAG","CAACTGCACCACGGATTTGT","561307.5.peg.2160","1292"
"15302",98,218,120,"CAACACTGTAGTGCTGAGTA","CAACTGCACCACGGATTTGT","561307.5.peg.2160","1292"
"15303",30,227,197,"TTTATAGTTCCTCCTTTAG","TTGGTAATACAACTGCACCA","561307.5.peg.2160","1292"
"15304",98,227,129,"CAACACTGTAGTGCTGAGTA","TTGGTAATACAACTGCACCA","561307.5.peg.2160","1292"
"15305",30,246,216,"TTTATAGTTCCTCCTTTAG","TGTGATTTACCAGTTCCGTT","561307.5.peg.2160","1292"
"15306",98,246,148,"CAACACTGTAGTGCTGAGTA","TGTGATTTACCAGTTCCGTT","561307.5.peg.2160","1292"
"15307",219,5,214,"ATTCGCTTACTTGGACCAGG","GTTACAAAGTGAAGATGAGG","561307.5.peg.2163","1295"
"15308",267,5,262,"TAGCAATCATCAAACCAAT","GTTACAAAGTGAAGATGAGG","561307.5.peg.2163","1295"
"15309",222,5,217,"GCAATTCGCTTACTTGGACC","GTTACAAAGTGAAGATGAGG","561307.5.peg.2163","1295"
"15310",244,5,239,"TCCGTAACCACAACCAACAT","GTTACAAAGTGAAGATGAGG","561307.5.peg.2163","1295"
"15311",297,5,292,"GCATTGTAATTGAATGATG","GTTACAAAGTGAAGATGAGG","561307.5.peg.2163","1295"
"15312",219,8,211,"ATTCGCTTACTTGGACCAGG","CGAGTTACAAAGTGAAGATG","561307.5.peg.2163","1295"
"15313",222,8,214,"GCAATTCGCTTACTTGGACC","CGAGTTACAAAGTGAAGATG","561307.5.peg.2163","1295"
"15314",244,8,236,"TCCGTAACCACAACCAACAT","CGAGTTACAAAGTGAAGATG","561307.5.peg.2163","1295"
"15315",267,8,259,"TAGCAATCATCAAACCAAT","CGAGTTACAAAGTGAAGATG","561307.5.peg.2163","1295"
"15316",297,8,289,"GCATTGTAATTGAATGATG","CGAGTTACAAAGTGAAGATG","561307.5.peg.2163","1295"
"15317",219,75,144,"ATTCGCTTACTTGGACCAGG","GTTCATTGCTAATTACACT","561307.5.peg.2163","1295"
"15318",244,75,169,"TCCGTAACCACAACCAACAT","GTTCATTGCTAATTACACT","561307.5.peg.2163","1295"
"15319",267,75,192,"TAGCAATCATCAAACCAAT","GTTCATTGCTAATTACACT","561307.5.peg.2163","1295"
"15320",222,75,147,"GCAATTCGCTTACTTGGACC","GTTCATTGCTAATTACACT","561307.5.peg.2163","1295"
"15321",297,75,222,"GCATTGTAATTGAATGATG","GTTCATTGCTAATTACACT","561307.5.peg.2163","1295"
"15322",5,219,214,"GTTACAAAGTGAAGATGAGG","ATTCGCTTACTTGGACCAGG","561307.5.peg.2163","1295"
"15323",8,219,211,"CGAGTTACAAAGTGAAGATG","ATTCGCTTACTTGGACCAGG","561307.5.peg.2163","1295"
"15324",75,219,144,"GTTCATTGCTAATTACACT","ATTCGCTTACTTGGACCAGG","561307.5.peg.2163","1295"
"15325",8,222,214,"CGAGTTACAAAGTGAAGATG","GCAATTCGCTTACTTGGACC","561307.5.peg.2163","1295"
"15326",75,222,147,"GTTCATTGCTAATTACACT","GCAATTCGCTTACTTGGACC","561307.5.peg.2163","1295"
"15327",5,222,217,"GTTACAAAGTGAAGATGAGG","GCAATTCGCTTACTTGGACC","561307.5.peg.2163","1295"
"15328",75,244,169,"GTTCATTGCTAATTACACT","TCCGTAACCACAACCAACAT","561307.5.peg.2163","1295"
"15329",8,244,236,"CGAGTTACAAAGTGAAGATG","TCCGTAACCACAACCAACAT","561307.5.peg.2163","1295"
"15330",5,244,239,"GTTACAAAGTGAAGATGAGG","TCCGTAACCACAACCAACAT","561307.5.peg.2163","1295"
"15331",75,267,192,"GTTCATTGCTAATTACACT","TAGCAATCATCAAACCAAT","561307.5.peg.2163","1295"
"15332",5,267,262,"GTTACAAAGTGAAGATGAGG","TAGCAATCATCAAACCAAT","561307.5.peg.2163","1295"
"15333",8,267,259,"CGAGTTACAAAGTGAAGATG","TAGCAATCATCAAACCAAT","561307.5.peg.2163","1295"
"15334",5,297,292,"GTTACAAAGTGAAGATGAGG","GCATTGTAATTGAATGATG","561307.5.peg.2163","1295"
"15335",8,297,289,"CGAGTTACAAAGTGAAGATG","GCATTGTAATTGAATGATG","561307.5.peg.2163","1295"
"15336",75,297,222,"GTTCATTGCTAATTACACT","GCATTGTAATTGAATGATG","561307.5.peg.2163","1295"
"15337",774,68,706,"TCAACAGTTGGTGGTTCACC","GTTTACGATGTCTTCCATAT","561307.5.peg.2164","1296"
"15338",621,68,553,"GCACGTAACAATACTGTTAA","GTTTACGATGTCTTCCATAT","561307.5.peg.2164","1296"
"15339",398,68,330,"TACCTGTATCAGTCATTAAT","GTTTACGATGTCTTCCATAT","561307.5.peg.2164","1296"
"15340",540,68,472,"TCTAACCATGCACCACGGTT","GTTTACGATGTCTTCCATAT","561307.5.peg.2164","1296"
"15341",1301,68,1233,"TTGATAAACCGATACGGAAT","GTTTACGATGTCTTCCATAT","561307.5.peg.2164","1296"
"15342",1518,68,1450,"CGTTCACGTGTTAAACCACC","GTTTACGATGTCTTCCATAT","561307.5.peg.2164","1296"
"15343",299,68,231,"GTGCAGCATAAGTAGCGTCA","GTTTACGATGTCTTCCATAT","561307.5.peg.2164","1296"
"15344",1151,68,1083,"TGCATTTAACTTCTGAGTCA","GTTTACGATGTCTTCCATAT","561307.5.peg.2164","1296"
"15345",1265,68,1197,"CACCTACAGAACGTAAACGA","GTTTACGATGTCTTCCATAT","561307.5.peg.2164","1296"
"15346",1605,68,1537,"AATCCAATGTTTGGTCCCTC","GTTTACGATGTCTTCCATAT","561307.5.peg.2164","1296"
"15347",1307,68,1239,"CCATTCTTGATAAACCGATA","GTTTACGATGTCTTCCATAT","561307.5.peg.2164","1296"
"15348",170,68,102,"TTCGATTAAACCTTCTCTT","GTTTACGATGTCTTCCATAT","561307.5.peg.2164","1296"
"15349",1104,68,1036,"GTACGACCTTCATCATCGTT","GTTTACGATGTCTTCCATAT","561307.5.peg.2164","1296"
"15350",1463,68,1395,"ACTCAGCTAATGGGTTTGCT","GTTTACGATGTCTTCCATAT","561307.5.peg.2164","1296"
"15351",1472,68,1404,"TATGCGTTAACTCAGCTAAT","GTTTACGATGTCTTCCATAT","561307.5.peg.2164","1296"
"15352",1583,68,1515,"GTGTTTCAATTGGACACATA","GTTTACGATGTCTTCCATAT","561307.5.peg.2164","1296"
"15353",1253,68,1185,"GTAAACGACGGTTACCTAAA","GTTTACGATGTCTTCCATAT","561307.5.peg.2164","1296"
"15354",1253,170,1083,"GTAAACGACGGTTACCTAAA","TTCGATTAAACCTTCTCTT","561307.5.peg.2164","1296"
"15355",1301,170,1131,"TTGATAAACCGATACGGAAT","TTCGATTAAACCTTCTCTT","561307.5.peg.2164","1296"
"15356",68,170,102,"GTTTACGATGTCTTCCATAT","TTCGATTAAACCTTCTCTT","561307.5.peg.2164","1296"
"15357",621,170,451,"GCACGTAACAATACTGTTAA","TTCGATTAAACCTTCTCTT","561307.5.peg.2164","1296"
"15358",1151,170,981,"TGCATTTAACTTCTGAGTCA","TTCGATTAAACCTTCTCTT","561307.5.peg.2164","1296"
"15359",1583,170,1413,"GTGTTTCAATTGGACACATA","TTCGATTAAACCTTCTCTT","561307.5.peg.2164","1296"
"15360",299,170,129,"GTGCAGCATAAGTAGCGTCA","TTCGATTAAACCTTCTCTT","561307.5.peg.2164","1296"
"15361",1104,170,934,"GTACGACCTTCATCATCGTT","TTCGATTAAACCTTCTCTT","561307.5.peg.2164","1296"
"15362",1307,170,1137,"CCATTCTTGATAAACCGATA","TTCGATTAAACCTTCTCTT","561307.5.peg.2164","1296"
"15363",1518,170,1348,"CGTTCACGTGTTAAACCACC","TTCGATTAAACCTTCTCTT","561307.5.peg.2164","1296"
"15364",1472,170,1302,"TATGCGTTAACTCAGCTAAT","TTCGATTAAACCTTCTCTT","561307.5.peg.2164","1296"
"15365",1463,170,1293,"ACTCAGCTAATGGGTTTGCT","TTCGATTAAACCTTCTCTT","561307.5.peg.2164","1296"
"15366",1265,170,1095,"CACCTACAGAACGTAAACGA","TTCGATTAAACCTTCTCTT","561307.5.peg.2164","1296"
"15367",540,170,370,"TCTAACCATGCACCACGGTT","TTCGATTAAACCTTCTCTT","561307.5.peg.2164","1296"
"15368",774,170,604,"TCAACAGTTGGTGGTTCACC","TTCGATTAAACCTTCTCTT","561307.5.peg.2164","1296"
"15369",1605,170,1435,"AATCCAATGTTTGGTCCCTC","TTCGATTAAACCTTCTCTT","561307.5.peg.2164","1296"
"15370",398,170,228,"TACCTGTATCAGTCATTAAT","TTCGATTAAACCTTCTCTT","561307.5.peg.2164","1296"
"15371",1151,299,852,"TGCATTTAACTTCTGAGTCA","GTGCAGCATAAGTAGCGTCA","561307.5.peg.2164","1296"
"15372",1518,299,1219,"CGTTCACGTGTTAAACCACC","GTGCAGCATAAGTAGCGTCA","561307.5.peg.2164","1296"
"15373",1253,299,954,"GTAAACGACGGTTACCTAAA","GTGCAGCATAAGTAGCGTCA","561307.5.peg.2164","1296"
"15374",1583,299,1284,"GTGTTTCAATTGGACACATA","GTGCAGCATAAGTAGCGTCA","561307.5.peg.2164","1296"
"15375",68,299,231,"GTTTACGATGTCTTCCATAT","GTGCAGCATAAGTAGCGTCA","561307.5.peg.2164","1296"
"15376",621,299,322,"GCACGTAACAATACTGTTAA","GTGCAGCATAAGTAGCGTCA","561307.5.peg.2164","1296"
"15377",540,299,241,"TCTAACCATGCACCACGGTT","GTGCAGCATAAGTAGCGTCA","561307.5.peg.2164","1296"
"15378",1605,299,1306,"AATCCAATGTTTGGTCCCTC","GTGCAGCATAAGTAGCGTCA","561307.5.peg.2164","1296"
"15379",1104,299,805,"GTACGACCTTCATCATCGTT","GTGCAGCATAAGTAGCGTCA","561307.5.peg.2164","1296"
"15380",1472,299,1173,"TATGCGTTAACTCAGCTAAT","GTGCAGCATAAGTAGCGTCA","561307.5.peg.2164","1296"
"15381",1265,299,966,"CACCTACAGAACGTAAACGA","GTGCAGCATAAGTAGCGTCA","561307.5.peg.2164","1296"
"15382",1301,299,1002,"TTGATAAACCGATACGGAAT","GTGCAGCATAAGTAGCGTCA","561307.5.peg.2164","1296"
"15383",1463,299,1164,"ACTCAGCTAATGGGTTTGCT","GTGCAGCATAAGTAGCGTCA","561307.5.peg.2164","1296"
"15384",774,299,475,"TCAACAGTTGGTGGTTCACC","GTGCAGCATAAGTAGCGTCA","561307.5.peg.2164","1296"
"15385",170,299,129,"TTCGATTAAACCTTCTCTT","GTGCAGCATAAGTAGCGTCA","561307.5.peg.2164","1296"
"15386",1307,299,1008,"CCATTCTTGATAAACCGATA","GTGCAGCATAAGTAGCGTCA","561307.5.peg.2164","1296"
"15387",1307,398,909,"CCATTCTTGATAAACCGATA","TACCTGTATCAGTCATTAAT","561307.5.peg.2164","1296"
"15388",540,398,142,"TCTAACCATGCACCACGGTT","TACCTGTATCAGTCATTAAT","561307.5.peg.2164","1296"
"15389",1472,398,1074,"TATGCGTTAACTCAGCTAAT","TACCTGTATCAGTCATTAAT","561307.5.peg.2164","1296"
"15390",621,398,223,"GCACGTAACAATACTGTTAA","TACCTGTATCAGTCATTAAT","561307.5.peg.2164","1296"
"15391",170,398,228,"TTCGATTAAACCTTCTCTT","TACCTGTATCAGTCATTAAT","561307.5.peg.2164","1296"
"15392",68,398,330,"GTTTACGATGTCTTCCATAT","TACCTGTATCAGTCATTAAT","561307.5.peg.2164","1296"
"15393",1463,398,1065,"ACTCAGCTAATGGGTTTGCT","TACCTGTATCAGTCATTAAT","561307.5.peg.2164","1296"
"15394",1151,398,753,"TGCATTTAACTTCTGAGTCA","TACCTGTATCAGTCATTAAT","561307.5.peg.2164","1296"
"15395",1518,398,1120,"CGTTCACGTGTTAAACCACC","TACCTGTATCAGTCATTAAT","561307.5.peg.2164","1296"
"15396",1583,398,1185,"GTGTTTCAATTGGACACATA","TACCTGTATCAGTCATTAAT","561307.5.peg.2164","1296"
"15397",1265,398,867,"CACCTACAGAACGTAAACGA","TACCTGTATCAGTCATTAAT","561307.5.peg.2164","1296"
"15398",1253,398,855,"GTAAACGACGGTTACCTAAA","TACCTGTATCAGTCATTAAT","561307.5.peg.2164","1296"
"15399",774,398,376,"TCAACAGTTGGTGGTTCACC","TACCTGTATCAGTCATTAAT","561307.5.peg.2164","1296"
"15400",1301,398,903,"TTGATAAACCGATACGGAAT","TACCTGTATCAGTCATTAAT","561307.5.peg.2164","1296"
"15401",1104,398,706,"GTACGACCTTCATCATCGTT","TACCTGTATCAGTCATTAAT","561307.5.peg.2164","1296"
"15402",1605,398,1207,"AATCCAATGTTTGGTCCCTC","TACCTGTATCAGTCATTAAT","561307.5.peg.2164","1296"
"15403",1518,540,978,"CGTTCACGTGTTAAACCACC","TCTAACCATGCACCACGGTT","561307.5.peg.2164","1296"
"15404",1307,540,767,"CCATTCTTGATAAACCGATA","TCTAACCATGCACCACGGTT","561307.5.peg.2164","1296"
"15405",68,540,472,"GTTTACGATGTCTTCCATAT","TCTAACCATGCACCACGGTT","561307.5.peg.2164","1296"
"15406",1253,540,713,"GTAAACGACGGTTACCTAAA","TCTAACCATGCACCACGGTT","561307.5.peg.2164","1296"
"15407",1583,540,1043,"GTGTTTCAATTGGACACATA","TCTAACCATGCACCACGGTT","561307.5.peg.2164","1296"
"15408",1463,540,923,"ACTCAGCTAATGGGTTTGCT","TCTAACCATGCACCACGGTT","561307.5.peg.2164","1296"
"15409",1301,540,761,"TTGATAAACCGATACGGAAT","TCTAACCATGCACCACGGTT","561307.5.peg.2164","1296"
"15410",1104,540,564,"GTACGACCTTCATCATCGTT","TCTAACCATGCACCACGGTT","561307.5.peg.2164","1296"
"15411",299,540,241,"GTGCAGCATAAGTAGCGTCA","TCTAACCATGCACCACGGTT","561307.5.peg.2164","1296"
"15412",398,540,142,"TACCTGTATCAGTCATTAAT","TCTAACCATGCACCACGGTT","561307.5.peg.2164","1296"
"15413",1151,540,611,"TGCATTTAACTTCTGAGTCA","TCTAACCATGCACCACGGTT","561307.5.peg.2164","1296"
"15414",1265,540,725,"CACCTACAGAACGTAAACGA","TCTAACCATGCACCACGGTT","561307.5.peg.2164","1296"
"15415",1472,540,932,"TATGCGTTAACTCAGCTAAT","TCTAACCATGCACCACGGTT","561307.5.peg.2164","1296"
"15416",774,540,234,"TCAACAGTTGGTGGTTCACC","TCTAACCATGCACCACGGTT","561307.5.peg.2164","1296"
"15417",1605,540,1065,"AATCCAATGTTTGGTCCCTC","TCTAACCATGCACCACGGTT","561307.5.peg.2164","1296"
"15418",170,540,370,"TTCGATTAAACCTTCTCTT","TCTAACCATGCACCACGGTT","561307.5.peg.2164","1296"
"15419",68,621,553,"GTTTACGATGTCTTCCATAT","GCACGTAACAATACTGTTAA","561307.5.peg.2164","1296"
"15420",398,621,223,"TACCTGTATCAGTCATTAAT","GCACGTAACAATACTGTTAA","561307.5.peg.2164","1296"
"15421",774,621,153,"TCAACAGTTGGTGGTTCACC","GCACGTAACAATACTGTTAA","561307.5.peg.2164","1296"
"15422",1463,621,842,"ACTCAGCTAATGGGTTTGCT","GCACGTAACAATACTGTTAA","561307.5.peg.2164","1296"
"15423",299,621,322,"GTGCAGCATAAGTAGCGTCA","GCACGTAACAATACTGTTAA","561307.5.peg.2164","1296"
"15424",1265,621,644,"CACCTACAGAACGTAAACGA","GCACGTAACAATACTGTTAA","561307.5.peg.2164","1296"
"15425",1583,621,962,"GTGTTTCAATTGGACACATA","GCACGTAACAATACTGTTAA","561307.5.peg.2164","1296"
"15426",170,621,451,"TTCGATTAAACCTTCTCTT","GCACGTAACAATACTGTTAA","561307.5.peg.2164","1296"
"15427",1151,621,530,"TGCATTTAACTTCTGAGTCA","GCACGTAACAATACTGTTAA","561307.5.peg.2164","1296"
"15428",1605,621,984,"AATCCAATGTTTGGTCCCTC","GCACGTAACAATACTGTTAA","561307.5.peg.2164","1296"
"15429",1253,621,632,"GTAAACGACGGTTACCTAAA","GCACGTAACAATACTGTTAA","561307.5.peg.2164","1296"
"15430",1301,621,680,"TTGATAAACCGATACGGAAT","GCACGTAACAATACTGTTAA","561307.5.peg.2164","1296"
"15431",1307,621,686,"CCATTCTTGATAAACCGATA","GCACGTAACAATACTGTTAA","561307.5.peg.2164","1296"
"15432",1472,621,851,"TATGCGTTAACTCAGCTAAT","GCACGTAACAATACTGTTAA","561307.5.peg.2164","1296"
"15433",1518,621,897,"CGTTCACGTGTTAAACCACC","GCACGTAACAATACTGTTAA","561307.5.peg.2164","1296"
"15434",1104,621,483,"GTACGACCTTCATCATCGTT","GCACGTAACAATACTGTTAA","561307.5.peg.2164","1296"
"15435",68,774,706,"GTTTACGATGTCTTCCATAT","TCAACAGTTGGTGGTTCACC","561307.5.peg.2164","1296"
"15436",1518,774,744,"CGTTCACGTGTTAAACCACC","TCAACAGTTGGTGGTTCACC","561307.5.peg.2164","1296"
"15437",1583,774,809,"GTGTTTCAATTGGACACATA","TCAACAGTTGGTGGTTCACC","561307.5.peg.2164","1296"
"15438",1104,774,330,"GTACGACCTTCATCATCGTT","TCAACAGTTGGTGGTTCACC","561307.5.peg.2164","1296"
"15439",1307,774,533,"CCATTCTTGATAAACCGATA","TCAACAGTTGGTGGTTCACC","561307.5.peg.2164","1296"
"15440",1253,774,479,"GTAAACGACGGTTACCTAAA","TCAACAGTTGGTGGTTCACC","561307.5.peg.2164","1296"
"15441",1605,774,831,"AATCCAATGTTTGGTCCCTC","TCAACAGTTGGTGGTTCACC","561307.5.peg.2164","1296"
"15442",621,774,153,"GCACGTAACAATACTGTTAA","TCAACAGTTGGTGGTTCACC","561307.5.peg.2164","1296"
"15443",1472,774,698,"TATGCGTTAACTCAGCTAAT","TCAACAGTTGGTGGTTCACC","561307.5.peg.2164","1296"
"15444",1265,774,491,"CACCTACAGAACGTAAACGA","TCAACAGTTGGTGGTTCACC","561307.5.peg.2164","1296"
"15445",1463,774,689,"ACTCAGCTAATGGGTTTGCT","TCAACAGTTGGTGGTTCACC","561307.5.peg.2164","1296"
"15446",1151,774,377,"TGCATTTAACTTCTGAGTCA","TCAACAGTTGGTGGTTCACC","561307.5.peg.2164","1296"
"15447",398,774,376,"TACCTGTATCAGTCATTAAT","TCAACAGTTGGTGGTTCACC","561307.5.peg.2164","1296"
"15448",1301,774,527,"TTGATAAACCGATACGGAAT","TCAACAGTTGGTGGTTCACC","561307.5.peg.2164","1296"
"15449",170,774,604,"TTCGATTAAACCTTCTCTT","TCAACAGTTGGTGGTTCACC","561307.5.peg.2164","1296"
"15450",540,774,234,"TCTAACCATGCACCACGGTT","TCAACAGTTGGTGGTTCACC","561307.5.peg.2164","1296"
"15451",299,774,475,"GTGCAGCATAAGTAGCGTCA","TCAACAGTTGGTGGTTCACC","561307.5.peg.2164","1296"
"15452",1307,1104,203,"CCATTCTTGATAAACCGATA","GTACGACCTTCATCATCGTT","561307.5.peg.2164","1296"
"15453",1301,1104,197,"TTGATAAACCGATACGGAAT","GTACGACCTTCATCATCGTT","561307.5.peg.2164","1296"
"15454",1265,1104,161,"CACCTACAGAACGTAAACGA","GTACGACCTTCATCATCGTT","561307.5.peg.2164","1296"
"15455",774,1104,330,"TCAACAGTTGGTGGTTCACC","GTACGACCTTCATCATCGTT","561307.5.peg.2164","1296"
"15456",621,1104,483,"GCACGTAACAATACTGTTAA","GTACGACCTTCATCATCGTT","561307.5.peg.2164","1296"
"15457",68,1104,1036,"GTTTACGATGTCTTCCATAT","GTACGACCTTCATCATCGTT","561307.5.peg.2164","1296"
"15458",299,1104,805,"GTGCAGCATAAGTAGCGTCA","GTACGACCTTCATCATCGTT","561307.5.peg.2164","1296"
"15459",1253,1104,149,"GTAAACGACGGTTACCTAAA","GTACGACCTTCATCATCGTT","561307.5.peg.2164","1296"
"15460",398,1104,706,"TACCTGTATCAGTCATTAAT","GTACGACCTTCATCATCGTT","561307.5.peg.2164","1296"
"15461",1463,1104,359,"ACTCAGCTAATGGGTTTGCT","GTACGACCTTCATCATCGTT","561307.5.peg.2164","1296"
"15462",1518,1104,414,"CGTTCACGTGTTAAACCACC","GTACGACCTTCATCATCGTT","561307.5.peg.2164","1296"
"15463",1605,1104,501,"AATCCAATGTTTGGTCCCTC","GTACGACCTTCATCATCGTT","561307.5.peg.2164","1296"
"15464",1472,1104,368,"TATGCGTTAACTCAGCTAAT","GTACGACCTTCATCATCGTT","561307.5.peg.2164","1296"
"15465",1583,1104,479,"GTGTTTCAATTGGACACATA","GTACGACCTTCATCATCGTT","561307.5.peg.2164","1296"
"15466",170,1104,934,"TTCGATTAAACCTTCTCTT","GTACGACCTTCATCATCGTT","561307.5.peg.2164","1296"
"15467",540,1104,564,"TCTAACCATGCACCACGGTT","GTACGACCTTCATCATCGTT","561307.5.peg.2164","1296"
"15468",68,1151,1083,"GTTTACGATGTCTTCCATAT","TGCATTTAACTTCTGAGTCA","561307.5.peg.2164","1296"
"15469",398,1151,753,"TACCTGTATCAGTCATTAAT","TGCATTTAACTTCTGAGTCA","561307.5.peg.2164","1296"
"15470",299,1151,852,"GTGCAGCATAAGTAGCGTCA","TGCATTTAACTTCTGAGTCA","561307.5.peg.2164","1296"
"15471",1605,1151,454,"AATCCAATGTTTGGTCCCTC","TGCATTTAACTTCTGAGTCA","561307.5.peg.2164","1296"
"15472",1265,1151,114,"CACCTACAGAACGTAAACGA","TGCATTTAACTTCTGAGTCA","561307.5.peg.2164","1296"
"15473",1583,1151,432,"GTGTTTCAATTGGACACATA","TGCATTTAACTTCTGAGTCA","561307.5.peg.2164","1296"
"15474",774,1151,377,"TCAACAGTTGGTGGTTCACC","TGCATTTAACTTCTGAGTCA","561307.5.peg.2164","1296"
"15475",1463,1151,312,"ACTCAGCTAATGGGTTTGCT","TGCATTTAACTTCTGAGTCA","561307.5.peg.2164","1296"
"15476",1518,1151,367,"CGTTCACGTGTTAAACCACC","TGCATTTAACTTCTGAGTCA","561307.5.peg.2164","1296"
"15477",1301,1151,150,"TTGATAAACCGATACGGAAT","TGCATTTAACTTCTGAGTCA","561307.5.peg.2164","1296"
"15478",1307,1151,156,"CCATTCTTGATAAACCGATA","TGCATTTAACTTCTGAGTCA","561307.5.peg.2164","1296"
"15479",170,1151,981,"TTCGATTAAACCTTCTCTT","TGCATTTAACTTCTGAGTCA","561307.5.peg.2164","1296"
"15480",540,1151,611,"TCTAACCATGCACCACGGTT","TGCATTTAACTTCTGAGTCA","561307.5.peg.2164","1296"
"15481",621,1151,530,"GCACGTAACAATACTGTTAA","TGCATTTAACTTCTGAGTCA","561307.5.peg.2164","1296"
"15482",1472,1151,321,"TATGCGTTAACTCAGCTAAT","TGCATTTAACTTCTGAGTCA","561307.5.peg.2164","1296"
"15483",1253,1151,102,"GTAAACGACGGTTACCTAAA","TGCATTTAACTTCTGAGTCA","561307.5.peg.2164","1296"
"15484",299,1253,954,"GTGCAGCATAAGTAGCGTCA","GTAAACGACGGTTACCTAAA","561307.5.peg.2164","1296"
"15485",1463,1253,210,"ACTCAGCTAATGGGTTTGCT","GTAAACGACGGTTACCTAAA","561307.5.peg.2164","1296"
"15486",1104,1253,149,"GTACGACCTTCATCATCGTT","GTAAACGACGGTTACCTAAA","561307.5.peg.2164","1296"
"15487",774,1253,479,"TCAACAGTTGGTGGTTCACC","GTAAACGACGGTTACCTAAA","561307.5.peg.2164","1296"
"15488",1472,1253,219,"TATGCGTTAACTCAGCTAAT","GTAAACGACGGTTACCTAAA","561307.5.peg.2164","1296"
"15489",1518,1253,265,"CGTTCACGTGTTAAACCACC","GTAAACGACGGTTACCTAAA","561307.5.peg.2164","1296"
"15490",621,1253,632,"GCACGTAACAATACTGTTAA","GTAAACGACGGTTACCTAAA","561307.5.peg.2164","1296"
"15491",170,1253,1083,"TTCGATTAAACCTTCTCTT","GTAAACGACGGTTACCTAAA","561307.5.peg.2164","1296"
"15492",1605,1253,352,"AATCCAATGTTTGGTCCCTC","GTAAACGACGGTTACCTAAA","561307.5.peg.2164","1296"
"15493",540,1253,713,"TCTAACCATGCACCACGGTT","GTAAACGACGGTTACCTAAA","561307.5.peg.2164","1296"
"15494",1151,1253,102,"TGCATTTAACTTCTGAGTCA","GTAAACGACGGTTACCTAAA","561307.5.peg.2164","1296"
"15495",68,1253,1185,"GTTTACGATGTCTTCCATAT","GTAAACGACGGTTACCTAAA","561307.5.peg.2164","1296"
"15496",1583,1253,330,"GTGTTTCAATTGGACACATA","GTAAACGACGGTTACCTAAA","561307.5.peg.2164","1296"
"15497",398,1253,855,"TACCTGTATCAGTCATTAAT","GTAAACGACGGTTACCTAAA","561307.5.peg.2164","1296"
"15498",68,1265,1197,"GTTTACGATGTCTTCCATAT","CACCTACAGAACGTAAACGA","561307.5.peg.2164","1296"
"15499",1472,1265,207,"TATGCGTTAACTCAGCTAAT","CACCTACAGAACGTAAACGA","561307.5.peg.2164","1296"
"15500",1518,1265,253,"CGTTCACGTGTTAAACCACC","CACCTACAGAACGTAAACGA","561307.5.peg.2164","1296"
"15501",621,1265,644,"GCACGTAACAATACTGTTAA","CACCTACAGAACGTAAACGA","561307.5.peg.2164","1296"
"15502",540,1265,725,"TCTAACCATGCACCACGGTT","CACCTACAGAACGTAAACGA","561307.5.peg.2164","1296"
"15503",1151,1265,114,"TGCATTTAACTTCTGAGTCA","CACCTACAGAACGTAAACGA","561307.5.peg.2164","1296"
"15504",1463,1265,198,"ACTCAGCTAATGGGTTTGCT","CACCTACAGAACGTAAACGA","561307.5.peg.2164","1296"
"15505",1605,1265,340,"AATCCAATGTTTGGTCCCTC","CACCTACAGAACGTAAACGA","561307.5.peg.2164","1296"
"15506",299,1265,966,"GTGCAGCATAAGTAGCGTCA","CACCTACAGAACGTAAACGA","561307.5.peg.2164","1296"
"15507",1583,1265,318,"GTGTTTCAATTGGACACATA","CACCTACAGAACGTAAACGA","561307.5.peg.2164","1296"
"15508",1104,1265,161,"GTACGACCTTCATCATCGTT","CACCTACAGAACGTAAACGA","561307.5.peg.2164","1296"
"15509",774,1265,491,"TCAACAGTTGGTGGTTCACC","CACCTACAGAACGTAAACGA","561307.5.peg.2164","1296"
"15510",170,1265,1095,"TTCGATTAAACCTTCTCTT","CACCTACAGAACGTAAACGA","561307.5.peg.2164","1296"
"15511",398,1265,867,"TACCTGTATCAGTCATTAAT","CACCTACAGAACGTAAACGA","561307.5.peg.2164","1296"
"15512",774,1301,527,"TCAACAGTTGGTGGTTCACC","TTGATAAACCGATACGGAAT","561307.5.peg.2164","1296"
"15513",621,1301,680,"GCACGTAACAATACTGTTAA","TTGATAAACCGATACGGAAT","561307.5.peg.2164","1296"
"15514",1605,1301,304,"AATCCAATGTTTGGTCCCTC","TTGATAAACCGATACGGAAT","561307.5.peg.2164","1296"
"15515",1472,1301,171,"TATGCGTTAACTCAGCTAAT","TTGATAAACCGATACGGAAT","561307.5.peg.2164","1296"
"15516",1151,1301,150,"TGCATTTAACTTCTGAGTCA","TTGATAAACCGATACGGAAT","561307.5.peg.2164","1296"
"15517",68,1301,1233,"GTTTACGATGTCTTCCATAT","TTGATAAACCGATACGGAAT","561307.5.peg.2164","1296"
"15518",1104,1301,197,"GTACGACCTTCATCATCGTT","TTGATAAACCGATACGGAAT","561307.5.peg.2164","1296"
"15519",299,1301,1002,"GTGCAGCATAAGTAGCGTCA","TTGATAAACCGATACGGAAT","561307.5.peg.2164","1296"
"15520",1583,1301,282,"GTGTTTCAATTGGACACATA","TTGATAAACCGATACGGAAT","561307.5.peg.2164","1296"
"15521",1463,1301,162,"ACTCAGCTAATGGGTTTGCT","TTGATAAACCGATACGGAAT","561307.5.peg.2164","1296"
"15522",1518,1301,217,"CGTTCACGTGTTAAACCACC","TTGATAAACCGATACGGAAT","561307.5.peg.2164","1296"
"15523",540,1301,761,"TCTAACCATGCACCACGGTT","TTGATAAACCGATACGGAAT","561307.5.peg.2164","1296"
"15524",398,1301,903,"TACCTGTATCAGTCATTAAT","TTGATAAACCGATACGGAAT","561307.5.peg.2164","1296"
"15525",170,1301,1131,"TTCGATTAAACCTTCTCTT","TTGATAAACCGATACGGAAT","561307.5.peg.2164","1296"
"15526",398,1307,909,"TACCTGTATCAGTCATTAAT","CCATTCTTGATAAACCGATA","561307.5.peg.2164","1296"
"15527",774,1307,533,"TCAACAGTTGGTGGTTCACC","CCATTCTTGATAAACCGATA","561307.5.peg.2164","1296"
"15528",68,1307,1239,"GTTTACGATGTCTTCCATAT","CCATTCTTGATAAACCGATA","561307.5.peg.2164","1296"
"15529",1518,1307,211,"CGTTCACGTGTTAAACCACC","CCATTCTTGATAAACCGATA","561307.5.peg.2164","1296"
"15530",1472,1307,165,"TATGCGTTAACTCAGCTAAT","CCATTCTTGATAAACCGATA","561307.5.peg.2164","1296"
"15531",299,1307,1008,"GTGCAGCATAAGTAGCGTCA","CCATTCTTGATAAACCGATA","561307.5.peg.2164","1296"
"15532",1463,1307,156,"ACTCAGCTAATGGGTTTGCT","CCATTCTTGATAAACCGATA","561307.5.peg.2164","1296"
"15533",1104,1307,203,"GTACGACCTTCATCATCGTT","CCATTCTTGATAAACCGATA","561307.5.peg.2164","1296"
"15534",1583,1307,276,"GTGTTTCAATTGGACACATA","CCATTCTTGATAAACCGATA","561307.5.peg.2164","1296"
"15535",1151,1307,156,"TGCATTTAACTTCTGAGTCA","CCATTCTTGATAAACCGATA","561307.5.peg.2164","1296"
"15536",621,1307,686,"GCACGTAACAATACTGTTAA","CCATTCTTGATAAACCGATA","561307.5.peg.2164","1296"
"15537",170,1307,1137,"TTCGATTAAACCTTCTCTT","CCATTCTTGATAAACCGATA","561307.5.peg.2164","1296"
"15538",1605,1307,298,"AATCCAATGTTTGGTCCCTC","CCATTCTTGATAAACCGATA","561307.5.peg.2164","1296"
"15539",540,1307,767,"TCTAACCATGCACCACGGTT","CCATTCTTGATAAACCGATA","561307.5.peg.2164","1296"
"15540",1104,1463,359,"GTACGACCTTCATCATCGTT","ACTCAGCTAATGGGTTTGCT","561307.5.peg.2164","1296"
"15541",68,1463,1395,"GTTTACGATGTCTTCCATAT","ACTCAGCTAATGGGTTTGCT","561307.5.peg.2164","1296"
"15542",398,1463,1065,"TACCTGTATCAGTCATTAAT","ACTCAGCTAATGGGTTTGCT","561307.5.peg.2164","1296"
"15543",1151,1463,312,"TGCATTTAACTTCTGAGTCA","ACTCAGCTAATGGGTTTGCT","561307.5.peg.2164","1296"
"15544",1265,1463,198,"CACCTACAGAACGTAAACGA","ACTCAGCTAATGGGTTTGCT","561307.5.peg.2164","1296"
"15545",1253,1463,210,"GTAAACGACGGTTACCTAAA","ACTCAGCTAATGGGTTTGCT","561307.5.peg.2164","1296"
"15546",774,1463,689,"TCAACAGTTGGTGGTTCACC","ACTCAGCTAATGGGTTTGCT","561307.5.peg.2164","1296"
"15547",1583,1463,120,"GTGTTTCAATTGGACACATA","ACTCAGCTAATGGGTTTGCT","561307.5.peg.2164","1296"
"15548",1307,1463,156,"CCATTCTTGATAAACCGATA","ACTCAGCTAATGGGTTTGCT","561307.5.peg.2164","1296"
"15549",1301,1463,162,"TTGATAAACCGATACGGAAT","ACTCAGCTAATGGGTTTGCT","561307.5.peg.2164","1296"
"15550",1605,1463,142,"AATCCAATGTTTGGTCCCTC","ACTCAGCTAATGGGTTTGCT","561307.5.peg.2164","1296"
"15551",540,1463,923,"TCTAACCATGCACCACGGTT","ACTCAGCTAATGGGTTTGCT","561307.5.peg.2164","1296"
"15552",621,1463,842,"GCACGTAACAATACTGTTAA","ACTCAGCTAATGGGTTTGCT","561307.5.peg.2164","1296"
"15553",170,1463,1293,"TTCGATTAAACCTTCTCTT","ACTCAGCTAATGGGTTTGCT","561307.5.peg.2164","1296"
"15554",299,1463,1164,"GTGCAGCATAAGTAGCGTCA","ACTCAGCTAATGGGTTTGCT","561307.5.peg.2164","1296"
"15555",540,1472,932,"TCTAACCATGCACCACGGTT","TATGCGTTAACTCAGCTAAT","561307.5.peg.2164","1296"
"15556",1151,1472,321,"TGCATTTAACTTCTGAGTCA","TATGCGTTAACTCAGCTAAT","561307.5.peg.2164","1296"
"15557",398,1472,1074,"TACCTGTATCAGTCATTAAT","TATGCGTTAACTCAGCTAAT","561307.5.peg.2164","1296"
"15558",1307,1472,165,"CCATTCTTGATAAACCGATA","TATGCGTTAACTCAGCTAAT","561307.5.peg.2164","1296"
"15559",1104,1472,368,"GTACGACCTTCATCATCGTT","TATGCGTTAACTCAGCTAAT","561307.5.peg.2164","1296"
"15560",299,1472,1173,"GTGCAGCATAAGTAGCGTCA","TATGCGTTAACTCAGCTAAT","561307.5.peg.2164","1296"
"15561",1301,1472,171,"TTGATAAACCGATACGGAAT","TATGCGTTAACTCAGCTAAT","561307.5.peg.2164","1296"
"15562",621,1472,851,"GCACGTAACAATACTGTTAA","TATGCGTTAACTCAGCTAAT","561307.5.peg.2164","1296"
"15563",1265,1472,207,"CACCTACAGAACGTAAACGA","TATGCGTTAACTCAGCTAAT","561307.5.peg.2164","1296"
"15564",170,1472,1302,"TTCGATTAAACCTTCTCTT","TATGCGTTAACTCAGCTAAT","561307.5.peg.2164","1296"
"15565",1253,1472,219,"GTAAACGACGGTTACCTAAA","TATGCGTTAACTCAGCTAAT","561307.5.peg.2164","1296"
"15566",68,1472,1404,"GTTTACGATGTCTTCCATAT","TATGCGTTAACTCAGCTAAT","561307.5.peg.2164","1296"
"15567",1583,1472,111,"GTGTTTCAATTGGACACATA","TATGCGTTAACTCAGCTAAT","561307.5.peg.2164","1296"
"15568",774,1472,698,"TCAACAGTTGGTGGTTCACC","TATGCGTTAACTCAGCTAAT","561307.5.peg.2164","1296"
"15569",1605,1472,133,"AATCCAATGTTTGGTCCCTC","TATGCGTTAACTCAGCTAAT","561307.5.peg.2164","1296"
"15570",398,1518,1120,"TACCTGTATCAGTCATTAAT","CGTTCACGTGTTAAACCACC","561307.5.peg.2164","1296"
"15571",540,1518,978,"TCTAACCATGCACCACGGTT","CGTTCACGTGTTAAACCACC","561307.5.peg.2164","1296"
"15572",774,1518,744,"TCAACAGTTGGTGGTTCACC","CGTTCACGTGTTAAACCACC","561307.5.peg.2164","1296"
"15573",1307,1518,211,"CCATTCTTGATAAACCGATA","CGTTCACGTGTTAAACCACC","561307.5.peg.2164","1296"
"15574",68,1518,1450,"GTTTACGATGTCTTCCATAT","CGTTCACGTGTTAAACCACC","561307.5.peg.2164","1296"
"15575",1151,1518,367,"TGCATTTAACTTCTGAGTCA","CGTTCACGTGTTAAACCACC","561307.5.peg.2164","1296"
"15576",1265,1518,253,"CACCTACAGAACGTAAACGA","CGTTCACGTGTTAAACCACC","561307.5.peg.2164","1296"
"15577",170,1518,1348,"TTCGATTAAACCTTCTCTT","CGTTCACGTGTTAAACCACC","561307.5.peg.2164","1296"
"15578",1253,1518,265,"GTAAACGACGGTTACCTAAA","CGTTCACGTGTTAAACCACC","561307.5.peg.2164","1296"
"15579",1104,1518,414,"GTACGACCTTCATCATCGTT","CGTTCACGTGTTAAACCACC","561307.5.peg.2164","1296"
"15580",1301,1518,217,"TTGATAAACCGATACGGAAT","CGTTCACGTGTTAAACCACC","561307.5.peg.2164","1296"
"15581",299,1518,1219,"GTGCAGCATAAGTAGCGTCA","CGTTCACGTGTTAAACCACC","561307.5.peg.2164","1296"
"15582",621,1518,897,"GCACGTAACAATACTGTTAA","CGTTCACGTGTTAAACCACC","561307.5.peg.2164","1296"
"15583",1307,1583,276,"CCATTCTTGATAAACCGATA","GTGTTTCAATTGGACACATA","561307.5.peg.2164","1296"
"15584",1463,1583,120,"ACTCAGCTAATGGGTTTGCT","GTGTTTCAATTGGACACATA","561307.5.peg.2164","1296"
"15585",1104,1583,479,"GTACGACCTTCATCATCGTT","GTGTTTCAATTGGACACATA","561307.5.peg.2164","1296"
"15586",1253,1583,330,"GTAAACGACGGTTACCTAAA","GTGTTTCAATTGGACACATA","561307.5.peg.2164","1296"
"15587",398,1583,1185,"TACCTGTATCAGTCATTAAT","GTGTTTCAATTGGACACATA","561307.5.peg.2164","1296"
"15588",299,1583,1284,"GTGCAGCATAAGTAGCGTCA","GTGTTTCAATTGGACACATA","561307.5.peg.2164","1296"
"15589",68,1583,1515,"GTTTACGATGTCTTCCATAT","GTGTTTCAATTGGACACATA","561307.5.peg.2164","1296"
"15590",1301,1583,282,"TTGATAAACCGATACGGAAT","GTGTTTCAATTGGACACATA","561307.5.peg.2164","1296"
"15591",774,1583,809,"TCAACAGTTGGTGGTTCACC","GTGTTTCAATTGGACACATA","561307.5.peg.2164","1296"
"15592",1151,1583,432,"TGCATTTAACTTCTGAGTCA","GTGTTTCAATTGGACACATA","561307.5.peg.2164","1296"
"15593",540,1583,1043,"TCTAACCATGCACCACGGTT","GTGTTTCAATTGGACACATA","561307.5.peg.2164","1296"
"15594",621,1583,962,"GCACGTAACAATACTGTTAA","GTGTTTCAATTGGACACATA","561307.5.peg.2164","1296"
"15595",1265,1583,318,"CACCTACAGAACGTAAACGA","GTGTTTCAATTGGACACATA","561307.5.peg.2164","1296"
"15596",170,1583,1413,"TTCGATTAAACCTTCTCTT","GTGTTTCAATTGGACACATA","561307.5.peg.2164","1296"
"15597",1472,1583,111,"TATGCGTTAACTCAGCTAAT","GTGTTTCAATTGGACACATA","561307.5.peg.2164","1296"
"15598",1463,1605,142,"ACTCAGCTAATGGGTTTGCT","AATCCAATGTTTGGTCCCTC","561307.5.peg.2164","1296"
"15599",1253,1605,352,"GTAAACGACGGTTACCTAAA","AATCCAATGTTTGGTCCCTC","561307.5.peg.2164","1296"
"15600",1301,1605,304,"TTGATAAACCGATACGGAAT","AATCCAATGTTTGGTCCCTC","561307.5.peg.2164","1296"
"15601",1151,1605,454,"TGCATTTAACTTCTGAGTCA","AATCCAATGTTTGGTCCCTC","561307.5.peg.2164","1296"
"15602",774,1605,831,"TCAACAGTTGGTGGTTCACC","AATCCAATGTTTGGTCCCTC","561307.5.peg.2164","1296"
"15603",1104,1605,501,"GTACGACCTTCATCATCGTT","AATCCAATGTTTGGTCCCTC","561307.5.peg.2164","1296"
"15604",1265,1605,340,"CACCTACAGAACGTAAACGA","AATCCAATGTTTGGTCCCTC","561307.5.peg.2164","1296"
"15605",68,1605,1537,"GTTTACGATGTCTTCCATAT","AATCCAATGTTTGGTCCCTC","561307.5.peg.2164","1296"
"15606",299,1605,1306,"GTGCAGCATAAGTAGCGTCA","AATCCAATGTTTGGTCCCTC","561307.5.peg.2164","1296"
"15607",1307,1605,298,"CCATTCTTGATAAACCGATA","AATCCAATGTTTGGTCCCTC","561307.5.peg.2164","1296"
"15608",170,1605,1435,"TTCGATTAAACCTTCTCTT","AATCCAATGTTTGGTCCCTC","561307.5.peg.2164","1296"
"15609",398,1605,1207,"TACCTGTATCAGTCATTAAT","AATCCAATGTTTGGTCCCTC","561307.5.peg.2164","1296"
"15610",1472,1605,133,"TATGCGTTAACTCAGCTAAT","AATCCAATGTTTGGTCCCTC","561307.5.peg.2164","1296"
"15611",540,1605,1065,"TCTAACCATGCACCACGGTT","AATCCAATGTTTGGTCCCTC","561307.5.peg.2164","1296"
"15612",621,1605,984,"GCACGTAACAATACTGTTAA","AATCCAATGTTTGGTCCCTC","561307.5.peg.2164","1296"
"15613",1409,5,1404,"AAGGAACGTGAACCGCCATT","AATCTAAATTGAAGGAGGT","561307.5.peg.2165","1297"
"15614",1509,5,1504,"TCTTGTGATGGTGTAACTAC","AATCTAAATTGAAGGAGGT","561307.5.peg.2165","1297"
"15615",1368,5,1363,"TATAAGCTGTTGTTACAAG","AATCTAAATTGAAGGAGGT","561307.5.peg.2165","1297"
"15616",960,5,955,"CGGTTACCTGGGCCAGTAAC","AATCTAAATTGAAGGAGGT","561307.5.peg.2165","1297"
"15617",1821,5,1816,"GGATCGATGAAATATCTGTT","AATCTAAATTGAAGGAGGT","561307.5.peg.2165","1297"
"15618",381,5,376,"AGTAATAATCCCATACGACT","AATCTAAATTGAAGGAGGT","561307.5.peg.2165","1297"
"15619",141,5,136,"GTACGGTAGTTGATTGTTTC","AATCTAAATTGAAGGAGGT","561307.5.peg.2165","1297"
"15620",752,5,747,"CCATTGGACGAATTTCTGGT","AATCTAAATTGAAGGAGGT","561307.5.peg.2165","1297"
"15621",1275,5,1270,"GGTGCACGGTTAAGTAATAC","AATCTAAATTGAAGGAGGT","561307.5.peg.2165","1297"
"15622",1332,5,1327,"GCACGACCTTCAACTAAAGT","AATCTAAATTGAAGGAGGT","561307.5.peg.2165","1297"
"15623",698,5,693,"AAGGTTTGTTACCTGAATTA","AATCTAAATTGAAGGAGGT","561307.5.peg.2165","1297"
"15624",414,5,409,"TAACTTCTTCTAATGCTCT","AATCTAAATTGAAGGAGGT","561307.5.peg.2165","1297"
"15625",348,5,343,"AATACCAAATGTGAGAAAC","AATCTAAATTGAAGGAGGT","561307.5.peg.2165","1297"
"15626",1521,5,1516,"CCAAGTACCATATCTTGTGA","AATCTAAATTGAAGGAGGT","561307.5.peg.2165","1297"
"15627",744,5,739,"CGAATTTCTGGTGGGATGAT","AATCTAAATTGAAGGAGGT","561307.5.peg.2165","1297"
"15628",1289,5,1284,"GTCTATGAAGTGTTGGTGCA","AATCTAAATTGAAGGAGGT","561307.5.peg.2165","1297"
"15629",1275,9,1266,"GGTGCACGGTTAAGTAATAC","CAGCTAATCTAAATTGAAGG","561307.5.peg.2165","1297"
"15630",698,9,689,"AAGGTTTGTTACCTGAATTA","CAGCTAATCTAAATTGAAGG","561307.5.peg.2165","1297"
"15631",348,9,339,"AATACCAAATGTGAGAAAC","CAGCTAATCTAAATTGAAGG","561307.5.peg.2165","1297"
"15632",752,9,743,"CCATTGGACGAATTTCTGGT","CAGCTAATCTAAATTGAAGG","561307.5.peg.2165","1297"
"15633",1509,9,1500,"TCTTGTGATGGTGTAACTAC","CAGCTAATCTAAATTGAAGG","561307.5.peg.2165","1297"
"15634",414,9,405,"TAACTTCTTCTAATGCTCT","CAGCTAATCTAAATTGAAGG","561307.5.peg.2165","1297"
"15635",1521,9,1512,"CCAAGTACCATATCTTGTGA","CAGCTAATCTAAATTGAAGG","561307.5.peg.2165","1297"
"15636",1289,9,1280,"GTCTATGAAGTGTTGGTGCA","CAGCTAATCTAAATTGAAGG","561307.5.peg.2165","1297"
"15637",381,9,372,"AGTAATAATCCCATACGACT","CAGCTAATCTAAATTGAAGG","561307.5.peg.2165","1297"
"15638",744,9,735,"CGAATTTCTGGTGGGATGAT","CAGCTAATCTAAATTGAAGG","561307.5.peg.2165","1297"
"15639",1368,9,1359,"TATAAGCTGTTGTTACAAG","CAGCTAATCTAAATTGAAGG","561307.5.peg.2165","1297"
"15640",1332,9,1323,"GCACGACCTTCAACTAAAGT","CAGCTAATCTAAATTGAAGG","561307.5.peg.2165","1297"
"15641",1409,9,1400,"AAGGAACGTGAACCGCCATT","CAGCTAATCTAAATTGAAGG","561307.5.peg.2165","1297"
"15642",960,9,951,"CGGTTACCTGGGCCAGTAAC","CAGCTAATCTAAATTGAAGG","561307.5.peg.2165","1297"
"15643",141,9,132,"GTACGGTAGTTGATTGTTTC","CAGCTAATCTAAATTGAAGG","561307.5.peg.2165","1297"
"15644",1821,9,1812,"GGATCGATGAAATATCTGTT","CAGCTAATCTAAATTGAAGG","561307.5.peg.2165","1297"
"15645",348,12,336,"AATACCAAATGTGAGAAAC","GCACAGCTAATCTAAATTGA","561307.5.peg.2165","1297"
"15646",1332,12,1320,"GCACGACCTTCAACTAAAGT","GCACAGCTAATCTAAATTGA","561307.5.peg.2165","1297"
"15647",1409,12,1397,"AAGGAACGTGAACCGCCATT","GCACAGCTAATCTAAATTGA","561307.5.peg.2165","1297"
"15648",1368,12,1356,"TATAAGCTGTTGTTACAAG","GCACAGCTAATCTAAATTGA","561307.5.peg.2165","1297"
"15649",1275,12,1263,"GGTGCACGGTTAAGTAATAC","GCACAGCTAATCTAAATTGA","561307.5.peg.2165","1297"
"15650",752,12,740,"CCATTGGACGAATTTCTGGT","GCACAGCTAATCTAAATTGA","561307.5.peg.2165","1297"
"15651",1509,12,1497,"TCTTGTGATGGTGTAACTAC","GCACAGCTAATCTAAATTGA","561307.5.peg.2165","1297"
"15652",744,12,732,"CGAATTTCTGGTGGGATGAT","GCACAGCTAATCTAAATTGA","561307.5.peg.2165","1297"
"15653",698,12,686,"AAGGTTTGTTACCTGAATTA","GCACAGCTAATCTAAATTGA","561307.5.peg.2165","1297"
"15654",1821,12,1809,"GGATCGATGAAATATCTGTT","GCACAGCTAATCTAAATTGA","561307.5.peg.2165","1297"
"15655",414,12,402,"TAACTTCTTCTAATGCTCT","GCACAGCTAATCTAAATTGA","561307.5.peg.2165","1297"
"15656",381,12,369,"AGTAATAATCCCATACGACT","GCACAGCTAATCTAAATTGA","561307.5.peg.2165","1297"
"15657",1289,12,1277,"GTCTATGAAGTGTTGGTGCA","GCACAGCTAATCTAAATTGA","561307.5.peg.2165","1297"
"15658",960,12,948,"CGGTTACCTGGGCCAGTAAC","GCACAGCTAATCTAAATTGA","561307.5.peg.2165","1297"
"15659",1521,12,1509,"CCAAGTACCATATCTTGTGA","GCACAGCTAATCTAAATTGA","561307.5.peg.2165","1297"
"15660",141,12,129,"GTACGGTAGTTGATTGTTTC","GCACAGCTAATCTAAATTGA","561307.5.peg.2165","1297"
"15661",348,141,207,"AATACCAAATGTGAGAAAC","GTACGGTAGTTGATTGTTTC","561307.5.peg.2165","1297"
"15662",744,141,603,"CGAATTTCTGGTGGGATGAT","GTACGGTAGTTGATTGTTTC","561307.5.peg.2165","1297"
"15663",752,141,611,"CCATTGGACGAATTTCTGGT","GTACGGTAGTTGATTGTTTC","561307.5.peg.2165","1297"
"15664",1289,141,1148,"GTCTATGAAGTGTTGGTGCA","GTACGGTAGTTGATTGTTTC","561307.5.peg.2165","1297"
"15665",381,141,240,"AGTAATAATCCCATACGACT","GTACGGTAGTTGATTGTTTC","561307.5.peg.2165","1297"
"15666",1821,141,1680,"GGATCGATGAAATATCTGTT","GTACGGTAGTTGATTGTTTC","561307.5.peg.2165","1297"
"15667",1509,141,1368,"TCTTGTGATGGTGTAACTAC","GTACGGTAGTTGATTGTTTC","561307.5.peg.2165","1297"
"15668",414,141,273,"TAACTTCTTCTAATGCTCT","GTACGGTAGTTGATTGTTTC","561307.5.peg.2165","1297"
"15669",960,141,819,"CGGTTACCTGGGCCAGTAAC","GTACGGTAGTTGATTGTTTC","561307.5.peg.2165","1297"
"15670",12,141,129,"GCACAGCTAATCTAAATTGA","GTACGGTAGTTGATTGTTTC","561307.5.peg.2165","1297"
"15671",698,141,557,"AAGGTTTGTTACCTGAATTA","GTACGGTAGTTGATTGTTTC","561307.5.peg.2165","1297"
"15672",1332,141,1191,"GCACGACCTTCAACTAAAGT","GTACGGTAGTTGATTGTTTC","561307.5.peg.2165","1297"
"15673",9,141,132,"CAGCTAATCTAAATTGAAGG","GTACGGTAGTTGATTGTTTC","561307.5.peg.2165","1297"
"15674",1275,141,1134,"GGTGCACGGTTAAGTAATAC","GTACGGTAGTTGATTGTTTC","561307.5.peg.2165","1297"
"15675",1368,141,1227,"TATAAGCTGTTGTTACAAG","GTACGGTAGTTGATTGTTTC","561307.5.peg.2165","1297"
"15676",1409,141,1268,"AAGGAACGTGAACCGCCATT","GTACGGTAGTTGATTGTTTC","561307.5.peg.2165","1297"
"15677",1521,141,1380,"CCAAGTACCATATCTTGTGA","GTACGGTAGTTGATTGTTTC","561307.5.peg.2165","1297"
"15678",5,141,136,"AATCTAAATTGAAGGAGGT","GTACGGTAGTTGATTGTTTC","561307.5.peg.2165","1297"
"15679",960,348,612,"CGGTTACCTGGGCCAGTAAC","AATACCAAATGTGAGAAAC","561307.5.peg.2165","1297"
"15680",1289,348,941,"GTCTATGAAGTGTTGGTGCA","AATACCAAATGTGAGAAAC","561307.5.peg.2165","1297"
"15681",141,348,207,"GTACGGTAGTTGATTGTTTC","AATACCAAATGTGAGAAAC","561307.5.peg.2165","1297"
"15682",752,348,404,"CCATTGGACGAATTTCTGGT","AATACCAAATGTGAGAAAC","561307.5.peg.2165","1297"
"15683",1509,348,1161,"TCTTGTGATGGTGTAACTAC","AATACCAAATGTGAGAAAC","561307.5.peg.2165","1297"
"15684",1821,348,1473,"GGATCGATGAAATATCTGTT","AATACCAAATGTGAGAAAC","561307.5.peg.2165","1297"
"15685",9,348,339,"CAGCTAATCTAAATTGAAGG","AATACCAAATGTGAGAAAC","561307.5.peg.2165","1297"
"15686",1368,348,1020,"TATAAGCTGTTGTTACAAG","AATACCAAATGTGAGAAAC","561307.5.peg.2165","1297"
"15687",1521,348,1173,"CCAAGTACCATATCTTGTGA","AATACCAAATGTGAGAAAC","561307.5.peg.2165","1297"
"15688",5,348,343,"AATCTAAATTGAAGGAGGT","AATACCAAATGTGAGAAAC","561307.5.peg.2165","1297"
"15689",1332,348,984,"GCACGACCTTCAACTAAAGT","AATACCAAATGTGAGAAAC","561307.5.peg.2165","1297"
"15690",1409,348,1061,"AAGGAACGTGAACCGCCATT","AATACCAAATGTGAGAAAC","561307.5.peg.2165","1297"
"15691",1275,348,927,"GGTGCACGGTTAAGTAATAC","AATACCAAATGTGAGAAAC","561307.5.peg.2165","1297"
"15692",12,348,336,"GCACAGCTAATCTAAATTGA","AATACCAAATGTGAGAAAC","561307.5.peg.2165","1297"
"15693",744,348,396,"CGAATTTCTGGTGGGATGAT","AATACCAAATGTGAGAAAC","561307.5.peg.2165","1297"
"15694",698,348,350,"AAGGTTTGTTACCTGAATTA","AATACCAAATGTGAGAAAC","561307.5.peg.2165","1297"
"15695",1409,381,1028,"AAGGAACGTGAACCGCCATT","AGTAATAATCCCATACGACT","561307.5.peg.2165","1297"
"15696",141,381,240,"GTACGGTAGTTGATTGTTTC","AGTAATAATCCCATACGACT","561307.5.peg.2165","1297"
"15697",744,381,363,"CGAATTTCTGGTGGGATGAT","AGTAATAATCCCATACGACT","561307.5.peg.2165","1297"
"15698",698,381,317,"AAGGTTTGTTACCTGAATTA","AGTAATAATCCCATACGACT","561307.5.peg.2165","1297"
"15699",5,381,376,"AATCTAAATTGAAGGAGGT","AGTAATAATCCCATACGACT","561307.5.peg.2165","1297"
"15700",1289,381,908,"GTCTATGAAGTGTTGGTGCA","AGTAATAATCCCATACGACT","561307.5.peg.2165","1297"
"15701",1521,381,1140,"CCAAGTACCATATCTTGTGA","AGTAATAATCCCATACGACT","561307.5.peg.2165","1297"
"15702",12,381,369,"GCACAGCTAATCTAAATTGA","AGTAATAATCCCATACGACT","561307.5.peg.2165","1297"
"15703",9,381,372,"CAGCTAATCTAAATTGAAGG","AGTAATAATCCCATACGACT","561307.5.peg.2165","1297"
"15704",1368,381,987,"TATAAGCTGTTGTTACAAG","AGTAATAATCCCATACGACT","561307.5.peg.2165","1297"
"15705",1332,381,951,"GCACGACCTTCAACTAAAGT","AGTAATAATCCCATACGACT","561307.5.peg.2165","1297"
"15706",1509,381,1128,"TCTTGTGATGGTGTAACTAC","AGTAATAATCCCATACGACT","561307.5.peg.2165","1297"
"15707",960,381,579,"CGGTTACCTGGGCCAGTAAC","AGTAATAATCCCATACGACT","561307.5.peg.2165","1297"
"15708",1821,381,1440,"GGATCGATGAAATATCTGTT","AGTAATAATCCCATACGACT","561307.5.peg.2165","1297"
"15709",752,381,371,"CCATTGGACGAATTTCTGGT","AGTAATAATCCCATACGACT","561307.5.peg.2165","1297"
"15710",1275,381,894,"GGTGCACGGTTAAGTAATAC","AGTAATAATCCCATACGACT","561307.5.peg.2165","1297"
"15711",744,414,330,"CGAATTTCTGGTGGGATGAT","TAACTTCTTCTAATGCTCT","561307.5.peg.2165","1297"
"15712",1368,414,954,"TATAAGCTGTTGTTACAAG","TAACTTCTTCTAATGCTCT","561307.5.peg.2165","1297"
"15713",1409,414,995,"AAGGAACGTGAACCGCCATT","TAACTTCTTCTAATGCTCT","561307.5.peg.2165","1297"
"15714",1821,414,1407,"GGATCGATGAAATATCTGTT","TAACTTCTTCTAATGCTCT","561307.5.peg.2165","1297"
"15715",1289,414,875,"GTCTATGAAGTGTTGGTGCA","TAACTTCTTCTAATGCTCT","561307.5.peg.2165","1297"
"15716",960,414,546,"CGGTTACCTGGGCCAGTAAC","TAACTTCTTCTAATGCTCT","561307.5.peg.2165","1297"
"15717",141,414,273,"GTACGGTAGTTGATTGTTTC","TAACTTCTTCTAATGCTCT","561307.5.peg.2165","1297"
"15718",12,414,402,"GCACAGCTAATCTAAATTGA","TAACTTCTTCTAATGCTCT","561307.5.peg.2165","1297"
"15719",1521,414,1107,"CCAAGTACCATATCTTGTGA","TAACTTCTTCTAATGCTCT","561307.5.peg.2165","1297"
"15720",9,414,405,"CAGCTAATCTAAATTGAAGG","TAACTTCTTCTAATGCTCT","561307.5.peg.2165","1297"
"15721",1275,414,861,"GGTGCACGGTTAAGTAATAC","TAACTTCTTCTAATGCTCT","561307.5.peg.2165","1297"
"15722",752,414,338,"CCATTGGACGAATTTCTGGT","TAACTTCTTCTAATGCTCT","561307.5.peg.2165","1297"
"15723",5,414,409,"AATCTAAATTGAAGGAGGT","TAACTTCTTCTAATGCTCT","561307.5.peg.2165","1297"
"15724",1332,414,918,"GCACGACCTTCAACTAAAGT","TAACTTCTTCTAATGCTCT","561307.5.peg.2165","1297"
"15725",1509,414,1095,"TCTTGTGATGGTGTAACTAC","TAACTTCTTCTAATGCTCT","561307.5.peg.2165","1297"
"15726",698,414,284,"AAGGTTTGTTACCTGAATTA","TAACTTCTTCTAATGCTCT","561307.5.peg.2165","1297"
"15727",141,698,557,"GTACGGTAGTTGATTGTTTC","AAGGTTTGTTACCTGAATTA","561307.5.peg.2165","1297"
"15728",1509,698,811,"TCTTGTGATGGTGTAACTAC","AAGGTTTGTTACCTGAATTA","561307.5.peg.2165","1297"
"15729",1275,698,577,"GGTGCACGGTTAAGTAATAC","AAGGTTTGTTACCTGAATTA","561307.5.peg.2165","1297"
"15730",1521,698,823,"CCAAGTACCATATCTTGTGA","AAGGTTTGTTACCTGAATTA","561307.5.peg.2165","1297"
"15731",9,698,689,"CAGCTAATCTAAATTGAAGG","AAGGTTTGTTACCTGAATTA","561307.5.peg.2165","1297"
"15732",1821,698,1123,"GGATCGATGAAATATCTGTT","AAGGTTTGTTACCTGAATTA","561307.5.peg.2165","1297"
"15733",960,698,262,"CGGTTACCTGGGCCAGTAAC","AAGGTTTGTTACCTGAATTA","561307.5.peg.2165","1297"
"15734",348,698,350,"AATACCAAATGTGAGAAAC","AAGGTTTGTTACCTGAATTA","561307.5.peg.2165","1297"
"15735",1409,698,711,"AAGGAACGTGAACCGCCATT","AAGGTTTGTTACCTGAATTA","561307.5.peg.2165","1297"
"15736",5,698,693,"AATCTAAATTGAAGGAGGT","AAGGTTTGTTACCTGAATTA","561307.5.peg.2165","1297"
"15737",1368,698,670,"TATAAGCTGTTGTTACAAG","AAGGTTTGTTACCTGAATTA","561307.5.peg.2165","1297"
"15738",414,698,284,"TAACTTCTTCTAATGCTCT","AAGGTTTGTTACCTGAATTA","561307.5.peg.2165","1297"
"15739",1289,698,591,"GTCTATGAAGTGTTGGTGCA","AAGGTTTGTTACCTGAATTA","561307.5.peg.2165","1297"
"15740",381,698,317,"AGTAATAATCCCATACGACT","AAGGTTTGTTACCTGAATTA","561307.5.peg.2165","1297"
"15741",1332,698,634,"GCACGACCTTCAACTAAAGT","AAGGTTTGTTACCTGAATTA","561307.5.peg.2165","1297"
"15742",12,698,686,"GCACAGCTAATCTAAATTGA","AAGGTTTGTTACCTGAATTA","561307.5.peg.2165","1297"
"15743",9,744,735,"CAGCTAATCTAAATTGAAGG","CGAATTTCTGGTGGGATGAT","561307.5.peg.2165","1297"
"15744",348,744,396,"AATACCAAATGTGAGAAAC","CGAATTTCTGGTGGGATGAT","561307.5.peg.2165","1297"
"15745",1821,744,1077,"GGATCGATGAAATATCTGTT","CGAATTTCTGGTGGGATGAT","561307.5.peg.2165","1297"
"15746",1409,744,665,"AAGGAACGTGAACCGCCATT","CGAATTTCTGGTGGGATGAT","561307.5.peg.2165","1297"
"15747",12,744,732,"GCACAGCTAATCTAAATTGA","CGAATTTCTGGTGGGATGAT","561307.5.peg.2165","1297"
"15748",1521,744,777,"CCAAGTACCATATCTTGTGA","CGAATTTCTGGTGGGATGAT","561307.5.peg.2165","1297"
"15749",1289,744,545,"GTCTATGAAGTGTTGGTGCA","CGAATTTCTGGTGGGATGAT","561307.5.peg.2165","1297"
"15750",141,744,603,"GTACGGTAGTTGATTGTTTC","CGAATTTCTGGTGGGATGAT","561307.5.peg.2165","1297"
"15751",1509,744,765,"TCTTGTGATGGTGTAACTAC","CGAATTTCTGGTGGGATGAT","561307.5.peg.2165","1297"
"15752",5,744,739,"AATCTAAATTGAAGGAGGT","CGAATTTCTGGTGGGATGAT","561307.5.peg.2165","1297"
"15753",1368,744,624,"TATAAGCTGTTGTTACAAG","CGAATTTCTGGTGGGATGAT","561307.5.peg.2165","1297"
"15754",381,744,363,"AGTAATAATCCCATACGACT","CGAATTTCTGGTGGGATGAT","561307.5.peg.2165","1297"
"15755",1275,744,531,"GGTGCACGGTTAAGTAATAC","CGAATTTCTGGTGGGATGAT","561307.5.peg.2165","1297"
"15756",414,744,330,"TAACTTCTTCTAATGCTCT","CGAATTTCTGGTGGGATGAT","561307.5.peg.2165","1297"
"15757",1332,744,588,"GCACGACCTTCAACTAAAGT","CGAATTTCTGGTGGGATGAT","561307.5.peg.2165","1297"
"15758",960,744,216,"CGGTTACCTGGGCCAGTAAC","CGAATTTCTGGTGGGATGAT","561307.5.peg.2165","1297"
"15759",1289,752,537,"GTCTATGAAGTGTTGGTGCA","CCATTGGACGAATTTCTGGT","561307.5.peg.2165","1297"
"15760",381,752,371,"AGTAATAATCCCATACGACT","CCATTGGACGAATTTCTGGT","561307.5.peg.2165","1297"
"15761",414,752,338,"TAACTTCTTCTAATGCTCT","CCATTGGACGAATTTCTGGT","561307.5.peg.2165","1297"
"15762",1821,752,1069,"GGATCGATGAAATATCTGTT","CCATTGGACGAATTTCTGGT","561307.5.peg.2165","1297"
"15763",1275,752,523,"GGTGCACGGTTAAGTAATAC","CCATTGGACGAATTTCTGGT","561307.5.peg.2165","1297"
"15764",1368,752,616,"TATAAGCTGTTGTTACAAG","CCATTGGACGAATTTCTGGT","561307.5.peg.2165","1297"
"15765",1332,752,580,"GCACGACCTTCAACTAAAGT","CCATTGGACGAATTTCTGGT","561307.5.peg.2165","1297"
"15766",1409,752,657,"AAGGAACGTGAACCGCCATT","CCATTGGACGAATTTCTGGT","561307.5.peg.2165","1297"
"15767",960,752,208,"CGGTTACCTGGGCCAGTAAC","CCATTGGACGAATTTCTGGT","561307.5.peg.2165","1297"
"15768",12,752,740,"GCACAGCTAATCTAAATTGA","CCATTGGACGAATTTCTGGT","561307.5.peg.2165","1297"
"15769",348,752,404,"AATACCAAATGTGAGAAAC","CCATTGGACGAATTTCTGGT","561307.5.peg.2165","1297"
"15770",5,752,747,"AATCTAAATTGAAGGAGGT","CCATTGGACGAATTTCTGGT","561307.5.peg.2165","1297"
"15771",1509,752,757,"TCTTGTGATGGTGTAACTAC","CCATTGGACGAATTTCTGGT","561307.5.peg.2165","1297"
"15772",1521,752,769,"CCAAGTACCATATCTTGTGA","CCATTGGACGAATTTCTGGT","561307.5.peg.2165","1297"
"15773",9,752,743,"CAGCTAATCTAAATTGAAGG","CCATTGGACGAATTTCTGGT","561307.5.peg.2165","1297"
"15774",141,752,611,"GTACGGTAGTTGATTGTTTC","CCATTGGACGAATTTCTGGT","561307.5.peg.2165","1297"
"15775",12,960,948,"GCACAGCTAATCTAAATTGA","CGGTTACCTGGGCCAGTAAC","561307.5.peg.2165","1297"
"15776",1275,960,315,"GGTGCACGGTTAAGTAATAC","CGGTTACCTGGGCCAGTAAC","561307.5.peg.2165","1297"
"15777",744,960,216,"CGAATTTCTGGTGGGATGAT","CGGTTACCTGGGCCAGTAAC","561307.5.peg.2165","1297"
"15778",1289,960,329,"GTCTATGAAGTGTTGGTGCA","CGGTTACCTGGGCCAGTAAC","561307.5.peg.2165","1297"
"15779",348,960,612,"AATACCAAATGTGAGAAAC","CGGTTACCTGGGCCAGTAAC","561307.5.peg.2165","1297"
"15780",1509,960,549,"TCTTGTGATGGTGTAACTAC","CGGTTACCTGGGCCAGTAAC","561307.5.peg.2165","1297"
"15781",1821,960,861,"GGATCGATGAAATATCTGTT","CGGTTACCTGGGCCAGTAAC","561307.5.peg.2165","1297"
"15782",381,960,579,"AGTAATAATCCCATACGACT","CGGTTACCTGGGCCAGTAAC","561307.5.peg.2165","1297"
"15783",1409,960,449,"AAGGAACGTGAACCGCCATT","CGGTTACCTGGGCCAGTAAC","561307.5.peg.2165","1297"
"15784",1332,960,372,"GCACGACCTTCAACTAAAGT","CGGTTACCTGGGCCAGTAAC","561307.5.peg.2165","1297"
"15785",1521,960,561,"CCAAGTACCATATCTTGTGA","CGGTTACCTGGGCCAGTAAC","561307.5.peg.2165","1297"
"15786",141,960,819,"GTACGGTAGTTGATTGTTTC","CGGTTACCTGGGCCAGTAAC","561307.5.peg.2165","1297"
"15787",9,960,951,"CAGCTAATCTAAATTGAAGG","CGGTTACCTGGGCCAGTAAC","561307.5.peg.2165","1297"
"15788",5,960,955,"AATCTAAATTGAAGGAGGT","CGGTTACCTGGGCCAGTAAC","561307.5.peg.2165","1297"
"15789",752,960,208,"CCATTGGACGAATTTCTGGT","CGGTTACCTGGGCCAGTAAC","561307.5.peg.2165","1297"
"15790",698,960,262,"AAGGTTTGTTACCTGAATTA","CGGTTACCTGGGCCAGTAAC","561307.5.peg.2165","1297"
"15791",1368,960,408,"TATAAGCTGTTGTTACAAG","CGGTTACCTGGGCCAGTAAC","561307.5.peg.2165","1297"
"15792",414,960,546,"TAACTTCTTCTAATGCTCT","CGGTTACCTGGGCCAGTAAC","561307.5.peg.2165","1297"
"15793",414,1275,861,"TAACTTCTTCTAATGCTCT","GGTGCACGGTTAAGTAATAC","561307.5.peg.2165","1297"
"15794",752,1275,523,"CCATTGGACGAATTTCTGGT","GGTGCACGGTTAAGTAATAC","561307.5.peg.2165","1297"
"15795",381,1275,894,"AGTAATAATCCCATACGACT","GGTGCACGGTTAAGTAATAC","561307.5.peg.2165","1297"
"15796",744,1275,531,"CGAATTTCTGGTGGGATGAT","GGTGCACGGTTAAGTAATAC","561307.5.peg.2165","1297"
"15797",1509,1275,234,"TCTTGTGATGGTGTAACTAC","GGTGCACGGTTAAGTAATAC","561307.5.peg.2165","1297"
"15798",1821,1275,546,"GGATCGATGAAATATCTGTT","GGTGCACGGTTAAGTAATAC","561307.5.peg.2165","1297"
"15799",5,1275,1270,"AATCTAAATTGAAGGAGGT","GGTGCACGGTTAAGTAATAC","561307.5.peg.2165","1297"
"15800",1409,1275,134,"AAGGAACGTGAACCGCCATT","GGTGCACGGTTAAGTAATAC","561307.5.peg.2165","1297"
"15801",12,1275,1263,"GCACAGCTAATCTAAATTGA","GGTGCACGGTTAAGTAATAC","561307.5.peg.2165","1297"
"15802",9,1275,1266,"CAGCTAATCTAAATTGAAGG","GGTGCACGGTTAAGTAATAC","561307.5.peg.2165","1297"
"15803",141,1275,1134,"GTACGGTAGTTGATTGTTTC","GGTGCACGGTTAAGTAATAC","561307.5.peg.2165","1297"
"15804",1521,1275,246,"CCAAGTACCATATCTTGTGA","GGTGCACGGTTAAGTAATAC","561307.5.peg.2165","1297"
"15805",698,1275,577,"AAGGTTTGTTACCTGAATTA","GGTGCACGGTTAAGTAATAC","561307.5.peg.2165","1297"
"15806",960,1275,315,"CGGTTACCTGGGCCAGTAAC","GGTGCACGGTTAAGTAATAC","561307.5.peg.2165","1297"
"15807",348,1275,927,"AATACCAAATGTGAGAAAC","GGTGCACGGTTAAGTAATAC","561307.5.peg.2165","1297"
"15808",381,1289,908,"AGTAATAATCCCATACGACT","GTCTATGAAGTGTTGGTGCA","561307.5.peg.2165","1297"
"15809",1821,1289,532,"GGATCGATGAAATATCTGTT","GTCTATGAAGTGTTGGTGCA","561307.5.peg.2165","1297"
"15810",348,1289,941,"AATACCAAATGTGAGAAAC","GTCTATGAAGTGTTGGTGCA","561307.5.peg.2165","1297"
"15811",698,1289,591,"AAGGTTTGTTACCTGAATTA","GTCTATGAAGTGTTGGTGCA","561307.5.peg.2165","1297"
"15812",744,1289,545,"CGAATTTCTGGTGGGATGAT","GTCTATGAAGTGTTGGTGCA","561307.5.peg.2165","1297"
"15813",5,1289,1284,"AATCTAAATTGAAGGAGGT","GTCTATGAAGTGTTGGTGCA","561307.5.peg.2165","1297"
"15814",414,1289,875,"TAACTTCTTCTAATGCTCT","GTCTATGAAGTGTTGGTGCA","561307.5.peg.2165","1297"
"15815",9,1289,1280,"CAGCTAATCTAAATTGAAGG","GTCTATGAAGTGTTGGTGCA","561307.5.peg.2165","1297"
"15816",1521,1289,232,"CCAAGTACCATATCTTGTGA","GTCTATGAAGTGTTGGTGCA","561307.5.peg.2165","1297"
"15817",1409,1289,120,"AAGGAACGTGAACCGCCATT","GTCTATGAAGTGTTGGTGCA","561307.5.peg.2165","1297"
"15818",141,1289,1148,"GTACGGTAGTTGATTGTTTC","GTCTATGAAGTGTTGGTGCA","561307.5.peg.2165","1297"
"15819",752,1289,537,"CCATTGGACGAATTTCTGGT","GTCTATGAAGTGTTGGTGCA","561307.5.peg.2165","1297"
"15820",1509,1289,220,"TCTTGTGATGGTGTAACTAC","GTCTATGAAGTGTTGGTGCA","561307.5.peg.2165","1297"
"15821",960,1289,329,"CGGTTACCTGGGCCAGTAAC","GTCTATGAAGTGTTGGTGCA","561307.5.peg.2165","1297"
"15822",12,1289,1277,"GCACAGCTAATCTAAATTGA","GTCTATGAAGTGTTGGTGCA","561307.5.peg.2165","1297"
"15823",1521,1332,189,"CCAAGTACCATATCTTGTGA","GCACGACCTTCAACTAAAGT","561307.5.peg.2165","1297"
"15824",698,1332,634,"AAGGTTTGTTACCTGAATTA","GCACGACCTTCAACTAAAGT","561307.5.peg.2165","1297"
"15825",1509,1332,177,"TCTTGTGATGGTGTAACTAC","GCACGACCTTCAACTAAAGT","561307.5.peg.2165","1297"
"15826",960,1332,372,"CGGTTACCTGGGCCAGTAAC","GCACGACCTTCAACTAAAGT","561307.5.peg.2165","1297"
"15827",5,1332,1327,"AATCTAAATTGAAGGAGGT","GCACGACCTTCAACTAAAGT","561307.5.peg.2165","1297"
"15828",9,1332,1323,"CAGCTAATCTAAATTGAAGG","GCACGACCTTCAACTAAAGT","561307.5.peg.2165","1297"
"15829",12,1332,1320,"GCACAGCTAATCTAAATTGA","GCACGACCTTCAACTAAAGT","561307.5.peg.2165","1297"
"15830",752,1332,580,"CCATTGGACGAATTTCTGGT","GCACGACCTTCAACTAAAGT","561307.5.peg.2165","1297"
"15831",414,1332,918,"TAACTTCTTCTAATGCTCT","GCACGACCTTCAACTAAAGT","561307.5.peg.2165","1297"
"15832",381,1332,951,"AGTAATAATCCCATACGACT","GCACGACCTTCAACTAAAGT","561307.5.peg.2165","1297"
"15833",744,1332,588,"CGAATTTCTGGTGGGATGAT","GCACGACCTTCAACTAAAGT","561307.5.peg.2165","1297"
"15834",348,1332,984,"AATACCAAATGTGAGAAAC","GCACGACCTTCAACTAAAGT","561307.5.peg.2165","1297"
"15835",141,1332,1191,"GTACGGTAGTTGATTGTTTC","GCACGACCTTCAACTAAAGT","561307.5.peg.2165","1297"
"15836",1821,1332,489,"GGATCGATGAAATATCTGTT","GCACGACCTTCAACTAAAGT","561307.5.peg.2165","1297"
"15837",1509,1368,141,"TCTTGTGATGGTGTAACTAC","TATAAGCTGTTGTTACAAG","561307.5.peg.2165","1297"
"15838",752,1368,616,"CCATTGGACGAATTTCTGGT","TATAAGCTGTTGTTACAAG","561307.5.peg.2165","1297"
"15839",1521,1368,153,"CCAAGTACCATATCTTGTGA","TATAAGCTGTTGTTACAAG","561307.5.peg.2165","1297"
"15840",960,1368,408,"CGGTTACCTGGGCCAGTAAC","TATAAGCTGTTGTTACAAG","561307.5.peg.2165","1297"
"15841",141,1368,1227,"GTACGGTAGTTGATTGTTTC","TATAAGCTGTTGTTACAAG","561307.5.peg.2165","1297"
"15842",744,1368,624,"CGAATTTCTGGTGGGATGAT","TATAAGCTGTTGTTACAAG","561307.5.peg.2165","1297"
"15843",348,1368,1020,"AATACCAAATGTGAGAAAC","TATAAGCTGTTGTTACAAG","561307.5.peg.2165","1297"
"15844",698,1368,670,"AAGGTTTGTTACCTGAATTA","TATAAGCTGTTGTTACAAG","561307.5.peg.2165","1297"
"15845",12,1368,1356,"GCACAGCTAATCTAAATTGA","TATAAGCTGTTGTTACAAG","561307.5.peg.2165","1297"
"15846",414,1368,954,"TAACTTCTTCTAATGCTCT","TATAAGCTGTTGTTACAAG","561307.5.peg.2165","1297"
"15847",5,1368,1363,"AATCTAAATTGAAGGAGGT","TATAAGCTGTTGTTACAAG","561307.5.peg.2165","1297"
"15848",381,1368,987,"AGTAATAATCCCATACGACT","TATAAGCTGTTGTTACAAG","561307.5.peg.2165","1297"
"15849",9,1368,1359,"CAGCTAATCTAAATTGAAGG","TATAAGCTGTTGTTACAAG","561307.5.peg.2165","1297"
"15850",1821,1368,453,"GGATCGATGAAATATCTGTT","TATAAGCTGTTGTTACAAG","561307.5.peg.2165","1297"
"15851",1821,1409,412,"GGATCGATGAAATATCTGTT","AAGGAACGTGAACCGCCATT","561307.5.peg.2165","1297"
"15852",141,1409,1268,"GTACGGTAGTTGATTGTTTC","AAGGAACGTGAACCGCCATT","561307.5.peg.2165","1297"
"15853",414,1409,995,"TAACTTCTTCTAATGCTCT","AAGGAACGTGAACCGCCATT","561307.5.peg.2165","1297"
"15854",12,1409,1397,"GCACAGCTAATCTAAATTGA","AAGGAACGTGAACCGCCATT","561307.5.peg.2165","1297"
"15855",348,1409,1061,"AATACCAAATGTGAGAAAC","AAGGAACGTGAACCGCCATT","561307.5.peg.2165","1297"
"15856",9,1409,1400,"CAGCTAATCTAAATTGAAGG","AAGGAACGTGAACCGCCATT","561307.5.peg.2165","1297"
"15857",1289,1409,120,"GTCTATGAAGTGTTGGTGCA","AAGGAACGTGAACCGCCATT","561307.5.peg.2165","1297"
"15858",5,1409,1404,"AATCTAAATTGAAGGAGGT","AAGGAACGTGAACCGCCATT","561307.5.peg.2165","1297"
"15859",1275,1409,134,"GGTGCACGGTTAAGTAATAC","AAGGAACGTGAACCGCCATT","561307.5.peg.2165","1297"
"15860",960,1409,449,"CGGTTACCTGGGCCAGTAAC","AAGGAACGTGAACCGCCATT","561307.5.peg.2165","1297"
"15861",744,1409,665,"CGAATTTCTGGTGGGATGAT","AAGGAACGTGAACCGCCATT","561307.5.peg.2165","1297"
"15862",698,1409,711,"AAGGTTTGTTACCTGAATTA","AAGGAACGTGAACCGCCATT","561307.5.peg.2165","1297"
"15863",1521,1409,112,"CCAAGTACCATATCTTGTGA","AAGGAACGTGAACCGCCATT","561307.5.peg.2165","1297"
"15864",381,1409,1028,"AGTAATAATCCCATACGACT","AAGGAACGTGAACCGCCATT","561307.5.peg.2165","1297"
"15865",1509,1409,100,"TCTTGTGATGGTGTAACTAC","AAGGAACGTGAACCGCCATT","561307.5.peg.2165","1297"
"15866",752,1409,657,"CCATTGGACGAATTTCTGGT","AAGGAACGTGAACCGCCATT","561307.5.peg.2165","1297"
"15867",348,1509,1161,"AATACCAAATGTGAGAAAC","TCTTGTGATGGTGTAACTAC","561307.5.peg.2165","1297"
"15868",141,1509,1368,"GTACGGTAGTTGATTGTTTC","TCTTGTGATGGTGTAACTAC","561307.5.peg.2165","1297"
"15869",744,1509,765,"CGAATTTCTGGTGGGATGAT","TCTTGTGATGGTGTAACTAC","561307.5.peg.2165","1297"
"15870",960,1509,549,"CGGTTACCTGGGCCAGTAAC","TCTTGTGATGGTGTAACTAC","561307.5.peg.2165","1297"
"15871",1332,1509,177,"GCACGACCTTCAACTAAAGT","TCTTGTGATGGTGTAACTAC","561307.5.peg.2165","1297"
"15872",698,1509,811,"AAGGTTTGTTACCTGAATTA","TCTTGTGATGGTGTAACTAC","561307.5.peg.2165","1297"
"15873",5,1509,1504,"AATCTAAATTGAAGGAGGT","TCTTGTGATGGTGTAACTAC","561307.5.peg.2165","1297"
"15874",381,1509,1128,"AGTAATAATCCCATACGACT","TCTTGTGATGGTGTAACTAC","561307.5.peg.2165","1297"
"15875",1275,1509,234,"GGTGCACGGTTAAGTAATAC","TCTTGTGATGGTGTAACTAC","561307.5.peg.2165","1297"
"15876",1368,1509,141,"TATAAGCTGTTGTTACAAG","TCTTGTGATGGTGTAACTAC","561307.5.peg.2165","1297"
"15877",414,1509,1095,"TAACTTCTTCTAATGCTCT","TCTTGTGATGGTGTAACTAC","561307.5.peg.2165","1297"
"15878",1821,1509,312,"GGATCGATGAAATATCTGTT","TCTTGTGATGGTGTAACTAC","561307.5.peg.2165","1297"
"15879",12,1509,1497,"GCACAGCTAATCTAAATTGA","TCTTGTGATGGTGTAACTAC","561307.5.peg.2165","1297"
"15880",9,1509,1500,"CAGCTAATCTAAATTGAAGG","TCTTGTGATGGTGTAACTAC","561307.5.peg.2165","1297"
"15881",752,1509,757,"CCATTGGACGAATTTCTGGT","TCTTGTGATGGTGTAACTAC","561307.5.peg.2165","1297"
"15882",1289,1509,220,"GTCTATGAAGTGTTGGTGCA","TCTTGTGATGGTGTAACTAC","561307.5.peg.2165","1297"
"15883",1409,1509,100,"AAGGAACGTGAACCGCCATT","TCTTGTGATGGTGTAACTAC","561307.5.peg.2165","1297"
"15884",9,1521,1512,"CAGCTAATCTAAATTGAAGG","CCAAGTACCATATCTTGTGA","561307.5.peg.2165","1297"
"15885",1289,1521,232,"GTCTATGAAGTGTTGGTGCA","CCAAGTACCATATCTTGTGA","561307.5.peg.2165","1297"
"15886",698,1521,823,"AAGGTTTGTTACCTGAATTA","CCAAGTACCATATCTTGTGA","561307.5.peg.2165","1297"
"15887",1275,1521,246,"GGTGCACGGTTAAGTAATAC","CCAAGTACCATATCTTGTGA","561307.5.peg.2165","1297"
"15888",5,1521,1516,"AATCTAAATTGAAGGAGGT","CCAAGTACCATATCTTGTGA","561307.5.peg.2165","1297"
"15889",381,1521,1140,"AGTAATAATCCCATACGACT","CCAAGTACCATATCTTGTGA","561307.5.peg.2165","1297"
"15890",348,1521,1173,"AATACCAAATGTGAGAAAC","CCAAGTACCATATCTTGTGA","561307.5.peg.2165","1297"
"15891",1409,1521,112,"AAGGAACGTGAACCGCCATT","CCAAGTACCATATCTTGTGA","561307.5.peg.2165","1297"
"15892",12,1521,1509,"GCACAGCTAATCTAAATTGA","CCAAGTACCATATCTTGTGA","561307.5.peg.2165","1297"
"15893",1368,1521,153,"TATAAGCTGTTGTTACAAG","CCAAGTACCATATCTTGTGA","561307.5.peg.2165","1297"
"15894",744,1521,777,"CGAATTTCTGGTGGGATGAT","CCAAGTACCATATCTTGTGA","561307.5.peg.2165","1297"
"15895",960,1521,561,"CGGTTACCTGGGCCAGTAAC","CCAAGTACCATATCTTGTGA","561307.5.peg.2165","1297"
"15896",414,1521,1107,"TAACTTCTTCTAATGCTCT","CCAAGTACCATATCTTGTGA","561307.5.peg.2165","1297"
"15897",1821,1521,300,"GGATCGATGAAATATCTGTT","CCAAGTACCATATCTTGTGA","561307.5.peg.2165","1297"
"15898",1332,1521,189,"GCACGACCTTCAACTAAAGT","CCAAGTACCATATCTTGTGA","561307.5.peg.2165","1297"
"15899",752,1521,769,"CCATTGGACGAATTTCTGGT","CCAAGTACCATATCTTGTGA","561307.5.peg.2165","1297"
"15900",141,1521,1380,"GTACGGTAGTTGATTGTTTC","CCAAGTACCATATCTTGTGA","561307.5.peg.2165","1297"
"15901",5,1821,1816,"AATCTAAATTGAAGGAGGT","GGATCGATGAAATATCTGTT","561307.5.peg.2165","1297"
"15902",960,1821,861,"CGGTTACCTGGGCCAGTAAC","GGATCGATGAAATATCTGTT","561307.5.peg.2165","1297"
"15903",141,1821,1680,"GTACGGTAGTTGATTGTTTC","GGATCGATGAAATATCTGTT","561307.5.peg.2165","1297"
"15904",381,1821,1440,"AGTAATAATCCCATACGACT","GGATCGATGAAATATCTGTT","561307.5.peg.2165","1297"
"15905",9,1821,1812,"CAGCTAATCTAAATTGAAGG","GGATCGATGAAATATCTGTT","561307.5.peg.2165","1297"
"15906",12,1821,1809,"GCACAGCTAATCTAAATTGA","GGATCGATGAAATATCTGTT","561307.5.peg.2165","1297"
"15907",698,1821,1123,"AAGGTTTGTTACCTGAATTA","GGATCGATGAAATATCTGTT","561307.5.peg.2165","1297"
"15908",348,1821,1473,"AATACCAAATGTGAGAAAC","GGATCGATGAAATATCTGTT","561307.5.peg.2165","1297"
"15909",1275,1821,546,"GGTGCACGGTTAAGTAATAC","GGATCGATGAAATATCTGTT","561307.5.peg.2165","1297"
"15910",1289,1821,532,"GTCTATGAAGTGTTGGTGCA","GGATCGATGAAATATCTGTT","561307.5.peg.2165","1297"
"15911",744,1821,1077,"CGAATTTCTGGTGGGATGAT","GGATCGATGAAATATCTGTT","561307.5.peg.2165","1297"
"15912",1332,1821,489,"GCACGACCTTCAACTAAAGT","GGATCGATGAAATATCTGTT","561307.5.peg.2165","1297"
"15913",1409,1821,412,"AAGGAACGTGAACCGCCATT","GGATCGATGAAATATCTGTT","561307.5.peg.2165","1297"
"15914",1509,1821,312,"TCTTGTGATGGTGTAACTAC","GGATCGATGAAATATCTGTT","561307.5.peg.2165","1297"
"15915",414,1821,1407,"TAACTTCTTCTAATGCTCT","GGATCGATGAAATATCTGTT","561307.5.peg.2165","1297"
"15916",1521,1821,300,"CCAAGTACCATATCTTGTGA","GGATCGATGAAATATCTGTT","561307.5.peg.2165","1297"
"15917",1368,1821,453,"TATAAGCTGTTGTTACAAG","GGATCGATGAAATATCTGTT","561307.5.peg.2165","1297"
"15918",752,1821,1069,"CCATTGGACGAATTTCTGGT","GGATCGATGAAATATCTGTT","561307.5.peg.2165","1297"
"15919",222,3,219,"TATTTACGTAACGCTGAGTT","TTTAATCCCACACATCCAGG","561307.5.peg.2167","1299"
"15920",222,65,157,"TATTTACGTAACGCTGAGTT","GTCTTGGTTTACGTACTAAT","561307.5.peg.2167","1299"
"15921",3,222,219,"TTTAATCCCACACATCCAGG","TATTTACGTAACGCTGAGTT","561307.5.peg.2167","1299"
"15922",65,222,157,"GTCTTGGTTTACGTACTAAT","TATTTACGTAACGCTGAGTT","561307.5.peg.2167","1299"
"15923",194,54,140,"GACCACTGCGTTGTTCAACT","TTAGGTACTGATCCTTTACG","561307.5.peg.2168","1300"
"15924",194,90,104,"GACCACTGCGTTGTTCAACT","TAGAGTTATGAATTGGATC","561307.5.peg.2168","1300"
"15925",54,194,140,"TTAGGTACTGATCCTTTACG","GACCACTGCGTTGTTCAACT","561307.5.peg.2168","1300"
"15926",90,194,104,"TAGAGTTATGAATTGGATC","GACCACTGCGTTGTTCAACT","561307.5.peg.2168","1300"
"15927",906,224,682,"CTAGCACGGTGACCAATAAT","CAGATGTGATAGTAATACCA","561307.5.peg.2169","1301"
"15928",785,224,561,"ATTCTACGTTAGTAGTAGCT","CAGATGTGATAGTAATACCA","561307.5.peg.2169","1301"
"15929",812,224,588,"AAGCTGTACCACAAAGTACT","CAGATGTGATAGTAATACCA","561307.5.peg.2169","1301"
"15930",920,224,696,"CTTCTTCAGGGTTGCTAGCA","CAGATGTGATAGTAATACCA","561307.5.peg.2169","1301"
"15931",1034,224,810,"TCATTGTACCTGAATACACA","CAGATGTGATAGTAATACCA","561307.5.peg.2169","1301"
"15932",885,224,661,"GGTTTAACGTCTAGTGGTGA","CAGATGTGATAGTAATACCA","561307.5.peg.2169","1301"
"15933",648,224,424,"GCTCTATCTAAGTGGTCTTC","CAGATGTGATAGTAATACCA","561307.5.peg.2169","1301"
"15934",891,224,667,"TAATTGGTTTAACGTCTAG","CAGATGTGATAGTAATACCA","561307.5.peg.2169","1301"
"15935",543,224,319,"AATTCGTCTTCCGCACCAAT","CAGATGTGATAGTAATACCA","561307.5.peg.2169","1301"
"15936",435,224,211,"TGTTTACAAATACGATACG","CAGATGTGATAGTAATACCA","561307.5.peg.2169","1301"
"15937",656,224,432,"CTTCTTCAGCTCTATCTAAG","CAGATGTGATAGTAATACCA","561307.5.peg.2169","1301"
"15938",812,297,515,"AAGCTGTACCACAAAGTACT","ACAGTGAAGTCTACGTGTCC","561307.5.peg.2169","1301"
"15939",656,297,359,"CTTCTTCAGCTCTATCTAAG","ACAGTGAAGTCTACGTGTCC","561307.5.peg.2169","1301"
"15940",1034,297,737,"TCATTGTACCTGAATACACA","ACAGTGAAGTCTACGTGTCC","561307.5.peg.2169","1301"
"15941",920,297,623,"CTTCTTCAGGGTTGCTAGCA","ACAGTGAAGTCTACGTGTCC","561307.5.peg.2169","1301"
"15942",435,297,138,"TGTTTACAAATACGATACG","ACAGTGAAGTCTACGTGTCC","561307.5.peg.2169","1301"
"15943",885,297,588,"GGTTTAACGTCTAGTGGTGA","ACAGTGAAGTCTACGTGTCC","561307.5.peg.2169","1301"
"15944",891,297,594,"TAATTGGTTTAACGTCTAG","ACAGTGAAGTCTACGTGTCC","561307.5.peg.2169","1301"
"15945",543,297,246,"AATTCGTCTTCCGCACCAAT","ACAGTGAAGTCTACGTGTCC","561307.5.peg.2169","1301"
"15946",648,297,351,"GCTCTATCTAAGTGGTCTTC","ACAGTGAAGTCTACGTGTCC","561307.5.peg.2169","1301"
"15947",785,297,488,"ATTCTACGTTAGTAGTAGCT","ACAGTGAAGTCTACGTGTCC","561307.5.peg.2169","1301"
"15948",906,297,609,"CTAGCACGGTGACCAATAAT","ACAGTGAAGTCTACGTGTCC","561307.5.peg.2169","1301"
"15949",543,435,108,"AATTCGTCTTCCGCACCAAT","TGTTTACAAATACGATACG","561307.5.peg.2169","1301"
"15950",224,435,211,"CAGATGTGATAGTAATACCA","TGTTTACAAATACGATACG","561307.5.peg.2169","1301"
"15951",648,435,213,"GCTCTATCTAAGTGGTCTTC","TGTTTACAAATACGATACG","561307.5.peg.2169","1301"
"15952",885,435,450,"GGTTTAACGTCTAGTGGTGA","TGTTTACAAATACGATACG","561307.5.peg.2169","1301"
"15953",920,435,485,"CTTCTTCAGGGTTGCTAGCA","TGTTTACAAATACGATACG","561307.5.peg.2169","1301"
"15954",656,435,221,"CTTCTTCAGCTCTATCTAAG","TGTTTACAAATACGATACG","561307.5.peg.2169","1301"
"15955",906,435,471,"CTAGCACGGTGACCAATAAT","TGTTTACAAATACGATACG","561307.5.peg.2169","1301"
"15956",812,435,377,"AAGCTGTACCACAAAGTACT","TGTTTACAAATACGATACG","561307.5.peg.2169","1301"
"15957",1034,435,599,"TCATTGTACCTGAATACACA","TGTTTACAAATACGATACG","561307.5.peg.2169","1301"
"15958",785,435,350,"ATTCTACGTTAGTAGTAGCT","TGTTTACAAATACGATACG","561307.5.peg.2169","1301"
"15959",297,435,138,"ACAGTGAAGTCTACGTGTCC","TGTTTACAAATACGATACG","561307.5.peg.2169","1301"
"15960",891,435,456,"TAATTGGTTTAACGTCTAG","TGTTTACAAATACGATACG","561307.5.peg.2169","1301"
"15961",1034,543,491,"TCATTGTACCTGAATACACA","AATTCGTCTTCCGCACCAAT","561307.5.peg.2169","1301"
"15962",891,543,348,"TAATTGGTTTAACGTCTAG","AATTCGTCTTCCGCACCAAT","561307.5.peg.2169","1301"
"15963",812,543,269,"AAGCTGTACCACAAAGTACT","AATTCGTCTTCCGCACCAAT","561307.5.peg.2169","1301"
"15964",435,543,108,"TGTTTACAAATACGATACG","AATTCGTCTTCCGCACCAAT","561307.5.peg.2169","1301"
"15965",656,543,113,"CTTCTTCAGCTCTATCTAAG","AATTCGTCTTCCGCACCAAT","561307.5.peg.2169","1301"
"15966",297,543,246,"ACAGTGAAGTCTACGTGTCC","AATTCGTCTTCCGCACCAAT","561307.5.peg.2169","1301"
"15967",906,543,363,"CTAGCACGGTGACCAATAAT","AATTCGTCTTCCGCACCAAT","561307.5.peg.2169","1301"
"15968",920,543,377,"CTTCTTCAGGGTTGCTAGCA","AATTCGTCTTCCGCACCAAT","561307.5.peg.2169","1301"
"15969",785,543,242,"ATTCTACGTTAGTAGTAGCT","AATTCGTCTTCCGCACCAAT","561307.5.peg.2169","1301"
"15970",648,543,105,"GCTCTATCTAAGTGGTCTTC","AATTCGTCTTCCGCACCAAT","561307.5.peg.2169","1301"
"15971",224,543,319,"CAGATGTGATAGTAATACCA","AATTCGTCTTCCGCACCAAT","561307.5.peg.2169","1301"
"15972",885,543,342,"GGTTTAACGTCTAGTGGTGA","AATTCGTCTTCCGCACCAAT","561307.5.peg.2169","1301"
"15973",885,648,237,"GGTTTAACGTCTAGTGGTGA","GCTCTATCTAAGTGGTCTTC","561307.5.peg.2169","1301"
"15974",435,648,213,"TGTTTACAAATACGATACG","GCTCTATCTAAGTGGTCTTC","561307.5.peg.2169","1301"
"15975",785,648,137,"ATTCTACGTTAGTAGTAGCT","GCTCTATCTAAGTGGTCTTC","561307.5.peg.2169","1301"
"15976",543,648,105,"AATTCGTCTTCCGCACCAAT","GCTCTATCTAAGTGGTCTTC","561307.5.peg.2169","1301"
"15977",1034,648,386,"TCATTGTACCTGAATACACA","GCTCTATCTAAGTGGTCTTC","561307.5.peg.2169","1301"
"15978",297,648,351,"ACAGTGAAGTCTACGTGTCC","GCTCTATCTAAGTGGTCTTC","561307.5.peg.2169","1301"
"15979",920,648,272,"CTTCTTCAGGGTTGCTAGCA","GCTCTATCTAAGTGGTCTTC","561307.5.peg.2169","1301"
"15980",812,648,164,"AAGCTGTACCACAAAGTACT","GCTCTATCTAAGTGGTCTTC","561307.5.peg.2169","1301"
"15981",906,648,258,"CTAGCACGGTGACCAATAAT","GCTCTATCTAAGTGGTCTTC","561307.5.peg.2169","1301"
"15982",224,648,424,"CAGATGTGATAGTAATACCA","GCTCTATCTAAGTGGTCTTC","561307.5.peg.2169","1301"
"15983",891,648,243,"TAATTGGTTTAACGTCTAG","GCTCTATCTAAGTGGTCTTC","561307.5.peg.2169","1301"
"15984",435,656,221,"TGTTTACAAATACGATACG","CTTCTTCAGCTCTATCTAAG","561307.5.peg.2169","1301"
"15985",906,656,250,"CTAGCACGGTGACCAATAAT","CTTCTTCAGCTCTATCTAAG","561307.5.peg.2169","1301"
"15986",812,656,156,"AAGCTGTACCACAAAGTACT","CTTCTTCAGCTCTATCTAAG","561307.5.peg.2169","1301"
"15987",891,656,235,"TAATTGGTTTAACGTCTAG","CTTCTTCAGCTCTATCTAAG","561307.5.peg.2169","1301"
"15988",920,656,264,"CTTCTTCAGGGTTGCTAGCA","CTTCTTCAGCTCTATCTAAG","561307.5.peg.2169","1301"
"15989",543,656,113,"AATTCGTCTTCCGCACCAAT","CTTCTTCAGCTCTATCTAAG","561307.5.peg.2169","1301"
"15990",785,656,129,"ATTCTACGTTAGTAGTAGCT","CTTCTTCAGCTCTATCTAAG","561307.5.peg.2169","1301"
"15991",297,656,359,"ACAGTGAAGTCTACGTGTCC","CTTCTTCAGCTCTATCTAAG","561307.5.peg.2169","1301"
"15992",1034,656,378,"TCATTGTACCTGAATACACA","CTTCTTCAGCTCTATCTAAG","561307.5.peg.2169","1301"
"15993",224,656,432,"CAGATGTGATAGTAATACCA","CTTCTTCAGCTCTATCTAAG","561307.5.peg.2169","1301"
"15994",885,656,229,"GGTTTAACGTCTAGTGGTGA","CTTCTTCAGCTCTATCTAAG","561307.5.peg.2169","1301"
"15995",920,785,135,"CTTCTTCAGGGTTGCTAGCA","ATTCTACGTTAGTAGTAGCT","561307.5.peg.2169","1301"
"15996",435,785,350,"TGTTTACAAATACGATACG","ATTCTACGTTAGTAGTAGCT","561307.5.peg.2169","1301"
"15997",543,785,242,"AATTCGTCTTCCGCACCAAT","ATTCTACGTTAGTAGTAGCT","561307.5.peg.2169","1301"
"15998",297,785,488,"ACAGTGAAGTCTACGTGTCC","ATTCTACGTTAGTAGTAGCT","561307.5.peg.2169","1301"
"15999",885,785,100,"GGTTTAACGTCTAGTGGTGA","ATTCTACGTTAGTAGTAGCT","561307.5.peg.2169","1301"
"16000",891,785,106,"TAATTGGTTTAACGTCTAG","ATTCTACGTTAGTAGTAGCT","561307.5.peg.2169","1301"
"16001",648,785,137,"GCTCTATCTAAGTGGTCTTC","ATTCTACGTTAGTAGTAGCT","561307.5.peg.2169","1301"
"16002",656,785,129,"CTTCTTCAGCTCTATCTAAG","ATTCTACGTTAGTAGTAGCT","561307.5.peg.2169","1301"
"16003",906,785,121,"CTAGCACGGTGACCAATAAT","ATTCTACGTTAGTAGTAGCT","561307.5.peg.2169","1301"
"16004",224,785,561,"CAGATGTGATAGTAATACCA","ATTCTACGTTAGTAGTAGCT","561307.5.peg.2169","1301"
"16005",1034,785,249,"TCATTGTACCTGAATACACA","ATTCTACGTTAGTAGTAGCT","561307.5.peg.2169","1301"
"16006",435,812,377,"TGTTTACAAATACGATACG","AAGCTGTACCACAAAGTACT","561307.5.peg.2169","1301"
"16007",648,812,164,"GCTCTATCTAAGTGGTCTTC","AAGCTGTACCACAAAGTACT","561307.5.peg.2169","1301"
"16008",224,812,588,"CAGATGTGATAGTAATACCA","AAGCTGTACCACAAAGTACT","561307.5.peg.2169","1301"
"16009",1034,812,222,"TCATTGTACCTGAATACACA","AAGCTGTACCACAAAGTACT","561307.5.peg.2169","1301"
"16010",543,812,269,"AATTCGTCTTCCGCACCAAT","AAGCTGTACCACAAAGTACT","561307.5.peg.2169","1301"
"16011",297,812,515,"ACAGTGAAGTCTACGTGTCC","AAGCTGTACCACAAAGTACT","561307.5.peg.2169","1301"
"16012",656,812,156,"CTTCTTCAGCTCTATCTAAG","AAGCTGTACCACAAAGTACT","561307.5.peg.2169","1301"
"16013",920,812,108,"CTTCTTCAGGGTTGCTAGCA","AAGCTGTACCACAAAGTACT","561307.5.peg.2169","1301"
"16014",224,885,661,"CAGATGTGATAGTAATACCA","GGTTTAACGTCTAGTGGTGA","561307.5.peg.2169","1301"
"16015",648,885,237,"GCTCTATCTAAGTGGTCTTC","GGTTTAACGTCTAGTGGTGA","561307.5.peg.2169","1301"
"16016",435,885,450,"TGTTTACAAATACGATACG","GGTTTAACGTCTAGTGGTGA","561307.5.peg.2169","1301"
"16017",1034,885,149,"TCATTGTACCTGAATACACA","GGTTTAACGTCTAGTGGTGA","561307.5.peg.2169","1301"
"16018",656,885,229,"CTTCTTCAGCTCTATCTAAG","GGTTTAACGTCTAGTGGTGA","561307.5.peg.2169","1301"
"16019",785,885,100,"ATTCTACGTTAGTAGTAGCT","GGTTTAACGTCTAGTGGTGA","561307.5.peg.2169","1301"
"16020",543,885,342,"AATTCGTCTTCCGCACCAAT","GGTTTAACGTCTAGTGGTGA","561307.5.peg.2169","1301"
"16021",297,885,588,"ACAGTGAAGTCTACGTGTCC","GGTTTAACGTCTAGTGGTGA","561307.5.peg.2169","1301"
"16022",435,891,456,"TGTTTACAAATACGATACG","TAATTGGTTTAACGTCTAG","561307.5.peg.2169","1301"
"16023",297,891,594,"ACAGTGAAGTCTACGTGTCC","TAATTGGTTTAACGTCTAG","561307.5.peg.2169","1301"
"16024",656,891,235,"CTTCTTCAGCTCTATCTAAG","TAATTGGTTTAACGTCTAG","561307.5.peg.2169","1301"
"16025",543,891,348,"AATTCGTCTTCCGCACCAAT","TAATTGGTTTAACGTCTAG","561307.5.peg.2169","1301"
"16026",224,891,667,"CAGATGTGATAGTAATACCA","TAATTGGTTTAACGTCTAG","561307.5.peg.2169","1301"
"16027",1034,891,143,"TCATTGTACCTGAATACACA","TAATTGGTTTAACGTCTAG","561307.5.peg.2169","1301"
"16028",648,891,243,"GCTCTATCTAAGTGGTCTTC","TAATTGGTTTAACGTCTAG","561307.5.peg.2169","1301"
"16029",785,891,106,"ATTCTACGTTAGTAGTAGCT","TAATTGGTTTAACGTCTAG","561307.5.peg.2169","1301"
"16030",224,906,682,"CAGATGTGATAGTAATACCA","CTAGCACGGTGACCAATAAT","561307.5.peg.2169","1301"
"16031",656,906,250,"CTTCTTCAGCTCTATCTAAG","CTAGCACGGTGACCAATAAT","561307.5.peg.2169","1301"
"16032",785,906,121,"ATTCTACGTTAGTAGTAGCT","CTAGCACGGTGACCAATAAT","561307.5.peg.2169","1301"
"16033",297,906,609,"ACAGTGAAGTCTACGTGTCC","CTAGCACGGTGACCAATAAT","561307.5.peg.2169","1301"
"16034",1034,906,128,"TCATTGTACCTGAATACACA","CTAGCACGGTGACCAATAAT","561307.5.peg.2169","1301"
"16035",543,906,363,"AATTCGTCTTCCGCACCAAT","CTAGCACGGTGACCAATAAT","561307.5.peg.2169","1301"
"16036",648,906,258,"GCTCTATCTAAGTGGTCTTC","CTAGCACGGTGACCAATAAT","561307.5.peg.2169","1301"
"16037",435,906,471,"TGTTTACAAATACGATACG","CTAGCACGGTGACCAATAAT","561307.5.peg.2169","1301"
"16038",224,920,696,"CAGATGTGATAGTAATACCA","CTTCTTCAGGGTTGCTAGCA","561307.5.peg.2169","1301"
"16039",656,920,264,"CTTCTTCAGCTCTATCTAAG","CTTCTTCAGGGTTGCTAGCA","561307.5.peg.2169","1301"
"16040",648,920,272,"GCTCTATCTAAGTGGTCTTC","CTTCTTCAGGGTTGCTAGCA","561307.5.peg.2169","1301"
"16041",543,920,377,"AATTCGTCTTCCGCACCAAT","CTTCTTCAGGGTTGCTAGCA","561307.5.peg.2169","1301"
"16042",1034,920,114,"TCATTGTACCTGAATACACA","CTTCTTCAGGGTTGCTAGCA","561307.5.peg.2169","1301"
"16043",785,920,135,"ATTCTACGTTAGTAGTAGCT","CTTCTTCAGGGTTGCTAGCA","561307.5.peg.2169","1301"
"16044",435,920,485,"TGTTTACAAATACGATACG","CTTCTTCAGGGTTGCTAGCA","561307.5.peg.2169","1301"
"16045",812,920,108,"AAGCTGTACCACAAAGTACT","CTTCTTCAGGGTTGCTAGCA","561307.5.peg.2169","1301"
"16046",297,920,623,"ACAGTGAAGTCTACGTGTCC","CTTCTTCAGGGTTGCTAGCA","561307.5.peg.2169","1301"
"16047",224,1034,810,"CAGATGTGATAGTAATACCA","TCATTGTACCTGAATACACA","561307.5.peg.2169","1301"
"16048",885,1034,149,"GGTTTAACGTCTAGTGGTGA","TCATTGTACCTGAATACACA","561307.5.peg.2169","1301"
"16049",920,1034,114,"CTTCTTCAGGGTTGCTAGCA","TCATTGTACCTGAATACACA","561307.5.peg.2169","1301"
"16050",656,1034,378,"CTTCTTCAGCTCTATCTAAG","TCATTGTACCTGAATACACA","561307.5.peg.2169","1301"
"16051",543,1034,491,"AATTCGTCTTCCGCACCAAT","TCATTGTACCTGAATACACA","561307.5.peg.2169","1301"
"16052",648,1034,386,"GCTCTATCTAAGTGGTCTTC","TCATTGTACCTGAATACACA","561307.5.peg.2169","1301"
"16053",906,1034,128,"CTAGCACGGTGACCAATAAT","TCATTGTACCTGAATACACA","561307.5.peg.2169","1301"
"16054",812,1034,222,"AAGCTGTACCACAAAGTACT","TCATTGTACCTGAATACACA","561307.5.peg.2169","1301"
"16055",297,1034,737,"ACAGTGAAGTCTACGTGTCC","TCATTGTACCTGAATACACA","561307.5.peg.2169","1301"
"16056",435,1034,599,"TGTTTACAAATACGATACG","TCATTGTACCTGAATACACA","561307.5.peg.2169","1301"
"16057",891,1034,143,"TAATTGGTTTAACGTCTAG","TCATTGTACCTGAATACACA","561307.5.peg.2169","1301"
"16058",785,1034,249,"ATTCTACGTTAGTAGTAGCT","TCATTGTACCTGAATACACA","561307.5.peg.2169","1301"
"16059",384,88,296,"TGTTCACGAGTTTGTGGCAT","GTGACCGATAGTACCGATAT","561307.5.peg.2170","1303"
"16060",260,88,172,"CGTAGTGACGTTTGTCAGTT","GTGACCGATAGTACCGATAT","561307.5.peg.2170","1303"
"16061",555,88,467,"AATGCTGAACCAGCGATTAC","GTGACCGATAGTACCGATAT","561307.5.peg.2170","1303"
"16062",390,88,302,"AGAATGTGTTCACGAGTTTG","GTGACCGATAGTACCGATAT","561307.5.peg.2170","1303"
"16063",296,88,208,"TAACGTAGTCAGCGTGTCCT","GTGACCGATAGTACCGATAT","561307.5.peg.2170","1303"
"16064",88,260,172,"GTGACCGATAGTACCGATAT","CGTAGTGACGTTTGTCAGTT","561307.5.peg.2170","1303"
"16065",384,260,124,"TGTTCACGAGTTTGTGGCAT","CGTAGTGACGTTTGTCAGTT","561307.5.peg.2170","1303"
"16066",390,260,130,"AGAATGTGTTCACGAGTTTG","CGTAGTGACGTTTGTCAGTT","561307.5.peg.2170","1303"
"16067",555,260,295,"AATGCTGAACCAGCGATTAC","CGTAGTGACGTTTGTCAGTT","561307.5.peg.2170","1303"
"16068",555,296,259,"AATGCTGAACCAGCGATTAC","TAACGTAGTCAGCGTGTCCT","561307.5.peg.2170","1303"
"16069",88,296,208,"GTGACCGATAGTACCGATAT","TAACGTAGTCAGCGTGTCCT","561307.5.peg.2170","1303"
"16070",88,384,296,"GTGACCGATAGTACCGATAT","TGTTCACGAGTTTGTGGCAT","561307.5.peg.2170","1303"
"16071",260,384,124,"CGTAGTGACGTTTGTCAGTT","TGTTCACGAGTTTGTGGCAT","561307.5.peg.2170","1303"
"16072",555,384,171,"AATGCTGAACCAGCGATTAC","TGTTCACGAGTTTGTGGCAT","561307.5.peg.2170","1303"
"16073",88,390,302,"GTGACCGATAGTACCGATAT","AGAATGTGTTCACGAGTTTG","561307.5.peg.2170","1303"
"16074",260,390,130,"CGTAGTGACGTTTGTCAGTT","AGAATGTGTTCACGAGTTTG","561307.5.peg.2170","1303"
"16075",555,390,165,"AATGCTGAACCAGCGATTAC","AGAATGTGTTCACGAGTTTG","561307.5.peg.2170","1303"
"16076",260,555,295,"CGTAGTGACGTTTGTCAGTT","AATGCTGAACCAGCGATTAC","561307.5.peg.2170","1303"
"16077",296,555,259,"TAACGTAGTCAGCGTGTCCT","AATGCTGAACCAGCGATTAC","561307.5.peg.2170","1303"
"16078",390,555,165,"AGAATGTGTTCACGAGTTTG","AATGCTGAACCAGCGATTAC","561307.5.peg.2170","1303"
"16079",88,555,467,"GTGACCGATAGTACCGATAT","AATGCTGAACCAGCGATTAC","561307.5.peg.2170","1303"
"16080",384,555,171,"TGTTCACGAGTTTGTGGCAT","AATGCTGAACCAGCGATTAC","561307.5.peg.2170","1303"
"16081",336,173,163,"CCACACGCATGCATACATCC","CACAAGATAACTGGCTTAAT","561307.5.peg.2171","1304"
"16082",471,173,298,"ATCATTTCTTGAGAACCACC","CACAAGATAACTGGCTTAAT","561307.5.peg.2171","1304"
"16083",449,173,276,"GCATGATTTCTTCACCGTAC","CACAAGATAACTGGCTTAAT","561307.5.peg.2171","1304"
"16084",294,173,121,"ACATCGTTTAATTCCTCGAC","CACAAGATAACTGGCTTAAT","561307.5.peg.2171","1304"
"16085",600,173,427,"AATGTGACGCTAAATTCATC","CACAAGATAACTGGCTTAAT","561307.5.peg.2171","1304"
"16086",336,207,129,"CCACACGCATGCATACATCC","TTGATACCATTGCGGCCGAT","561307.5.peg.2171","1304"
"16087",449,207,242,"GCATGATTTCTTCACCGTAC","TTGATACCATTGCGGCCGAT","561307.5.peg.2171","1304"
"16088",471,207,264,"ATCATTTCTTGAGAACCACC","TTGATACCATTGCGGCCGAT","561307.5.peg.2171","1304"
"16089",600,207,393,"AATGTGACGCTAAATTCATC","TTGATACCATTGCGGCCGAT","561307.5.peg.2171","1304"
"16090",600,232,368,"AATGTGACGCTAAATTCATC","TGTGCCCAAGCCTTTAAATG","561307.5.peg.2171","1304"
"16091",336,232,104,"CCACACGCATGCATACATCC","TGTGCCCAAGCCTTTAAATG","561307.5.peg.2171","1304"
"16092",471,232,239,"ATCATTTCTTGAGAACCACC","TGTGCCCAAGCCTTTAAATG","561307.5.peg.2171","1304"
"16093",449,232,217,"GCATGATTTCTTCACCGTAC","TGTGCCCAAGCCTTTAAATG","561307.5.peg.2171","1304"
"16094",471,258,213,"ATCATTTCTTGAGAACCACC","TCAGCTCTTAATGCAATGGT","561307.5.peg.2171","1304"
"16095",449,258,191,"GCATGATTTCTTCACCGTAC","TCAGCTCTTAATGCAATGGT","561307.5.peg.2171","1304"
"16096",600,258,342,"AATGTGACGCTAAATTCATC","TCAGCTCTTAATGCAATGGT","561307.5.peg.2171","1304"
"16097",173,294,121,"CACAAGATAACTGGCTTAAT","ACATCGTTTAATTCCTCGAC","561307.5.peg.2171","1304"
"16098",600,294,306,"AATGTGACGCTAAATTCATC","ACATCGTTTAATTCCTCGAC","561307.5.peg.2171","1304"
"16099",449,294,155,"GCATGATTTCTTCACCGTAC","ACATCGTTTAATTCCTCGAC","561307.5.peg.2171","1304"
"16100",471,294,177,"ATCATTTCTTGAGAACCACC","ACATCGTTTAATTCCTCGAC","561307.5.peg.2171","1304"
"16101",173,336,163,"CACAAGATAACTGGCTTAAT","CCACACGCATGCATACATCC","561307.5.peg.2171","1304"
"16102",600,336,264,"AATGTGACGCTAAATTCATC","CCACACGCATGCATACATCC","561307.5.peg.2171","1304"
"16103",207,336,129,"TTGATACCATTGCGGCCGAT","CCACACGCATGCATACATCC","561307.5.peg.2171","1304"
"16104",471,336,135,"ATCATTTCTTGAGAACCACC","CCACACGCATGCATACATCC","561307.5.peg.2171","1304"
"16105",232,336,104,"TGTGCCCAAGCCTTTAAATG","CCACACGCATGCATACATCC","561307.5.peg.2171","1304"
"16106",449,336,113,"GCATGATTTCTTCACCGTAC","CCACACGCATGCATACATCC","561307.5.peg.2171","1304"
"16107",294,449,155,"ACATCGTTTAATTCCTCGAC","GCATGATTTCTTCACCGTAC","561307.5.peg.2171","1304"
"16108",207,449,242,"TTGATACCATTGCGGCCGAT","GCATGATTTCTTCACCGTAC","561307.5.peg.2171","1304"
"16109",600,449,151,"AATGTGACGCTAAATTCATC","GCATGATTTCTTCACCGTAC","561307.5.peg.2171","1304"
"16110",336,449,113,"CCACACGCATGCATACATCC","GCATGATTTCTTCACCGTAC","561307.5.peg.2171","1304"
"16111",173,449,276,"CACAAGATAACTGGCTTAAT","GCATGATTTCTTCACCGTAC","561307.5.peg.2171","1304"
"16112",232,449,217,"TGTGCCCAAGCCTTTAAATG","GCATGATTTCTTCACCGTAC","561307.5.peg.2171","1304"
"16113",258,449,191,"TCAGCTCTTAATGCAATGGT","GCATGATTTCTTCACCGTAC","561307.5.peg.2171","1304"
"16114",232,471,239,"TGTGCCCAAGCCTTTAAATG","ATCATTTCTTGAGAACCACC","561307.5.peg.2171","1304"
"16115",336,471,135,"CCACACGCATGCATACATCC","ATCATTTCTTGAGAACCACC","561307.5.peg.2171","1304"
"16116",258,471,213,"TCAGCTCTTAATGCAATGGT","ATCATTTCTTGAGAACCACC","561307.5.peg.2171","1304"
"16117",173,471,298,"CACAAGATAACTGGCTTAAT","ATCATTTCTTGAGAACCACC","561307.5.peg.2171","1304"
"16118",294,471,177,"ACATCGTTTAATTCCTCGAC","ATCATTTCTTGAGAACCACC","561307.5.peg.2171","1304"
"16119",207,471,264,"TTGATACCATTGCGGCCGAT","ATCATTTCTTGAGAACCACC","561307.5.peg.2171","1304"
"16120",600,471,129,"AATGTGACGCTAAATTCATC","ATCATTTCTTGAGAACCACC","561307.5.peg.2171","1304"
"16121",173,600,427,"CACAAGATAACTGGCTTAAT","AATGTGACGCTAAATTCATC","561307.5.peg.2171","1304"
"16122",449,600,151,"GCATGATTTCTTCACCGTAC","AATGTGACGCTAAATTCATC","561307.5.peg.2171","1304"
"16123",258,600,342,"TCAGCTCTTAATGCAATGGT","AATGTGACGCTAAATTCATC","561307.5.peg.2171","1304"
"16124",336,600,264,"CCACACGCATGCATACATCC","AATGTGACGCTAAATTCATC","561307.5.peg.2171","1304"
"16125",294,600,306,"ACATCGTTTAATTCCTCGAC","AATGTGACGCTAAATTCATC","561307.5.peg.2171","1304"
"16126",207,600,393,"TTGATACCATTGCGGCCGAT","AATGTGACGCTAAATTCATC","561307.5.peg.2171","1304"
"16127",471,600,129,"ATCATTTCTTGAGAACCACC","AATGTGACGCTAAATTCATC","561307.5.peg.2171","1304"
"16128",232,600,368,"TGTGCCCAAGCCTTTAAATG","AATGTGACGCTAAATTCATC","561307.5.peg.2171","1304"
"16129",509,11,498,"GTAAATCATCCATGTCTGAA","TTACCAAACAATACTTAAGG","561307.5.peg.2172","1305"
"16130",11,509,498,"TTACCAAACAATACTTAAGG","GTAAATCATCCATGTCTGAA","561307.5.peg.2172","1305"
"16131",390,84,306,"ATAACTGCCTCGTCTTCAGT","TCTTCTGCTTTATCTGGCGT","561307.5.peg.2173","1306"
"16132",390,119,271,"ATAACTGCCTCGTCTTCAGT","GACTAAGGGAATATGGTGAT","561307.5.peg.2173","1306"
"16133",390,133,257,"ATAACTGCCTCGTCTTCAGT","AGGTGCTGTATATTGACTAA","561307.5.peg.2173","1306"
"16134",84,390,306,"TCTTCTGCTTTATCTGGCGT","ATAACTGCCTCGTCTTCAGT","561307.5.peg.2173","1306"
"16135",119,390,271,"GACTAAGGGAATATGGTGAT","ATAACTGCCTCGTCTTCAGT","561307.5.peg.2173","1306"
"16136",133,390,257,"AGGTGCTGTATATTGACTAA","ATAACTGCCTCGTCTTCAGT","561307.5.peg.2173","1306"
"16137",353,5,348,"TTAAGTTATGTACCGGGTTA","AACCGCAACTAGCGATATGG","561307.5.peg.2174","1307"
"16138",393,5,388,"CAAAGTTTCACATACGCATG","AACCGCAACTAGCGATATGG","561307.5.peg.2174","1307"
"16139",288,5,283,"CCAATACCTACTATATTGTC","AACCGCAACTAGCGATATGG","561307.5.peg.2174","1307"
"16140",756,5,751,"GCTTCACCAATATTAACAAC","AACCGCAACTAGCGATATGG","561307.5.peg.2174","1307"
"16141",353,8,345,"TTAAGTTATGTACCGGGTTA","AATAACCGCAACTAGCGATA","561307.5.peg.2174","1307"
"16142",393,8,385,"CAAAGTTTCACATACGCATG","AATAACCGCAACTAGCGATA","561307.5.peg.2174","1307"
"16143",288,8,280,"CCAATACCTACTATATTGTC","AATAACCGCAACTAGCGATA","561307.5.peg.2174","1307"
"16144",756,8,748,"GCTTCACCAATATTAACAAC","AATAACCGCAACTAGCGATA","561307.5.peg.2174","1307"
"16145",353,26,327,"TTAAGTTATGTACCGGGTTA","TTCCTCCATATCGCTAGTTG","561307.5.peg.2174","1307"
"16146",393,26,367,"CAAAGTTTCACATACGCATG","TTCCTCCATATCGCTAGTTG","561307.5.peg.2174","1307"
"16147",756,26,730,"GCTTCACCAATATTAACAAC","TTCCTCCATATCGCTAGTTG","561307.5.peg.2174","1307"
"16148",288,26,262,"CCAATACCTACTATATTGTC","TTCCTCCATATCGCTAGTTG","561307.5.peg.2174","1307"
"16149",5,288,283,"AACCGCAACTAGCGATATGG","CCAATACCTACTATATTGTC","561307.5.peg.2174","1307"
"16150",26,288,262,"TTCCTCCATATCGCTAGTTG","CCAATACCTACTATATTGTC","561307.5.peg.2174","1307"
"16151",8,288,280,"AATAACCGCAACTAGCGATA","CCAATACCTACTATATTGTC","561307.5.peg.2174","1307"
"16152",756,288,468,"GCTTCACCAATATTAACAAC","CCAATACCTACTATATTGTC","561307.5.peg.2174","1307"
"16153",393,288,105,"CAAAGTTTCACATACGCATG","CCAATACCTACTATATTGTC","561307.5.peg.2174","1307"
"16154",8,353,345,"AATAACCGCAACTAGCGATA","TTAAGTTATGTACCGGGTTA","561307.5.peg.2174","1307"
"16155",756,353,403,"GCTTCACCAATATTAACAAC","TTAAGTTATGTACCGGGTTA","561307.5.peg.2174","1307"
"16156",26,353,327,"TTCCTCCATATCGCTAGTTG","TTAAGTTATGTACCGGGTTA","561307.5.peg.2174","1307"
"16157",5,353,348,"AACCGCAACTAGCGATATGG","TTAAGTTATGTACCGGGTTA","561307.5.peg.2174","1307"
"16158",8,393,385,"AATAACCGCAACTAGCGATA","CAAAGTTTCACATACGCATG","561307.5.peg.2174","1307"
"16159",5,393,388,"AACCGCAACTAGCGATATGG","CAAAGTTTCACATACGCATG","561307.5.peg.2174","1307"
"16160",288,393,105,"CCAATACCTACTATATTGTC","CAAAGTTTCACATACGCATG","561307.5.peg.2174","1307"
"16161",26,393,367,"TTCCTCCATATCGCTAGTTG","CAAAGTTTCACATACGCATG","561307.5.peg.2174","1307"
"16162",756,393,363,"GCTTCACCAATATTAACAAC","CAAAGTTTCACATACGCATG","561307.5.peg.2174","1307"
"16163",5,756,751,"AACCGCAACTAGCGATATGG","GCTTCACCAATATTAACAAC","561307.5.peg.2174","1307"
"16164",8,756,748,"AATAACCGCAACTAGCGATA","GCTTCACCAATATTAACAAC","561307.5.peg.2174","1307"
"16165",393,756,363,"CAAAGTTTCACATACGCATG","GCTTCACCAATATTAACAAC","561307.5.peg.2174","1307"
"16166",26,756,730,"TTCCTCCATATCGCTAGTTG","GCTTCACCAATATTAACAAC","561307.5.peg.2174","1307"
"16167",288,756,468,"CCAATACCTACTATATTGTC","GCTTCACCAATATTAACAAC","561307.5.peg.2174","1307"
"16168",353,756,403,"TTAAGTTATGTACCGGGTTA","GCTTCACCAATATTAACAAC","561307.5.peg.2174","1307"
"16169",462,1,461,"TTTACACCATACATTGTCGT","TAGCTATAGTCCATCACAAG","561307.5.peg.2175","1308"
"16170",162,1,161,"TGTACAGGTGAGTCTGCTTC","TAGCTATAGTCCATCACAAG","561307.5.peg.2175","1308"
"16171",393,1,392,"CCAAATGCACCAATTGAACT","TAGCTATAGTCCATCACAAG","561307.5.peg.2175","1308"
"16172",224,1,223,"CCCTAACTAACTCAAACATA","TAGCTATAGTCCATCACAAG","561307.5.peg.2175","1308"
"16173",441,1,440,"GGTTGCTGAATCGTTACTTG","TAGCTATAGTCCATCACAAG","561307.5.peg.2175","1308"
"16174",309,1,308,"TTAAATCCCAAGCTAGAAT","TAGCTATAGTCCATCACAAG","561307.5.peg.2175","1308"
"16175",426,1,425,"ACTTGTGGCGTATTAACTTT","TAGCTATAGTCCATCACAAG","561307.5.peg.2175","1308"
"16176",426,11,415,"ACTTGTGGCGTATTAACTTT","AGCTATATAGAAGAGACAA","561307.5.peg.2175","1308"
"16177",309,11,298,"TTAAATCCCAAGCTAGAAT","AGCTATATAGAAGAGACAA","561307.5.peg.2175","1308"
"16178",162,11,151,"TGTACAGGTGAGTCTGCTTC","AGCTATATAGAAGAGACAA","561307.5.peg.2175","1308"
"16179",462,11,451,"TTTACACCATACATTGTCGT","AGCTATATAGAAGAGACAA","561307.5.peg.2175","1308"
"16180",393,11,382,"CCAAATGCACCAATTGAACT","AGCTATATAGAAGAGACAA","561307.5.peg.2175","1308"
"16181",441,11,430,"GGTTGCTGAATCGTTACTTG","AGCTATATAGAAGAGACAA","561307.5.peg.2175","1308"
"16182",224,11,213,"CCCTAACTAACTCAAACATA","AGCTATATAGAAGAGACAA","561307.5.peg.2175","1308"
"16183",1,162,161,"TAGCTATAGTCCATCACAAG","TGTACAGGTGAGTCTGCTTC","561307.5.peg.2175","1308"
"16184",11,162,151,"AGCTATATAGAAGAGACAA","TGTACAGGTGAGTCTGCTTC","561307.5.peg.2175","1308"
"16185",309,162,147,"TTAAATCCCAAGCTAGAAT","TGTACAGGTGAGTCTGCTTC","561307.5.peg.2175","1308"
"16186",441,162,279,"GGTTGCTGAATCGTTACTTG","TGTACAGGTGAGTCTGCTTC","561307.5.peg.2175","1308"
"16187",393,162,231,"CCAAATGCACCAATTGAACT","TGTACAGGTGAGTCTGCTTC","561307.5.peg.2175","1308"
"16188",426,162,264,"ACTTGTGGCGTATTAACTTT","TGTACAGGTGAGTCTGCTTC","561307.5.peg.2175","1308"
"16189",462,162,300,"TTTACACCATACATTGTCGT","TGTACAGGTGAGTCTGCTTC","561307.5.peg.2175","1308"
"16190",11,224,213,"AGCTATATAGAAGAGACAA","CCCTAACTAACTCAAACATA","561307.5.peg.2175","1308"
"16191",393,224,169,"CCAAATGCACCAATTGAACT","CCCTAACTAACTCAAACATA","561307.5.peg.2175","1308"
"16192",1,224,223,"TAGCTATAGTCCATCACAAG","CCCTAACTAACTCAAACATA","561307.5.peg.2175","1308"
"16193",462,224,238,"TTTACACCATACATTGTCGT","CCCTAACTAACTCAAACATA","561307.5.peg.2175","1308"
"16194",441,224,217,"GGTTGCTGAATCGTTACTTG","CCCTAACTAACTCAAACATA","561307.5.peg.2175","1308"
"16195",426,224,202,"ACTTGTGGCGTATTAACTTT","CCCTAACTAACTCAAACATA","561307.5.peg.2175","1308"
"16196",1,309,308,"TAGCTATAGTCCATCACAAG","TTAAATCCCAAGCTAGAAT","561307.5.peg.2175","1308"
"16197",426,309,117,"ACTTGTGGCGTATTAACTTT","TTAAATCCCAAGCTAGAAT","561307.5.peg.2175","1308"
"16198",441,309,132,"GGTTGCTGAATCGTTACTTG","TTAAATCCCAAGCTAGAAT","561307.5.peg.2175","1308"
"16199",162,309,147,"TGTACAGGTGAGTCTGCTTC","TTAAATCCCAAGCTAGAAT","561307.5.peg.2175","1308"
"16200",462,309,153,"TTTACACCATACATTGTCGT","TTAAATCCCAAGCTAGAAT","561307.5.peg.2175","1308"
"16201",11,309,298,"AGCTATATAGAAGAGACAA","TTAAATCCCAAGCTAGAAT","561307.5.peg.2175","1308"
"16202",162,393,231,"TGTACAGGTGAGTCTGCTTC","CCAAATGCACCAATTGAACT","561307.5.peg.2175","1308"
"16203",11,393,382,"AGCTATATAGAAGAGACAA","CCAAATGCACCAATTGAACT","561307.5.peg.2175","1308"
"16204",1,393,392,"TAGCTATAGTCCATCACAAG","CCAAATGCACCAATTGAACT","561307.5.peg.2175","1308"
"16205",224,393,169,"CCCTAACTAACTCAAACATA","CCAAATGCACCAATTGAACT","561307.5.peg.2175","1308"
"16206",1,426,425,"TAGCTATAGTCCATCACAAG","ACTTGTGGCGTATTAACTTT","561307.5.peg.2175","1308"
"16207",162,426,264,"TGTACAGGTGAGTCTGCTTC","ACTTGTGGCGTATTAACTTT","561307.5.peg.2175","1308"
"16208",224,426,202,"CCCTAACTAACTCAAACATA","ACTTGTGGCGTATTAACTTT","561307.5.peg.2175","1308"
"16209",309,426,117,"TTAAATCCCAAGCTAGAAT","ACTTGTGGCGTATTAACTTT","561307.5.peg.2175","1308"
"16210",11,426,415,"AGCTATATAGAAGAGACAA","ACTTGTGGCGTATTAACTTT","561307.5.peg.2175","1308"
"16211",224,441,217,"CCCTAACTAACTCAAACATA","GGTTGCTGAATCGTTACTTG","561307.5.peg.2175","1308"
"16212",309,441,132,"TTAAATCCCAAGCTAGAAT","GGTTGCTGAATCGTTACTTG","561307.5.peg.2175","1308"
"16213",162,441,279,"TGTACAGGTGAGTCTGCTTC","GGTTGCTGAATCGTTACTTG","561307.5.peg.2175","1308"
"16214",11,441,430,"AGCTATATAGAAGAGACAA","GGTTGCTGAATCGTTACTTG","561307.5.peg.2175","1308"
"16215",1,441,440,"TAGCTATAGTCCATCACAAG","GGTTGCTGAATCGTTACTTG","561307.5.peg.2175","1308"
"16216",1,462,461,"TAGCTATAGTCCATCACAAG","TTTACACCATACATTGTCGT","561307.5.peg.2175","1308"
"16217",309,462,153,"TTAAATCCCAAGCTAGAAT","TTTACACCATACATTGTCGT","561307.5.peg.2175","1308"
"16218",11,462,451,"AGCTATATAGAAGAGACAA","TTTACACCATACATTGTCGT","561307.5.peg.2175","1308"
"16219",224,462,238,"CCCTAACTAACTCAAACATA","TTTACACCATACATTGTCGT","561307.5.peg.2175","1308"
"16220",162,462,300,"TGTACAGGTGAGTCTGCTTC","TTTACACCATACATTGTCGT","561307.5.peg.2175","1308"
"16221",360,49,311,"AATTCTGCTTCGTCTACTTG","AACTTTAACTGCTTGTGACA","561307.5.peg.2176","1309"
"16222",429,49,380,"AATGATTGACCTTCCCCTTC","AACTTTAACTGCTTGTGACA","561307.5.peg.2176","1309"
"16223",360,99,261,"AATTCTGCTTCGTCTACTTG","AACCTAGTTGAGATGTATT","561307.5.peg.2176","1309"
"16224",429,99,330,"AATGATTGACCTTCCCCTTC","AACCTAGTTGAGATGTATT","561307.5.peg.2176","1309"
"16225",49,360,311,"AACTTTAACTGCTTGTGACA","AATTCTGCTTCGTCTACTTG","561307.5.peg.2176","1309"
"16226",99,360,261,"AACCTAGTTGAGATGTATT","AATTCTGCTTCGTCTACTTG","561307.5.peg.2176","1309"
"16227",49,429,380,"AACTTTAACTGCTTGTGACA","AATGATTGACCTTCCCCTTC","561307.5.peg.2176","1309"
"16228",99,429,330,"AACCTAGTTGAGATGTATT","AATGATTGACCTTCCCCTTC","561307.5.peg.2176","1309"
"16229",592,492,100,"TAATGATGCTCGCGTCAGGT","CAATGATCTATAATCCACTT","561307.5.peg.218","1313"
"16230",596,492,104,"CATCTAATGATGCTCGCGTC","CAATGATCTATAATCCACTT","561307.5.peg.218","1313"
"16231",675,492,183,"CCTCCTATATGGAGACAATA","CAATGATCTATAATCCACTT","561307.5.peg.218","1313"
"16232",492,592,100,"CAATGATCTATAATCCACTT","TAATGATGCTCGCGTCAGGT","561307.5.peg.218","1313"
"16233",492,596,104,"CAATGATCTATAATCCACTT","CATCTAATGATGCTCGCGTC","561307.5.peg.218","1313"
"16234",492,675,183,"CAATGATCTATAATCCACTT","CCTCCTATATGGAGACAATA","561307.5.peg.218","1313"
"16235",123,7,116,"TTAGTGATGATAGCACCTAT","TGTACCATAAGTGAGGTATC","561307.5.peg.2181","1315"
"16236",238,7,231,"ACGCCAACTACCTAACACTT","TGTACCATAAGTGAGGTATC","561307.5.peg.2181","1315"
"16237",198,7,191,"ATATGTTCAGCATGCGCCGT","TGTACCATAAGTGAGGTATC","561307.5.peg.2181","1315"
"16238",198,14,184,"ATATGTTCAGCATGCGCCGT","TGAGTATTGTACCATAAGTG","561307.5.peg.2181","1315"
"16239",123,14,109,"TTAGTGATGATAGCACCTAT","TGAGTATTGTACCATAAGTG","561307.5.peg.2181","1315"
"16240",238,14,224,"ACGCCAACTACCTAACACTT","TGAGTATTGTACCATAAGTG","561307.5.peg.2181","1315"
"16241",198,26,172,"ATATGTTCAGCATGCGCCGT","ATGTCCAGATACCTCACTTA","561307.5.peg.2181","1315"
"16242",238,26,212,"ACGCCAACTACCTAACACTT","ATGTCCAGATACCTCACTTA","561307.5.peg.2181","1315"
"16243",7,123,116,"TGTACCATAAGTGAGGTATC","TTAGTGATGATAGCACCTAT","561307.5.peg.2181","1315"
"16244",238,123,115,"ACGCCAACTACCTAACACTT","TTAGTGATGATAGCACCTAT","561307.5.peg.2181","1315"
"16245",14,123,109,"TGAGTATTGTACCATAAGTG","TTAGTGATGATAGCACCTAT","561307.5.peg.2181","1315"
"16246",14,198,184,"TGAGTATTGTACCATAAGTG","ATATGTTCAGCATGCGCCGT","561307.5.peg.2181","1315"
"16247",7,198,191,"TGTACCATAAGTGAGGTATC","ATATGTTCAGCATGCGCCGT","561307.5.peg.2181","1315"
"16248",26,198,172,"ATGTCCAGATACCTCACTTA","ATATGTTCAGCATGCGCCGT","561307.5.peg.2181","1315"
"16249",7,238,231,"TGTACCATAAGTGAGGTATC","ACGCCAACTACCTAACACTT","561307.5.peg.2181","1315"
"16250",26,238,212,"ATGTCCAGATACCTCACTTA","ACGCCAACTACCTAACACTT","561307.5.peg.2181","1315"
"16251",14,238,224,"TGAGTATTGTACCATAAGTG","ACGCCAACTACCTAACACTT","561307.5.peg.2181","1315"
"16252",123,238,115,"TTAGTGATGATAGCACCTAT","ACGCCAACTACCTAACACTT","561307.5.peg.2181","1315"
"16253",204,67,137,"GTTAAATCTGTGTCAGCAAC","TAGCGTGCCATCCATATCAG","561307.5.peg.2182","1316"
"16254",67,204,137,"TAGCGTGCCATCCATATCAG","GTTAAATCTGTGTCAGCAAC","561307.5.peg.2182","1316"
"16255",264,114,150,"GCTTTCAATTCACTTGTCGC","ACACGTTCGTCCTCTCCTTC","561307.5.peg.2185","1319"
"16256",480,114,366,"CCTGATGTTCTTGATACACC","ACACGTTCGTCCTCTCCTTC","561307.5.peg.2185","1319"
"16257",114,264,150,"ACACGTTCGTCCTCTCCTTC","GCTTTCAATTCACTTGTCGC","561307.5.peg.2185","1319"
"16258",480,264,216,"CCTGATGTTCTTGATACACC","GCTTTCAATTCACTTGTCGC","561307.5.peg.2185","1319"
"16259",114,480,366,"ACACGTTCGTCCTCTCCTTC","CCTGATGTTCTTGATACACC","561307.5.peg.2185","1319"
"16260",264,480,216,"GCTTTCAATTCACTTGTCGC","CCTGATGTTCTTGATACACC","561307.5.peg.2185","1319"
"16261",330,126,204,"GATCCTAATCCACGTGATGG","TTAAACGGTACTGCAATAGC","561307.5.peg.2187","1321"
"16262",243,126,117,"ACCAAAGACTTAAGATGGTC","TTAAACGGTACTGCAATAGC","561307.5.peg.2187","1321"
"16263",300,126,174,"GTTTGGATCGTTACTGCTAG","TTAAACGGTACTGCAATAGC","561307.5.peg.2187","1321"
"16264",248,126,122,"GGTTCACCAAAGACTTAAGA","TTAAACGGTACTGCAATAGC","561307.5.peg.2187","1321"
"16265",317,126,191,"GTGATGGTGGTAAATTCGTT","TTAAACGGTACTGCAATAGC","561307.5.peg.2187","1321"
"16266",333,126,207,"CTCGATCCTAATCCACGTGA","TTAAACGGTACTGCAATAGC","561307.5.peg.2187","1321"
"16267",471,126,345,"GTTTGCGTATCAATACCACT","TTAAACGGTACTGCAATAGC","561307.5.peg.2187","1321"
"16268",333,178,155,"CTCGATCCTAATCCACGTGA","CGAATAGTTCCCGCTCTCTA","561307.5.peg.2187","1321"
"16269",471,178,293,"GTTTGCGTATCAATACCACT","CGAATAGTTCCCGCTCTCTA","561307.5.peg.2187","1321"
"16270",317,178,139,"GTGATGGTGGTAAATTCGTT","CGAATAGTTCCCGCTCTCTA","561307.5.peg.2187","1321"
"16271",300,178,122,"GTTTGGATCGTTACTGCTAG","CGAATAGTTCCCGCTCTCTA","561307.5.peg.2187","1321"
"16272",330,178,152,"GATCCTAATCCACGTGATGG","CGAATAGTTCCCGCTCTCTA","561307.5.peg.2187","1321"
"16273",126,243,117,"TTAAACGGTACTGCAATAGC","ACCAAAGACTTAAGATGGTC","561307.5.peg.2187","1321"
"16274",471,243,228,"GTTTGCGTATCAATACCACT","ACCAAAGACTTAAGATGGTC","561307.5.peg.2187","1321"
"16275",126,248,122,"TTAAACGGTACTGCAATAGC","GGTTCACCAAAGACTTAAGA","561307.5.peg.2187","1321"
"16276",471,248,223,"GTTTGCGTATCAATACCACT","GGTTCACCAAAGACTTAAGA","561307.5.peg.2187","1321"
"16277",126,300,174,"TTAAACGGTACTGCAATAGC","GTTTGGATCGTTACTGCTAG","561307.5.peg.2187","1321"
"16278",471,300,171,"GTTTGCGTATCAATACCACT","GTTTGGATCGTTACTGCTAG","561307.5.peg.2187","1321"
"16279",178,300,122,"CGAATAGTTCCCGCTCTCTA","GTTTGGATCGTTACTGCTAG","561307.5.peg.2187","1321"
"16280",126,317,191,"TTAAACGGTACTGCAATAGC","GTGATGGTGGTAAATTCGTT","561307.5.peg.2187","1321"
"16281",178,317,139,"CGAATAGTTCCCGCTCTCTA","GTGATGGTGGTAAATTCGTT","561307.5.peg.2187","1321"
"16282",471,317,154,"GTTTGCGTATCAATACCACT","GTGATGGTGGTAAATTCGTT","561307.5.peg.2187","1321"
"16283",471,330,141,"GTTTGCGTATCAATACCACT","GATCCTAATCCACGTGATGG","561307.5.peg.2187","1321"
"16284",178,330,152,"CGAATAGTTCCCGCTCTCTA","GATCCTAATCCACGTGATGG","561307.5.peg.2187","1321"
"16285",126,330,204,"TTAAACGGTACTGCAATAGC","GATCCTAATCCACGTGATGG","561307.5.peg.2187","1321"
"16286",471,333,138,"GTTTGCGTATCAATACCACT","CTCGATCCTAATCCACGTGA","561307.5.peg.2187","1321"
"16287",178,333,155,"CGAATAGTTCCCGCTCTCTA","CTCGATCCTAATCCACGTGA","561307.5.peg.2187","1321"
"16288",126,333,207,"TTAAACGGTACTGCAATAGC","CTCGATCCTAATCCACGTGA","561307.5.peg.2187","1321"
"16289",300,471,171,"GTTTGGATCGTTACTGCTAG","GTTTGCGTATCAATACCACT","561307.5.peg.2187","1321"
"16290",330,471,141,"GATCCTAATCCACGTGATGG","GTTTGCGTATCAATACCACT","561307.5.peg.2187","1321"
"16291",126,471,345,"TTAAACGGTACTGCAATAGC","GTTTGCGTATCAATACCACT","561307.5.peg.2187","1321"
"16292",243,471,228,"ACCAAAGACTTAAGATGGTC","GTTTGCGTATCAATACCACT","561307.5.peg.2187","1321"
"16293",333,471,138,"CTCGATCCTAATCCACGTGA","GTTTGCGTATCAATACCACT","561307.5.peg.2187","1321"
"16294",248,471,223,"GGTTCACCAAAGACTTAAGA","GTTTGCGTATCAATACCACT","561307.5.peg.2187","1321"
"16295",178,471,293,"CGAATAGTTCCCGCTCTCTA","GTTTGCGTATCAATACCACT","561307.5.peg.2187","1321"
"16296",317,471,154,"GTGATGGTGGTAAATTCGTT","GTTTGCGTATCAATACCACT","561307.5.peg.2187","1321"
"16297",345,9,336,"GAAGCCAACCCTGCTGCTGT","ACTTGGATTGAGAATTTAGG","561307.5.peg.2188","1322"
"16298",345,26,319,"GAAGCCAACCCTGCTGCTGT","AAGCTGGTGCAGCACATACT","561307.5.peg.2188","1322"
"16299",9,345,336,"ACTTGGATTGAGAATTTAGG","GAAGCCAACCCTGCTGCTGT","561307.5.peg.2188","1322"
"16300",26,345,319,"AAGCTGGTGCAGCACATACT","GAAGCCAACCCTGCTGCTGT","561307.5.peg.2188","1322"
"16301",156,13,143,"ATAACACGTTTACGTCCAAC","TTAACAGATAAAGAAGTGG","561307.5.peg.219","1324"
"16302",324,13,311,"GGTAATGCCAACAATGATTC","TTAACAGATAAAGAAGTGG","561307.5.peg.219","1324"
"16303",147,13,134,"TTACGTCCAACAGGTCGATC","TTAACAGATAAAGAAGTGG","561307.5.peg.219","1324"
"16304",405,13,392,"TCGATAATTGCCTGATGAAT","TTAACAGATAAAGAAGTGG","561307.5.peg.219","1324"
"16305",13,147,134,"TTAACAGATAAAGAAGTGG","TTACGTCCAACAGGTCGATC","561307.5.peg.219","1324"
"16306",324,147,177,"GGTAATGCCAACAATGATTC","TTACGTCCAACAGGTCGATC","561307.5.peg.219","1324"
"16307",405,147,258,"TCGATAATTGCCTGATGAAT","TTACGTCCAACAGGTCGATC","561307.5.peg.219","1324"
"16308",13,156,143,"TTAACAGATAAAGAAGTGG","ATAACACGTTTACGTCCAAC","561307.5.peg.219","1324"
"16309",324,156,168,"GGTAATGCCAACAATGATTC","ATAACACGTTTACGTCCAAC","561307.5.peg.219","1324"
"16310",405,156,249,"TCGATAATTGCCTGATGAAT","ATAACACGTTTACGTCCAAC","561307.5.peg.219","1324"
"16311",156,324,168,"ATAACACGTTTACGTCCAAC","GGTAATGCCAACAATGATTC","561307.5.peg.219","1324"
"16312",13,324,311,"TTAACAGATAAAGAAGTGG","GGTAATGCCAACAATGATTC","561307.5.peg.219","1324"
"16313",147,324,177,"TTACGTCCAACAGGTCGATC","GGTAATGCCAACAATGATTC","561307.5.peg.219","1324"
"16314",13,405,392,"TTAACAGATAAAGAAGTGG","TCGATAATTGCCTGATGAAT","561307.5.peg.219","1324"
"16315",147,405,258,"TTACGTCCAACAGGTCGATC","TCGATAATTGCCTGATGAAT","561307.5.peg.219","1324"
"16316",156,405,249,"ATAACACGTTTACGTCCAAC","TCGATAATTGCCTGATGAAT","561307.5.peg.219","1324"
"16317",436,198,238,"AGGAATGACAGAGGTAGCAC","TCATGTACAAGTGTCTTCGA","561307.5.peg.2191","1326"
"16318",299,198,101,"TGTTATCGTCTGCTAATAAG","TCATGTACAAGTGTCTTCGA","561307.5.peg.2191","1326"
"16319",528,198,330,"CCTACAATAACGAGGTGCTT","TCATGTACAAGTGTCTTCGA","561307.5.peg.2191","1326"
"16320",536,198,338,"AACCGCCACCTACAATAACG","TCATGTACAAGTGTCTTCGA","561307.5.peg.2191","1326"
"16321",456,198,258,"TGATCAAGGCCTTTAATGTT","TCATGTACAAGTGTCTTCGA","561307.5.peg.2191","1326"
"16322",445,198,247,"TTAATGTTAGGAATGACAG","TCATGTACAAGTGTCTTCGA","561307.5.peg.2191","1326"
"16323",198,299,101,"TCATGTACAAGTGTCTTCGA","TGTTATCGTCTGCTAATAAG","561307.5.peg.2191","1326"
"16324",456,299,157,"TGATCAAGGCCTTTAATGTT","TGTTATCGTCTGCTAATAAG","561307.5.peg.2191","1326"
"16325",436,299,137,"AGGAATGACAGAGGTAGCAC","TGTTATCGTCTGCTAATAAG","561307.5.peg.2191","1326"
"16326",536,299,237,"AACCGCCACCTACAATAACG","TGTTATCGTCTGCTAATAAG","561307.5.peg.2191","1326"
"16327",528,299,229,"CCTACAATAACGAGGTGCTT","TGTTATCGTCTGCTAATAAG","561307.5.peg.2191","1326"
"16328",445,299,146,"TTAATGTTAGGAATGACAG","TGTTATCGTCTGCTAATAAG","561307.5.peg.2191","1326"
"16329",198,436,238,"TCATGTACAAGTGTCTTCGA","AGGAATGACAGAGGTAGCAC","561307.5.peg.2191","1326"
"16330",299,436,137,"TGTTATCGTCTGCTAATAAG","AGGAATGACAGAGGTAGCAC","561307.5.peg.2191","1326"
"16331",536,436,100,"AACCGCCACCTACAATAACG","AGGAATGACAGAGGTAGCAC","561307.5.peg.2191","1326"
"16332",198,445,247,"TCATGTACAAGTGTCTTCGA","TTAATGTTAGGAATGACAG","561307.5.peg.2191","1326"
"16333",299,445,146,"TGTTATCGTCTGCTAATAAG","TTAATGTTAGGAATGACAG","561307.5.peg.2191","1326"
"16334",198,456,258,"TCATGTACAAGTGTCTTCGA","TGATCAAGGCCTTTAATGTT","561307.5.peg.2191","1326"
"16335",299,456,157,"TGTTATCGTCTGCTAATAAG","TGATCAAGGCCTTTAATGTT","561307.5.peg.2191","1326"
"16336",198,528,330,"TCATGTACAAGTGTCTTCGA","CCTACAATAACGAGGTGCTT","561307.5.peg.2191","1326"
"16337",299,528,229,"TGTTATCGTCTGCTAATAAG","CCTACAATAACGAGGTGCTT","561307.5.peg.2191","1326"
"16338",299,536,237,"TGTTATCGTCTGCTAATAAG","AACCGCCACCTACAATAACG","561307.5.peg.2191","1326"
"16339",436,536,100,"AGGAATGACAGAGGTAGCAC","AACCGCCACCTACAATAACG","561307.5.peg.2191","1326"
"16340",198,536,338,"TCATGTACAAGTGTCTTCGA","AACCGCCACCTACAATAACG","561307.5.peg.2191","1326"
"16341",424,48,376,"TGAAATGGCTTGCTGATTAT","AATACATGTCAATACTCAT","561307.5.peg.2193","1328"
"16342",439,48,391,"ATTTGTTGGTTCGATGAAA","AATACATGTCAATACTCAT","561307.5.peg.2193","1328"
"16343",578,48,530,"GCGCTTGGGTAAGTCCTTGT","AATACATGTCAATACTCAT","561307.5.peg.2193","1328"
"16344",639,48,591,"CAATCAAGTTCTTTACCTGA","AATACATGTCAATACTCAT","561307.5.peg.2193","1328"
"16345",578,86,492,"GCGCTTGGGTAAGTCCTTGT","AATTCCCCACACTTGAAGCT","561307.5.peg.2193","1328"
"16346",424,86,338,"TGAAATGGCTTGCTGATTAT","AATTCCCCACACTTGAAGCT","561307.5.peg.2193","1328"
"16347",639,86,553,"CAATCAAGTTCTTTACCTGA","AATTCCCCACACTTGAAGCT","561307.5.peg.2193","1328"
"16348",439,86,353,"ATTTGTTGGTTCGATGAAA","AATTCCCCACACTTGAAGCT","561307.5.peg.2193","1328"
"16349",48,424,376,"AATACATGTCAATACTCAT","TGAAATGGCTTGCTGATTAT","561307.5.peg.2193","1328"
"16350",578,424,154,"GCGCTTGGGTAAGTCCTTGT","TGAAATGGCTTGCTGATTAT","561307.5.peg.2193","1328"
"16351",86,424,338,"AATTCCCCACACTTGAAGCT","TGAAATGGCTTGCTGATTAT","561307.5.peg.2193","1328"
"16352",639,424,215,"CAATCAAGTTCTTTACCTGA","TGAAATGGCTTGCTGATTAT","561307.5.peg.2193","1328"
"16353",48,439,391,"AATACATGTCAATACTCAT","ATTTGTTGGTTCGATGAAA","561307.5.peg.2193","1328"
"16354",578,439,139,"GCGCTTGGGTAAGTCCTTGT","ATTTGTTGGTTCGATGAAA","561307.5.peg.2193","1328"
"16355",86,439,353,"AATTCCCCACACTTGAAGCT","ATTTGTTGGTTCGATGAAA","561307.5.peg.2193","1328"
"16356",639,439,200,"CAATCAAGTTCTTTACCTGA","ATTTGTTGGTTCGATGAAA","561307.5.peg.2193","1328"
"16357",424,578,154,"TGAAATGGCTTGCTGATTAT","GCGCTTGGGTAAGTCCTTGT","561307.5.peg.2193","1328"
"16358",48,578,530,"AATACATGTCAATACTCAT","GCGCTTGGGTAAGTCCTTGT","561307.5.peg.2193","1328"
"16359",439,578,139,"ATTTGTTGGTTCGATGAAA","GCGCTTGGGTAAGTCCTTGT","561307.5.peg.2193","1328"
"16360",86,578,492,"AATTCCCCACACTTGAAGCT","GCGCTTGGGTAAGTCCTTGT","561307.5.peg.2193","1328"
"16361",48,639,591,"AATACATGTCAATACTCAT","CAATCAAGTTCTTTACCTGA","561307.5.peg.2193","1328"
"16362",86,639,553,"AATTCCCCACACTTGAAGCT","CAATCAAGTTCTTTACCTGA","561307.5.peg.2193","1328"
"16363",424,639,215,"TGAAATGGCTTGCTGATTAT","CAATCAAGTTCTTTACCTGA","561307.5.peg.2193","1328"
"16364",439,639,200,"ATTTGTTGGTTCGATGAAA","CAATCAAGTTCTTTACCTGA","561307.5.peg.2193","1328"
"16365",264,161,103,"AAGACCGTACTTCCTGCCAC","GAATCAGCCAATTAATCATT","561307.5.peg.2204","1341"
"16366",161,264,103,"GAATCAGCCAATTAATCATT","AAGACCGTACTTCCTGCCAC","561307.5.peg.2204","1341"
"16367",267,4,263,"AAAGCAGAGCTACCTGCAAC","TAAGCCCTAAGAAATGGAGC","561307.5.peg.2207","1344"
"16368",267,10,257,"AAAGCAGAGCTACCTGCAAC","TCATATAAGCCCTAAGAAA","561307.5.peg.2207","1344"
"16369",267,29,238,"AAAGCAGAGCTACCTGCAAC","TTTACCAGCTCCATTTCTTA","561307.5.peg.2207","1344"
"16370",4,267,263,"TAAGCCCTAAGAAATGGAGC","AAAGCAGAGCTACCTGCAAC","561307.5.peg.2207","1344"
"16371",10,267,257,"TCATATAAGCCCTAAGAAA","AAAGCAGAGCTACCTGCAAC","561307.5.peg.2207","1344"
"16372",29,267,238,"TTTACCAGCTCCATTTCTTA","AAAGCAGAGCTACCTGCAAC","561307.5.peg.2207","1344"
"16373",141,5,136,"CCTTGTTCTTCATCTAAGTT","AGTTATAAAGATAAGGAGCT","561307.5.peg.2208","1345"
"16374",231,5,226,"ACCAATTCTTCTGATCGTTC","AGTTATAAAGATAAGGAGCT","561307.5.peg.2208","1345"
"16375",450,5,445,"GCTGCAACTGCTTGATCTTT","AGTTATAAAGATAAGGAGCT","561307.5.peg.2208","1345"
"16376",435,5,430,"TCTTTCGGAGTGTTGTTATC","AGTTATAAAGATAAGGAGCT","561307.5.peg.2208","1345"
"16377",450,31,419,"GCTGCAACTGCTTGATCTTT","TCATGATAGTGTGATAG","561307.5.peg.2208","1345"
"16378",141,31,110,"CCTTGTTCTTCATCTAAGTT","TCATGATAGTGTGATAG","561307.5.peg.2208","1345"
"16379",231,31,200,"ACCAATTCTTCTGATCGTTC","TCATGATAGTGTGATAG","561307.5.peg.2208","1345"
"16380",435,31,404,"TCTTTCGGAGTGTTGTTATC","TCATGATAGTGTGATAG","561307.5.peg.2208","1345"
"16381",435,96,339,"TCTTTCGGAGTGTTGTTATC","GCGTTCGTCCCAAGTGCGAT","561307.5.peg.2208","1345"
"16382",231,96,135,"ACCAATTCTTCTGATCGTTC","GCGTTCGTCCCAAGTGCGAT","561307.5.peg.2208","1345"
"16383",450,96,354,"GCTGCAACTGCTTGATCTTT","GCGTTCGTCCCAAGTGCGAT","561307.5.peg.2208","1345"
"16384",5,141,136,"AGTTATAAAGATAAGGAGCT","CCTTGTTCTTCATCTAAGTT","561307.5.peg.2208","1345"
"16385",31,141,110,"TCATGATAGTGTGATAG","CCTTGTTCTTCATCTAAGTT","561307.5.peg.2208","1345"
"16386",435,141,294,"TCTTTCGGAGTGTTGTTATC","CCTTGTTCTTCATCTAAGTT","561307.5.peg.2208","1345"
"16387",450,141,309,"GCTGCAACTGCTTGATCTTT","CCTTGTTCTTCATCTAAGTT","561307.5.peg.2208","1345"
"16388",5,231,226,"AGTTATAAAGATAAGGAGCT","ACCAATTCTTCTGATCGTTC","561307.5.peg.2208","1345"
"16389",31,231,200,"TCATGATAGTGTGATAG","ACCAATTCTTCTGATCGTTC","561307.5.peg.2208","1345"
"16390",96,231,135,"GCGTTCGTCCCAAGTGCGAT","ACCAATTCTTCTGATCGTTC","561307.5.peg.2208","1345"
"16391",435,231,204,"TCTTTCGGAGTGTTGTTATC","ACCAATTCTTCTGATCGTTC","561307.5.peg.2208","1345"
"16392",450,231,219,"GCTGCAACTGCTTGATCTTT","ACCAATTCTTCTGATCGTTC","561307.5.peg.2208","1345"
"16393",31,435,404,"TCATGATAGTGTGATAG","TCTTTCGGAGTGTTGTTATC","561307.5.peg.2208","1345"
"16394",231,435,204,"ACCAATTCTTCTGATCGTTC","TCTTTCGGAGTGTTGTTATC","561307.5.peg.2208","1345"
"16395",96,435,339,"GCGTTCGTCCCAAGTGCGAT","TCTTTCGGAGTGTTGTTATC","561307.5.peg.2208","1345"
"16396",5,435,430,"AGTTATAAAGATAAGGAGCT","TCTTTCGGAGTGTTGTTATC","561307.5.peg.2208","1345"
"16397",141,435,294,"CCTTGTTCTTCATCTAAGTT","TCTTTCGGAGTGTTGTTATC","561307.5.peg.2208","1345"
"16398",5,450,445,"AGTTATAAAGATAAGGAGCT","GCTGCAACTGCTTGATCTTT","561307.5.peg.2208","1345"
"16399",141,450,309,"CCTTGTTCTTCATCTAAGTT","GCTGCAACTGCTTGATCTTT","561307.5.peg.2208","1345"
"16400",96,450,354,"GCGTTCGTCCCAAGTGCGAT","GCTGCAACTGCTTGATCTTT","561307.5.peg.2208","1345"
"16401",31,450,419,"TCATGATAGTGTGATAG","GCTGCAACTGCTTGATCTTT","561307.5.peg.2208","1345"
"16402",231,450,219,"ACCAATTCTTCTGATCGTTC","GCTGCAACTGCTTGATCTTT","561307.5.peg.2208","1345"
"16403",276,81,195,"GAAATGCTATACCAATACAC","AATTGTGCAGTATTACCGTT","561307.5.peg.2209","1346"
"16404",276,168,108,"GAAATGCTATACCAATACAC","GTATGTCTCACGTCACGTAT","561307.5.peg.2209","1346"
"16405",81,276,195,"AATTGTGCAGTATTACCGTT","GAAATGCTATACCAATACAC","561307.5.peg.2209","1346"
"16406",168,276,108,"GTATGTCTCACGTCACGTAT","GAAATGCTATACCAATACAC","561307.5.peg.2209","1346"
"16407",124,7,117,"AATACCTTGCATATTCTTGC","TTATAAGCAATTCAACTGGA","561307.5.peg.221","1347"
"16408",7,124,117,"TTATAAGCAATTCAACTGGA","AATACCTTGCATATTCTTGC","561307.5.peg.221","1347"
"16409",330,104,226,"AATGCAGCACATAATGCCAA","CATGAATATATCGATGTATC","561307.5.peg.2211","1349"
"16410",413,104,309,"TCGCTTGTGTGTATGCTTCA","CATGAATATATCGATGTATC","561307.5.peg.2211","1349"
"16411",492,104,388,"ATTACTTCCGCAACTTCTCT","CATGAATATATCGATGTATC","561307.5.peg.2211","1349"
"16412",413,170,243,"TCGCTTGTGTGTATGCTTCA","GTCTAATTCGACGTAACCTT","561307.5.peg.2211","1349"
"16413",330,170,160,"AATGCAGCACATAATGCCAA","GTCTAATTCGACGTAACCTT","561307.5.peg.2211","1349"
"16414",492,170,322,"ATTACTTCCGCAACTTCTCT","GTCTAATTCGACGTAACCTT","561307.5.peg.2211","1349"
"16415",104,330,226,"CATGAATATATCGATGTATC","AATGCAGCACATAATGCCAA","561307.5.peg.2211","1349"
"16416",170,330,160,"GTCTAATTCGACGTAACCTT","AATGCAGCACATAATGCCAA","561307.5.peg.2211","1349"
"16417",492,330,162,"ATTACTTCCGCAACTTCTCT","AATGCAGCACATAATGCCAA","561307.5.peg.2211","1349"
"16418",104,413,309,"CATGAATATATCGATGTATC","TCGCTTGTGTGTATGCTTCA","561307.5.peg.2211","1349"
"16419",170,413,243,"GTCTAATTCGACGTAACCTT","TCGCTTGTGTGTATGCTTCA","561307.5.peg.2211","1349"
"16420",104,492,388,"CATGAATATATCGATGTATC","ATTACTTCCGCAACTTCTCT","561307.5.peg.2211","1349"
"16421",330,492,162,"AATGCAGCACATAATGCCAA","ATTACTTCCGCAACTTCTCT","561307.5.peg.2211","1349"
"16422",170,492,322,"GTCTAATTCGACGTAACCTT","ATTACTTCCGCAACTTCTCT","561307.5.peg.2211","1349"
"16423",120,9,111,"GTTTGTACCAACGCTTCACC","ATACTGGAGTGACTATAAGG","561307.5.peg.2213","1351"
"16424",166,9,157,"GCATTCTTAACATGTAAAT","ATACTGGAGTGACTATAAGG","561307.5.peg.2213","1351"
"16425",459,9,450,"GTAATAGAAGACGCTGCTGC","ATACTGGAGTGACTATAAGG","561307.5.peg.2213","1351"
"16426",284,9,275,"ACATCCAAGCGATAGACACA","ATACTGGAGTGACTATAAGG","561307.5.peg.2213","1351"
"16427",120,12,108,"GTTTGTACCAACGCTTCACC","TACATACTGGAGTGACTATA","561307.5.peg.2213","1351"
"16428",284,12,272,"ACATCCAAGCGATAGACACA","TACATACTGGAGTGACTATA","561307.5.peg.2213","1351"
"16429",459,12,447,"GTAATAGAAGACGCTGCTGC","TACATACTGGAGTGACTATA","561307.5.peg.2213","1351"
"16430",166,12,154,"GCATTCTTAACATGTAAAT","TACATACTGGAGTGACTATA","561307.5.peg.2213","1351"
"16431",12,120,108,"TACATACTGGAGTGACTATA","GTTTGTACCAACGCTTCACC","561307.5.peg.2213","1351"
"16432",9,120,111,"ATACTGGAGTGACTATAAGG","GTTTGTACCAACGCTTCACC","561307.5.peg.2213","1351"
"16433",284,120,164,"ACATCCAAGCGATAGACACA","GTTTGTACCAACGCTTCACC","561307.5.peg.2213","1351"
"16434",459,120,339,"GTAATAGAAGACGCTGCTGC","GTTTGTACCAACGCTTCACC","561307.5.peg.2213","1351"
"16435",12,166,154,"TACATACTGGAGTGACTATA","GCATTCTTAACATGTAAAT","561307.5.peg.2213","1351"
"16436",9,166,157,"ATACTGGAGTGACTATAAGG","GCATTCTTAACATGTAAAT","561307.5.peg.2213","1351"
"16437",284,166,118,"ACATCCAAGCGATAGACACA","GCATTCTTAACATGTAAAT","561307.5.peg.2213","1351"
"16438",459,166,293,"GTAATAGAAGACGCTGCTGC","GCATTCTTAACATGTAAAT","561307.5.peg.2213","1351"
"16439",9,284,275,"ATACTGGAGTGACTATAAGG","ACATCCAAGCGATAGACACA","561307.5.peg.2213","1351"
"16440",166,284,118,"GCATTCTTAACATGTAAAT","ACATCCAAGCGATAGACACA","561307.5.peg.2213","1351"
"16441",12,284,272,"TACATACTGGAGTGACTATA","ACATCCAAGCGATAGACACA","561307.5.peg.2213","1351"
"16442",120,284,164,"GTTTGTACCAACGCTTCACC","ACATCCAAGCGATAGACACA","561307.5.peg.2213","1351"
"16443",459,284,175,"GTAATAGAAGACGCTGCTGC","ACATCCAAGCGATAGACACA","561307.5.peg.2213","1351"
"16444",9,459,450,"ATACTGGAGTGACTATAAGG","GTAATAGAAGACGCTGCTGC","561307.5.peg.2213","1351"
"16445",284,459,175,"ACATCCAAGCGATAGACACA","GTAATAGAAGACGCTGCTGC","561307.5.peg.2213","1351"
"16446",12,459,447,"TACATACTGGAGTGACTATA","GTAATAGAAGACGCTGCTGC","561307.5.peg.2213","1351"
"16447",166,459,293,"GCATTCTTAACATGTAAAT","GTAATAGAAGACGCTGCTGC","561307.5.peg.2213","1351"
"16448",120,459,339,"GTTTGTACCAACGCTTCACC","GTAATAGAAGACGCTGCTGC","561307.5.peg.2213","1351"
"16449",443,228,215,"CAATATGTAAATCTCCTGTA","ATCGCTTGAGCAATTTCACG","561307.5.peg.2215","1353"
"16450",639,228,411,"TTTCCATTATAGCCATCTTC","ATCGCTTGAGCAATTTCACG","561307.5.peg.2215","1353"
"16451",228,443,215,"ATCGCTTGAGCAATTTCACG","CAATATGTAAATCTCCTGTA","561307.5.peg.2215","1353"
"16452",639,443,196,"TTTCCATTATAGCCATCTTC","CAATATGTAAATCTCCTGTA","561307.5.peg.2215","1353"
"16453",228,639,411,"ATCGCTTGAGCAATTTCACG","TTTCCATTATAGCCATCTTC","561307.5.peg.2215","1353"
"16454",443,639,196,"CAATATGTAAATCTCCTGTA","TTTCCATTATAGCCATCTTC","561307.5.peg.2215","1353"
"16455",339,95,244,"TCATGCGCAAGAATTAGATC","CTTTCATACCACAGCCACTC","561307.5.peg.2217","1355"
"16456",339,162,177,"TCATGCGCAAGAATTAGATC","AACGAAACAATTCTATGGTA","561307.5.peg.2217","1355"
"16457",95,339,244,"CTTTCATACCACAGCCACTC","TCATGCGCAAGAATTAGATC","561307.5.peg.2217","1355"
"16458",162,339,177,"AACGAAACAATTCTATGGTA","TCATGCGCAAGAATTAGATC","561307.5.peg.2217","1355"
"16459",419,180,239,"AGATTCTAACTGGATAGCCT","ACAATGCTTCTAATAATCT","561307.5.peg.2218","1356"
"16460",180,419,239,"ACAATGCTTCTAATAATCT","AGATTCTAACTGGATAGCCT","561307.5.peg.2218","1356"
"16461",243,124,119,"CTTCATTGTAAGAATACAT","AGAGTTGCCACTTGCTGCTT","561307.5.peg.2221","1360"
"16462",124,243,119,"AGAGTTGCCACTTGCTGCTT","CTTCATTGTAAGAATACAT","561307.5.peg.2221","1360"
"16463",394,29,365,"GTCATCTTTCTTCGATGCAA","CGTATATAGAATGAAGGTT","561307.5.peg.2223","1362"
"16464",29,394,365,"CGTATATAGAATGAAGGTT","GTCATCTTTCTTCGATGCAA","561307.5.peg.2223","1362"
"16465",282,8,274,"GTTCTTTCGATAATGTTTC","AAGACACTTAAAGCAAGGGG","561307.5.peg.2228","1367"
"16466",282,13,269,"GTTCTTTCGATAATGTTTC","GATTAAGACACTTAAAGCA","561307.5.peg.2228","1367"
"16467",8,282,274,"AAGACACTTAAAGCAAGGGG","GTTCTTTCGATAATGTTTC","561307.5.peg.2228","1367"
"16468",13,282,269,"GATTAAGACACTTAAAGCA","GTTCTTTCGATAATGTTTC","561307.5.peg.2228","1367"
"16469",732,139,593,"CTAGGTAGCCAAATATGAAA","TGCAACCAACGCTATGTACC","561307.5.peg.2229","1368"
"16470",953,139,814,"GACTGATTGTAGAGTACGCT","TGCAACCAACGCTATGTACC","561307.5.peg.2229","1368"
"16471",750,139,611,"GTAGGTGCAGCCATTGCTCT","TGCAACCAACGCTATGTACC","561307.5.peg.2229","1368"
"16472",768,139,629,"AAATAAGCACTTACAGGTGT","TGCAACCAACGCTATGTACC","561307.5.peg.2229","1368"
"16473",1028,139,889,"TAGATGCTATTGCGTCTTGT","TGCAACCAACGCTATGTACC","561307.5.peg.2229","1368"
"16474",750,198,552,"GTAGGTGCAGCCATTGCTCT","TATTGCAGTTTAGCTACTGA","561307.5.peg.2229","1368"
"16475",768,198,570,"AAATAAGCACTTACAGGTGT","TATTGCAGTTTAGCTACTGA","561307.5.peg.2229","1368"
"16476",732,198,534,"CTAGGTAGCCAAATATGAAA","TATTGCAGTTTAGCTACTGA","561307.5.peg.2229","1368"
"16477",953,198,755,"GACTGATTGTAGAGTACGCT","TATTGCAGTTTAGCTACTGA","561307.5.peg.2229","1368"
"16478",1028,198,830,"TAGATGCTATTGCGTCTTGT","TATTGCAGTTTAGCTACTGA","561307.5.peg.2229","1368"
"16479",139,732,593,"TGCAACCAACGCTATGTACC","CTAGGTAGCCAAATATGAAA","561307.5.peg.2229","1368"
"16480",953,732,221,"GACTGATTGTAGAGTACGCT","CTAGGTAGCCAAATATGAAA","561307.5.peg.2229","1368"
"16481",198,732,534,"TATTGCAGTTTAGCTACTGA","CTAGGTAGCCAAATATGAAA","561307.5.peg.2229","1368"
"16482",1028,732,296,"TAGATGCTATTGCGTCTTGT","CTAGGTAGCCAAATATGAAA","561307.5.peg.2229","1368"
"16483",139,750,611,"TGCAACCAACGCTATGTACC","GTAGGTGCAGCCATTGCTCT","561307.5.peg.2229","1368"
"16484",198,750,552,"TATTGCAGTTTAGCTACTGA","GTAGGTGCAGCCATTGCTCT","561307.5.peg.2229","1368"
"16485",1028,750,278,"TAGATGCTATTGCGTCTTGT","GTAGGTGCAGCCATTGCTCT","561307.5.peg.2229","1368"
"16486",953,750,203,"GACTGATTGTAGAGTACGCT","GTAGGTGCAGCCATTGCTCT","561307.5.peg.2229","1368"
"16487",139,768,629,"TGCAACCAACGCTATGTACC","AAATAAGCACTTACAGGTGT","561307.5.peg.2229","1368"
"16488",953,768,185,"GACTGATTGTAGAGTACGCT","AAATAAGCACTTACAGGTGT","561307.5.peg.2229","1368"
"16489",198,768,570,"TATTGCAGTTTAGCTACTGA","AAATAAGCACTTACAGGTGT","561307.5.peg.2229","1368"
"16490",1028,768,260,"TAGATGCTATTGCGTCTTGT","AAATAAGCACTTACAGGTGT","561307.5.peg.2229","1368"
"16491",139,953,814,"TGCAACCAACGCTATGTACC","GACTGATTGTAGAGTACGCT","561307.5.peg.2229","1368"
"16492",198,953,755,"TATTGCAGTTTAGCTACTGA","GACTGATTGTAGAGTACGCT","561307.5.peg.2229","1368"
"16493",732,953,221,"CTAGGTAGCCAAATATGAAA","GACTGATTGTAGAGTACGCT","561307.5.peg.2229","1368"
"16494",750,953,203,"GTAGGTGCAGCCATTGCTCT","GACTGATTGTAGAGTACGCT","561307.5.peg.2229","1368"
"16495",768,953,185,"AAATAAGCACTTACAGGTGT","GACTGATTGTAGAGTACGCT","561307.5.peg.2229","1368"
"16496",139,1028,889,"TGCAACCAACGCTATGTACC","TAGATGCTATTGCGTCTTGT","561307.5.peg.2229","1368"
"16497",732,1028,296,"CTAGGTAGCCAAATATGAAA","TAGATGCTATTGCGTCTTGT","561307.5.peg.2229","1368"
"16498",750,1028,278,"GTAGGTGCAGCCATTGCTCT","TAGATGCTATTGCGTCTTGT","561307.5.peg.2229","1368"
"16499",198,1028,830,"TATTGCAGTTTAGCTACTGA","TAGATGCTATTGCGTCTTGT","561307.5.peg.2229","1368"
"16500",768,1028,260,"AAATAAGCACTTACAGGTGT","TAGATGCTATTGCGTCTTGT","561307.5.peg.2229","1368"
"16501",366,6,360,"TACTTCGCTTTAATAGCACT","TAGATGAACTAGAAACTAGG","561307.5.peg.223","1369"
"16502",577,6,571,"AATGACACGAACAGCACGCT","TAGATGAACTAGAAACTAGG","561307.5.peg.223","1369"
"16503",140,6,134,"CAATTACACGCACACCAGGT","TAGATGAACTAGAAACTAGG","561307.5.peg.223","1369"
"16504",144,6,138,"GGTACAATTACACGCACACC","TAGATGAACTAGAAACTAGG","561307.5.peg.223","1369"
"16505",1011,6,1005,"TGCGGTGTTAGAGCGATTTC","TAGATGAACTAGAAACTAGG","561307.5.peg.223","1369"
"16506",117,6,111,"ATGACAGATTCGAGTTGTTC","TAGATGAACTAGAAACTAGG","561307.5.peg.223","1369"
"16507",736,6,730,"TTGATAAGTCCATCTAAAC","TAGATGAACTAGAAACTAGG","561307.5.peg.223","1369"
"16508",174,6,168,"ACATAACCTTGAATCGTTCT","TAGATGAACTAGAAACTAGG","561307.5.peg.223","1369"
"16509",216,6,210,"GAAACGTCAAGTTGTGCATC","TAGATGAACTAGAAACTAGG","561307.5.peg.223","1369"
"16510",6,117,111,"TAGATGAACTAGAAACTAGG","ATGACAGATTCGAGTTGTTC","561307.5.peg.223","1369"
"16511",366,117,249,"TACTTCGCTTTAATAGCACT","ATGACAGATTCGAGTTGTTC","561307.5.peg.223","1369"
"16512",736,117,619,"TTGATAAGTCCATCTAAAC","ATGACAGATTCGAGTTGTTC","561307.5.peg.223","1369"
"16513",1011,117,894,"TGCGGTGTTAGAGCGATTTC","ATGACAGATTCGAGTTGTTC","561307.5.peg.223","1369"
"16514",577,117,460,"AATGACACGAACAGCACGCT","ATGACAGATTCGAGTTGTTC","561307.5.peg.223","1369"
"16515",1011,140,871,"TGCGGTGTTAGAGCGATTTC","CAATTACACGCACACCAGGT","561307.5.peg.223","1369"
"16516",6,140,134,"TAGATGAACTAGAAACTAGG","CAATTACACGCACACCAGGT","561307.5.peg.223","1369"
"16517",577,140,437,"AATGACACGAACAGCACGCT","CAATTACACGCACACCAGGT","561307.5.peg.223","1369"
"16518",366,140,226,"TACTTCGCTTTAATAGCACT","CAATTACACGCACACCAGGT","561307.5.peg.223","1369"
"16519",736,140,596,"TTGATAAGTCCATCTAAAC","CAATTACACGCACACCAGGT","561307.5.peg.223","1369"
"16520",6,144,138,"TAGATGAACTAGAAACTAGG","GGTACAATTACACGCACACC","561307.5.peg.223","1369"
"16521",1011,144,867,"TGCGGTGTTAGAGCGATTTC","GGTACAATTACACGCACACC","561307.5.peg.223","1369"
"16522",736,144,592,"TTGATAAGTCCATCTAAAC","GGTACAATTACACGCACACC","561307.5.peg.223","1369"
"16523",577,144,433,"AATGACACGAACAGCACGCT","GGTACAATTACACGCACACC","561307.5.peg.223","1369"
"16524",366,144,222,"TACTTCGCTTTAATAGCACT","GGTACAATTACACGCACACC","561307.5.peg.223","1369"
"16525",577,174,403,"AATGACACGAACAGCACGCT","ACATAACCTTGAATCGTTCT","561307.5.peg.223","1369"
"16526",1011,174,837,"TGCGGTGTTAGAGCGATTTC","ACATAACCTTGAATCGTTCT","561307.5.peg.223","1369"
"16527",6,174,168,"TAGATGAACTAGAAACTAGG","ACATAACCTTGAATCGTTCT","561307.5.peg.223","1369"
"16528",736,174,562,"TTGATAAGTCCATCTAAAC","ACATAACCTTGAATCGTTCT","561307.5.peg.223","1369"
"16529",366,174,192,"TACTTCGCTTTAATAGCACT","ACATAACCTTGAATCGTTCT","561307.5.peg.223","1369"
"16530",366,216,150,"TACTTCGCTTTAATAGCACT","GAAACGTCAAGTTGTGCATC","561307.5.peg.223","1369"
"16531",736,216,520,"TTGATAAGTCCATCTAAAC","GAAACGTCAAGTTGTGCATC","561307.5.peg.223","1369"
"16532",1011,216,795,"TGCGGTGTTAGAGCGATTTC","GAAACGTCAAGTTGTGCATC","561307.5.peg.223","1369"
"16533",577,216,361,"AATGACACGAACAGCACGCT","GAAACGTCAAGTTGTGCATC","561307.5.peg.223","1369"
"16534",6,216,210,"TAGATGAACTAGAAACTAGG","GAAACGTCAAGTTGTGCATC","561307.5.peg.223","1369"
"16535",6,366,360,"TAGATGAACTAGAAACTAGG","TACTTCGCTTTAATAGCACT","561307.5.peg.223","1369"
"16536",577,366,211,"AATGACACGAACAGCACGCT","TACTTCGCTTTAATAGCACT","561307.5.peg.223","1369"
"16537",144,366,222,"GGTACAATTACACGCACACC","TACTTCGCTTTAATAGCACT","561307.5.peg.223","1369"
"16538",140,366,226,"CAATTACACGCACACCAGGT","TACTTCGCTTTAATAGCACT","561307.5.peg.223","1369"
"16539",117,366,249,"ATGACAGATTCGAGTTGTTC","TACTTCGCTTTAATAGCACT","561307.5.peg.223","1369"
"16540",174,366,192,"ACATAACCTTGAATCGTTCT","TACTTCGCTTTAATAGCACT","561307.5.peg.223","1369"
"16541",216,366,150,"GAAACGTCAAGTTGTGCATC","TACTTCGCTTTAATAGCACT","561307.5.peg.223","1369"
"16542",1011,366,645,"TGCGGTGTTAGAGCGATTTC","TACTTCGCTTTAATAGCACT","561307.5.peg.223","1369"
"16543",736,366,370,"TTGATAAGTCCATCTAAAC","TACTTCGCTTTAATAGCACT","561307.5.peg.223","1369"
"16544",216,577,361,"GAAACGTCAAGTTGTGCATC","AATGACACGAACAGCACGCT","561307.5.peg.223","1369"
"16545",144,577,433,"GGTACAATTACACGCACACC","AATGACACGAACAGCACGCT","561307.5.peg.223","1369"
"16546",174,577,403,"ACATAACCTTGAATCGTTCT","AATGACACGAACAGCACGCT","561307.5.peg.223","1369"
"16547",1011,577,434,"TGCGGTGTTAGAGCGATTTC","AATGACACGAACAGCACGCT","561307.5.peg.223","1369"
"16548",140,577,437,"CAATTACACGCACACCAGGT","AATGACACGAACAGCACGCT","561307.5.peg.223","1369"
"16549",117,577,460,"ATGACAGATTCGAGTTGTTC","AATGACACGAACAGCACGCT","561307.5.peg.223","1369"
"16550",6,577,571,"TAGATGAACTAGAAACTAGG","AATGACACGAACAGCACGCT","561307.5.peg.223","1369"
"16551",366,577,211,"TACTTCGCTTTAATAGCACT","AATGACACGAACAGCACGCT","561307.5.peg.223","1369"
"16552",736,577,159,"TTGATAAGTCCATCTAAAC","AATGACACGAACAGCACGCT","561307.5.peg.223","1369"
"16553",117,736,619,"ATGACAGATTCGAGTTGTTC","TTGATAAGTCCATCTAAAC","561307.5.peg.223","1369"
"16554",174,736,562,"ACATAACCTTGAATCGTTCT","TTGATAAGTCCATCTAAAC","561307.5.peg.223","1369"
"16555",6,736,730,"TAGATGAACTAGAAACTAGG","TTGATAAGTCCATCTAAAC","561307.5.peg.223","1369"
"16556",1011,736,275,"TGCGGTGTTAGAGCGATTTC","TTGATAAGTCCATCTAAAC","561307.5.peg.223","1369"
"16557",366,736,370,"TACTTCGCTTTAATAGCACT","TTGATAAGTCCATCTAAAC","561307.5.peg.223","1369"
"16558",216,736,520,"GAAACGTCAAGTTGTGCATC","TTGATAAGTCCATCTAAAC","561307.5.peg.223","1369"
"16559",144,736,592,"GGTACAATTACACGCACACC","TTGATAAGTCCATCTAAAC","561307.5.peg.223","1369"
"16560",140,736,596,"CAATTACACGCACACCAGGT","TTGATAAGTCCATCTAAAC","561307.5.peg.223","1369"
"16561",577,736,159,"AATGACACGAACAGCACGCT","TTGATAAGTCCATCTAAAC","561307.5.peg.223","1369"
"16562",6,1011,1005,"TAGATGAACTAGAAACTAGG","TGCGGTGTTAGAGCGATTTC","561307.5.peg.223","1369"
"16563",117,1011,894,"ATGACAGATTCGAGTTGTTC","TGCGGTGTTAGAGCGATTTC","561307.5.peg.223","1369"
"16564",736,1011,275,"TTGATAAGTCCATCTAAAC","TGCGGTGTTAGAGCGATTTC","561307.5.peg.223","1369"
"16565",216,1011,795,"GAAACGTCAAGTTGTGCATC","TGCGGTGTTAGAGCGATTTC","561307.5.peg.223","1369"
"16566",366,1011,645,"TACTTCGCTTTAATAGCACT","TGCGGTGTTAGAGCGATTTC","561307.5.peg.223","1369"
"16567",144,1011,867,"GGTACAATTACACGCACACC","TGCGGTGTTAGAGCGATTTC","561307.5.peg.223","1369"
"16568",577,1011,434,"AATGACACGAACAGCACGCT","TGCGGTGTTAGAGCGATTTC","561307.5.peg.223","1369"
"16569",174,1011,837,"ACATAACCTTGAATCGTTCT","TGCGGTGTTAGAGCGATTTC","561307.5.peg.223","1369"
"16570",140,1011,871,"CAATTACACGCACACCAGGT","TGCGGTGTTAGAGCGATTTC","561307.5.peg.223","1369"
"16571",150,6,144,"CCACCAATAAACCCACCACC","TTAAATTATCAAGATCGGAG","561307.5.peg.2230","1370"
"16572",6,150,144,"TTAAATTATCAAGATCGGAG","CCACCAATAAACCCACCACC","561307.5.peg.2230","1370"
"16573",215,7,208,"CAAAGTCTAGCGTAATTGGA","TGAAATTGAAGGCCTAAGGG","561307.5.peg.2232","1372"
"16574",219,7,212,"CCTCCAAAGTCTAGCGTAAT","TGAAATTGAAGGCCTAAGGG","561307.5.peg.2232","1372"
"16575",745,7,738,"CTCAGTATTTAACACAGCGT","TGAAATTGAAGGCCTAAGGG","561307.5.peg.2232","1372"
"16576",304,7,297,"TAAAGTAATCACAAACGAAG","TGAAATTGAAGGCCTAAGGG","561307.5.peg.2232","1372"
"16577",738,7,731,"TTTAACACAGCGTAGGCTTT","TGAAATTGAAGGCCTAAGGG","561307.5.peg.2232","1372"
"16578",215,9,206,"CAAAGTCTAGCGTAATTGGA","GATGAAATTGAAGGCCTAAG","561307.5.peg.2232","1372"
"16579",304,9,295,"TAAAGTAATCACAAACGAAG","GATGAAATTGAAGGCCTAAG","561307.5.peg.2232","1372"
"16580",738,9,729,"TTTAACACAGCGTAGGCTTT","GATGAAATTGAAGGCCTAAG","561307.5.peg.2232","1372"
"16581",219,9,210,"CCTCCAAAGTCTAGCGTAAT","GATGAAATTGAAGGCCTAAG","561307.5.peg.2232","1372"
"16582",745,9,736,"CTCAGTATTTAACACAGCGT","GATGAAATTGAAGGCCTAAG","561307.5.peg.2232","1372"
"16583",215,11,204,"CAAAGTCTAGCGTAATTGGA","AAGATGAAATTGAAGGCCTA","561307.5.peg.2232","1372"
"16584",745,11,734,"CTCAGTATTTAACACAGCGT","AAGATGAAATTGAAGGCCTA","561307.5.peg.2232","1372"
"16585",738,11,727,"TTTAACACAGCGTAGGCTTT","AAGATGAAATTGAAGGCCTA","561307.5.peg.2232","1372"
"16586",304,11,293,"TAAAGTAATCACAAACGAAG","AAGATGAAATTGAAGGCCTA","561307.5.peg.2232","1372"
"16587",219,11,208,"CCTCCAAAGTCTAGCGTAAT","AAGATGAAATTGAAGGCCTA","561307.5.peg.2232","1372"
"16588",304,34,270,"TAAAGTAATCACAAACGAAG","TAGCATCATCTTCCCCCCTT","561307.5.peg.2232","1372"
"16589",219,34,185,"CCTCCAAAGTCTAGCGTAAT","TAGCATCATCTTCCCCCCTT","561307.5.peg.2232","1372"
"16590",215,34,181,"CAAAGTCTAGCGTAATTGGA","TAGCATCATCTTCCCCCCTT","561307.5.peg.2232","1372"
"16591",745,34,711,"CTCAGTATTTAACACAGCGT","TAGCATCATCTTCCCCCCTT","561307.5.peg.2232","1372"
"16592",738,34,704,"TTTAACACAGCGTAGGCTTT","TAGCATCATCTTCCCCCCTT","561307.5.peg.2232","1372"
"16593",304,87,217,"TAAAGTAATCACAAACGAAG","AGGATTAAGGCACAAAGGAA","561307.5.peg.2232","1372"
"16594",745,87,658,"CTCAGTATTTAACACAGCGT","AGGATTAAGGCACAAAGGAA","561307.5.peg.2232","1372"
"16595",215,87,128,"CAAAGTCTAGCGTAATTGGA","AGGATTAAGGCACAAAGGAA","561307.5.peg.2232","1372"
"16596",219,87,132,"CCTCCAAAGTCTAGCGTAAT","AGGATTAAGGCACAAAGGAA","561307.5.peg.2232","1372"
"16597",738,87,651,"TTTAACACAGCGTAGGCTTT","AGGATTAAGGCACAAAGGAA","561307.5.peg.2232","1372"
"16598",304,92,212,"TAAAGTAATCACAAACGAAG","ATACAAGGATTAAGGCACAA","561307.5.peg.2232","1372"
"16599",738,92,646,"TTTAACACAGCGTAGGCTTT","ATACAAGGATTAAGGCACAA","561307.5.peg.2232","1372"
"16600",219,92,127,"CCTCCAAAGTCTAGCGTAAT","ATACAAGGATTAAGGCACAA","561307.5.peg.2232","1372"
"16601",215,92,123,"CAAAGTCTAGCGTAATTGGA","ATACAAGGATTAAGGCACAA","561307.5.peg.2232","1372"
"16602",745,92,653,"CTCAGTATTTAACACAGCGT","ATACAAGGATTAAGGCACAA","561307.5.peg.2232","1372"
"16603",34,215,181,"TAGCATCATCTTCCCCCCTT","CAAAGTCTAGCGTAATTGGA","561307.5.peg.2232","1372"
"16604",9,215,206,"GATGAAATTGAAGGCCTAAG","CAAAGTCTAGCGTAATTGGA","561307.5.peg.2232","1372"
"16605",87,215,128,"AGGATTAAGGCACAAAGGAA","CAAAGTCTAGCGTAATTGGA","561307.5.peg.2232","1372"
"16606",738,215,523,"TTTAACACAGCGTAGGCTTT","CAAAGTCTAGCGTAATTGGA","561307.5.peg.2232","1372"
"16607",92,215,123,"ATACAAGGATTAAGGCACAA","CAAAGTCTAGCGTAATTGGA","561307.5.peg.2232","1372"
"16608",7,215,208,"TGAAATTGAAGGCCTAAGGG","CAAAGTCTAGCGTAATTGGA","561307.5.peg.2232","1372"
"16609",745,215,530,"CTCAGTATTTAACACAGCGT","CAAAGTCTAGCGTAATTGGA","561307.5.peg.2232","1372"
"16610",11,215,204,"AAGATGAAATTGAAGGCCTA","CAAAGTCTAGCGTAATTGGA","561307.5.peg.2232","1372"
"16611",7,219,212,"TGAAATTGAAGGCCTAAGGG","CCTCCAAAGTCTAGCGTAAT","561307.5.peg.2232","1372"
"16612",745,219,526,"CTCAGTATTTAACACAGCGT","CCTCCAAAGTCTAGCGTAAT","561307.5.peg.2232","1372"
"16613",92,219,127,"ATACAAGGATTAAGGCACAA","CCTCCAAAGTCTAGCGTAAT","561307.5.peg.2232","1372"
"16614",34,219,185,"TAGCATCATCTTCCCCCCTT","CCTCCAAAGTCTAGCGTAAT","561307.5.peg.2232","1372"
"16615",87,219,132,"AGGATTAAGGCACAAAGGAA","CCTCCAAAGTCTAGCGTAAT","561307.5.peg.2232","1372"
"16616",11,219,208,"AAGATGAAATTGAAGGCCTA","CCTCCAAAGTCTAGCGTAAT","561307.5.peg.2232","1372"
"16617",738,219,519,"TTTAACACAGCGTAGGCTTT","CCTCCAAAGTCTAGCGTAAT","561307.5.peg.2232","1372"
"16618",9,219,210,"GATGAAATTGAAGGCCTAAG","CCTCCAAAGTCTAGCGTAAT","561307.5.peg.2232","1372"
"16619",34,304,270,"TAGCATCATCTTCCCCCCTT","TAAAGTAATCACAAACGAAG","561307.5.peg.2232","1372"
"16620",92,304,212,"ATACAAGGATTAAGGCACAA","TAAAGTAATCACAAACGAAG","561307.5.peg.2232","1372"
"16621",9,304,295,"GATGAAATTGAAGGCCTAAG","TAAAGTAATCACAAACGAAG","561307.5.peg.2232","1372"
"16622",11,304,293,"AAGATGAAATTGAAGGCCTA","TAAAGTAATCACAAACGAAG","561307.5.peg.2232","1372"
"16623",7,304,297,"TGAAATTGAAGGCCTAAGGG","TAAAGTAATCACAAACGAAG","561307.5.peg.2232","1372"
"16624",87,304,217,"AGGATTAAGGCACAAAGGAA","TAAAGTAATCACAAACGAAG","561307.5.peg.2232","1372"
"16625",745,304,441,"CTCAGTATTTAACACAGCGT","TAAAGTAATCACAAACGAAG","561307.5.peg.2232","1372"
"16626",738,304,434,"TTTAACACAGCGTAGGCTTT","TAAAGTAATCACAAACGAAG","561307.5.peg.2232","1372"
"16627",87,738,651,"AGGATTAAGGCACAAAGGAA","TTTAACACAGCGTAGGCTTT","561307.5.peg.2232","1372"
"16628",7,738,731,"TGAAATTGAAGGCCTAAGGG","TTTAACACAGCGTAGGCTTT","561307.5.peg.2232","1372"
"16629",215,738,523,"CAAAGTCTAGCGTAATTGGA","TTTAACACAGCGTAGGCTTT","561307.5.peg.2232","1372"
"16630",34,738,704,"TAGCATCATCTTCCCCCCTT","TTTAACACAGCGTAGGCTTT","561307.5.peg.2232","1372"
"16631",11,738,727,"AAGATGAAATTGAAGGCCTA","TTTAACACAGCGTAGGCTTT","561307.5.peg.2232","1372"
"16632",304,738,434,"TAAAGTAATCACAAACGAAG","TTTAACACAGCGTAGGCTTT","561307.5.peg.2232","1372"
"16633",219,738,519,"CCTCCAAAGTCTAGCGTAAT","TTTAACACAGCGTAGGCTTT","561307.5.peg.2232","1372"
"16634",92,738,646,"ATACAAGGATTAAGGCACAA","TTTAACACAGCGTAGGCTTT","561307.5.peg.2232","1372"
"16635",9,738,729,"GATGAAATTGAAGGCCTAAG","TTTAACACAGCGTAGGCTTT","561307.5.peg.2232","1372"
"16636",9,745,736,"GATGAAATTGAAGGCCTAAG","CTCAGTATTTAACACAGCGT","561307.5.peg.2232","1372"
"16637",7,745,738,"TGAAATTGAAGGCCTAAGGG","CTCAGTATTTAACACAGCGT","561307.5.peg.2232","1372"
"16638",11,745,734,"AAGATGAAATTGAAGGCCTA","CTCAGTATTTAACACAGCGT","561307.5.peg.2232","1372"
"16639",87,745,658,"AGGATTAAGGCACAAAGGAA","CTCAGTATTTAACACAGCGT","561307.5.peg.2232","1372"
"16640",304,745,441,"TAAAGTAATCACAAACGAAG","CTCAGTATTTAACACAGCGT","561307.5.peg.2232","1372"
"16641",215,745,530,"CAAAGTCTAGCGTAATTGGA","CTCAGTATTTAACACAGCGT","561307.5.peg.2232","1372"
"16642",34,745,711,"TAGCATCATCTTCCCCCCTT","CTCAGTATTTAACACAGCGT","561307.5.peg.2232","1372"
"16643",92,745,653,"ATACAAGGATTAAGGCACAA","CTCAGTATTTAACACAGCGT","561307.5.peg.2232","1372"
"16644",219,745,526,"CCTCCAAAGTCTAGCGTAAT","CTCAGTATTTAACACAGCGT","561307.5.peg.2232","1372"
"16645",199,11,188,"CCGATTAAAGTTAATAACA","TATCACGCTTTATTGGTGGG","561307.5.peg.2235","1375"
"16646",199,13,186,"CCGATTAAAGTTAATAACA","AATATCACGCTTTATTGGTG","561307.5.peg.2235","1375"
"16647",11,199,188,"TATCACGCTTTATTGGTGGG","CCGATTAAAGTTAATAACA","561307.5.peg.2235","1375"
"16648",13,199,186,"AATATCACGCTTTATTGGTG","CCGATTAAAGTTAATAACA","561307.5.peg.2235","1375"
"16649",297,123,174,"CCTAATGCCATCATCATCAC","ATAAATGCTAGGGGTACTTT","561307.5.peg.2236","1376"
"16650",409,123,286,"TGCATCAGTAGGACAAAGAA","ATAAATGCTAGGGGTACTTT","561307.5.peg.2236","1376"
"16651",381,123,258,"ATTGCAAATGCTGCTCCAAT","ATAAATGCTAGGGGTACTTT","561307.5.peg.2236","1376"
"16652",662,123,539,"CTCGACGCATCAATGTTAAT","ATAAATGCTAGGGGTACTTT","561307.5.peg.2236","1376"
"16653",297,178,119,"CCTAATGCCATCATCATCAC","ATTAAATTGAACAGGGATTG","561307.5.peg.2236","1376"
"16654",662,178,484,"CTCGACGCATCAATGTTAAT","ATTAAATTGAACAGGGATTG","561307.5.peg.2236","1376"
"16655",409,178,231,"TGCATCAGTAGGACAAAGAA","ATTAAATTGAACAGGGATTG","561307.5.peg.2236","1376"
"16656",381,178,203,"ATTGCAAATGCTGCTCCAAT","ATTAAATTGAACAGGGATTG","561307.5.peg.2236","1376"
"16657",123,297,174,"ATAAATGCTAGGGGTACTTT","CCTAATGCCATCATCATCAC","561307.5.peg.2236","1376"
"16658",178,297,119,"ATTAAATTGAACAGGGATTG","CCTAATGCCATCATCATCAC","561307.5.peg.2236","1376"
"16659",409,297,112,"TGCATCAGTAGGACAAAGAA","CCTAATGCCATCATCATCAC","561307.5.peg.2236","1376"
"16660",662,297,365,"CTCGACGCATCAATGTTAAT","CCTAATGCCATCATCATCAC","561307.5.peg.2236","1376"
"16661",178,381,203,"ATTAAATTGAACAGGGATTG","ATTGCAAATGCTGCTCCAAT","561307.5.peg.2236","1376"
"16662",662,381,281,"CTCGACGCATCAATGTTAAT","ATTGCAAATGCTGCTCCAAT","561307.5.peg.2236","1376"
"16663",123,381,258,"ATAAATGCTAGGGGTACTTT","ATTGCAAATGCTGCTCCAAT","561307.5.peg.2236","1376"
"16664",178,409,231,"ATTAAATTGAACAGGGATTG","TGCATCAGTAGGACAAAGAA","561307.5.peg.2236","1376"
"16665",662,409,253,"CTCGACGCATCAATGTTAAT","TGCATCAGTAGGACAAAGAA","561307.5.peg.2236","1376"
"16666",123,409,286,"ATAAATGCTAGGGGTACTTT","TGCATCAGTAGGACAAAGAA","561307.5.peg.2236","1376"
"16667",297,409,112,"CCTAATGCCATCATCATCAC","TGCATCAGTAGGACAAAGAA","561307.5.peg.2236","1376"
"16668",381,662,281,"ATTGCAAATGCTGCTCCAAT","CTCGACGCATCAATGTTAAT","561307.5.peg.2236","1376"
"16669",123,662,539,"ATAAATGCTAGGGGTACTTT","CTCGACGCATCAATGTTAAT","561307.5.peg.2236","1376"
"16670",178,662,484,"ATTAAATTGAACAGGGATTG","CTCGACGCATCAATGTTAAT","561307.5.peg.2236","1376"
"16671",297,662,365,"CCTAATGCCATCATCATCAC","CTCGACGCATCAATGTTAAT","561307.5.peg.2236","1376"
"16672",409,662,253,"TGCATCAGTAGGACAAAGAA","CTCGACGCATCAATGTTAAT","561307.5.peg.2236","1376"
"16673",209,13,196,"CATTCGTAACTTCCCAAACT","CGTTTAGCCAAGAAGCAAGG","561307.5.peg.2238","1378"
"16674",312,13,299,"ATAATCAGTGCTATTGAACC","CGTTTAGCCAAGAAGCAAGG","561307.5.peg.2238","1378"
"16675",432,13,419,"AAAGCAGTAGATAATGAAGC","CGTTTAGCCAAGAAGCAAGG","561307.5.peg.2238","1378"
"16676",530,13,517,"ATACTACAGACCAAGCAAAT","CGTTTAGCCAAGAAGCAAGG","561307.5.peg.2238","1378"
"16677",530,16,514,"ATACTACAGACCAAGCAAAT","AATCGTTTAGCCAAGAAGCA","561307.5.peg.2238","1378"
"16678",209,16,193,"CATTCGTAACTTCCCAAACT","AATCGTTTAGCCAAGAAGCA","561307.5.peg.2238","1378"
"16679",312,16,296,"ATAATCAGTGCTATTGAACC","AATCGTTTAGCCAAGAAGCA","561307.5.peg.2238","1378"
"16680",432,16,416,"AAAGCAGTAGATAATGAAGC","AATCGTTTAGCCAAGAAGCA","561307.5.peg.2238","1378"
"16681",432,23,409,"AAAGCAGTAGATAATGAAGC","TATTTCTCCTCCTTGCTTCT","561307.5.peg.2238","1378"
"16682",530,23,507,"ATACTACAGACCAAGCAAAT","TATTTCTCCTCCTTGCTTCT","561307.5.peg.2238","1378"
"16683",209,23,186,"CATTCGTAACTTCCCAAACT","TATTTCTCCTCCTTGCTTCT","561307.5.peg.2238","1378"
"16684",312,23,289,"ATAATCAGTGCTATTGAACC","TATTTCTCCTCCTTGCTTCT","561307.5.peg.2238","1378"
"16685",16,209,193,"AATCGTTTAGCCAAGAAGCA","CATTCGTAACTTCCCAAACT","561307.5.peg.2238","1378"
"16686",23,209,186,"TATTTCTCCTCCTTGCTTCT","CATTCGTAACTTCCCAAACT","561307.5.peg.2238","1378"
"16687",432,209,223,"AAAGCAGTAGATAATGAAGC","CATTCGTAACTTCCCAAACT","561307.5.peg.2238","1378"
"16688",312,209,103,"ATAATCAGTGCTATTGAACC","CATTCGTAACTTCCCAAACT","561307.5.peg.2238","1378"
"16689",530,209,321,"ATACTACAGACCAAGCAAAT","CATTCGTAACTTCCCAAACT","561307.5.peg.2238","1378"
"16690",13,209,196,"CGTTTAGCCAAGAAGCAAGG","CATTCGTAACTTCCCAAACT","561307.5.peg.2238","1378"
"16691",13,312,299,"CGTTTAGCCAAGAAGCAAGG","ATAATCAGTGCTATTGAACC","561307.5.peg.2238","1378"
"16692",16,312,296,"AATCGTTTAGCCAAGAAGCA","ATAATCAGTGCTATTGAACC","561307.5.peg.2238","1378"
"16693",23,312,289,"TATTTCTCCTCCTTGCTTCT","ATAATCAGTGCTATTGAACC","561307.5.peg.2238","1378"
"16694",209,312,103,"CATTCGTAACTTCCCAAACT","ATAATCAGTGCTATTGAACC","561307.5.peg.2238","1378"
"16695",432,312,120,"AAAGCAGTAGATAATGAAGC","ATAATCAGTGCTATTGAACC","561307.5.peg.2238","1378"
"16696",530,312,218,"ATACTACAGACCAAGCAAAT","ATAATCAGTGCTATTGAACC","561307.5.peg.2238","1378"
"16697",209,432,223,"CATTCGTAACTTCCCAAACT","AAAGCAGTAGATAATGAAGC","561307.5.peg.2238","1378"
"16698",312,432,120,"ATAATCAGTGCTATTGAACC","AAAGCAGTAGATAATGAAGC","561307.5.peg.2238","1378"
"16699",13,432,419,"CGTTTAGCCAAGAAGCAAGG","AAAGCAGTAGATAATGAAGC","561307.5.peg.2238","1378"
"16700",23,432,409,"TATTTCTCCTCCTTGCTTCT","AAAGCAGTAGATAATGAAGC","561307.5.peg.2238","1378"
"16701",16,432,416,"AATCGTTTAGCCAAGAAGCA","AAAGCAGTAGATAATGAAGC","561307.5.peg.2238","1378"
"16702",13,530,517,"CGTTTAGCCAAGAAGCAAGG","ATACTACAGACCAAGCAAAT","561307.5.peg.2238","1378"
"16703",23,530,507,"TATTTCTCCTCCTTGCTTCT","ATACTACAGACCAAGCAAAT","561307.5.peg.2238","1378"
"16704",312,530,218,"ATAATCAGTGCTATTGAACC","ATACTACAGACCAAGCAAAT","561307.5.peg.2238","1378"
"16705",16,530,514,"AATCGTTTAGCCAAGAAGCA","ATACTACAGACCAAGCAAAT","561307.5.peg.2238","1378"
"16706",209,530,321,"CATTCGTAACTTCCCAAACT","ATACTACAGACCAAGCAAAT","561307.5.peg.2238","1378"
"16707",291,135,156,"CCACCCATTTCCATAAATGT","TCTGCAATTGCGAACATTAA","561307.5.peg.2239","1379"
"16708",678,135,543,"TATGGTAGACAGTATCTTT","TCTGCAATTGCGAACATTAA","561307.5.peg.2239","1379"
"16709",572,135,437,"ATGATCGAACTATAAACGAT","TCTGCAATTGCGAACATTAA","561307.5.peg.2239","1379"
"16710",552,135,417,"GGGTTAAACATCGCTTCTAT","TCTGCAATTGCGAACATTAA","561307.5.peg.2239","1379"
"16711",135,291,156,"TCTGCAATTGCGAACATTAA","CCACCCATTTCCATAAATGT","561307.5.peg.2239","1379"
"16712",552,291,261,"GGGTTAAACATCGCTTCTAT","CCACCCATTTCCATAAATGT","561307.5.peg.2239","1379"
"16713",572,291,281,"ATGATCGAACTATAAACGAT","CCACCCATTTCCATAAATGT","561307.5.peg.2239","1379"
"16714",678,291,387,"TATGGTAGACAGTATCTTT","CCACCCATTTCCATAAATGT","561307.5.peg.2239","1379"
"16715",135,552,417,"TCTGCAATTGCGAACATTAA","GGGTTAAACATCGCTTCTAT","561307.5.peg.2239","1379"
"16716",678,552,126,"TATGGTAGACAGTATCTTT","GGGTTAAACATCGCTTCTAT","561307.5.peg.2239","1379"
"16717",291,552,261,"CCACCCATTTCCATAAATGT","GGGTTAAACATCGCTTCTAT","561307.5.peg.2239","1379"
"16718",291,572,281,"CCACCCATTTCCATAAATGT","ATGATCGAACTATAAACGAT","561307.5.peg.2239","1379"
"16719",135,572,437,"TCTGCAATTGCGAACATTAA","ATGATCGAACTATAAACGAT","561307.5.peg.2239","1379"
"16720",678,572,106,"TATGGTAGACAGTATCTTT","ATGATCGAACTATAAACGAT","561307.5.peg.2239","1379"
"16721",135,678,543,"TCTGCAATTGCGAACATTAA","TATGGTAGACAGTATCTTT","561307.5.peg.2239","1379"
"16722",552,678,126,"GGGTTAAACATCGCTTCTAT","TATGGTAGACAGTATCTTT","561307.5.peg.2239","1379"
"16723",291,678,387,"CCACCCATTTCCATAAATGT","TATGGTAGACAGTATCTTT","561307.5.peg.2239","1379"
"16724",572,678,106,"ATGATCGAACTATAAACGAT","TATGGTAGACAGTATCTTT","561307.5.peg.2239","1379"
"16725",246,70,176,"GCAATATGCTGTATTTCTGA","TGCCGCAATGCCACCTGTAA","561307.5.peg.224","1380"
"16726",303,70,233,"GCAATTGTATTTGCCGTTGC","TGCCGCAATGCCACCTGTAA","561307.5.peg.224","1380"
"16727",387,70,317,"ATAGCAGGCGCAATAAATTT","TGCCGCAATGCCACCTGTAA","561307.5.peg.224","1380"
"16728",402,70,332,"TACATATGCACATTCATAGC","TGCCGCAATGCCACCTGTAA","561307.5.peg.224","1380"
"16729",70,246,176,"TGCCGCAATGCCACCTGTAA","GCAATATGCTGTATTTCTGA","561307.5.peg.224","1380"
"16730",387,246,141,"ATAGCAGGCGCAATAAATTT","GCAATATGCTGTATTTCTGA","561307.5.peg.224","1380"
"16731",402,246,156,"TACATATGCACATTCATAGC","GCAATATGCTGTATTTCTGA","561307.5.peg.224","1380"
"16732",70,303,233,"TGCCGCAATGCCACCTGTAA","GCAATTGTATTTGCCGTTGC","561307.5.peg.224","1380"
"16733",70,387,317,"TGCCGCAATGCCACCTGTAA","ATAGCAGGCGCAATAAATTT","561307.5.peg.224","1380"
"16734",246,387,141,"GCAATATGCTGTATTTCTGA","ATAGCAGGCGCAATAAATTT","561307.5.peg.224","1380"
"16735",70,402,332,"TGCCGCAATGCCACCTGTAA","TACATATGCACATTCATAGC","561307.5.peg.224","1380"
"16736",246,402,156,"GCAATATGCTGTATTTCTGA","TACATATGCACATTCATAGC","561307.5.peg.224","1380"
"16737",302,76,226,"GGATTGGTTGAATTAATTCA","AATTGCGACACCATCAGATG","561307.5.peg.2241","1382"
"16738",747,76,671,"GCGATTAACTCATCTTCAGT","AATTGCGACACCATCAGATG","561307.5.peg.2241","1382"
"16739",501,76,425,"ACGCTTTCATCAATCATACT","AATTGCGACACCATCAGATG","561307.5.peg.2241","1382"
"16740",495,76,419,"TCATCAATCATACTCGGATT","AATTGCGACACCATCAGATG","561307.5.peg.2241","1382"
"16741",76,302,226,"AATTGCGACACCATCAGATG","GGATTGGTTGAATTAATTCA","561307.5.peg.2241","1382"
"16742",495,302,193,"TCATCAATCATACTCGGATT","GGATTGGTTGAATTAATTCA","561307.5.peg.2241","1382"
"16743",501,302,199,"ACGCTTTCATCAATCATACT","GGATTGGTTGAATTAATTCA","561307.5.peg.2241","1382"
"16744",747,302,445,"GCGATTAACTCATCTTCAGT","GGATTGGTTGAATTAATTCA","561307.5.peg.2241","1382"
"16745",76,495,419,"AATTGCGACACCATCAGATG","TCATCAATCATACTCGGATT","561307.5.peg.2241","1382"
"16746",747,495,252,"GCGATTAACTCATCTTCAGT","TCATCAATCATACTCGGATT","561307.5.peg.2241","1382"
"16747",302,495,193,"GGATTGGTTGAATTAATTCA","TCATCAATCATACTCGGATT","561307.5.peg.2241","1382"
"16748",302,501,199,"GGATTGGTTGAATTAATTCA","ACGCTTTCATCAATCATACT","561307.5.peg.2241","1382"
"16749",76,501,425,"AATTGCGACACCATCAGATG","ACGCTTTCATCAATCATACT","561307.5.peg.2241","1382"
"16750",747,501,246,"GCGATTAACTCATCTTCAGT","ACGCTTTCATCAATCATACT","561307.5.peg.2241","1382"
"16751",76,747,671,"AATTGCGACACCATCAGATG","GCGATTAACTCATCTTCAGT","561307.5.peg.2241","1382"
"16752",495,747,252,"TCATCAATCATACTCGGATT","GCGATTAACTCATCTTCAGT","561307.5.peg.2241","1382"
"16753",302,747,445,"GGATTGGTTGAATTAATTCA","GCGATTAACTCATCTTCAGT","561307.5.peg.2241","1382"
"16754",501,747,246,"ACGCTTTCATCAATCATACT","GCGATTAACTCATCTTCAGT","561307.5.peg.2241","1382"
"16755",564,11,553,"TCGATAACAATTGGAAACTC","AACTACAACGAAACACAGAA","561307.5.peg.2244","1385"
"16756",11,564,553,"AACTACAACGAAACACAGAA","TCGATAACAATTGGAAACTC","561307.5.peg.2244","1385"
"16757",274,164,110,"ACCCATAATGATAGTTTCGC","TTGTTAATTGTTCGAGGTGA","561307.5.peg.2247","1388"
"16758",274,170,104,"ACCCATAATGATAGTTTCGC","CCCCGTTTGTTAATTGTTCG","561307.5.peg.2247","1388"
"16759",164,274,110,"TTGTTAATTGTTCGAGGTGA","ACCCATAATGATAGTTTCGC","561307.5.peg.2247","1388"
"16760",170,274,104,"CCCCGTTTGTTAATTGTTCG","ACCCATAATGATAGTTTCGC","561307.5.peg.2247","1388"
"16761",415,11,404,"ATCTTTGATATACGTTTCAG","GATTACGACAACTTATAAG","561307.5.peg.2248","1389"
"16762",516,11,505,"TGAACATCTAACATTGCTGT","GATTACGACAACTTATAAG","561307.5.peg.2248","1389"
"16763",676,11,665,"TATGATTTCAGGACATTCAT","GATTACGACAACTTATAAG","561307.5.peg.2248","1389"
"16764",354,11,343,"AACGCATCCATGTCTTCACG","GATTACGACAACTTATAAG","561307.5.peg.2248","1389"
"16765",11,354,343,"GATTACGACAACTTATAAG","AACGCATCCATGTCTTCACG","561307.5.peg.2248","1389"
"16766",516,354,162,"TGAACATCTAACATTGCTGT","AACGCATCCATGTCTTCACG","561307.5.peg.2248","1389"
"16767",676,354,322,"TATGATTTCAGGACATTCAT","AACGCATCCATGTCTTCACG","561307.5.peg.2248","1389"
"16768",11,415,404,"GATTACGACAACTTATAAG","ATCTTTGATATACGTTTCAG","561307.5.peg.2248","1389"
"16769",676,415,261,"TATGATTTCAGGACATTCAT","ATCTTTGATATACGTTTCAG","561307.5.peg.2248","1389"
"16770",516,415,101,"TGAACATCTAACATTGCTGT","ATCTTTGATATACGTTTCAG","561307.5.peg.2248","1389"
"16771",11,516,505,"GATTACGACAACTTATAAG","TGAACATCTAACATTGCTGT","561307.5.peg.2248","1389"
"16772",354,516,162,"AACGCATCCATGTCTTCACG","TGAACATCTAACATTGCTGT","561307.5.peg.2248","1389"
"16773",415,516,101,"ATCTTTGATATACGTTTCAG","TGAACATCTAACATTGCTGT","561307.5.peg.2248","1389"
"16774",676,516,160,"TATGATTTCAGGACATTCAT","TGAACATCTAACATTGCTGT","561307.5.peg.2248","1389"
"16775",354,676,322,"AACGCATCCATGTCTTCACG","TATGATTTCAGGACATTCAT","561307.5.peg.2248","1389"
"16776",516,676,160,"TGAACATCTAACATTGCTGT","TATGATTTCAGGACATTCAT","561307.5.peg.2248","1389"
"16777",11,676,665,"GATTACGACAACTTATAAG","TATGATTTCAGGACATTCAT","561307.5.peg.2248","1389"
"16778",415,676,261,"ATCTTTGATATACGTTTCAG","TATGATTTCAGGACATTCAT","561307.5.peg.2248","1389"
"16779",468,144,324,"CCATCTTTCTTGACAACAAC","GGTGTCATTGCCTCATTACC","561307.5.peg.2250","1392"
"16780",261,144,117,"CCATCAATTAGCGGCTGTTC","GGTGTCATTGCCTCATTACC","561307.5.peg.2250","1392"
"16781",538,144,394,"CATAATCTCAATAGCACTTC","GGTGTCATTGCCTCATTACC","561307.5.peg.2250","1392"
"16782",327,144,183,"ATTTGAGCTGCTTGCTTATT","GGTGTCATTGCCTCATTACC","561307.5.peg.2250","1392"
"16783",270,144,126,"TCTGCTAATCCATCAATTAG","GGTGTCATTGCCTCATTACC","561307.5.peg.2250","1392"
"16784",399,144,255,"CTTCTTTATAATCAGCAGT","GGTGTCATTGCCTCATTACC","561307.5.peg.2250","1392"
"16785",468,165,303,"CCATCTTTCTTGACAACAAC","TCAGTGTGTACTTCAGCTAT","561307.5.peg.2250","1392"
"16786",399,165,234,"CTTCTTTATAATCAGCAGT","TCAGTGTGTACTTCAGCTAT","561307.5.peg.2250","1392"
"16787",270,165,105,"TCTGCTAATCCATCAATTAG","TCAGTGTGTACTTCAGCTAT","561307.5.peg.2250","1392"
"16788",538,165,373,"CATAATCTCAATAGCACTTC","TCAGTGTGTACTTCAGCTAT","561307.5.peg.2250","1392"
"16789",327,165,162,"ATTTGAGCTGCTTGCTTATT","TCAGTGTGTACTTCAGCTAT","561307.5.peg.2250","1392"
"16790",468,261,207,"CCATCTTTCTTGACAACAAC","CCATCAATTAGCGGCTGTTC","561307.5.peg.2250","1392"
"16791",538,261,277,"CATAATCTCAATAGCACTTC","CCATCAATTAGCGGCTGTTC","561307.5.peg.2250","1392"
"16792",144,261,117,"GGTGTCATTGCCTCATTACC","CCATCAATTAGCGGCTGTTC","561307.5.peg.2250","1392"
"16793",399,261,138,"CTTCTTTATAATCAGCAGT","CCATCAATTAGCGGCTGTTC","561307.5.peg.2250","1392"
"16794",399,270,129,"CTTCTTTATAATCAGCAGT","TCTGCTAATCCATCAATTAG","561307.5.peg.2250","1392"
"16795",468,270,198,"CCATCTTTCTTGACAACAAC","TCTGCTAATCCATCAATTAG","561307.5.peg.2250","1392"
"16796",144,270,126,"GGTGTCATTGCCTCATTACC","TCTGCTAATCCATCAATTAG","561307.5.peg.2250","1392"
"16797",165,270,105,"TCAGTGTGTACTTCAGCTAT","TCTGCTAATCCATCAATTAG","561307.5.peg.2250","1392"
"16798",538,270,268,"CATAATCTCAATAGCACTTC","TCTGCTAATCCATCAATTAG","561307.5.peg.2250","1392"
"16799",468,327,141,"CCATCTTTCTTGACAACAAC","ATTTGAGCTGCTTGCTTATT","561307.5.peg.2250","1392"
"16800",538,327,211,"CATAATCTCAATAGCACTTC","ATTTGAGCTGCTTGCTTATT","561307.5.peg.2250","1392"
"16801",165,327,162,"TCAGTGTGTACTTCAGCTAT","ATTTGAGCTGCTTGCTTATT","561307.5.peg.2250","1392"
"16802",144,327,183,"GGTGTCATTGCCTCATTACC","ATTTGAGCTGCTTGCTTATT","561307.5.peg.2250","1392"
"16803",261,399,138,"CCATCAATTAGCGGCTGTTC","CTTCTTTATAATCAGCAGT","561307.5.peg.2250","1392"
"16804",270,399,129,"TCTGCTAATCCATCAATTAG","CTTCTTTATAATCAGCAGT","561307.5.peg.2250","1392"
"16805",165,399,234,"TCAGTGTGTACTTCAGCTAT","CTTCTTTATAATCAGCAGT","561307.5.peg.2250","1392"
"16806",538,399,139,"CATAATCTCAATAGCACTTC","CTTCTTTATAATCAGCAGT","561307.5.peg.2250","1392"
"16807",144,399,255,"GGTGTCATTGCCTCATTACC","CTTCTTTATAATCAGCAGT","561307.5.peg.2250","1392"
"16808",270,468,198,"TCTGCTAATCCATCAATTAG","CCATCTTTCTTGACAACAAC","561307.5.peg.2250","1392"
"16809",144,468,324,"GGTGTCATTGCCTCATTACC","CCATCTTTCTTGACAACAAC","561307.5.peg.2250","1392"
"16810",327,468,141,"ATTTGAGCTGCTTGCTTATT","CCATCTTTCTTGACAACAAC","561307.5.peg.2250","1392"
"16811",165,468,303,"TCAGTGTGTACTTCAGCTAT","CCATCTTTCTTGACAACAAC","561307.5.peg.2250","1392"
"16812",261,468,207,"CCATCAATTAGCGGCTGTTC","CCATCTTTCTTGACAACAAC","561307.5.peg.2250","1392"
"16813",144,538,394,"GGTGTCATTGCCTCATTACC","CATAATCTCAATAGCACTTC","561307.5.peg.2250","1392"
"16814",261,538,277,"CCATCAATTAGCGGCTGTTC","CATAATCTCAATAGCACTTC","561307.5.peg.2250","1392"
"16815",270,538,268,"TCTGCTAATCCATCAATTAG","CATAATCTCAATAGCACTTC","561307.5.peg.2250","1392"
"16816",327,538,211,"ATTTGAGCTGCTTGCTTATT","CATAATCTCAATAGCACTTC","561307.5.peg.2250","1392"
"16817",165,538,373,"TCAGTGTGTACTTCAGCTAT","CATAATCTCAATAGCACTTC","561307.5.peg.2250","1392"
"16818",399,538,139,"CTTCTTTATAATCAGCAGT","CATAATCTCAATAGCACTTC","561307.5.peg.2250","1392"
"16819",357,180,177,"TTTGCAACAGTTTGTTGGAA","AAGTCTGAAACAGAACGAAC","561307.5.peg.2251","1393"
"16820",429,180,249,"GCTGCAGCACGTAACATTGT","AAGTCTGAAACAGAACGAAC","561307.5.peg.2251","1393"
"16821",486,180,306,"AATACTTCTTGATAATCTGC","AAGTCTGAAACAGAACGAAC","561307.5.peg.2251","1393"
"16822",180,357,177,"AAGTCTGAAACAGAACGAAC","TTTGCAACAGTTTGTTGGAA","561307.5.peg.2251","1393"
"16823",486,357,129,"AATACTTCTTGATAATCTGC","TTTGCAACAGTTTGTTGGAA","561307.5.peg.2251","1393"
"16824",180,429,249,"AAGTCTGAAACAGAACGAAC","GCTGCAGCACGTAACATTGT","561307.5.peg.2251","1393"
"16825",180,486,306,"AAGTCTGAAACAGAACGAAC","AATACTTCTTGATAATCTGC","561307.5.peg.2251","1393"
"16826",357,486,129,"TTTGCAACAGTTTGTTGGAA","AATACTTCTTGATAATCTGC","561307.5.peg.2251","1393"
"16827",296,11,285,"TATTACCTGAAGTAGCATAA","ATTAAACAAATATGGGAAG","561307.5.peg.2254","1396"
"16828",446,11,435,"CTTCAGTATCAGAAGACGAA","ATTAAACAAATATGGGAAG","561307.5.peg.2254","1396"
"16829",600,11,589,"ACAAGTGGTCTGATAGCATT","ATTAAACAAATATGGGAAG","561307.5.peg.2254","1396"
"16830",296,108,188,"TATTACCTGAAGTAGCATAA","TATGTTAGTTGCGCTGCTTC","561307.5.peg.2254","1396"
"16831",600,108,492,"ACAAGTGGTCTGATAGCATT","TATGTTAGTTGCGCTGCTTC","561307.5.peg.2254","1396"
"16832",446,108,338,"CTTCAGTATCAGAAGACGAA","TATGTTAGTTGCGCTGCTTC","561307.5.peg.2254","1396"
"16833",11,296,285,"ATTAAACAAATATGGGAAG","TATTACCTGAAGTAGCATAA","561307.5.peg.2254","1396"
"16834",446,296,150,"CTTCAGTATCAGAAGACGAA","TATTACCTGAAGTAGCATAA","561307.5.peg.2254","1396"
"16835",108,296,188,"TATGTTAGTTGCGCTGCTTC","TATTACCTGAAGTAGCATAA","561307.5.peg.2254","1396"
"16836",600,296,304,"ACAAGTGGTCTGATAGCATT","TATTACCTGAAGTAGCATAA","561307.5.peg.2254","1396"
"16837",11,446,435,"ATTAAACAAATATGGGAAG","CTTCAGTATCAGAAGACGAA","561307.5.peg.2254","1396"
"16838",108,446,338,"TATGTTAGTTGCGCTGCTTC","CTTCAGTATCAGAAGACGAA","561307.5.peg.2254","1396"
"16839",600,446,154,"ACAAGTGGTCTGATAGCATT","CTTCAGTATCAGAAGACGAA","561307.5.peg.2254","1396"
"16840",296,446,150,"TATTACCTGAAGTAGCATAA","CTTCAGTATCAGAAGACGAA","561307.5.peg.2254","1396"
"16841",11,600,589,"ATTAAACAAATATGGGAAG","ACAAGTGGTCTGATAGCATT","561307.5.peg.2254","1396"
"16842",446,600,154,"CTTCAGTATCAGAAGACGAA","ACAAGTGGTCTGATAGCATT","561307.5.peg.2254","1396"
"16843",108,600,492,"TATGTTAGTTGCGCTGCTTC","ACAAGTGGTCTGATAGCATT","561307.5.peg.2254","1396"
"16844",296,600,304,"TATTACCTGAAGTAGCATAA","ACAAGTGGTCTGATAGCATT","561307.5.peg.2254","1396"
"16845",325,69,256,"GACTCTACTTTAAATACTA","GTTTAATTTCTTCAACGCT","561307.5.peg.2255","1397"
"16846",966,69,897,"TTTCATAAGGAGAAATACC","GTTTAATTTCTTCAACGCT","561307.5.peg.2255","1397"
"16847",954,69,885,"GAAATACCTGGCTCACGTGT","GTTTAATTTCTTCAACGCT","561307.5.peg.2255","1397"
"16848",372,69,303,"CCTGTAGCAGCCCCTTGATA","GTTTAATTTCTTCAACGCT","561307.5.peg.2255","1397"
"16849",252,69,183,"AGCACATGGTCACCTGACGT","GTTTAATTTCTTCAACGCT","561307.5.peg.2255","1397"
"16850",282,69,213,"ACTACCCCTGCACCTTCACC","GTTTAATTTCTTCAACGCT","561307.5.peg.2255","1397"
"16851",552,69,483,"TCGATTTCACCAGCAGTTGT","GTTTAATTTCTTCAACGCT","561307.5.peg.2255","1397"
"16852",266,69,197,"CACCAGGCCCCATAAGCACA","GTTTAATTTCTTCAACGCT","561307.5.peg.2255","1397"
"16853",978,69,909,"CTGAAAGCATCATTTCATA","GTTTAATTTCTTCAACGCT","561307.5.peg.2255","1397"
"16854",266,165,101,"CACCAGGCCCCATAAGCACA","TACCTGTTTCTGTAAAGTT","561307.5.peg.2255","1397"
"16855",966,165,801,"TTTCATAAGGAGAAATACC","TACCTGTTTCTGTAAAGTT","561307.5.peg.2255","1397"
"16856",325,165,160,"GACTCTACTTTAAATACTA","TACCTGTTTCTGTAAAGTT","561307.5.peg.2255","1397"
"16857",954,165,789,"GAAATACCTGGCTCACGTGT","TACCTGTTTCTGTAAAGTT","561307.5.peg.2255","1397"
"16858",552,165,387,"TCGATTTCACCAGCAGTTGT","TACCTGTTTCTGTAAAGTT","561307.5.peg.2255","1397"
"16859",282,165,117,"ACTACCCCTGCACCTTCACC","TACCTGTTTCTGTAAAGTT","561307.5.peg.2255","1397"
"16860",978,165,813,"CTGAAAGCATCATTTCATA","TACCTGTTTCTGTAAAGTT","561307.5.peg.2255","1397"
"16861",372,165,207,"CCTGTAGCAGCCCCTTGATA","TACCTGTTTCTGTAAAGTT","561307.5.peg.2255","1397"
"16862",372,252,120,"CCTGTAGCAGCCCCTTGATA","AGCACATGGTCACCTGACGT","561307.5.peg.2255","1397"
"16863",552,252,300,"TCGATTTCACCAGCAGTTGT","AGCACATGGTCACCTGACGT","561307.5.peg.2255","1397"
"16864",69,252,183,"GTTTAATTTCTTCAACGCT","AGCACATGGTCACCTGACGT","561307.5.peg.2255","1397"
"16865",966,252,714,"TTTCATAAGGAGAAATACC","AGCACATGGTCACCTGACGT","561307.5.peg.2255","1397"
"16866",954,252,702,"GAAATACCTGGCTCACGTGT","AGCACATGGTCACCTGACGT","561307.5.peg.2255","1397"
"16867",978,252,726,"CTGAAAGCATCATTTCATA","AGCACATGGTCACCTGACGT","561307.5.peg.2255","1397"
"16868",552,266,286,"TCGATTTCACCAGCAGTTGT","CACCAGGCCCCATAAGCACA","561307.5.peg.2255","1397"
"16869",954,266,688,"GAAATACCTGGCTCACGTGT","CACCAGGCCCCATAAGCACA","561307.5.peg.2255","1397"
"16870",978,266,712,"CTGAAAGCATCATTTCATA","CACCAGGCCCCATAAGCACA","561307.5.peg.2255","1397"
"16871",372,266,106,"CCTGTAGCAGCCCCTTGATA","CACCAGGCCCCATAAGCACA","561307.5.peg.2255","1397"
"16872",966,266,700,"TTTCATAAGGAGAAATACC","CACCAGGCCCCATAAGCACA","561307.5.peg.2255","1397"
"16873",165,266,101,"TACCTGTTTCTGTAAAGTT","CACCAGGCCCCATAAGCACA","561307.5.peg.2255","1397"
"16874",69,266,197,"GTTTAATTTCTTCAACGCT","CACCAGGCCCCATAAGCACA","561307.5.peg.2255","1397"
"16875",978,282,696,"CTGAAAGCATCATTTCATA","ACTACCCCTGCACCTTCACC","561307.5.peg.2255","1397"
"16876",69,282,213,"GTTTAATTTCTTCAACGCT","ACTACCCCTGCACCTTCACC","561307.5.peg.2255","1397"
"16877",552,282,270,"TCGATTTCACCAGCAGTTGT","ACTACCCCTGCACCTTCACC","561307.5.peg.2255","1397"
"16878",954,282,672,"GAAATACCTGGCTCACGTGT","ACTACCCCTGCACCTTCACC","561307.5.peg.2255","1397"
"16879",966,282,684,"TTTCATAAGGAGAAATACC","ACTACCCCTGCACCTTCACC","561307.5.peg.2255","1397"
"16880",165,282,117,"TACCTGTTTCTGTAAAGTT","ACTACCCCTGCACCTTCACC","561307.5.peg.2255","1397"
"16881",69,325,256,"GTTTAATTTCTTCAACGCT","GACTCTACTTTAAATACTA","561307.5.peg.2255","1397"
"16882",165,325,160,"TACCTGTTTCTGTAAAGTT","GACTCTACTTTAAATACTA","561307.5.peg.2255","1397"
"16883",552,325,227,"TCGATTTCACCAGCAGTTGT","GACTCTACTTTAAATACTA","561307.5.peg.2255","1397"
"16884",978,325,653,"CTGAAAGCATCATTTCATA","GACTCTACTTTAAATACTA","561307.5.peg.2255","1397"
"16885",954,325,629,"GAAATACCTGGCTCACGTGT","GACTCTACTTTAAATACTA","561307.5.peg.2255","1397"
"16886",966,325,641,"TTTCATAAGGAGAAATACC","GACTCTACTTTAAATACTA","561307.5.peg.2255","1397"
"16887",252,372,120,"AGCACATGGTCACCTGACGT","CCTGTAGCAGCCCCTTGATA","561307.5.peg.2255","1397"
"16888",966,372,594,"TTTCATAAGGAGAAATACC","CCTGTAGCAGCCCCTTGATA","561307.5.peg.2255","1397"
"16889",165,372,207,"TACCTGTTTCTGTAAAGTT","CCTGTAGCAGCCCCTTGATA","561307.5.peg.2255","1397"
"16890",978,372,606,"CTGAAAGCATCATTTCATA","CCTGTAGCAGCCCCTTGATA","561307.5.peg.2255","1397"
"16891",954,372,582,"GAAATACCTGGCTCACGTGT","CCTGTAGCAGCCCCTTGATA","561307.5.peg.2255","1397"
"16892",69,372,303,"GTTTAATTTCTTCAACGCT","CCTGTAGCAGCCCCTTGATA","561307.5.peg.2255","1397"
"16893",552,372,180,"TCGATTTCACCAGCAGTTGT","CCTGTAGCAGCCCCTTGATA","561307.5.peg.2255","1397"
"16894",266,372,106,"CACCAGGCCCCATAAGCACA","CCTGTAGCAGCCCCTTGATA","561307.5.peg.2255","1397"
"16895",69,552,483,"GTTTAATTTCTTCAACGCT","TCGATTTCACCAGCAGTTGT","561307.5.peg.2255","1397"
"16896",978,552,426,"CTGAAAGCATCATTTCATA","TCGATTTCACCAGCAGTTGT","561307.5.peg.2255","1397"
"16897",266,552,286,"CACCAGGCCCCATAAGCACA","TCGATTTCACCAGCAGTTGT","561307.5.peg.2255","1397"
"16898",966,552,414,"TTTCATAAGGAGAAATACC","TCGATTTCACCAGCAGTTGT","561307.5.peg.2255","1397"
"16899",165,552,387,"TACCTGTTTCTGTAAAGTT","TCGATTTCACCAGCAGTTGT","561307.5.peg.2255","1397"
"16900",252,552,300,"AGCACATGGTCACCTGACGT","TCGATTTCACCAGCAGTTGT","561307.5.peg.2255","1397"
"16901",372,552,180,"CCTGTAGCAGCCCCTTGATA","TCGATTTCACCAGCAGTTGT","561307.5.peg.2255","1397"
"16902",954,552,402,"GAAATACCTGGCTCACGTGT","TCGATTTCACCAGCAGTTGT","561307.5.peg.2255","1397"
"16903",325,552,227,"GACTCTACTTTAAATACTA","TCGATTTCACCAGCAGTTGT","561307.5.peg.2255","1397"
"16904",282,552,270,"ACTACCCCTGCACCTTCACC","TCGATTTCACCAGCAGTTGT","561307.5.peg.2255","1397"
"16905",252,954,702,"AGCACATGGTCACCTGACGT","GAAATACCTGGCTCACGTGT","561307.5.peg.2255","1397"
"16906",69,954,885,"GTTTAATTTCTTCAACGCT","GAAATACCTGGCTCACGTGT","561307.5.peg.2255","1397"
"16907",266,954,688,"CACCAGGCCCCATAAGCACA","GAAATACCTGGCTCACGTGT","561307.5.peg.2255","1397"
"16908",165,954,789,"TACCTGTTTCTGTAAAGTT","GAAATACCTGGCTCACGTGT","561307.5.peg.2255","1397"
"16909",282,954,672,"ACTACCCCTGCACCTTCACC","GAAATACCTGGCTCACGTGT","561307.5.peg.2255","1397"
"16910",325,954,629,"GACTCTACTTTAAATACTA","GAAATACCTGGCTCACGTGT","561307.5.peg.2255","1397"
"16911",372,954,582,"CCTGTAGCAGCCCCTTGATA","GAAATACCTGGCTCACGTGT","561307.5.peg.2255","1397"
"16912",552,954,402,"TCGATTTCACCAGCAGTTGT","GAAATACCTGGCTCACGTGT","561307.5.peg.2255","1397"
"16913",69,966,897,"GTTTAATTTCTTCAACGCT","TTTCATAAGGAGAAATACC","561307.5.peg.2255","1397"
"16914",552,966,414,"TCGATTTCACCAGCAGTTGT","TTTCATAAGGAGAAATACC","561307.5.peg.2255","1397"
"16915",282,966,684,"ACTACCCCTGCACCTTCACC","TTTCATAAGGAGAAATACC","561307.5.peg.2255","1397"
"16916",252,966,714,"AGCACATGGTCACCTGACGT","TTTCATAAGGAGAAATACC","561307.5.peg.2255","1397"
"16917",372,966,594,"CCTGTAGCAGCCCCTTGATA","TTTCATAAGGAGAAATACC","561307.5.peg.2255","1397"
"16918",266,966,700,"CACCAGGCCCCATAAGCACA","TTTCATAAGGAGAAATACC","561307.5.peg.2255","1397"
"16919",165,966,801,"TACCTGTTTCTGTAAAGTT","TTTCATAAGGAGAAATACC","561307.5.peg.2255","1397"
"16920",325,966,641,"GACTCTACTTTAAATACTA","TTTCATAAGGAGAAATACC","561307.5.peg.2255","1397"
"16921",165,978,813,"TACCTGTTTCTGTAAAGTT","CTGAAAGCATCATTTCATA","561307.5.peg.2255","1397"
"16922",252,978,726,"AGCACATGGTCACCTGACGT","CTGAAAGCATCATTTCATA","561307.5.peg.2255","1397"
"16923",266,978,712,"CACCAGGCCCCATAAGCACA","CTGAAAGCATCATTTCATA","561307.5.peg.2255","1397"
"16924",372,978,606,"CCTGTAGCAGCCCCTTGATA","CTGAAAGCATCATTTCATA","561307.5.peg.2255","1397"
"16925",325,978,653,"GACTCTACTTTAAATACTA","CTGAAAGCATCATTTCATA","561307.5.peg.2255","1397"
"16926",69,978,909,"GTTTAATTTCTTCAACGCT","CTGAAAGCATCATTTCATA","561307.5.peg.2255","1397"
"16927",282,978,696,"ACTACCCCTGCACCTTCACC","CTGAAAGCATCATTTCATA","561307.5.peg.2255","1397"
"16928",552,978,426,"TCGATTTCACCAGCAGTTGT","CTGAAAGCATCATTTCATA","561307.5.peg.2255","1397"
"16929",246,75,171,"CGTTTAACTTCCGAAATAAT","TCTCTATCACAATTCGAACC","561307.5.peg.2256","1398"
"16930",75,246,171,"TCTCTATCACAATTCGAACC","CGTTTAACTTCCGAAATAAT","561307.5.peg.2256","1398"
"16931",303,13,290,"TACGAACAACTACTTCTAA","ATATGTACGCTAAATTTGAG","561307.5.peg.2258","1400"
"16932",13,303,290,"ATATGTACGCTAAATTTGAG","TACGAACAACTACTTCTAA","561307.5.peg.2258","1400"
"16933",336,168,168,"TGTATAGCTTGGTAACCTTG","CTACATGGACAATCTTCAGA","561307.5.peg.2259","1401"
"16934",409,168,241,"TGAAATGAACGGGACAACTT","CTACATGGACAATCTTCAGA","561307.5.peg.2259","1401"
"16935",336,183,153,"TGTATAGCTTGGTAACCTTG","TCGTGTGCAACGTATCTACA","561307.5.peg.2259","1401"
"16936",409,183,226,"TGAAATGAACGGGACAACTT","TCGTGTGCAACGTATCTACA","561307.5.peg.2259","1401"
"16937",168,336,168,"CTACATGGACAATCTTCAGA","TGTATAGCTTGGTAACCTTG","561307.5.peg.2259","1401"
"16938",183,336,153,"TCGTGTGCAACGTATCTACA","TGTATAGCTTGGTAACCTTG","561307.5.peg.2259","1401"
"16939",168,409,241,"CTACATGGACAATCTTCAGA","TGAAATGAACGGGACAACTT","561307.5.peg.2259","1401"
"16940",183,409,226,"TCGTGTGCAACGTATCTACA","TGAAATGAACGGGACAACTT","561307.5.peg.2259","1401"
"16941",144,8,136,"TCATTAGCGCCTTTAATTTG","AGAAATGACTTATCATTCGG","561307.5.peg.2262","1405"
"16942",8,144,136,"AGAAATGACTTATCATTCGG","TCATTAGCGCCTTTAATTTG","561307.5.peg.2262","1405"
"16943",262,9,253,"ATGGTGCATCTTACCAGATT","CCTACATTTGTAGTATTAGG","561307.5.peg.2263","1406"
"16944",384,9,375,"ATTGGATCTTTCTCACTCTT","CCTACATTTGTAGTATTAGG","561307.5.peg.2263","1406"
"16945",381,9,372,"GGATCTTTCTCACTCTTCGG","CCTACATTTGTAGTATTAGG","561307.5.peg.2263","1406"
"16946",491,9,482,"ATACAACAGGACGATCTTTA","CCTACATTTGTAGTATTAGG","561307.5.peg.2263","1406"
"16947",318,9,309,"AAAGCAGCAACGATTATGAT","CCTACATTTGTAGTATTAGG","561307.5.peg.2263","1406"
"16948",504,9,495,"GCTTGAAGCTTAAATACAAC","CCTACATTTGTAGTATTAGG","561307.5.peg.2263","1406"
"16949",381,19,362,"GGATCTTTCTCACTCTTCGG","CTCCTAATACTACAAATGTA","561307.5.peg.2263","1406"
"16950",318,19,299,"AAAGCAGCAACGATTATGAT","CTCCTAATACTACAAATGTA","561307.5.peg.2263","1406"
"16951",262,19,243,"ATGGTGCATCTTACCAGATT","CTCCTAATACTACAAATGTA","561307.5.peg.2263","1406"
"16952",504,19,485,"GCTTGAAGCTTAAATACAAC","CTCCTAATACTACAAATGTA","561307.5.peg.2263","1406"
"16953",491,19,472,"ATACAACAGGACGATCTTTA","CTCCTAATACTACAAATGTA","561307.5.peg.2263","1406"
"16954",384,19,365,"ATTGGATCTTTCTCACTCTT","CTCCTAATACTACAAATGTA","561307.5.peg.2263","1406"
"16955",19,262,243,"CTCCTAATACTACAAATGTA","ATGGTGCATCTTACCAGATT","561307.5.peg.2263","1406"
"16956",504,262,242,"GCTTGAAGCTTAAATACAAC","ATGGTGCATCTTACCAGATT","561307.5.peg.2263","1406"
"16957",384,262,122,"ATTGGATCTTTCTCACTCTT","ATGGTGCATCTTACCAGATT","561307.5.peg.2263","1406"
"16958",9,262,253,"CCTACATTTGTAGTATTAGG","ATGGTGCATCTTACCAGATT","561307.5.peg.2263","1406"
"16959",381,262,119,"GGATCTTTCTCACTCTTCGG","ATGGTGCATCTTACCAGATT","561307.5.peg.2263","1406"
"16960",491,262,229,"ATACAACAGGACGATCTTTA","ATGGTGCATCTTACCAGATT","561307.5.peg.2263","1406"
"16961",504,318,186,"GCTTGAAGCTTAAATACAAC","AAAGCAGCAACGATTATGAT","561307.5.peg.2263","1406"
"16962",491,318,173,"ATACAACAGGACGATCTTTA","AAAGCAGCAACGATTATGAT","561307.5.peg.2263","1406"
"16963",19,318,299,"CTCCTAATACTACAAATGTA","AAAGCAGCAACGATTATGAT","561307.5.peg.2263","1406"
"16964",9,318,309,"CCTACATTTGTAGTATTAGG","AAAGCAGCAACGATTATGAT","561307.5.peg.2263","1406"
"16965",19,381,362,"CTCCTAATACTACAAATGTA","GGATCTTTCTCACTCTTCGG","561307.5.peg.2263","1406"
"16966",9,381,372,"CCTACATTTGTAGTATTAGG","GGATCTTTCTCACTCTTCGG","561307.5.peg.2263","1406"
"16967",262,381,119,"ATGGTGCATCTTACCAGATT","GGATCTTTCTCACTCTTCGG","561307.5.peg.2263","1406"
"16968",491,381,110,"ATACAACAGGACGATCTTTA","GGATCTTTCTCACTCTTCGG","561307.5.peg.2263","1406"
"16969",504,381,123,"GCTTGAAGCTTAAATACAAC","GGATCTTTCTCACTCTTCGG","561307.5.peg.2263","1406"
"16970",262,384,122,"ATGGTGCATCTTACCAGATT","ATTGGATCTTTCTCACTCTT","561307.5.peg.2263","1406"
"16971",9,384,375,"CCTACATTTGTAGTATTAGG","ATTGGATCTTTCTCACTCTT","561307.5.peg.2263","1406"
"16972",491,384,107,"ATACAACAGGACGATCTTTA","ATTGGATCTTTCTCACTCTT","561307.5.peg.2263","1406"
"16973",19,384,365,"CTCCTAATACTACAAATGTA","ATTGGATCTTTCTCACTCTT","561307.5.peg.2263","1406"
"16974",504,384,120,"GCTTGAAGCTTAAATACAAC","ATTGGATCTTTCTCACTCTT","561307.5.peg.2263","1406"
"16975",9,491,482,"CCTACATTTGTAGTATTAGG","ATACAACAGGACGATCTTTA","561307.5.peg.2263","1406"
"16976",318,491,173,"AAAGCAGCAACGATTATGAT","ATACAACAGGACGATCTTTA","561307.5.peg.2263","1406"
"16977",262,491,229,"ATGGTGCATCTTACCAGATT","ATACAACAGGACGATCTTTA","561307.5.peg.2263","1406"
"16978",384,491,107,"ATTGGATCTTTCTCACTCTT","ATACAACAGGACGATCTTTA","561307.5.peg.2263","1406"
"16979",19,491,472,"CTCCTAATACTACAAATGTA","ATACAACAGGACGATCTTTA","561307.5.peg.2263","1406"
"16980",381,491,110,"GGATCTTTCTCACTCTTCGG","ATACAACAGGACGATCTTTA","561307.5.peg.2263","1406"
"16981",9,504,495,"CCTACATTTGTAGTATTAGG","GCTTGAAGCTTAAATACAAC","561307.5.peg.2263","1406"
"16982",318,504,186,"AAAGCAGCAACGATTATGAT","GCTTGAAGCTTAAATACAAC","561307.5.peg.2263","1406"
"16983",19,504,485,"CTCCTAATACTACAAATGTA","GCTTGAAGCTTAAATACAAC","561307.5.peg.2263","1406"
"16984",381,504,123,"GGATCTTTCTCACTCTTCGG","GCTTGAAGCTTAAATACAAC","561307.5.peg.2263","1406"
"16985",384,504,120,"ATTGGATCTTTCTCACTCTT","GCTTGAAGCTTAAATACAAC","561307.5.peg.2263","1406"
"16986",262,504,242,"ATGGTGCATCTTACCAGATT","GCTTGAAGCTTAAATACAAC","561307.5.peg.2263","1406"
"16987",908,7,901,"AGTAAATACCAAATGCTGGA","GACAATGATGATCATGGAGG","561307.5.peg.2264","1407"
"16988",887,7,880,"GGATAACGATATAAACTTCA","GACAATGATGATCATGGAGG","561307.5.peg.2264","1407"
"16989",582,7,575,"TAATAGTTAACACCCGGACC","GACAATGATGATCATGGAGG","561307.5.peg.2264","1407"
"16990",118,7,111,"AAACCAATAACTAAGAATG","GACAATGATGATCATGGAGG","561307.5.peg.2264","1407"
"16991",509,7,502,"ACCACCAATAATAAATGAC","GACAATGATGATCATGGAGG","561307.5.peg.2264","1407"
"16992",768,7,761,"AATGCTAACGCTACTGTTAA","GACAATGATGATCATGGAGG","561307.5.peg.2264","1407"
"16993",637,7,630,"GAAGTTGATACCTGTAGCTA","GACAATGATGATCATGGAGG","561307.5.peg.2264","1407"
"16994",257,7,250,"GTAACGCATCAATACCACCA","GACAATGATGATCATGGAGG","561307.5.peg.2264","1407"
"16995",941,7,934,"AACGCTTACGAGCGAATGTC","GACAATGATGATCATGGAGG","561307.5.peg.2264","1407"
"16996",764,7,757,"CTAACGCTACTGTTAAAGGA","GACAATGATGATCATGGAGG","561307.5.peg.2264","1407"
"16997",561,7,554,"GGACTGAATTCACCTGCTAG","GACAATGATGATCATGGAGG","561307.5.peg.2264","1407"
"16998",849,7,842,"AAGAAGTTAGCCCAAAGCAT","GACAATGATGATCATGGAGG","561307.5.peg.2264","1407"
"16999",534,7,527,"TAGTTTGTCCAACCAGCTGC","GACAATGATGATCATGGAGG","561307.5.peg.2264","1407"
"17000",588,7,581,"TTAAGTAATAGTTAACACC","GACAATGATGATCATGGAGG","561307.5.peg.2264","1407"
"17001",997,7,990,"GAAACTAAGGAACGCGATAC","GACAATGATGATCATGGAGG","561307.5.peg.2264","1407"
"17002",908,10,898,"AGTAAATACCAAATGCTGGA","CAAGACAATGATGATCATGG","561307.5.peg.2264","1407"
"17003",509,10,499,"ACCACCAATAATAAATGAC","CAAGACAATGATGATCATGG","561307.5.peg.2264","1407"
"17004",582,10,572,"TAATAGTTAACACCCGGACC","CAAGACAATGATGATCATGG","561307.5.peg.2264","1407"
"17005",257,10,247,"GTAACGCATCAATACCACCA","CAAGACAATGATGATCATGG","561307.5.peg.2264","1407"
"17006",561,10,551,"GGACTGAATTCACCTGCTAG","CAAGACAATGATGATCATGG","561307.5.peg.2264","1407"
"17007",534,10,524,"TAGTTTGTCCAACCAGCTGC","CAAGACAATGATGATCATGG","561307.5.peg.2264","1407"
"17008",768,10,758,"AATGCTAACGCTACTGTTAA","CAAGACAATGATGATCATGG","561307.5.peg.2264","1407"
"17009",887,10,877,"GGATAACGATATAAACTTCA","CAAGACAATGATGATCATGG","561307.5.peg.2264","1407"
"17010",997,10,987,"GAAACTAAGGAACGCGATAC","CAAGACAATGATGATCATGG","561307.5.peg.2264","1407"
"17011",764,10,754,"CTAACGCTACTGTTAAAGGA","CAAGACAATGATGATCATGG","561307.5.peg.2264","1407"
"17012",637,10,627,"GAAGTTGATACCTGTAGCTA","CAAGACAATGATGATCATGG","561307.5.peg.2264","1407"
"17013",849,10,839,"AAGAAGTTAGCCCAAAGCAT","CAAGACAATGATGATCATGG","561307.5.peg.2264","1407"
"17014",941,10,931,"AACGCTTACGAGCGAATGTC","CAAGACAATGATGATCATGG","561307.5.peg.2264","1407"
"17015",588,10,578,"TTAAGTAATAGTTAACACC","CAAGACAATGATGATCATGG","561307.5.peg.2264","1407"
"17016",118,10,108,"AAACCAATAACTAAGAATG","CAAGACAATGATGATCATGG","561307.5.peg.2264","1407"
"17017",637,13,624,"GAAGTTGATACCTGTAGCTA","GATCAAGACAATGATGATCA","561307.5.peg.2264","1407"
"17018",768,13,755,"AATGCTAACGCTACTGTTAA","GATCAAGACAATGATGATCA","561307.5.peg.2264","1407"
"17019",849,13,836,"AAGAAGTTAGCCCAAAGCAT","GATCAAGACAATGATGATCA","561307.5.peg.2264","1407"
"17020",887,13,874,"GGATAACGATATAAACTTCA","GATCAAGACAATGATGATCA","561307.5.peg.2264","1407"
"17021",588,13,575,"TTAAGTAATAGTTAACACC","GATCAAGACAATGATGATCA","561307.5.peg.2264","1407"
"17022",941,13,928,"AACGCTTACGAGCGAATGTC","GATCAAGACAATGATGATCA","561307.5.peg.2264","1407"
"17023",561,13,548,"GGACTGAATTCACCTGCTAG","GATCAAGACAATGATGATCA","561307.5.peg.2264","1407"
"17024",118,13,105,"AAACCAATAACTAAGAATG","GATCAAGACAATGATGATCA","561307.5.peg.2264","1407"
"17025",257,13,244,"GTAACGCATCAATACCACCA","GATCAAGACAATGATGATCA","561307.5.peg.2264","1407"
"17026",997,13,984,"GAAACTAAGGAACGCGATAC","GATCAAGACAATGATGATCA","561307.5.peg.2264","1407"
"17027",764,13,751,"CTAACGCTACTGTTAAAGGA","GATCAAGACAATGATGATCA","561307.5.peg.2264","1407"
"17028",908,13,895,"AGTAAATACCAAATGCTGGA","GATCAAGACAATGATGATCA","561307.5.peg.2264","1407"
"17029",582,13,569,"TAATAGTTAACACCCGGACC","GATCAAGACAATGATGATCA","561307.5.peg.2264","1407"
"17030",509,13,496,"ACCACCAATAATAAATGAC","GATCAAGACAATGATGATCA","561307.5.peg.2264","1407"
"17031",534,13,521,"TAGTTTGTCCAACCAGCTGC","GATCAAGACAATGATGATCA","561307.5.peg.2264","1407"
"17032",561,60,501,"GGACTGAATTCACCTGCTAG","TAACTAGTAATTGATCCCA","561307.5.peg.2264","1407"
"17033",887,60,827,"GGATAACGATATAAACTTCA","TAACTAGTAATTGATCCCA","561307.5.peg.2264","1407"
"17034",764,60,704,"CTAACGCTACTGTTAAAGGA","TAACTAGTAATTGATCCCA","561307.5.peg.2264","1407"
"17035",849,60,789,"AAGAAGTTAGCCCAAAGCAT","TAACTAGTAATTGATCCCA","561307.5.peg.2264","1407"
"17036",941,60,881,"AACGCTTACGAGCGAATGTC","TAACTAGTAATTGATCCCA","561307.5.peg.2264","1407"
"17037",509,60,449,"ACCACCAATAATAAATGAC","TAACTAGTAATTGATCCCA","561307.5.peg.2264","1407"
"17038",768,60,708,"AATGCTAACGCTACTGTTAA","TAACTAGTAATTGATCCCA","561307.5.peg.2264","1407"
"17039",534,60,474,"TAGTTTGTCCAACCAGCTGC","TAACTAGTAATTGATCCCA","561307.5.peg.2264","1407"
"17040",637,60,577,"GAAGTTGATACCTGTAGCTA","TAACTAGTAATTGATCCCA","561307.5.peg.2264","1407"
"17041",582,60,522,"TAATAGTTAACACCCGGACC","TAACTAGTAATTGATCCCA","561307.5.peg.2264","1407"
"17042",908,60,848,"AGTAAATACCAAATGCTGGA","TAACTAGTAATTGATCCCA","561307.5.peg.2264","1407"
"17043",588,60,528,"TTAAGTAATAGTTAACACC","TAACTAGTAATTGATCCCA","561307.5.peg.2264","1407"
"17044",997,60,937,"GAAACTAAGGAACGCGATAC","TAACTAGTAATTGATCCCA","561307.5.peg.2264","1407"
"17045",257,60,197,"GTAACGCATCAATACCACCA","TAACTAGTAATTGATCCCA","561307.5.peg.2264","1407"
"17046",637,118,519,"GAAGTTGATACCTGTAGCTA","AAACCAATAACTAAGAATG","561307.5.peg.2264","1407"
"17047",10,118,108,"CAAGACAATGATGATCATGG","AAACCAATAACTAAGAATG","561307.5.peg.2264","1407"
"17048",764,118,646,"CTAACGCTACTGTTAAAGGA","AAACCAATAACTAAGAATG","561307.5.peg.2264","1407"
"17049",768,118,650,"AATGCTAACGCTACTGTTAA","AAACCAATAACTAAGAATG","561307.5.peg.2264","1407"
"17050",887,118,769,"GGATAACGATATAAACTTCA","AAACCAATAACTAAGAATG","561307.5.peg.2264","1407"
"17051",561,118,443,"GGACTGAATTCACCTGCTAG","AAACCAATAACTAAGAATG","561307.5.peg.2264","1407"
"17052",849,118,731,"AAGAAGTTAGCCCAAAGCAT","AAACCAATAACTAAGAATG","561307.5.peg.2264","1407"
"17053",257,118,139,"GTAACGCATCAATACCACCA","AAACCAATAACTAAGAATG","561307.5.peg.2264","1407"
"17054",582,118,464,"TAATAGTTAACACCCGGACC","AAACCAATAACTAAGAATG","561307.5.peg.2264","1407"
"17055",509,118,391,"ACCACCAATAATAAATGAC","AAACCAATAACTAAGAATG","561307.5.peg.2264","1407"
"17056",997,118,879,"GAAACTAAGGAACGCGATAC","AAACCAATAACTAAGAATG","561307.5.peg.2264","1407"
"17057",13,118,105,"GATCAAGACAATGATGATCA","AAACCAATAACTAAGAATG","561307.5.peg.2264","1407"
"17058",7,118,111,"GACAATGATGATCATGGAGG","AAACCAATAACTAAGAATG","561307.5.peg.2264","1407"
"17059",534,118,416,"TAGTTTGTCCAACCAGCTGC","AAACCAATAACTAAGAATG","561307.5.peg.2264","1407"
"17060",941,118,823,"AACGCTTACGAGCGAATGTC","AAACCAATAACTAAGAATG","561307.5.peg.2264","1407"
"17061",588,118,470,"TTAAGTAATAGTTAACACC","AAACCAATAACTAAGAATG","561307.5.peg.2264","1407"
"17062",908,118,790,"AGTAAATACCAAATGCTGGA","AAACCAATAACTAAGAATG","561307.5.peg.2264","1407"
"17063",588,257,331,"TTAAGTAATAGTTAACACC","GTAACGCATCAATACCACCA","561307.5.peg.2264","1407"
"17064",7,257,250,"GACAATGATGATCATGGAGG","GTAACGCATCAATACCACCA","561307.5.peg.2264","1407"
"17065",10,257,247,"CAAGACAATGATGATCATGG","GTAACGCATCAATACCACCA","561307.5.peg.2264","1407"
"17066",13,257,244,"GATCAAGACAATGATGATCA","GTAACGCATCAATACCACCA","561307.5.peg.2264","1407"
"17067",60,257,197,"TAACTAGTAATTGATCCCA","GTAACGCATCAATACCACCA","561307.5.peg.2264","1407"
"17068",561,257,304,"GGACTGAATTCACCTGCTAG","GTAACGCATCAATACCACCA","561307.5.peg.2264","1407"
"17069",534,257,277,"TAGTTTGTCCAACCAGCTGC","GTAACGCATCAATACCACCA","561307.5.peg.2264","1407"
"17070",637,257,380,"GAAGTTGATACCTGTAGCTA","GTAACGCATCAATACCACCA","561307.5.peg.2264","1407"
"17071",582,257,325,"TAATAGTTAACACCCGGACC","GTAACGCATCAATACCACCA","561307.5.peg.2264","1407"
"17072",764,257,507,"CTAACGCTACTGTTAAAGGA","GTAACGCATCAATACCACCA","561307.5.peg.2264","1407"
"17073",118,257,139,"AAACCAATAACTAAGAATG","GTAACGCATCAATACCACCA","561307.5.peg.2264","1407"
"17074",997,257,740,"GAAACTAAGGAACGCGATAC","GTAACGCATCAATACCACCA","561307.5.peg.2264","1407"
"17075",908,257,651,"AGTAAATACCAAATGCTGGA","GTAACGCATCAATACCACCA","561307.5.peg.2264","1407"
"17076",509,257,252,"ACCACCAATAATAAATGAC","GTAACGCATCAATACCACCA","561307.5.peg.2264","1407"
"17077",941,257,684,"AACGCTTACGAGCGAATGTC","GTAACGCATCAATACCACCA","561307.5.peg.2264","1407"
"17078",849,257,592,"AAGAAGTTAGCCCAAAGCAT","GTAACGCATCAATACCACCA","561307.5.peg.2264","1407"
"17079",887,257,630,"GGATAACGATATAAACTTCA","GTAACGCATCAATACCACCA","561307.5.peg.2264","1407"
"17080",768,257,511,"AATGCTAACGCTACTGTTAA","GTAACGCATCAATACCACCA","561307.5.peg.2264","1407"
"17081",257,509,252,"GTAACGCATCAATACCACCA","ACCACCAATAATAAATGAC","561307.5.peg.2264","1407"
"17082",941,509,432,"AACGCTTACGAGCGAATGTC","ACCACCAATAATAAATGAC","561307.5.peg.2264","1407"
"17083",60,509,449,"TAACTAGTAATTGATCCCA","ACCACCAATAATAAATGAC","561307.5.peg.2264","1407"
"17084",7,509,502,"GACAATGATGATCATGGAGG","ACCACCAATAATAAATGAC","561307.5.peg.2264","1407"
"17085",887,509,378,"GGATAACGATATAAACTTCA","ACCACCAATAATAAATGAC","561307.5.peg.2264","1407"
"17086",10,509,499,"CAAGACAATGATGATCATGG","ACCACCAATAATAAATGAC","561307.5.peg.2264","1407"
"17087",908,509,399,"AGTAAATACCAAATGCTGGA","ACCACCAATAATAAATGAC","561307.5.peg.2264","1407"
"17088",997,509,488,"GAAACTAAGGAACGCGATAC","ACCACCAATAATAAATGAC","561307.5.peg.2264","1407"
"17089",849,509,340,"AAGAAGTTAGCCCAAAGCAT","ACCACCAATAATAAATGAC","561307.5.peg.2264","1407"
"17090",637,509,128,"GAAGTTGATACCTGTAGCTA","ACCACCAATAATAAATGAC","561307.5.peg.2264","1407"
"17091",13,509,496,"GATCAAGACAATGATGATCA","ACCACCAATAATAAATGAC","561307.5.peg.2264","1407"
"17092",768,509,259,"AATGCTAACGCTACTGTTAA","ACCACCAATAATAAATGAC","561307.5.peg.2264","1407"
"17093",118,509,391,"AAACCAATAACTAAGAATG","ACCACCAATAATAAATGAC","561307.5.peg.2264","1407"
"17094",764,509,255,"CTAACGCTACTGTTAAAGGA","ACCACCAATAATAAATGAC","561307.5.peg.2264","1407"
"17095",941,534,407,"AACGCTTACGAGCGAATGTC","TAGTTTGTCCAACCAGCTGC","561307.5.peg.2264","1407"
"17096",997,534,463,"GAAACTAAGGAACGCGATAC","TAGTTTGTCCAACCAGCTGC","561307.5.peg.2264","1407"
"17097",60,534,474,"TAACTAGTAATTGATCCCA","TAGTTTGTCCAACCAGCTGC","561307.5.peg.2264","1407"
"17098",849,534,315,"AAGAAGTTAGCCCAAAGCAT","TAGTTTGTCCAACCAGCTGC","561307.5.peg.2264","1407"
"17099",118,534,416,"AAACCAATAACTAAGAATG","TAGTTTGTCCAACCAGCTGC","561307.5.peg.2264","1407"
"17100",7,534,527,"GACAATGATGATCATGGAGG","TAGTTTGTCCAACCAGCTGC","561307.5.peg.2264","1407"
"17101",637,534,103,"GAAGTTGATACCTGTAGCTA","TAGTTTGTCCAACCAGCTGC","561307.5.peg.2264","1407"
"17102",764,534,230,"CTAACGCTACTGTTAAAGGA","TAGTTTGTCCAACCAGCTGC","561307.5.peg.2264","1407"
"17103",257,534,277,"GTAACGCATCAATACCACCA","TAGTTTGTCCAACCAGCTGC","561307.5.peg.2264","1407"
"17104",768,534,234,"AATGCTAACGCTACTGTTAA","TAGTTTGTCCAACCAGCTGC","561307.5.peg.2264","1407"
"17105",908,534,374,"AGTAAATACCAAATGCTGGA","TAGTTTGTCCAACCAGCTGC","561307.5.peg.2264","1407"
"17106",10,534,524,"CAAGACAATGATGATCATGG","TAGTTTGTCCAACCAGCTGC","561307.5.peg.2264","1407"
"17107",887,534,353,"GGATAACGATATAAACTTCA","TAGTTTGTCCAACCAGCTGC","561307.5.peg.2264","1407"
"17108",13,534,521,"GATCAAGACAATGATGATCA","TAGTTTGTCCAACCAGCTGC","561307.5.peg.2264","1407"
"17109",908,561,347,"AGTAAATACCAAATGCTGGA","GGACTGAATTCACCTGCTAG","561307.5.peg.2264","1407"
"17110",768,561,207,"AATGCTAACGCTACTGTTAA","GGACTGAATTCACCTGCTAG","561307.5.peg.2264","1407"
"17111",7,561,554,"GACAATGATGATCATGGAGG","GGACTGAATTCACCTGCTAG","561307.5.peg.2264","1407"
"17112",849,561,288,"AAGAAGTTAGCCCAAAGCAT","GGACTGAATTCACCTGCTAG","561307.5.peg.2264","1407"
"17113",941,561,380,"AACGCTTACGAGCGAATGTC","GGACTGAATTCACCTGCTAG","561307.5.peg.2264","1407"
"17114",118,561,443,"AAACCAATAACTAAGAATG","GGACTGAATTCACCTGCTAG","561307.5.peg.2264","1407"
"17115",997,561,436,"GAAACTAAGGAACGCGATAC","GGACTGAATTCACCTGCTAG","561307.5.peg.2264","1407"
"17116",887,561,326,"GGATAACGATATAAACTTCA","GGACTGAATTCACCTGCTAG","561307.5.peg.2264","1407"
"17117",10,561,551,"CAAGACAATGATGATCATGG","GGACTGAATTCACCTGCTAG","561307.5.peg.2264","1407"
"17118",257,561,304,"GTAACGCATCAATACCACCA","GGACTGAATTCACCTGCTAG","561307.5.peg.2264","1407"
"17119",13,561,548,"GATCAAGACAATGATGATCA","GGACTGAATTCACCTGCTAG","561307.5.peg.2264","1407"
"17120",60,561,501,"TAACTAGTAATTGATCCCA","GGACTGAATTCACCTGCTAG","561307.5.peg.2264","1407"
"17121",764,561,203,"CTAACGCTACTGTTAAAGGA","GGACTGAATTCACCTGCTAG","561307.5.peg.2264","1407"
"17122",887,582,305,"GGATAACGATATAAACTTCA","TAATAGTTAACACCCGGACC","561307.5.peg.2264","1407"
"17123",13,582,569,"GATCAAGACAATGATGATCA","TAATAGTTAACACCCGGACC","561307.5.peg.2264","1407"
"17124",941,582,359,"AACGCTTACGAGCGAATGTC","TAATAGTTAACACCCGGACC","561307.5.peg.2264","1407"
"17125",7,582,575,"GACAATGATGATCATGGAGG","TAATAGTTAACACCCGGACC","561307.5.peg.2264","1407"
"17126",118,582,464,"AAACCAATAACTAAGAATG","TAATAGTTAACACCCGGACC","561307.5.peg.2264","1407"
"17127",60,582,522,"TAACTAGTAATTGATCCCA","TAATAGTTAACACCCGGACC","561307.5.peg.2264","1407"
"17128",997,582,415,"GAAACTAAGGAACGCGATAC","TAATAGTTAACACCCGGACC","561307.5.peg.2264","1407"
"17129",764,582,182,"CTAACGCTACTGTTAAAGGA","TAATAGTTAACACCCGGACC","561307.5.peg.2264","1407"
"17130",908,582,326,"AGTAAATACCAAATGCTGGA","TAATAGTTAACACCCGGACC","561307.5.peg.2264","1407"
"17131",849,582,267,"AAGAAGTTAGCCCAAAGCAT","TAATAGTTAACACCCGGACC","561307.5.peg.2264","1407"
"17132",10,582,572,"CAAGACAATGATGATCATGG","TAATAGTTAACACCCGGACC","561307.5.peg.2264","1407"
"17133",257,582,325,"GTAACGCATCAATACCACCA","TAATAGTTAACACCCGGACC","561307.5.peg.2264","1407"
"17134",768,582,186,"AATGCTAACGCTACTGTTAA","TAATAGTTAACACCCGGACC","561307.5.peg.2264","1407"
"17135",997,588,409,"GAAACTAAGGAACGCGATAC","TTAAGTAATAGTTAACACC","561307.5.peg.2264","1407"
"17136",10,588,578,"CAAGACAATGATGATCATGG","TTAAGTAATAGTTAACACC","561307.5.peg.2264","1407"
"17137",13,588,575,"GATCAAGACAATGATGATCA","TTAAGTAATAGTTAACACC","561307.5.peg.2264","1407"
"17138",887,588,299,"GGATAACGATATAAACTTCA","TTAAGTAATAGTTAACACC","561307.5.peg.2264","1407"
"17139",60,588,528,"TAACTAGTAATTGATCCCA","TTAAGTAATAGTTAACACC","561307.5.peg.2264","1407"
"17140",941,588,353,"AACGCTTACGAGCGAATGTC","TTAAGTAATAGTTAACACC","561307.5.peg.2264","1407"
"17141",7,588,581,"GACAATGATGATCATGGAGG","TTAAGTAATAGTTAACACC","561307.5.peg.2264","1407"
"17142",118,588,470,"AAACCAATAACTAAGAATG","TTAAGTAATAGTTAACACC","561307.5.peg.2264","1407"
"17143",257,588,331,"GTAACGCATCAATACCACCA","TTAAGTAATAGTTAACACC","561307.5.peg.2264","1407"
"17144",908,588,320,"AGTAAATACCAAATGCTGGA","TTAAGTAATAGTTAACACC","561307.5.peg.2264","1407"
"17145",768,588,180,"AATGCTAACGCTACTGTTAA","TTAAGTAATAGTTAACACC","561307.5.peg.2264","1407"
"17146",764,588,176,"CTAACGCTACTGTTAAAGGA","TTAAGTAATAGTTAACACC","561307.5.peg.2264","1407"
"17147",849,588,261,"AAGAAGTTAGCCCAAAGCAT","TTAAGTAATAGTTAACACC","561307.5.peg.2264","1407"
"17148",13,637,624,"GATCAAGACAATGATGATCA","GAAGTTGATACCTGTAGCTA","561307.5.peg.2264","1407"
"17149",7,637,630,"GACAATGATGATCATGGAGG","GAAGTTGATACCTGTAGCTA","561307.5.peg.2264","1407"
"17150",997,637,360,"GAAACTAAGGAACGCGATAC","GAAGTTGATACCTGTAGCTA","561307.5.peg.2264","1407"
"17151",118,637,519,"AAACCAATAACTAAGAATG","GAAGTTGATACCTGTAGCTA","561307.5.peg.2264","1407"
"17152",509,637,128,"ACCACCAATAATAAATGAC","GAAGTTGATACCTGTAGCTA","561307.5.peg.2264","1407"
"17153",534,637,103,"TAGTTTGTCCAACCAGCTGC","GAAGTTGATACCTGTAGCTA","561307.5.peg.2264","1407"
"17154",60,637,577,"TAACTAGTAATTGATCCCA","GAAGTTGATACCTGTAGCTA","561307.5.peg.2264","1407"
"17155",257,637,380,"GTAACGCATCAATACCACCA","GAAGTTGATACCTGTAGCTA","561307.5.peg.2264","1407"
"17156",764,637,127,"CTAACGCTACTGTTAAAGGA","GAAGTTGATACCTGTAGCTA","561307.5.peg.2264","1407"
"17157",908,637,271,"AGTAAATACCAAATGCTGGA","GAAGTTGATACCTGTAGCTA","561307.5.peg.2264","1407"
"17158",887,637,250,"GGATAACGATATAAACTTCA","GAAGTTGATACCTGTAGCTA","561307.5.peg.2264","1407"
"17159",10,637,627,"CAAGACAATGATGATCATGG","GAAGTTGATACCTGTAGCTA","561307.5.peg.2264","1407"
"17160",768,637,131,"AATGCTAACGCTACTGTTAA","GAAGTTGATACCTGTAGCTA","561307.5.peg.2264","1407"
"17161",849,637,212,"AAGAAGTTAGCCCAAAGCAT","GAAGTTGATACCTGTAGCTA","561307.5.peg.2264","1407"
"17162",941,637,304,"AACGCTTACGAGCGAATGTC","GAAGTTGATACCTGTAGCTA","561307.5.peg.2264","1407"
"17163",257,764,507,"GTAACGCATCAATACCACCA","CTAACGCTACTGTTAAAGGA","561307.5.peg.2264","1407"
"17164",561,764,203,"GGACTGAATTCACCTGCTAG","CTAACGCTACTGTTAAAGGA","561307.5.peg.2264","1407"
"17165",10,764,754,"CAAGACAATGATGATCATGG","CTAACGCTACTGTTAAAGGA","561307.5.peg.2264","1407"
"17166",509,764,255,"ACCACCAATAATAAATGAC","CTAACGCTACTGTTAAAGGA","561307.5.peg.2264","1407"
"17167",582,764,182,"TAATAGTTAACACCCGGACC","CTAACGCTACTGTTAAAGGA","561307.5.peg.2264","1407"
"17168",7,764,757,"GACAATGATGATCATGGAGG","CTAACGCTACTGTTAAAGGA","561307.5.peg.2264","1407"
"17169",887,764,123,"GGATAACGATATAAACTTCA","CTAACGCTACTGTTAAAGGA","561307.5.peg.2264","1407"
"17170",13,764,751,"GATCAAGACAATGATGATCA","CTAACGCTACTGTTAAAGGA","561307.5.peg.2264","1407"
"17171",941,764,177,"AACGCTTACGAGCGAATGTC","CTAACGCTACTGTTAAAGGA","561307.5.peg.2264","1407"
"17172",997,764,233,"GAAACTAAGGAACGCGATAC","CTAACGCTACTGTTAAAGGA","561307.5.peg.2264","1407"
"17173",534,764,230,"TAGTTTGTCCAACCAGCTGC","CTAACGCTACTGTTAAAGGA","561307.5.peg.2264","1407"
"17174",118,764,646,"AAACCAATAACTAAGAATG","CTAACGCTACTGTTAAAGGA","561307.5.peg.2264","1407"
"17175",637,764,127,"GAAGTTGATACCTGTAGCTA","CTAACGCTACTGTTAAAGGA","561307.5.peg.2264","1407"
"17176",60,764,704,"TAACTAGTAATTGATCCCA","CTAACGCTACTGTTAAAGGA","561307.5.peg.2264","1407"
"17177",588,764,176,"TTAAGTAATAGTTAACACC","CTAACGCTACTGTTAAAGGA","561307.5.peg.2264","1407"
"17178",908,764,144,"AGTAAATACCAAATGCTGGA","CTAACGCTACTGTTAAAGGA","561307.5.peg.2264","1407"
"17179",588,768,180,"TTAAGTAATAGTTAACACC","AATGCTAACGCTACTGTTAA","561307.5.peg.2264","1407"
"17180",997,768,229,"GAAACTAAGGAACGCGATAC","AATGCTAACGCTACTGTTAA","561307.5.peg.2264","1407"
"17181",13,768,755,"GATCAAGACAATGATGATCA","AATGCTAACGCTACTGTTAA","561307.5.peg.2264","1407"
"17182",941,768,173,"AACGCTTACGAGCGAATGTC","AATGCTAACGCTACTGTTAA","561307.5.peg.2264","1407"
"17183",561,768,207,"GGACTGAATTCACCTGCTAG","AATGCTAACGCTACTGTTAA","561307.5.peg.2264","1407"
"17184",7,768,761,"GACAATGATGATCATGGAGG","AATGCTAACGCTACTGTTAA","561307.5.peg.2264","1407"
"17185",10,768,758,"CAAGACAATGATGATCATGG","AATGCTAACGCTACTGTTAA","561307.5.peg.2264","1407"
"17186",257,768,511,"GTAACGCATCAATACCACCA","AATGCTAACGCTACTGTTAA","561307.5.peg.2264","1407"
"17187",534,768,234,"TAGTTTGTCCAACCAGCTGC","AATGCTAACGCTACTGTTAA","561307.5.peg.2264","1407"
"17188",637,768,131,"GAAGTTGATACCTGTAGCTA","AATGCTAACGCTACTGTTAA","561307.5.peg.2264","1407"
"17189",582,768,186,"TAATAGTTAACACCCGGACC","AATGCTAACGCTACTGTTAA","561307.5.peg.2264","1407"
"17190",118,768,650,"AAACCAATAACTAAGAATG","AATGCTAACGCTACTGTTAA","561307.5.peg.2264","1407"
"17191",60,768,708,"TAACTAGTAATTGATCCCA","AATGCTAACGCTACTGTTAA","561307.5.peg.2264","1407"
"17192",509,768,259,"ACCACCAATAATAAATGAC","AATGCTAACGCTACTGTTAA","561307.5.peg.2264","1407"
"17193",887,768,119,"GGATAACGATATAAACTTCA","AATGCTAACGCTACTGTTAA","561307.5.peg.2264","1407"
"17194",908,768,140,"AGTAAATACCAAATGCTGGA","AATGCTAACGCTACTGTTAA","561307.5.peg.2264","1407"
"17195",13,849,836,"GATCAAGACAATGATGATCA","AAGAAGTTAGCCCAAAGCAT","561307.5.peg.2264","1407"
"17196",588,849,261,"TTAAGTAATAGTTAACACC","AAGAAGTTAGCCCAAAGCAT","561307.5.peg.2264","1407"
"17197",118,849,731,"AAACCAATAACTAAGAATG","AAGAAGTTAGCCCAAAGCAT","561307.5.peg.2264","1407"
"17198",10,849,839,"CAAGACAATGATGATCATGG","AAGAAGTTAGCCCAAAGCAT","561307.5.peg.2264","1407"
"17199",7,849,842,"GACAATGATGATCATGGAGG","AAGAAGTTAGCCCAAAGCAT","561307.5.peg.2264","1407"
"17200",257,849,592,"GTAACGCATCAATACCACCA","AAGAAGTTAGCCCAAAGCAT","561307.5.peg.2264","1407"
"17201",60,849,789,"TAACTAGTAATTGATCCCA","AAGAAGTTAGCCCAAAGCAT","561307.5.peg.2264","1407"
"17202",582,849,267,"TAATAGTTAACACCCGGACC","AAGAAGTTAGCCCAAAGCAT","561307.5.peg.2264","1407"
"17203",637,849,212,"GAAGTTGATACCTGTAGCTA","AAGAAGTTAGCCCAAAGCAT","561307.5.peg.2264","1407"
"17204",997,849,148,"GAAACTAAGGAACGCGATAC","AAGAAGTTAGCCCAAAGCAT","561307.5.peg.2264","1407"
"17205",509,849,340,"ACCACCAATAATAAATGAC","AAGAAGTTAGCCCAAAGCAT","561307.5.peg.2264","1407"
"17206",561,849,288,"GGACTGAATTCACCTGCTAG","AAGAAGTTAGCCCAAAGCAT","561307.5.peg.2264","1407"
"17207",534,849,315,"TAGTTTGTCCAACCAGCTGC","AAGAAGTTAGCCCAAAGCAT","561307.5.peg.2264","1407"
"17208",768,887,119,"AATGCTAACGCTACTGTTAA","GGATAACGATATAAACTTCA","561307.5.peg.2264","1407"
"17209",997,887,110,"GAAACTAAGGAACGCGATAC","GGATAACGATATAAACTTCA","561307.5.peg.2264","1407"
"17210",582,887,305,"TAATAGTTAACACCCGGACC","GGATAACGATATAAACTTCA","561307.5.peg.2264","1407"
"17211",257,887,630,"GTAACGCATCAATACCACCA","GGATAACGATATAAACTTCA","561307.5.peg.2264","1407"
"17212",637,887,250,"GAAGTTGATACCTGTAGCTA","GGATAACGATATAAACTTCA","561307.5.peg.2264","1407"
"17213",534,887,353,"TAGTTTGTCCAACCAGCTGC","GGATAACGATATAAACTTCA","561307.5.peg.2264","1407"
"17214",13,887,874,"GATCAAGACAATGATGATCA","GGATAACGATATAAACTTCA","561307.5.peg.2264","1407"
"17215",7,887,880,"GACAATGATGATCATGGAGG","GGATAACGATATAAACTTCA","561307.5.peg.2264","1407"
"17216",588,887,299,"TTAAGTAATAGTTAACACC","GGATAACGATATAAACTTCA","561307.5.peg.2264","1407"
"17217",509,887,378,"ACCACCAATAATAAATGAC","GGATAACGATATAAACTTCA","561307.5.peg.2264","1407"
"17218",764,887,123,"CTAACGCTACTGTTAAAGGA","GGATAACGATATAAACTTCA","561307.5.peg.2264","1407"
"17219",60,887,827,"TAACTAGTAATTGATCCCA","GGATAACGATATAAACTTCA","561307.5.peg.2264","1407"
"17220",561,887,326,"GGACTGAATTCACCTGCTAG","GGATAACGATATAAACTTCA","561307.5.peg.2264","1407"
"17221",118,887,769,"AAACCAATAACTAAGAATG","GGATAACGATATAAACTTCA","561307.5.peg.2264","1407"
"17222",10,887,877,"CAAGACAATGATGATCATGG","GGATAACGATATAAACTTCA","561307.5.peg.2264","1407"
"17223",257,908,651,"GTAACGCATCAATACCACCA","AGTAAATACCAAATGCTGGA","561307.5.peg.2264","1407"
"17224",118,908,790,"AAACCAATAACTAAGAATG","AGTAAATACCAAATGCTGGA","561307.5.peg.2264","1407"
"17225",60,908,848,"TAACTAGTAATTGATCCCA","AGTAAATACCAAATGCTGGA","561307.5.peg.2264","1407"
"17226",764,908,144,"CTAACGCTACTGTTAAAGGA","AGTAAATACCAAATGCTGGA","561307.5.peg.2264","1407"
"17227",7,908,901,"GACAATGATGATCATGGAGG","AGTAAATACCAAATGCTGGA","561307.5.peg.2264","1407"
"17228",10,908,898,"CAAGACAATGATGATCATGG","AGTAAATACCAAATGCTGGA","561307.5.peg.2264","1407"
"17229",582,908,326,"TAATAGTTAACACCCGGACC","AGTAAATACCAAATGCTGGA","561307.5.peg.2264","1407"
"17230",561,908,347,"GGACTGAATTCACCTGCTAG","AGTAAATACCAAATGCTGGA","561307.5.peg.2264","1407"
"17231",588,908,320,"TTAAGTAATAGTTAACACC","AGTAAATACCAAATGCTGGA","561307.5.peg.2264","1407"
"17232",534,908,374,"TAGTTTGTCCAACCAGCTGC","AGTAAATACCAAATGCTGGA","561307.5.peg.2264","1407"
"17233",637,908,271,"GAAGTTGATACCTGTAGCTA","AGTAAATACCAAATGCTGGA","561307.5.peg.2264","1407"
"17234",13,908,895,"GATCAAGACAATGATGATCA","AGTAAATACCAAATGCTGGA","561307.5.peg.2264","1407"
"17235",509,908,399,"ACCACCAATAATAAATGAC","AGTAAATACCAAATGCTGGA","561307.5.peg.2264","1407"
"17236",768,908,140,"AATGCTAACGCTACTGTTAA","AGTAAATACCAAATGCTGGA","561307.5.peg.2264","1407"
"17237",582,941,359,"TAATAGTTAACACCCGGACC","AACGCTTACGAGCGAATGTC","561307.5.peg.2264","1407"
"17238",561,941,380,"GGACTGAATTCACCTGCTAG","AACGCTTACGAGCGAATGTC","561307.5.peg.2264","1407"
"17239",588,941,353,"TTAAGTAATAGTTAACACC","AACGCTTACGAGCGAATGTC","561307.5.peg.2264","1407"
"17240",509,941,432,"ACCACCAATAATAAATGAC","AACGCTTACGAGCGAATGTC","561307.5.peg.2264","1407"
"17241",13,941,928,"GATCAAGACAATGATGATCA","AACGCTTACGAGCGAATGTC","561307.5.peg.2264","1407"
"17242",534,941,407,"TAGTTTGTCCAACCAGCTGC","AACGCTTACGAGCGAATGTC","561307.5.peg.2264","1407"
"17243",768,941,173,"AATGCTAACGCTACTGTTAA","AACGCTTACGAGCGAATGTC","561307.5.peg.2264","1407"
"17244",637,941,304,"GAAGTTGATACCTGTAGCTA","AACGCTTACGAGCGAATGTC","561307.5.peg.2264","1407"
"17245",60,941,881,"TAACTAGTAATTGATCCCA","AACGCTTACGAGCGAATGTC","561307.5.peg.2264","1407"
"17246",118,941,823,"AAACCAATAACTAAGAATG","AACGCTTACGAGCGAATGTC","561307.5.peg.2264","1407"
"17247",7,941,934,"GACAATGATGATCATGGAGG","AACGCTTACGAGCGAATGTC","561307.5.peg.2264","1407"
"17248",764,941,177,"CTAACGCTACTGTTAAAGGA","AACGCTTACGAGCGAATGTC","561307.5.peg.2264","1407"
"17249",257,941,684,"GTAACGCATCAATACCACCA","AACGCTTACGAGCGAATGTC","561307.5.peg.2264","1407"
"17250",10,941,931,"CAAGACAATGATGATCATGG","AACGCTTACGAGCGAATGTC","561307.5.peg.2264","1407"
"17251",7,997,990,"GACAATGATGATCATGGAGG","GAAACTAAGGAACGCGATAC","561307.5.peg.2264","1407"
"17252",534,997,463,"TAGTTTGTCCAACCAGCTGC","GAAACTAAGGAACGCGATAC","561307.5.peg.2264","1407"
"17253",582,997,415,"TAATAGTTAACACCCGGACC","GAAACTAAGGAACGCGATAC","561307.5.peg.2264","1407"
"17254",257,997,740,"GTAACGCATCAATACCACCA","GAAACTAAGGAACGCGATAC","561307.5.peg.2264","1407"
"17255",561,997,436,"GGACTGAATTCACCTGCTAG","GAAACTAAGGAACGCGATAC","561307.5.peg.2264","1407"
"17256",10,997,987,"CAAGACAATGATGATCATGG","GAAACTAAGGAACGCGATAC","561307.5.peg.2264","1407"
"17257",60,997,937,"TAACTAGTAATTGATCCCA","GAAACTAAGGAACGCGATAC","561307.5.peg.2264","1407"
"17258",13,997,984,"GATCAAGACAATGATGATCA","GAAACTAAGGAACGCGATAC","561307.5.peg.2264","1407"
"17259",637,997,360,"GAAGTTGATACCTGTAGCTA","GAAACTAAGGAACGCGATAC","561307.5.peg.2264","1407"
"17260",118,997,879,"AAACCAATAACTAAGAATG","GAAACTAAGGAACGCGATAC","561307.5.peg.2264","1407"
"17261",849,997,148,"AAGAAGTTAGCCCAAAGCAT","GAAACTAAGGAACGCGATAC","561307.5.peg.2264","1407"
"17262",509,997,488,"ACCACCAATAATAAATGAC","GAAACTAAGGAACGCGATAC","561307.5.peg.2264","1407"
"17263",764,997,233,"CTAACGCTACTGTTAAAGGA","GAAACTAAGGAACGCGATAC","561307.5.peg.2264","1407"
"17264",768,997,229,"AATGCTAACGCTACTGTTAA","GAAACTAAGGAACGCGATAC","561307.5.peg.2264","1407"
"17265",887,997,110,"GGATAACGATATAAACTTCA","GAAACTAAGGAACGCGATAC","561307.5.peg.2264","1407"
"17266",588,997,409,"TTAAGTAATAGTTAACACC","GAAACTAAGGAACGCGATAC","561307.5.peg.2264","1407"
"17267",133,13,120,"GGTACCGAATAACGCAAATT","AGAAGCGCGTATTAAAGAAA","561307.5.peg.2265","1408"
"17268",154,13,141,"AGTTAATAGTGTCGCAAATA","AGAAGCGCGTATTAAAGAAA","561307.5.peg.2265","1408"
"17269",13,133,120,"AGAAGCGCGTATTAAAGAAA","GGTACCGAATAACGCAAATT","561307.5.peg.2265","1408"
"17270",13,154,141,"AGAAGCGCGTATTAAAGAAA","AGTTAATAGTGTCGCAAATA","561307.5.peg.2265","1408"
"17271",134,8,126,"AGATAATTGTCAACTTCGCG","CACCATCCCTATCATATATA","561307.5.peg.2266","1409"
"17272",134,13,121,"AGATAATTGTCAACTTCGCG","ATGATAGGGATGGTGTATAG","561307.5.peg.2266","1409"
"17273",134,23,111,"AGATAATTGTCAACTTCGCG","TGCCGTATATATGATAGGGA","561307.5.peg.2266","1409"
"17274",134,27,107,"AGATAATTGTCAACTTCGCG","TTACTGCCGTATATATGATA","561307.5.peg.2266","1409"
"17275",8,134,126,"CACCATCCCTATCATATATA","AGATAATTGTCAACTTCGCG","561307.5.peg.2266","1409"
"17276",13,134,121,"ATGATAGGGATGGTGTATAG","AGATAATTGTCAACTTCGCG","561307.5.peg.2266","1409"
"17277",23,134,111,"TGCCGTATATATGATAGGGA","AGATAATTGTCAACTTCGCG","561307.5.peg.2266","1409"
"17278",27,134,107,"TTACTGCCGTATATATGATA","AGATAATTGTCAACTTCGCG","561307.5.peg.2266","1409"
"17279",396,80,316,"TATCGTAATAGCCAACTTT","CAATGAGAACCAATGCTAGA","561307.5.peg.2268","1411"
"17280",570,80,490,"TAGGTTCATTTAAGTCGTA","CAATGAGAACCAATGCTAGA","561307.5.peg.2268","1411"
"17281",454,80,374,"AGCTTCTACCGAATCCATTG","CAATGAGAACCAATGCTAGA","561307.5.peg.2268","1411"
"17282",588,80,508,"TTACCAGTATCATCTGTGTT","CAATGAGAACCAATGCTAGA","561307.5.peg.2268","1411"
"17283",447,80,367,"ACCGAATCCATTGCGGCAAT","CAATGAGAACCAATGCTAGA","561307.5.peg.2268","1411"
"17284",478,80,398,"TAATCAACAGGTACATTCA","CAATGAGAACCAATGCTAGA","561307.5.peg.2268","1411"
"17285",372,80,292,"ATGTAGCTGATAGTATCACG","CAATGAGAACCAATGCTAGA","561307.5.peg.2268","1411"
"17286",219,80,139,"ATAGAGATAGGTTGTTCTTC","CAATGAGAACCAATGCTAGA","561307.5.peg.2268","1411"
"17287",570,108,462,"TAGGTTCATTTAAGTCGTA","AGTAACGTAGCGAAGACTAT","561307.5.peg.2268","1411"
"17288",447,108,339,"ACCGAATCCATTGCGGCAAT","AGTAACGTAGCGAAGACTAT","561307.5.peg.2268","1411"
"17289",219,108,111,"ATAGAGATAGGTTGTTCTTC","AGTAACGTAGCGAAGACTAT","561307.5.peg.2268","1411"
"17290",588,108,480,"TTACCAGTATCATCTGTGTT","AGTAACGTAGCGAAGACTAT","561307.5.peg.2268","1411"
"17291",454,108,346,"AGCTTCTACCGAATCCATTG","AGTAACGTAGCGAAGACTAT","561307.5.peg.2268","1411"
"17292",478,108,370,"TAATCAACAGGTACATTCA","AGTAACGTAGCGAAGACTAT","561307.5.peg.2268","1411"
"17293",372,108,264,"ATGTAGCTGATAGTATCACG","AGTAACGTAGCGAAGACTAT","561307.5.peg.2268","1411"
"17294",396,108,288,"TATCGTAATAGCCAACTTT","AGTAACGTAGCGAAGACTAT","561307.5.peg.2268","1411"
"17295",478,142,336,"TAATCAACAGGTACATTCA","AGAAGATTCGAATGCATCTT","561307.5.peg.2268","1411"
"17296",447,142,305,"ACCGAATCCATTGCGGCAAT","AGAAGATTCGAATGCATCTT","561307.5.peg.2268","1411"
"17297",372,142,230,"ATGTAGCTGATAGTATCACG","AGAAGATTCGAATGCATCTT","561307.5.peg.2268","1411"
"17298",396,142,254,"TATCGTAATAGCCAACTTT","AGAAGATTCGAATGCATCTT","561307.5.peg.2268","1411"
"17299",454,142,312,"AGCTTCTACCGAATCCATTG","AGAAGATTCGAATGCATCTT","561307.5.peg.2268","1411"
"17300",570,142,428,"TAGGTTCATTTAAGTCGTA","AGAAGATTCGAATGCATCTT","561307.5.peg.2268","1411"
"17301",588,142,446,"TTACCAGTATCATCTGTGTT","AGAAGATTCGAATGCATCTT","561307.5.peg.2268","1411"
"17302",80,219,139,"CAATGAGAACCAATGCTAGA","ATAGAGATAGGTTGTTCTTC","561307.5.peg.2268","1411"
"17303",454,219,235,"AGCTTCTACCGAATCCATTG","ATAGAGATAGGTTGTTCTTC","561307.5.peg.2268","1411"
"17304",570,219,351,"TAGGTTCATTTAAGTCGTA","ATAGAGATAGGTTGTTCTTC","561307.5.peg.2268","1411"
"17305",372,219,153,"ATGTAGCTGATAGTATCACG","ATAGAGATAGGTTGTTCTTC","561307.5.peg.2268","1411"
"17306",478,219,259,"TAATCAACAGGTACATTCA","ATAGAGATAGGTTGTTCTTC","561307.5.peg.2268","1411"
"17307",447,219,228,"ACCGAATCCATTGCGGCAAT","ATAGAGATAGGTTGTTCTTC","561307.5.peg.2268","1411"
"17308",396,219,177,"TATCGTAATAGCCAACTTT","ATAGAGATAGGTTGTTCTTC","561307.5.peg.2268","1411"
"17309",108,219,111,"AGTAACGTAGCGAAGACTAT","ATAGAGATAGGTTGTTCTTC","561307.5.peg.2268","1411"
"17310",588,219,369,"TTACCAGTATCATCTGTGTT","ATAGAGATAGGTTGTTCTTC","561307.5.peg.2268","1411"
"17311",219,372,153,"ATAGAGATAGGTTGTTCTTC","ATGTAGCTGATAGTATCACG","561307.5.peg.2268","1411"
"17312",142,372,230,"AGAAGATTCGAATGCATCTT","ATGTAGCTGATAGTATCACG","561307.5.peg.2268","1411"
"17313",80,372,292,"CAATGAGAACCAATGCTAGA","ATGTAGCTGATAGTATCACG","561307.5.peg.2268","1411"
"17314",478,372,106,"TAATCAACAGGTACATTCA","ATGTAGCTGATAGTATCACG","561307.5.peg.2268","1411"
"17315",570,372,198,"TAGGTTCATTTAAGTCGTA","ATGTAGCTGATAGTATCACG","561307.5.peg.2268","1411"
"17316",108,372,264,"AGTAACGTAGCGAAGACTAT","ATGTAGCTGATAGTATCACG","561307.5.peg.2268","1411"
"17317",588,372,216,"TTACCAGTATCATCTGTGTT","ATGTAGCTGATAGTATCACG","561307.5.peg.2268","1411"
"17318",142,396,254,"AGAAGATTCGAATGCATCTT","TATCGTAATAGCCAACTTT","561307.5.peg.2268","1411"
"17319",219,396,177,"ATAGAGATAGGTTGTTCTTC","TATCGTAATAGCCAACTTT","561307.5.peg.2268","1411"
"17320",80,396,316,"CAATGAGAACCAATGCTAGA","TATCGTAATAGCCAACTTT","561307.5.peg.2268","1411"
"17321",588,396,192,"TTACCAGTATCATCTGTGTT","TATCGTAATAGCCAACTTT","561307.5.peg.2268","1411"
"17322",570,396,174,"TAGGTTCATTTAAGTCGTA","TATCGTAATAGCCAACTTT","561307.5.peg.2268","1411"
"17323",108,396,288,"AGTAACGTAGCGAAGACTAT","TATCGTAATAGCCAACTTT","561307.5.peg.2268","1411"
"17324",588,447,141,"TTACCAGTATCATCTGTGTT","ACCGAATCCATTGCGGCAAT","561307.5.peg.2268","1411"
"17325",80,447,367,"CAATGAGAACCAATGCTAGA","ACCGAATCCATTGCGGCAAT","561307.5.peg.2268","1411"
"17326",108,447,339,"AGTAACGTAGCGAAGACTAT","ACCGAATCCATTGCGGCAAT","561307.5.peg.2268","1411"
"17327",219,447,228,"ATAGAGATAGGTTGTTCTTC","ACCGAATCCATTGCGGCAAT","561307.5.peg.2268","1411"
"17328",142,447,305,"AGAAGATTCGAATGCATCTT","ACCGAATCCATTGCGGCAAT","561307.5.peg.2268","1411"
"17329",570,447,123,"TAGGTTCATTTAAGTCGTA","ACCGAATCCATTGCGGCAAT","561307.5.peg.2268","1411"
"17330",108,454,346,"AGTAACGTAGCGAAGACTAT","AGCTTCTACCGAATCCATTG","561307.5.peg.2268","1411"
"17331",570,454,116,"TAGGTTCATTTAAGTCGTA","AGCTTCTACCGAATCCATTG","561307.5.peg.2268","1411"
"17332",588,454,134,"TTACCAGTATCATCTGTGTT","AGCTTCTACCGAATCCATTG","561307.5.peg.2268","1411"
"17333",80,454,374,"CAATGAGAACCAATGCTAGA","AGCTTCTACCGAATCCATTG","561307.5.peg.2268","1411"
"17334",219,454,235,"ATAGAGATAGGTTGTTCTTC","AGCTTCTACCGAATCCATTG","561307.5.peg.2268","1411"
"17335",142,454,312,"AGAAGATTCGAATGCATCTT","AGCTTCTACCGAATCCATTG","561307.5.peg.2268","1411"
"17336",142,478,336,"AGAAGATTCGAATGCATCTT","TAATCAACAGGTACATTCA","561307.5.peg.2268","1411"
"17337",219,478,259,"ATAGAGATAGGTTGTTCTTC","TAATCAACAGGTACATTCA","561307.5.peg.2268","1411"
"17338",108,478,370,"AGTAACGTAGCGAAGACTAT","TAATCAACAGGTACATTCA","561307.5.peg.2268","1411"
"17339",372,478,106,"ATGTAGCTGATAGTATCACG","TAATCAACAGGTACATTCA","561307.5.peg.2268","1411"
"17340",588,478,110,"TTACCAGTATCATCTGTGTT","TAATCAACAGGTACATTCA","561307.5.peg.2268","1411"
"17341",80,478,398,"CAATGAGAACCAATGCTAGA","TAATCAACAGGTACATTCA","561307.5.peg.2268","1411"
"17342",80,570,490,"CAATGAGAACCAATGCTAGA","TAGGTTCATTTAAGTCGTA","561307.5.peg.2268","1411"
"17343",108,570,462,"AGTAACGTAGCGAAGACTAT","TAGGTTCATTTAAGTCGTA","561307.5.peg.2268","1411"
"17344",447,570,123,"ACCGAATCCATTGCGGCAAT","TAGGTTCATTTAAGTCGTA","561307.5.peg.2268","1411"
"17345",219,570,351,"ATAGAGATAGGTTGTTCTTC","TAGGTTCATTTAAGTCGTA","561307.5.peg.2268","1411"
"17346",396,570,174,"TATCGTAATAGCCAACTTT","TAGGTTCATTTAAGTCGTA","561307.5.peg.2268","1411"
"17347",454,570,116,"AGCTTCTACCGAATCCATTG","TAGGTTCATTTAAGTCGTA","561307.5.peg.2268","1411"
"17348",142,570,428,"AGAAGATTCGAATGCATCTT","TAGGTTCATTTAAGTCGTA","561307.5.peg.2268","1411"
"17349",372,570,198,"ATGTAGCTGATAGTATCACG","TAGGTTCATTTAAGTCGTA","561307.5.peg.2268","1411"
"17350",142,588,446,"AGAAGATTCGAATGCATCTT","TTACCAGTATCATCTGTGTT","561307.5.peg.2268","1411"
"17351",454,588,134,"AGCTTCTACCGAATCCATTG","TTACCAGTATCATCTGTGTT","561307.5.peg.2268","1411"
"17352",80,588,508,"CAATGAGAACCAATGCTAGA","TTACCAGTATCATCTGTGTT","561307.5.peg.2268","1411"
"17353",396,588,192,"TATCGTAATAGCCAACTTT","TTACCAGTATCATCTGTGTT","561307.5.peg.2268","1411"
"17354",108,588,480,"AGTAACGTAGCGAAGACTAT","TTACCAGTATCATCTGTGTT","561307.5.peg.2268","1411"
"17355",478,588,110,"TAATCAACAGGTACATTCA","TTACCAGTATCATCTGTGTT","561307.5.peg.2268","1411"
"17356",219,588,369,"ATAGAGATAGGTTGTTCTTC","TTACCAGTATCATCTGTGTT","561307.5.peg.2268","1411"
"17357",372,588,216,"ATGTAGCTGATAGTATCACG","TTACCAGTATCATCTGTGTT","561307.5.peg.2268","1411"
"17358",447,588,141,"ACCGAATCCATTGCGGCAAT","TTACCAGTATCATCTGTGTT","561307.5.peg.2268","1411"
"17359",404,252,152,"ATGTTTACCCATAATCTCA","GCAAACATGGGTGGATTAAA","561307.5.peg.227","1413"
"17360",392,252,140,"TAATCTCAAGGATGACAGTG","GCAAACATGGGTGGATTAAA","561307.5.peg.227","1413"
"17361",516,252,264,"GGTGCTTCATAATTAAATCC","GCAAACATGGGTGGATTAAA","561307.5.peg.227","1413"
"17362",486,252,234,"GTACGATAGTGATTCGTATT","GCAAACATGGGTGGATTAAA","561307.5.peg.227","1413"
"17363",745,252,493,"AATAGGAGTAGGTGGTAACT","GCAAACATGGGTGGATTAAA","561307.5.peg.227","1413"
"17364",252,392,140,"GCAAACATGGGTGGATTAAA","TAATCTCAAGGATGACAGTG","561307.5.peg.227","1413"
"17365",745,392,353,"AATAGGAGTAGGTGGTAACT","TAATCTCAAGGATGACAGTG","561307.5.peg.227","1413"
"17366",516,392,124,"GGTGCTTCATAATTAAATCC","TAATCTCAAGGATGACAGTG","561307.5.peg.227","1413"
"17367",252,404,152,"GCAAACATGGGTGGATTAAA","ATGTTTACCCATAATCTCA","561307.5.peg.227","1413"
"17368",516,404,112,"GGTGCTTCATAATTAAATCC","ATGTTTACCCATAATCTCA","561307.5.peg.227","1413"
"17369",745,404,341,"AATAGGAGTAGGTGGTAACT","ATGTTTACCCATAATCTCA","561307.5.peg.227","1413"
"17370",252,486,234,"GCAAACATGGGTGGATTAAA","GTACGATAGTGATTCGTATT","561307.5.peg.227","1413"
"17371",745,486,259,"AATAGGAGTAGGTGGTAACT","GTACGATAGTGATTCGTATT","561307.5.peg.227","1413"
"17372",252,516,264,"GCAAACATGGGTGGATTAAA","GGTGCTTCATAATTAAATCC","561307.5.peg.227","1413"
"17373",392,516,124,"TAATCTCAAGGATGACAGTG","GGTGCTTCATAATTAAATCC","561307.5.peg.227","1413"
"17374",404,516,112,"ATGTTTACCCATAATCTCA","GGTGCTTCATAATTAAATCC","561307.5.peg.227","1413"
"17375",745,516,229,"AATAGGAGTAGGTGGTAACT","GGTGCTTCATAATTAAATCC","561307.5.peg.227","1413"
"17376",392,745,353,"TAATCTCAAGGATGACAGTG","AATAGGAGTAGGTGGTAACT","561307.5.peg.227","1413"
"17377",252,745,493,"GCAAACATGGGTGGATTAAA","AATAGGAGTAGGTGGTAACT","561307.5.peg.227","1413"
"17378",404,745,341,"ATGTTTACCCATAATCTCA","AATAGGAGTAGGTGGTAACT","561307.5.peg.227","1413"
"17379",486,745,259,"GTACGATAGTGATTCGTATT","AATAGGAGTAGGTGGTAACT","561307.5.peg.227","1413"
"17380",516,745,229,"GGTGCTTCATAATTAAATCC","AATAGGAGTAGGTGGTAACT","561307.5.peg.227","1413"
"17381",1848,78,1770,"GTTGTAGGTGTTGATGGCTT","AGCGTTAATGCAACCATTGA","561307.5.peg.2271","1415"
"17382",825,78,747,"TCATGAACTACGATACCTTC","AGCGTTAATGCAACCATTGA","561307.5.peg.2271","1415"
"17383",1001,78,923,"TTCAACATTGATGAATCTA","AGCGTTAATGCAACCATTGA","561307.5.peg.2271","1415"
"17384",576,78,498,"GCTGATGTAGTTGCAGCTTT","AGCGTTAATGCAACCATTGA","561307.5.peg.2271","1415"
"17385",402,78,324,"GTGCTTGTTGACTTTGCAAC","AGCGTTAATGCAACCATTGA","561307.5.peg.2271","1415"
"17386",1198,78,1120,"TCTTAAATATCCATGTGGAT","AGCGTTAATGCAACCATTGA","561307.5.peg.2271","1415"
"17387",960,78,882,"CCCCAAGATAAGTAATCCGT","AGCGTTAATGCAACCATTGA","561307.5.peg.2271","1415"
"17388",1665,78,1587,"ACTTGTTTAGATGTACCCCA","AGCGTTAATGCAACCATTGA","561307.5.peg.2271","1415"
"17389",1116,78,1038,"CCATCATACTCAGCACTGTC","AGCGTTAATGCAACCATTGA","561307.5.peg.2271","1415"
"17390",540,78,462,"TATTGCGTTTCAAGAGCTGC","AGCGTTAATGCAACCATTGA","561307.5.peg.2271","1415"
"17391",1854,78,1776,"TATTTGTTGTAGGTGTTGA","AGCGTTAATGCAACCATTGA","561307.5.peg.2271","1415"
"17392",1350,78,1272,"TTACCAGTTGATGGTTTCGA","AGCGTTAATGCAACCATTGA","561307.5.peg.2271","1415"
"17393",1341,78,1263,"GATGGTTTCGACGGTGTTGT","AGCGTTAATGCAACCATTGA","561307.5.peg.2271","1415"
"17394",791,78,713,"CGTTACGGTATGCGTATTTA","AGCGTTAATGCAACCATTGA","561307.5.peg.2271","1415"
"17395",806,78,728,"CAGGACGACCTACGCCGTTA","AGCGTTAATGCAACCATTGA","561307.5.peg.2271","1415"
"17396",1296,78,1218,"GTTGTAGATTGCGTACCCCA","AGCGTTAATGCAACCATTGA","561307.5.peg.2271","1415"
"17397",1830,78,1752,"TTAGGTGTTGGTGTAGGCGT","AGCGTTAATGCAACCATTGA","561307.5.peg.2271","1415"
"17398",1842,78,1764,"GGTGTTGATGGCTTAGGTGT","AGCGTTAATGCAACCATTGA","561307.5.peg.2271","1415"
"17399",657,78,579,"GGTGTTGCAGCAACTGATCT","AGCGTTAATGCAACCATTGA","561307.5.peg.2271","1415"
"17400",1193,78,1115,"AATATCCATGTGGATCGGCA","AGCGTTAATGCAACCATTGA","561307.5.peg.2271","1415"
"17401",1715,78,1637,"GCTTTGAAGCCTTAAATGTT","AGCGTTAATGCAACCATTGA","561307.5.peg.2271","1415"
"17402",1296,402,894,"GTTGTAGATTGCGTACCCCA","GTGCTTGTTGACTTTGCAAC","561307.5.peg.2271","1415"
"17403",1842,402,1440,"GGTGTTGATGGCTTAGGTGT","GTGCTTGTTGACTTTGCAAC","561307.5.peg.2271","1415"
"17404",791,402,389,"CGTTACGGTATGCGTATTTA","GTGCTTGTTGACTTTGCAAC","561307.5.peg.2271","1415"
"17405",540,402,138,"TATTGCGTTTCAAGAGCTGC","GTGCTTGTTGACTTTGCAAC","561307.5.peg.2271","1415"
"17406",1848,402,1446,"GTTGTAGGTGTTGATGGCTT","GTGCTTGTTGACTTTGCAAC","561307.5.peg.2271","1415"
"17407",1830,402,1428,"TTAGGTGTTGGTGTAGGCGT","GTGCTTGTTGACTTTGCAAC","561307.5.peg.2271","1415"
"17408",1001,402,599,"TTCAACATTGATGAATCTA","GTGCTTGTTGACTTTGCAAC","561307.5.peg.2271","1415"
"17409",1665,402,1263,"ACTTGTTTAGATGTACCCCA","GTGCTTGTTGACTTTGCAAC","561307.5.peg.2271","1415"
"17410",806,402,404,"CAGGACGACCTACGCCGTTA","GTGCTTGTTGACTTTGCAAC","561307.5.peg.2271","1415"
"17411",960,402,558,"CCCCAAGATAAGTAATCCGT","GTGCTTGTTGACTTTGCAAC","561307.5.peg.2271","1415"
"17412",657,402,255,"GGTGTTGCAGCAACTGATCT","GTGCTTGTTGACTTTGCAAC","561307.5.peg.2271","1415"
"17413",825,402,423,"TCATGAACTACGATACCTTC","GTGCTTGTTGACTTTGCAAC","561307.5.peg.2271","1415"
"17414",1350,402,948,"TTACCAGTTGATGGTTTCGA","GTGCTTGTTGACTTTGCAAC","561307.5.peg.2271","1415"
"17415",1198,402,796,"TCTTAAATATCCATGTGGAT","GTGCTTGTTGACTTTGCAAC","561307.5.peg.2271","1415"
"17416",1341,402,939,"GATGGTTTCGACGGTGTTGT","GTGCTTGTTGACTTTGCAAC","561307.5.peg.2271","1415"
"17417",1193,402,791,"AATATCCATGTGGATCGGCA","GTGCTTGTTGACTTTGCAAC","561307.5.peg.2271","1415"
"17418",1854,402,1452,"TATTTGTTGTAGGTGTTGA","GTGCTTGTTGACTTTGCAAC","561307.5.peg.2271","1415"
"17419",1715,402,1313,"GCTTTGAAGCCTTAAATGTT","GTGCTTGTTGACTTTGCAAC","561307.5.peg.2271","1415"
"17420",78,402,324,"AGCGTTAATGCAACCATTGA","GTGCTTGTTGACTTTGCAAC","561307.5.peg.2271","1415"
"17421",1116,402,714,"CCATCATACTCAGCACTGTC","GTGCTTGTTGACTTTGCAAC","561307.5.peg.2271","1415"
"17422",576,402,174,"GCTGATGTAGTTGCAGCTTT","GTGCTTGTTGACTTTGCAAC","561307.5.peg.2271","1415"
"17423",791,540,251,"CGTTACGGTATGCGTATTTA","TATTGCGTTTCAAGAGCTGC","561307.5.peg.2271","1415"
"17424",825,540,285,"TCATGAACTACGATACCTTC","TATTGCGTTTCAAGAGCTGC","561307.5.peg.2271","1415"
"17425",1296,540,756,"GTTGTAGATTGCGTACCCCA","TATTGCGTTTCAAGAGCTGC","561307.5.peg.2271","1415"
"17426",1001,540,461,"TTCAACATTGATGAATCTA","TATTGCGTTTCAAGAGCTGC","561307.5.peg.2271","1415"
"17427",806,540,266,"CAGGACGACCTACGCCGTTA","TATTGCGTTTCAAGAGCTGC","561307.5.peg.2271","1415"
"17428",1830,540,1290,"TTAGGTGTTGGTGTAGGCGT","TATTGCGTTTCAAGAGCTGC","561307.5.peg.2271","1415"
"17429",1715,540,1175,"GCTTTGAAGCCTTAAATGTT","TATTGCGTTTCAAGAGCTGC","561307.5.peg.2271","1415"
"17430",1665,540,1125,"ACTTGTTTAGATGTACCCCA","TATTGCGTTTCAAGAGCTGC","561307.5.peg.2271","1415"
"17431",78,540,462,"AGCGTTAATGCAACCATTGA","TATTGCGTTTCAAGAGCTGC","561307.5.peg.2271","1415"
"17432",1193,540,653,"AATATCCATGTGGATCGGCA","TATTGCGTTTCAAGAGCTGC","561307.5.peg.2271","1415"
"17433",1198,540,658,"TCTTAAATATCCATGTGGAT","TATTGCGTTTCAAGAGCTGC","561307.5.peg.2271","1415"
"17434",960,540,420,"CCCCAAGATAAGTAATCCGT","TATTGCGTTTCAAGAGCTGC","561307.5.peg.2271","1415"
"17435",1350,540,810,"TTACCAGTTGATGGTTTCGA","TATTGCGTTTCAAGAGCTGC","561307.5.peg.2271","1415"
"17436",1842,540,1302,"GGTGTTGATGGCTTAGGTGT","TATTGCGTTTCAAGAGCTGC","561307.5.peg.2271","1415"
"17437",1854,540,1314,"TATTTGTTGTAGGTGTTGA","TATTGCGTTTCAAGAGCTGC","561307.5.peg.2271","1415"
"17438",1848,540,1308,"GTTGTAGGTGTTGATGGCTT","TATTGCGTTTCAAGAGCTGC","561307.5.peg.2271","1415"
"17439",1341,540,801,"GATGGTTTCGACGGTGTTGT","TATTGCGTTTCAAGAGCTGC","561307.5.peg.2271","1415"
"17440",1116,540,576,"CCATCATACTCAGCACTGTC","TATTGCGTTTCAAGAGCTGC","561307.5.peg.2271","1415"
"17441",402,540,138,"GTGCTTGTTGACTTTGCAAC","TATTGCGTTTCAAGAGCTGC","561307.5.peg.2271","1415"
"17442",657,540,117,"GGTGTTGCAGCAACTGATCT","TATTGCGTTTCAAGAGCTGC","561307.5.peg.2271","1415"
"17443",1854,576,1278,"TATTTGTTGTAGGTGTTGA","GCTGATGTAGTTGCAGCTTT","561307.5.peg.2271","1415"
"17444",1715,576,1139,"GCTTTGAAGCCTTAAATGTT","GCTGATGTAGTTGCAGCTTT","561307.5.peg.2271","1415"
"17445",825,576,249,"TCATGAACTACGATACCTTC","GCTGATGTAGTTGCAGCTTT","561307.5.peg.2271","1415"
"17446",1341,576,765,"GATGGTTTCGACGGTGTTGT","GCTGATGTAGTTGCAGCTTT","561307.5.peg.2271","1415"
"17447",1665,576,1089,"ACTTGTTTAGATGTACCCCA","GCTGATGTAGTTGCAGCTTT","561307.5.peg.2271","1415"
"17448",1198,576,622,"TCTTAAATATCCATGTGGAT","GCTGATGTAGTTGCAGCTTT","561307.5.peg.2271","1415"
"17449",1848,576,1272,"GTTGTAGGTGTTGATGGCTT","GCTGATGTAGTTGCAGCTTT","561307.5.peg.2271","1415"
"17450",960,576,384,"CCCCAAGATAAGTAATCCGT","GCTGATGTAGTTGCAGCTTT","561307.5.peg.2271","1415"
"17451",1116,576,540,"CCATCATACTCAGCACTGTC","GCTGATGTAGTTGCAGCTTT","561307.5.peg.2271","1415"
"17452",78,576,498,"AGCGTTAATGCAACCATTGA","GCTGATGTAGTTGCAGCTTT","561307.5.peg.2271","1415"
"17453",791,576,215,"CGTTACGGTATGCGTATTTA","GCTGATGTAGTTGCAGCTTT","561307.5.peg.2271","1415"
"17454",1350,576,774,"TTACCAGTTGATGGTTTCGA","GCTGATGTAGTTGCAGCTTT","561307.5.peg.2271","1415"
"17455",1842,576,1266,"GGTGTTGATGGCTTAGGTGT","GCTGATGTAGTTGCAGCTTT","561307.5.peg.2271","1415"
"17456",1830,576,1254,"TTAGGTGTTGGTGTAGGCGT","GCTGATGTAGTTGCAGCTTT","561307.5.peg.2271","1415"
"17457",1193,576,617,"AATATCCATGTGGATCGGCA","GCTGATGTAGTTGCAGCTTT","561307.5.peg.2271","1415"
"17458",1001,576,425,"TTCAACATTGATGAATCTA","GCTGATGTAGTTGCAGCTTT","561307.5.peg.2271","1415"
"17459",806,576,230,"CAGGACGACCTACGCCGTTA","GCTGATGTAGTTGCAGCTTT","561307.5.peg.2271","1415"
"17460",1296,576,720,"GTTGTAGATTGCGTACCCCA","GCTGATGTAGTTGCAGCTTT","561307.5.peg.2271","1415"
"17461",402,576,174,"GTGCTTGTTGACTTTGCAAC","GCTGATGTAGTTGCAGCTTT","561307.5.peg.2271","1415"
"17462",1715,657,1058,"GCTTTGAAGCCTTAAATGTT","GGTGTTGCAGCAACTGATCT","561307.5.peg.2271","1415"
"17463",1842,657,1185,"GGTGTTGATGGCTTAGGTGT","GGTGTTGCAGCAACTGATCT","561307.5.peg.2271","1415"
"17464",1116,657,459,"CCATCATACTCAGCACTGTC","GGTGTTGCAGCAACTGATCT","561307.5.peg.2271","1415"
"17465",402,657,255,"GTGCTTGTTGACTTTGCAAC","GGTGTTGCAGCAACTGATCT","561307.5.peg.2271","1415"
"17466",540,657,117,"TATTGCGTTTCAAGAGCTGC","GGTGTTGCAGCAACTGATCT","561307.5.peg.2271","1415"
"17467",1341,657,684,"GATGGTTTCGACGGTGTTGT","GGTGTTGCAGCAACTGATCT","561307.5.peg.2271","1415"
"17468",1193,657,536,"AATATCCATGTGGATCGGCA","GGTGTTGCAGCAACTGATCT","561307.5.peg.2271","1415"
"17469",1665,657,1008,"ACTTGTTTAGATGTACCCCA","GGTGTTGCAGCAACTGATCT","561307.5.peg.2271","1415"
"17470",1198,657,541,"TCTTAAATATCCATGTGGAT","GGTGTTGCAGCAACTGATCT","561307.5.peg.2271","1415"
"17471",78,657,579,"AGCGTTAATGCAACCATTGA","GGTGTTGCAGCAACTGATCT","561307.5.peg.2271","1415"
"17472",791,657,134,"CGTTACGGTATGCGTATTTA","GGTGTTGCAGCAACTGATCT","561307.5.peg.2271","1415"
"17473",960,657,303,"CCCCAAGATAAGTAATCCGT","GGTGTTGCAGCAACTGATCT","561307.5.peg.2271","1415"
"17474",1001,657,344,"TTCAACATTGATGAATCTA","GGTGTTGCAGCAACTGATCT","561307.5.peg.2271","1415"
"17475",1830,657,1173,"TTAGGTGTTGGTGTAGGCGT","GGTGTTGCAGCAACTGATCT","561307.5.peg.2271","1415"
"17476",1296,657,639,"GTTGTAGATTGCGTACCCCA","GGTGTTGCAGCAACTGATCT","561307.5.peg.2271","1415"
"17477",1350,657,693,"TTACCAGTTGATGGTTTCGA","GGTGTTGCAGCAACTGATCT","561307.5.peg.2271","1415"
"17478",825,657,168,"TCATGAACTACGATACCTTC","GGTGTTGCAGCAACTGATCT","561307.5.peg.2271","1415"
"17479",1854,657,1197,"TATTTGTTGTAGGTGTTGA","GGTGTTGCAGCAACTGATCT","561307.5.peg.2271","1415"
"17480",806,657,149,"CAGGACGACCTACGCCGTTA","GGTGTTGCAGCAACTGATCT","561307.5.peg.2271","1415"
"17481",1848,657,1191,"GTTGTAGGTGTTGATGGCTT","GGTGTTGCAGCAACTGATCT","561307.5.peg.2271","1415"
"17482",1350,791,559,"TTACCAGTTGATGGTTTCGA","CGTTACGGTATGCGTATTTA","561307.5.peg.2271","1415"
"17483",402,791,389,"GTGCTTGTTGACTTTGCAAC","CGTTACGGTATGCGTATTTA","561307.5.peg.2271","1415"
"17484",576,791,215,"GCTGATGTAGTTGCAGCTTT","CGTTACGGTATGCGTATTTA","561307.5.peg.2271","1415"
"17485",1854,791,1063,"TATTTGTTGTAGGTGTTGA","CGTTACGGTATGCGTATTTA","561307.5.peg.2271","1415"
"17486",1296,791,505,"GTTGTAGATTGCGTACCCCA","CGTTACGGTATGCGTATTTA","561307.5.peg.2271","1415"
"17487",1116,791,325,"CCATCATACTCAGCACTGTC","CGTTACGGTATGCGTATTTA","561307.5.peg.2271","1415"
"17488",1665,791,874,"ACTTGTTTAGATGTACCCCA","CGTTACGGTATGCGTATTTA","561307.5.peg.2271","1415"
"17489",540,791,251,"TATTGCGTTTCAAGAGCTGC","CGTTACGGTATGCGTATTTA","561307.5.peg.2271","1415"
"17490",1715,791,924,"GCTTTGAAGCCTTAAATGTT","CGTTACGGTATGCGTATTTA","561307.5.peg.2271","1415"
"17491",1001,791,210,"TTCAACATTGATGAATCTA","CGTTACGGTATGCGTATTTA","561307.5.peg.2271","1415"
"17492",1830,791,1039,"TTAGGTGTTGGTGTAGGCGT","CGTTACGGTATGCGTATTTA","561307.5.peg.2271","1415"
"17493",1198,791,407,"TCTTAAATATCCATGTGGAT","CGTTACGGTATGCGTATTTA","561307.5.peg.2271","1415"
"17494",1848,791,1057,"GTTGTAGGTGTTGATGGCTT","CGTTACGGTATGCGTATTTA","561307.5.peg.2271","1415"
"17495",1193,791,402,"AATATCCATGTGGATCGGCA","CGTTACGGTATGCGTATTTA","561307.5.peg.2271","1415"
"17496",657,791,134,"GGTGTTGCAGCAACTGATCT","CGTTACGGTATGCGTATTTA","561307.5.peg.2271","1415"
"17497",1842,791,1051,"GGTGTTGATGGCTTAGGTGT","CGTTACGGTATGCGTATTTA","561307.5.peg.2271","1415"
"17498",1341,791,550,"GATGGTTTCGACGGTGTTGT","CGTTACGGTATGCGTATTTA","561307.5.peg.2271","1415"
"17499",960,791,169,"CCCCAAGATAAGTAATCCGT","CGTTACGGTATGCGTATTTA","561307.5.peg.2271","1415"
"17500",78,791,713,"AGCGTTAATGCAACCATTGA","CGTTACGGTATGCGTATTTA","561307.5.peg.2271","1415"
"17501",540,806,266,"TATTGCGTTTCAAGAGCTGC","CAGGACGACCTACGCCGTTA","561307.5.peg.2271","1415"
"17502",1848,806,1042,"GTTGTAGGTGTTGATGGCTT","CAGGACGACCTACGCCGTTA","561307.5.peg.2271","1415"
"17503",657,806,149,"GGTGTTGCAGCAACTGATCT","CAGGACGACCTACGCCGTTA","561307.5.peg.2271","1415"
"17504",1842,806,1036,"GGTGTTGATGGCTTAGGTGT","CAGGACGACCTACGCCGTTA","561307.5.peg.2271","1415"
"17505",1296,806,490,"GTTGTAGATTGCGTACCCCA","CAGGACGACCTACGCCGTTA","561307.5.peg.2271","1415"
"17506",1001,806,195,"TTCAACATTGATGAATCTA","CAGGACGACCTACGCCGTTA","561307.5.peg.2271","1415"
"17507",1350,806,544,"TTACCAGTTGATGGTTTCGA","CAGGACGACCTACGCCGTTA","561307.5.peg.2271","1415"
"17508",1830,806,1024,"TTAGGTGTTGGTGTAGGCGT","CAGGACGACCTACGCCGTTA","561307.5.peg.2271","1415"
"17509",1341,806,535,"GATGGTTTCGACGGTGTTGT","CAGGACGACCTACGCCGTTA","561307.5.peg.2271","1415"
"17510",1193,806,387,"AATATCCATGTGGATCGGCA","CAGGACGACCTACGCCGTTA","561307.5.peg.2271","1415"
"17511",576,806,230,"GCTGATGTAGTTGCAGCTTT","CAGGACGACCTACGCCGTTA","561307.5.peg.2271","1415"
"17512",960,806,154,"CCCCAAGATAAGTAATCCGT","CAGGACGACCTACGCCGTTA","561307.5.peg.2271","1415"
"17513",1665,806,859,"ACTTGTTTAGATGTACCCCA","CAGGACGACCTACGCCGTTA","561307.5.peg.2271","1415"
"17514",1116,806,310,"CCATCATACTCAGCACTGTC","CAGGACGACCTACGCCGTTA","561307.5.peg.2271","1415"
"17515",1715,806,909,"GCTTTGAAGCCTTAAATGTT","CAGGACGACCTACGCCGTTA","561307.5.peg.2271","1415"
"17516",1854,806,1048,"TATTTGTTGTAGGTGTTGA","CAGGACGACCTACGCCGTTA","561307.5.peg.2271","1415"
"17517",78,806,728,"AGCGTTAATGCAACCATTGA","CAGGACGACCTACGCCGTTA","561307.5.peg.2271","1415"
"17518",402,806,404,"GTGCTTGTTGACTTTGCAAC","CAGGACGACCTACGCCGTTA","561307.5.peg.2271","1415"
"17519",1198,806,392,"TCTTAAATATCCATGTGGAT","CAGGACGACCTACGCCGTTA","561307.5.peg.2271","1415"
"17520",1350,825,525,"TTACCAGTTGATGGTTTCGA","TCATGAACTACGATACCTTC","561307.5.peg.2271","1415"
"17521",657,825,168,"GGTGTTGCAGCAACTGATCT","TCATGAACTACGATACCTTC","561307.5.peg.2271","1415"
"17522",1001,825,176,"TTCAACATTGATGAATCTA","TCATGAACTACGATACCTTC","561307.5.peg.2271","1415"
"17523",1665,825,840,"ACTTGTTTAGATGTACCCCA","TCATGAACTACGATACCTTC","561307.5.peg.2271","1415"
"17524",78,825,747,"AGCGTTAATGCAACCATTGA","TCATGAACTACGATACCTTC","561307.5.peg.2271","1415"
"17525",1854,825,1029,"TATTTGTTGTAGGTGTTGA","TCATGAACTACGATACCTTC","561307.5.peg.2271","1415"
"17526",1198,825,373,"TCTTAAATATCCATGTGGAT","TCATGAACTACGATACCTTC","561307.5.peg.2271","1415"
"17527",1830,825,1005,"TTAGGTGTTGGTGTAGGCGT","TCATGAACTACGATACCTTC","561307.5.peg.2271","1415"
"17528",1193,825,368,"AATATCCATGTGGATCGGCA","TCATGAACTACGATACCTTC","561307.5.peg.2271","1415"
"17529",1116,825,291,"CCATCATACTCAGCACTGTC","TCATGAACTACGATACCTTC","561307.5.peg.2271","1415"
"17530",1842,825,1017,"GGTGTTGATGGCTTAGGTGT","TCATGAACTACGATACCTTC","561307.5.peg.2271","1415"
"17531",960,825,135,"CCCCAAGATAAGTAATCCGT","TCATGAACTACGATACCTTC","561307.5.peg.2271","1415"
"17532",1296,825,471,"GTTGTAGATTGCGTACCCCA","TCATGAACTACGATACCTTC","561307.5.peg.2271","1415"
"17533",402,825,423,"GTGCTTGTTGACTTTGCAAC","TCATGAACTACGATACCTTC","561307.5.peg.2271","1415"
"17534",576,825,249,"GCTGATGTAGTTGCAGCTTT","TCATGAACTACGATACCTTC","561307.5.peg.2271","1415"
"17535",1715,825,890,"GCTTTGAAGCCTTAAATGTT","TCATGAACTACGATACCTTC","561307.5.peg.2271","1415"
"17536",1848,825,1023,"GTTGTAGGTGTTGATGGCTT","TCATGAACTACGATACCTTC","561307.5.peg.2271","1415"
"17537",540,825,285,"TATTGCGTTTCAAGAGCTGC","TCATGAACTACGATACCTTC","561307.5.peg.2271","1415"
"17538",1341,825,516,"GATGGTTTCGACGGTGTTGT","TCATGAACTACGATACCTTC","561307.5.peg.2271","1415"
"17539",402,960,558,"GTGCTTGTTGACTTTGCAAC","CCCCAAGATAAGTAATCCGT","561307.5.peg.2271","1415"
"17540",1296,960,336,"GTTGTAGATTGCGTACCCCA","CCCCAAGATAAGTAATCCGT","561307.5.peg.2271","1415"
"17541",1854,960,894,"TATTTGTTGTAGGTGTTGA","CCCCAAGATAAGTAATCCGT","561307.5.peg.2271","1415"
"17542",1193,960,233,"AATATCCATGTGGATCGGCA","CCCCAAGATAAGTAATCCGT","561307.5.peg.2271","1415"
"17543",1715,960,755,"GCTTTGAAGCCTTAAATGTT","CCCCAAGATAAGTAATCCGT","561307.5.peg.2271","1415"
"17544",1350,960,390,"TTACCAGTTGATGGTTTCGA","CCCCAAGATAAGTAATCCGT","561307.5.peg.2271","1415"
"17545",1842,960,882,"GGTGTTGATGGCTTAGGTGT","CCCCAAGATAAGTAATCCGT","561307.5.peg.2271","1415"
"17546",825,960,135,"TCATGAACTACGATACCTTC","CCCCAAGATAAGTAATCCGT","561307.5.peg.2271","1415"
"17547",1116,960,156,"CCATCATACTCAGCACTGTC","CCCCAAGATAAGTAATCCGT","561307.5.peg.2271","1415"
"17548",1830,960,870,"TTAGGTGTTGGTGTAGGCGT","CCCCAAGATAAGTAATCCGT","561307.5.peg.2271","1415"
"17549",791,960,169,"CGTTACGGTATGCGTATTTA","CCCCAAGATAAGTAATCCGT","561307.5.peg.2271","1415"
"17550",1848,960,888,"GTTGTAGGTGTTGATGGCTT","CCCCAAGATAAGTAATCCGT","561307.5.peg.2271","1415"
"17551",1198,960,238,"TCTTAAATATCCATGTGGAT","CCCCAAGATAAGTAATCCGT","561307.5.peg.2271","1415"
"17552",1341,960,381,"GATGGTTTCGACGGTGTTGT","CCCCAAGATAAGTAATCCGT","561307.5.peg.2271","1415"
"17553",576,960,384,"GCTGATGTAGTTGCAGCTTT","CCCCAAGATAAGTAATCCGT","561307.5.peg.2271","1415"
"17554",806,960,154,"CAGGACGACCTACGCCGTTA","CCCCAAGATAAGTAATCCGT","561307.5.peg.2271","1415"
"17555",657,960,303,"GGTGTTGCAGCAACTGATCT","CCCCAAGATAAGTAATCCGT","561307.5.peg.2271","1415"
"17556",540,960,420,"TATTGCGTTTCAAGAGCTGC","CCCCAAGATAAGTAATCCGT","561307.5.peg.2271","1415"
"17557",1665,960,705,"ACTTGTTTAGATGTACCCCA","CCCCAAGATAAGTAATCCGT","561307.5.peg.2271","1415"
"17558",78,960,882,"AGCGTTAATGCAACCATTGA","CCCCAAGATAAGTAATCCGT","561307.5.peg.2271","1415"
"17559",825,1001,176,"TCATGAACTACGATACCTTC","TTCAACATTGATGAATCTA","561307.5.peg.2271","1415"
"17560",1193,1001,192,"AATATCCATGTGGATCGGCA","TTCAACATTGATGAATCTA","561307.5.peg.2271","1415"
"17561",1842,1001,841,"GGTGTTGATGGCTTAGGTGT","TTCAACATTGATGAATCTA","561307.5.peg.2271","1415"
"17562",402,1001,599,"GTGCTTGTTGACTTTGCAAC","TTCAACATTGATGAATCTA","561307.5.peg.2271","1415"
"17563",1848,1001,847,"GTTGTAGGTGTTGATGGCTT","TTCAACATTGATGAATCTA","561307.5.peg.2271","1415"
"17564",1341,1001,340,"GATGGTTTCGACGGTGTTGT","TTCAACATTGATGAATCTA","561307.5.peg.2271","1415"
"17565",576,1001,425,"GCTGATGTAGTTGCAGCTTT","TTCAACATTGATGAATCTA","561307.5.peg.2271","1415"
"17566",1350,1001,349,"TTACCAGTTGATGGTTTCGA","TTCAACATTGATGAATCTA","561307.5.peg.2271","1415"
"17567",78,1001,923,"AGCGTTAATGCAACCATTGA","TTCAACATTGATGAATCTA","561307.5.peg.2271","1415"
"17568",1830,1001,829,"TTAGGTGTTGGTGTAGGCGT","TTCAACATTGATGAATCTA","561307.5.peg.2271","1415"
"17569",1665,1001,664,"ACTTGTTTAGATGTACCCCA","TTCAACATTGATGAATCTA","561307.5.peg.2271","1415"
"17570",657,1001,344,"GGTGTTGCAGCAACTGATCT","TTCAACATTGATGAATCTA","561307.5.peg.2271","1415"
"17571",1296,1001,295,"GTTGTAGATTGCGTACCCCA","TTCAACATTGATGAATCTA","561307.5.peg.2271","1415"
"17572",1198,1001,197,"TCTTAAATATCCATGTGGAT","TTCAACATTGATGAATCTA","561307.5.peg.2271","1415"
"17573",1854,1001,853,"TATTTGTTGTAGGTGTTGA","TTCAACATTGATGAATCTA","561307.5.peg.2271","1415"
"17574",806,1001,195,"CAGGACGACCTACGCCGTTA","TTCAACATTGATGAATCTA","561307.5.peg.2271","1415"
"17575",1116,1001,115,"CCATCATACTCAGCACTGTC","TTCAACATTGATGAATCTA","561307.5.peg.2271","1415"
"17576",540,1001,461,"TATTGCGTTTCAAGAGCTGC","TTCAACATTGATGAATCTA","561307.5.peg.2271","1415"
"17577",1715,1001,714,"GCTTTGAAGCCTTAAATGTT","TTCAACATTGATGAATCTA","561307.5.peg.2271","1415"
"17578",791,1001,210,"CGTTACGGTATGCGTATTTA","TTCAACATTGATGAATCTA","561307.5.peg.2271","1415"
"17579",791,1116,325,"CGTTACGGTATGCGTATTTA","CCATCATACTCAGCACTGTC","561307.5.peg.2271","1415"
"17580",1848,1116,732,"GTTGTAGGTGTTGATGGCTT","CCATCATACTCAGCACTGTC","561307.5.peg.2271","1415"
"17581",1665,1116,549,"ACTTGTTTAGATGTACCCCA","CCATCATACTCAGCACTGTC","561307.5.peg.2271","1415"
"17582",806,1116,310,"CAGGACGACCTACGCCGTTA","CCATCATACTCAGCACTGTC","561307.5.peg.2271","1415"
"17583",402,1116,714,"GTGCTTGTTGACTTTGCAAC","CCATCATACTCAGCACTGTC","561307.5.peg.2271","1415"
"17584",960,1116,156,"CCCCAAGATAAGTAATCCGT","CCATCATACTCAGCACTGTC","561307.5.peg.2271","1415"
"17585",78,1116,1038,"AGCGTTAATGCAACCATTGA","CCATCATACTCAGCACTGTC","561307.5.peg.2271","1415"
"17586",1296,1116,180,"GTTGTAGATTGCGTACCCCA","CCATCATACTCAGCACTGTC","561307.5.peg.2271","1415"
"17587",1350,1116,234,"TTACCAGTTGATGGTTTCGA","CCATCATACTCAGCACTGTC","561307.5.peg.2271","1415"
"17588",657,1116,459,"GGTGTTGCAGCAACTGATCT","CCATCATACTCAGCACTGTC","561307.5.peg.2271","1415"
"17589",1715,1116,599,"GCTTTGAAGCCTTAAATGTT","CCATCATACTCAGCACTGTC","561307.5.peg.2271","1415"
"17590",825,1116,291,"TCATGAACTACGATACCTTC","CCATCATACTCAGCACTGTC","561307.5.peg.2271","1415"
"17591",1001,1116,115,"TTCAACATTGATGAATCTA","CCATCATACTCAGCACTGTC","561307.5.peg.2271","1415"
"17592",1341,1116,225,"GATGGTTTCGACGGTGTTGT","CCATCATACTCAGCACTGTC","561307.5.peg.2271","1415"
"17593",1842,1116,726,"GGTGTTGATGGCTTAGGTGT","CCATCATACTCAGCACTGTC","561307.5.peg.2271","1415"
"17594",1830,1116,714,"TTAGGTGTTGGTGTAGGCGT","CCATCATACTCAGCACTGTC","561307.5.peg.2271","1415"
"17595",1854,1116,738,"TATTTGTTGTAGGTGTTGA","CCATCATACTCAGCACTGTC","561307.5.peg.2271","1415"
"17596",540,1116,576,"TATTGCGTTTCAAGAGCTGC","CCATCATACTCAGCACTGTC","561307.5.peg.2271","1415"
"17597",576,1116,540,"GCTGATGTAGTTGCAGCTTT","CCATCATACTCAGCACTGTC","561307.5.peg.2271","1415"
"17598",540,1193,653,"TATTGCGTTTCAAGAGCTGC","AATATCCATGTGGATCGGCA","561307.5.peg.2271","1415"
"17599",402,1193,791,"GTGCTTGTTGACTTTGCAAC","AATATCCATGTGGATCGGCA","561307.5.peg.2271","1415"
"17600",1830,1193,637,"TTAGGTGTTGGTGTAGGCGT","AATATCCATGTGGATCGGCA","561307.5.peg.2271","1415"
"17601",78,1193,1115,"AGCGTTAATGCAACCATTGA","AATATCCATGTGGATCGGCA","561307.5.peg.2271","1415"
"17602",960,1193,233,"CCCCAAGATAAGTAATCCGT","AATATCCATGTGGATCGGCA","561307.5.peg.2271","1415"
"17603",806,1193,387,"CAGGACGACCTACGCCGTTA","AATATCCATGTGGATCGGCA","561307.5.peg.2271","1415"
"17604",1001,1193,192,"TTCAACATTGATGAATCTA","AATATCCATGTGGATCGGCA","561307.5.peg.2271","1415"
"17605",657,1193,536,"GGTGTTGCAGCAACTGATCT","AATATCCATGTGGATCGGCA","561307.5.peg.2271","1415"
"17606",576,1193,617,"GCTGATGTAGTTGCAGCTTT","AATATCCATGTGGATCGGCA","561307.5.peg.2271","1415"
"17607",1842,1193,649,"GGTGTTGATGGCTTAGGTGT","AATATCCATGTGGATCGGCA","561307.5.peg.2271","1415"
"17608",1848,1193,655,"GTTGTAGGTGTTGATGGCTT","AATATCCATGTGGATCGGCA","561307.5.peg.2271","1415"
"17609",791,1193,402,"CGTTACGGTATGCGTATTTA","AATATCCATGTGGATCGGCA","561307.5.peg.2271","1415"
"17610",1350,1193,157,"TTACCAGTTGATGGTTTCGA","AATATCCATGTGGATCGGCA","561307.5.peg.2271","1415"
"17611",1854,1193,661,"TATTTGTTGTAGGTGTTGA","AATATCCATGTGGATCGGCA","561307.5.peg.2271","1415"
"17612",1341,1193,148,"GATGGTTTCGACGGTGTTGT","AATATCCATGTGGATCGGCA","561307.5.peg.2271","1415"
"17613",1665,1193,472,"ACTTGTTTAGATGTACCCCA","AATATCCATGTGGATCGGCA","561307.5.peg.2271","1415"
"17614",1715,1193,522,"GCTTTGAAGCCTTAAATGTT","AATATCCATGTGGATCGGCA","561307.5.peg.2271","1415"
"17615",825,1193,368,"TCATGAACTACGATACCTTC","AATATCCATGTGGATCGGCA","561307.5.peg.2271","1415"
"17616",1296,1193,103,"GTTGTAGATTGCGTACCCCA","AATATCCATGTGGATCGGCA","561307.5.peg.2271","1415"
"17617",806,1198,392,"CAGGACGACCTACGCCGTTA","TCTTAAATATCCATGTGGAT","561307.5.peg.2271","1415"
"17618",825,1198,373,"TCATGAACTACGATACCTTC","TCTTAAATATCCATGTGGAT","561307.5.peg.2271","1415"
"17619",540,1198,658,"TATTGCGTTTCAAGAGCTGC","TCTTAAATATCCATGTGGAT","561307.5.peg.2271","1415"
"17620",402,1198,796,"GTGCTTGTTGACTTTGCAAC","TCTTAAATATCCATGTGGAT","561307.5.peg.2271","1415"
"17621",657,1198,541,"GGTGTTGCAGCAACTGATCT","TCTTAAATATCCATGTGGAT","561307.5.peg.2271","1415"
"17622",1830,1198,632,"TTAGGTGTTGGTGTAGGCGT","TCTTAAATATCCATGTGGAT","561307.5.peg.2271","1415"
"17623",1665,1198,467,"ACTTGTTTAGATGTACCCCA","TCTTAAATATCCATGTGGAT","561307.5.peg.2271","1415"
"17624",1001,1198,197,"TTCAACATTGATGAATCTA","TCTTAAATATCCATGTGGAT","561307.5.peg.2271","1415"
"17625",1842,1198,644,"GGTGTTGATGGCTTAGGTGT","TCTTAAATATCCATGTGGAT","561307.5.peg.2271","1415"
"17626",1350,1198,152,"TTACCAGTTGATGGTTTCGA","TCTTAAATATCCATGTGGAT","561307.5.peg.2271","1415"
"17627",1715,1198,517,"GCTTTGAAGCCTTAAATGTT","TCTTAAATATCCATGTGGAT","561307.5.peg.2271","1415"
"17628",1848,1198,650,"GTTGTAGGTGTTGATGGCTT","TCTTAAATATCCATGTGGAT","561307.5.peg.2271","1415"
"17629",576,1198,622,"GCTGATGTAGTTGCAGCTTT","TCTTAAATATCCATGTGGAT","561307.5.peg.2271","1415"
"17630",1341,1198,143,"GATGGTTTCGACGGTGTTGT","TCTTAAATATCCATGTGGAT","561307.5.peg.2271","1415"
"17631",791,1198,407,"CGTTACGGTATGCGTATTTA","TCTTAAATATCCATGTGGAT","561307.5.peg.2271","1415"
"17632",78,1198,1120,"AGCGTTAATGCAACCATTGA","TCTTAAATATCCATGTGGAT","561307.5.peg.2271","1415"
"17633",1854,1198,656,"TATTTGTTGTAGGTGTTGA","TCTTAAATATCCATGTGGAT","561307.5.peg.2271","1415"
"17634",960,1198,238,"CCCCAAGATAAGTAATCCGT","TCTTAAATATCCATGTGGAT","561307.5.peg.2271","1415"
"17635",1665,1296,369,"ACTTGTTTAGATGTACCCCA","GTTGTAGATTGCGTACCCCA","561307.5.peg.2271","1415"
"17636",402,1296,894,"GTGCTTGTTGACTTTGCAAC","GTTGTAGATTGCGTACCCCA","561307.5.peg.2271","1415"
"17637",960,1296,336,"CCCCAAGATAAGTAATCCGT","GTTGTAGATTGCGTACCCCA","561307.5.peg.2271","1415"
"17638",1116,1296,180,"CCATCATACTCAGCACTGTC","GTTGTAGATTGCGTACCCCA","561307.5.peg.2271","1415"
"17639",825,1296,471,"TCATGAACTACGATACCTTC","GTTGTAGATTGCGTACCCCA","561307.5.peg.2271","1415"
"17640",1001,1296,295,"TTCAACATTGATGAATCTA","GTTGTAGATTGCGTACCCCA","561307.5.peg.2271","1415"
"17641",657,1296,639,"GGTGTTGCAGCAACTGATCT","GTTGTAGATTGCGTACCCCA","561307.5.peg.2271","1415"
"17642",806,1296,490,"CAGGACGACCTACGCCGTTA","GTTGTAGATTGCGTACCCCA","561307.5.peg.2271","1415"
"17643",1854,1296,558,"TATTTGTTGTAGGTGTTGA","GTTGTAGATTGCGTACCCCA","561307.5.peg.2271","1415"
"17644",1848,1296,552,"GTTGTAGGTGTTGATGGCTT","GTTGTAGATTGCGTACCCCA","561307.5.peg.2271","1415"
"17645",1193,1296,103,"AATATCCATGTGGATCGGCA","GTTGTAGATTGCGTACCCCA","561307.5.peg.2271","1415"
"17646",791,1296,505,"CGTTACGGTATGCGTATTTA","GTTGTAGATTGCGTACCCCA","561307.5.peg.2271","1415"
"17647",540,1296,756,"TATTGCGTTTCAAGAGCTGC","GTTGTAGATTGCGTACCCCA","561307.5.peg.2271","1415"
"17648",1715,1296,419,"GCTTTGAAGCCTTAAATGTT","GTTGTAGATTGCGTACCCCA","561307.5.peg.2271","1415"
"17649",1842,1296,546,"GGTGTTGATGGCTTAGGTGT","GTTGTAGATTGCGTACCCCA","561307.5.peg.2271","1415"
"17650",576,1296,720,"GCTGATGTAGTTGCAGCTTT","GTTGTAGATTGCGTACCCCA","561307.5.peg.2271","1415"
"17651",1830,1296,534,"TTAGGTGTTGGTGTAGGCGT","GTTGTAGATTGCGTACCCCA","561307.5.peg.2271","1415"
"17652",78,1296,1218,"AGCGTTAATGCAACCATTGA","GTTGTAGATTGCGTACCCCA","561307.5.peg.2271","1415"
"17653",825,1341,516,"TCATGAACTACGATACCTTC","GATGGTTTCGACGGTGTTGT","561307.5.peg.2271","1415"
"17654",1854,1341,513,"TATTTGTTGTAGGTGTTGA","GATGGTTTCGACGGTGTTGT","561307.5.peg.2271","1415"
"17655",1842,1341,501,"GGTGTTGATGGCTTAGGTGT","GATGGTTTCGACGGTGTTGT","561307.5.peg.2271","1415"
"17656",1116,1341,225,"CCATCATACTCAGCACTGTC","GATGGTTTCGACGGTGTTGT","561307.5.peg.2271","1415"
"17657",402,1341,939,"GTGCTTGTTGACTTTGCAAC","GATGGTTTCGACGGTGTTGT","561307.5.peg.2271","1415"
"17658",78,1341,1263,"AGCGTTAATGCAACCATTGA","GATGGTTTCGACGGTGTTGT","561307.5.peg.2271","1415"
"17659",576,1341,765,"GCTGATGTAGTTGCAGCTTT","GATGGTTTCGACGGTGTTGT","561307.5.peg.2271","1415"
"17660",1001,1341,340,"TTCAACATTGATGAATCTA","GATGGTTTCGACGGTGTTGT","561307.5.peg.2271","1415"
"17661",540,1341,801,"TATTGCGTTTCAAGAGCTGC","GATGGTTTCGACGGTGTTGT","561307.5.peg.2271","1415"
"17662",791,1341,550,"CGTTACGGTATGCGTATTTA","GATGGTTTCGACGGTGTTGT","561307.5.peg.2271","1415"
"17663",1665,1341,324,"ACTTGTTTAGATGTACCCCA","GATGGTTTCGACGGTGTTGT","561307.5.peg.2271","1415"
"17664",1715,1341,374,"GCTTTGAAGCCTTAAATGTT","GATGGTTTCGACGGTGTTGT","561307.5.peg.2271","1415"
"17665",1198,1341,143,"TCTTAAATATCCATGTGGAT","GATGGTTTCGACGGTGTTGT","561307.5.peg.2271","1415"
"17666",1848,1341,507,"GTTGTAGGTGTTGATGGCTT","GATGGTTTCGACGGTGTTGT","561307.5.peg.2271","1415"
"17667",1830,1341,489,"TTAGGTGTTGGTGTAGGCGT","GATGGTTTCGACGGTGTTGT","561307.5.peg.2271","1415"
"17668",806,1341,535,"CAGGACGACCTACGCCGTTA","GATGGTTTCGACGGTGTTGT","561307.5.peg.2271","1415"
"17669",1193,1341,148,"AATATCCATGTGGATCGGCA","GATGGTTTCGACGGTGTTGT","561307.5.peg.2271","1415"
"17670",960,1341,381,"CCCCAAGATAAGTAATCCGT","GATGGTTTCGACGGTGTTGT","561307.5.peg.2271","1415"
"17671",657,1341,684,"GGTGTTGCAGCAACTGATCT","GATGGTTTCGACGGTGTTGT","561307.5.peg.2271","1415"
"17672",825,1350,525,"TCATGAACTACGATACCTTC","TTACCAGTTGATGGTTTCGA","561307.5.peg.2271","1415"
"17673",1193,1350,157,"AATATCCATGTGGATCGGCA","TTACCAGTTGATGGTTTCGA","561307.5.peg.2271","1415"
"17674",1001,1350,349,"TTCAACATTGATGAATCTA","TTACCAGTTGATGGTTTCGA","561307.5.peg.2271","1415"
"17675",402,1350,948,"GTGCTTGTTGACTTTGCAAC","TTACCAGTTGATGGTTTCGA","561307.5.peg.2271","1415"
"17676",791,1350,559,"CGTTACGGTATGCGTATTTA","TTACCAGTTGATGGTTTCGA","561307.5.peg.2271","1415"
"17677",1848,1350,498,"GTTGTAGGTGTTGATGGCTT","TTACCAGTTGATGGTTTCGA","561307.5.peg.2271","1415"
"17678",806,1350,544,"CAGGACGACCTACGCCGTTA","TTACCAGTTGATGGTTTCGA","561307.5.peg.2271","1415"
"17679",540,1350,810,"TATTGCGTTTCAAGAGCTGC","TTACCAGTTGATGGTTTCGA","561307.5.peg.2271","1415"
"17680",1715,1350,365,"GCTTTGAAGCCTTAAATGTT","TTACCAGTTGATGGTTTCGA","561307.5.peg.2271","1415"
"17681",1116,1350,234,"CCATCATACTCAGCACTGTC","TTACCAGTTGATGGTTTCGA","561307.5.peg.2271","1415"
"17682",657,1350,693,"GGTGTTGCAGCAACTGATCT","TTACCAGTTGATGGTTTCGA","561307.5.peg.2271","1415"
"17683",1665,1350,315,"ACTTGTTTAGATGTACCCCA","TTACCAGTTGATGGTTTCGA","561307.5.peg.2271","1415"
"17684",1854,1350,504,"TATTTGTTGTAGGTGTTGA","TTACCAGTTGATGGTTTCGA","561307.5.peg.2271","1415"
"17685",576,1350,774,"GCTGATGTAGTTGCAGCTTT","TTACCAGTTGATGGTTTCGA","561307.5.peg.2271","1415"
"17686",1842,1350,492,"GGTGTTGATGGCTTAGGTGT","TTACCAGTTGATGGTTTCGA","561307.5.peg.2271","1415"
"17687",78,1350,1272,"AGCGTTAATGCAACCATTGA","TTACCAGTTGATGGTTTCGA","561307.5.peg.2271","1415"
"17688",1830,1350,480,"TTAGGTGTTGGTGTAGGCGT","TTACCAGTTGATGGTTTCGA","561307.5.peg.2271","1415"
"17689",1198,1350,152,"TCTTAAATATCCATGTGGAT","TTACCAGTTGATGGTTTCGA","561307.5.peg.2271","1415"
"17690",960,1350,390,"CCCCAAGATAAGTAATCCGT","TTACCAGTTGATGGTTTCGA","561307.5.peg.2271","1415"
"17691",78,1665,1587,"AGCGTTAATGCAACCATTGA","ACTTGTTTAGATGTACCCCA","561307.5.peg.2271","1415"
"17692",806,1665,859,"CAGGACGACCTACGCCGTTA","ACTTGTTTAGATGTACCCCA","561307.5.peg.2271","1415"
"17693",1296,1665,369,"GTTGTAGATTGCGTACCCCA","ACTTGTTTAGATGTACCCCA","561307.5.peg.2271","1415"
"17694",1830,1665,165,"TTAGGTGTTGGTGTAGGCGT","ACTTGTTTAGATGTACCCCA","561307.5.peg.2271","1415"
"17695",1341,1665,324,"GATGGTTTCGACGGTGTTGT","ACTTGTTTAGATGTACCCCA","561307.5.peg.2271","1415"
"17696",540,1665,1125,"TATTGCGTTTCAAGAGCTGC","ACTTGTTTAGATGTACCCCA","561307.5.peg.2271","1415"
"17697",657,1665,1008,"GGTGTTGCAGCAACTGATCT","ACTTGTTTAGATGTACCCCA","561307.5.peg.2271","1415"
"17698",402,1665,1263,"GTGCTTGTTGACTTTGCAAC","ACTTGTTTAGATGTACCCCA","561307.5.peg.2271","1415"
"17699",825,1665,840,"TCATGAACTACGATACCTTC","ACTTGTTTAGATGTACCCCA","561307.5.peg.2271","1415"
"17700",1854,1665,189,"TATTTGTTGTAGGTGTTGA","ACTTGTTTAGATGTACCCCA","561307.5.peg.2271","1415"
"17701",791,1665,874,"CGTTACGGTATGCGTATTTA","ACTTGTTTAGATGTACCCCA","561307.5.peg.2271","1415"
"17702",1116,1665,549,"CCATCATACTCAGCACTGTC","ACTTGTTTAGATGTACCCCA","561307.5.peg.2271","1415"
"17703",1193,1665,472,"AATATCCATGTGGATCGGCA","ACTTGTTTAGATGTACCCCA","561307.5.peg.2271","1415"
"17704",1842,1665,177,"GGTGTTGATGGCTTAGGTGT","ACTTGTTTAGATGTACCCCA","561307.5.peg.2271","1415"
"17705",576,1665,1089,"GCTGATGTAGTTGCAGCTTT","ACTTGTTTAGATGTACCCCA","561307.5.peg.2271","1415"
"17706",1198,1665,467,"TCTTAAATATCCATGTGGAT","ACTTGTTTAGATGTACCCCA","561307.5.peg.2271","1415"
"17707",1001,1665,664,"TTCAACATTGATGAATCTA","ACTTGTTTAGATGTACCCCA","561307.5.peg.2271","1415"
"17708",1350,1665,315,"TTACCAGTTGATGGTTTCGA","ACTTGTTTAGATGTACCCCA","561307.5.peg.2271","1415"
"17709",960,1665,705,"CCCCAAGATAAGTAATCCGT","ACTTGTTTAGATGTACCCCA","561307.5.peg.2271","1415"
"17710",1848,1665,183,"GTTGTAGGTGTTGATGGCTT","ACTTGTTTAGATGTACCCCA","561307.5.peg.2271","1415"
"17711",1854,1715,139,"TATTTGTTGTAGGTGTTGA","GCTTTGAAGCCTTAAATGTT","561307.5.peg.2271","1415"
"17712",825,1715,890,"TCATGAACTACGATACCTTC","GCTTTGAAGCCTTAAATGTT","561307.5.peg.2271","1415"
"17713",78,1715,1637,"AGCGTTAATGCAACCATTGA","GCTTTGAAGCCTTAAATGTT","561307.5.peg.2271","1415"
"17714",1116,1715,599,"CCATCATACTCAGCACTGTC","GCTTTGAAGCCTTAAATGTT","561307.5.peg.2271","1415"
"17715",1001,1715,714,"TTCAACATTGATGAATCTA","GCTTTGAAGCCTTAAATGTT","561307.5.peg.2271","1415"
"17716",1296,1715,419,"GTTGTAGATTGCGTACCCCA","GCTTTGAAGCCTTAAATGTT","561307.5.peg.2271","1415"
"17717",402,1715,1313,"GTGCTTGTTGACTTTGCAAC","GCTTTGAAGCCTTAAATGTT","561307.5.peg.2271","1415"
"17718",1830,1715,115,"TTAGGTGTTGGTGTAGGCGT","GCTTTGAAGCCTTAAATGTT","561307.5.peg.2271","1415"
"17719",1848,1715,133,"GTTGTAGGTGTTGATGGCTT","GCTTTGAAGCCTTAAATGTT","561307.5.peg.2271","1415"
"17720",576,1715,1139,"GCTGATGTAGTTGCAGCTTT","GCTTTGAAGCCTTAAATGTT","561307.5.peg.2271","1415"
"17721",657,1715,1058,"GGTGTTGCAGCAACTGATCT","GCTTTGAAGCCTTAAATGTT","561307.5.peg.2271","1415"
"17722",806,1715,909,"CAGGACGACCTACGCCGTTA","GCTTTGAAGCCTTAAATGTT","561307.5.peg.2271","1415"
"17723",1350,1715,365,"TTACCAGTTGATGGTTTCGA","GCTTTGAAGCCTTAAATGTT","561307.5.peg.2271","1415"
"17724",1842,1715,127,"GGTGTTGATGGCTTAGGTGT","GCTTTGAAGCCTTAAATGTT","561307.5.peg.2271","1415"
"17725",540,1715,1175,"TATTGCGTTTCAAGAGCTGC","GCTTTGAAGCCTTAAATGTT","561307.5.peg.2271","1415"
"17726",960,1715,755,"CCCCAAGATAAGTAATCCGT","GCTTTGAAGCCTTAAATGTT","561307.5.peg.2271","1415"
"17727",1198,1715,517,"TCTTAAATATCCATGTGGAT","GCTTTGAAGCCTTAAATGTT","561307.5.peg.2271","1415"
"17728",1193,1715,522,"AATATCCATGTGGATCGGCA","GCTTTGAAGCCTTAAATGTT","561307.5.peg.2271","1415"
"17729",791,1715,924,"CGTTACGGTATGCGTATTTA","GCTTTGAAGCCTTAAATGTT","561307.5.peg.2271","1415"
"17730",1341,1715,374,"GATGGTTTCGACGGTGTTGT","GCTTTGAAGCCTTAAATGTT","561307.5.peg.2271","1415"
"17731",1001,1830,829,"TTCAACATTGATGAATCTA","TTAGGTGTTGGTGTAGGCGT","561307.5.peg.2271","1415"
"17732",402,1830,1428,"GTGCTTGTTGACTTTGCAAC","TTAGGTGTTGGTGTAGGCGT","561307.5.peg.2271","1415"
"17733",576,1830,1254,"GCTGATGTAGTTGCAGCTTT","TTAGGTGTTGGTGTAGGCGT","561307.5.peg.2271","1415"
"17734",806,1830,1024,"CAGGACGACCTACGCCGTTA","TTAGGTGTTGGTGTAGGCGT","561307.5.peg.2271","1415"
"17735",1296,1830,534,"GTTGTAGATTGCGTACCCCA","TTAGGTGTTGGTGTAGGCGT","561307.5.peg.2271","1415"
"17736",1715,1830,115,"GCTTTGAAGCCTTAAATGTT","TTAGGTGTTGGTGTAGGCGT","561307.5.peg.2271","1415"
"17737",960,1830,870,"CCCCAAGATAAGTAATCCGT","TTAGGTGTTGGTGTAGGCGT","561307.5.peg.2271","1415"
"17738",540,1830,1290,"TATTGCGTTTCAAGAGCTGC","TTAGGTGTTGGTGTAGGCGT","561307.5.peg.2271","1415"
"17739",1193,1830,637,"AATATCCATGTGGATCGGCA","TTAGGTGTTGGTGTAGGCGT","561307.5.peg.2271","1415"
"17740",825,1830,1005,"TCATGAACTACGATACCTTC","TTAGGTGTTGGTGTAGGCGT","561307.5.peg.2271","1415"
"17741",791,1830,1039,"CGTTACGGTATGCGTATTTA","TTAGGTGTTGGTGTAGGCGT","561307.5.peg.2271","1415"
"17742",657,1830,1173,"GGTGTTGCAGCAACTGATCT","TTAGGTGTTGGTGTAGGCGT","561307.5.peg.2271","1415"
"17743",1116,1830,714,"CCATCATACTCAGCACTGTC","TTAGGTGTTGGTGTAGGCGT","561307.5.peg.2271","1415"
"17744",1341,1830,489,"GATGGTTTCGACGGTGTTGT","TTAGGTGTTGGTGTAGGCGT","561307.5.peg.2271","1415"
"17745",1198,1830,632,"TCTTAAATATCCATGTGGAT","TTAGGTGTTGGTGTAGGCGT","561307.5.peg.2271","1415"
"17746",78,1830,1752,"AGCGTTAATGCAACCATTGA","TTAGGTGTTGGTGTAGGCGT","561307.5.peg.2271","1415"
"17747",1350,1830,480,"TTACCAGTTGATGGTTTCGA","TTAGGTGTTGGTGTAGGCGT","561307.5.peg.2271","1415"
"17748",1665,1830,165,"ACTTGTTTAGATGTACCCCA","TTAGGTGTTGGTGTAGGCGT","561307.5.peg.2271","1415"
"17749",960,1842,882,"CCCCAAGATAAGTAATCCGT","GGTGTTGATGGCTTAGGTGT","561307.5.peg.2271","1415"
"17750",1001,1842,841,"TTCAACATTGATGAATCTA","GGTGTTGATGGCTTAGGTGT","561307.5.peg.2271","1415"
"17751",806,1842,1036,"CAGGACGACCTACGCCGTTA","GGTGTTGATGGCTTAGGTGT","561307.5.peg.2271","1415"
"17752",1665,1842,177,"ACTTGTTTAGATGTACCCCA","GGTGTTGATGGCTTAGGTGT","561307.5.peg.2271","1415"
"17753",825,1842,1017,"TCATGAACTACGATACCTTC","GGTGTTGATGGCTTAGGTGT","561307.5.peg.2271","1415"
"17754",1193,1842,649,"AATATCCATGTGGATCGGCA","GGTGTTGATGGCTTAGGTGT","561307.5.peg.2271","1415"
"17755",540,1842,1302,"TATTGCGTTTCAAGAGCTGC","GGTGTTGATGGCTTAGGTGT","561307.5.peg.2271","1415"
"17756",1715,1842,127,"GCTTTGAAGCCTTAAATGTT","GGTGTTGATGGCTTAGGTGT","561307.5.peg.2271","1415"
"17757",576,1842,1266,"GCTGATGTAGTTGCAGCTTT","GGTGTTGATGGCTTAGGTGT","561307.5.peg.2271","1415"
"17758",402,1842,1440,"GTGCTTGTTGACTTTGCAAC","GGTGTTGATGGCTTAGGTGT","561307.5.peg.2271","1415"
"17759",78,1842,1764,"AGCGTTAATGCAACCATTGA","GGTGTTGATGGCTTAGGTGT","561307.5.peg.2271","1415"
"17760",1116,1842,726,"CCATCATACTCAGCACTGTC","GGTGTTGATGGCTTAGGTGT","561307.5.peg.2271","1415"
"17761",1296,1842,546,"GTTGTAGATTGCGTACCCCA","GGTGTTGATGGCTTAGGTGT","561307.5.peg.2271","1415"
"17762",1350,1842,492,"TTACCAGTTGATGGTTTCGA","GGTGTTGATGGCTTAGGTGT","561307.5.peg.2271","1415"
"17763",1198,1842,644,"TCTTAAATATCCATGTGGAT","GGTGTTGATGGCTTAGGTGT","561307.5.peg.2271","1415"
"17764",657,1842,1185,"GGTGTTGCAGCAACTGATCT","GGTGTTGATGGCTTAGGTGT","561307.5.peg.2271","1415"
"17765",791,1842,1051,"CGTTACGGTATGCGTATTTA","GGTGTTGATGGCTTAGGTGT","561307.5.peg.2271","1415"
"17766",1341,1842,501,"GATGGTTTCGACGGTGTTGT","GGTGTTGATGGCTTAGGTGT","561307.5.peg.2271","1415"
"17767",825,1848,1023,"TCATGAACTACGATACCTTC","GTTGTAGGTGTTGATGGCTT","561307.5.peg.2271","1415"
"17768",657,1848,1191,"GGTGTTGCAGCAACTGATCT","GTTGTAGGTGTTGATGGCTT","561307.5.peg.2271","1415"
"17769",1665,1848,183,"ACTTGTTTAGATGTACCCCA","GTTGTAGGTGTTGATGGCTT","561307.5.peg.2271","1415"
"17770",960,1848,888,"CCCCAAGATAAGTAATCCGT","GTTGTAGGTGTTGATGGCTT","561307.5.peg.2271","1415"
"17771",1350,1848,498,"TTACCAGTTGATGGTTTCGA","GTTGTAGGTGTTGATGGCTT","561307.5.peg.2271","1415"
"17772",402,1848,1446,"GTGCTTGTTGACTTTGCAAC","GTTGTAGGTGTTGATGGCTT","561307.5.peg.2271","1415"
"17773",1715,1848,133,"GCTTTGAAGCCTTAAATGTT","GTTGTAGGTGTTGATGGCTT","561307.5.peg.2271","1415"
"17774",1341,1848,507,"GATGGTTTCGACGGTGTTGT","GTTGTAGGTGTTGATGGCTT","561307.5.peg.2271","1415"
"17775",791,1848,1057,"CGTTACGGTATGCGTATTTA","GTTGTAGGTGTTGATGGCTT","561307.5.peg.2271","1415"
"17776",540,1848,1308,"TATTGCGTTTCAAGAGCTGC","GTTGTAGGTGTTGATGGCTT","561307.5.peg.2271","1415"
"17777",1193,1848,655,"AATATCCATGTGGATCGGCA","GTTGTAGGTGTTGATGGCTT","561307.5.peg.2271","1415"
"17778",1001,1848,847,"TTCAACATTGATGAATCTA","GTTGTAGGTGTTGATGGCTT","561307.5.peg.2271","1415"
"17779",806,1848,1042,"CAGGACGACCTACGCCGTTA","GTTGTAGGTGTTGATGGCTT","561307.5.peg.2271","1415"
"17780",1296,1848,552,"GTTGTAGATTGCGTACCCCA","GTTGTAGGTGTTGATGGCTT","561307.5.peg.2271","1415"
"17781",78,1848,1770,"AGCGTTAATGCAACCATTGA","GTTGTAGGTGTTGATGGCTT","561307.5.peg.2271","1415"
"17782",576,1848,1272,"GCTGATGTAGTTGCAGCTTT","GTTGTAGGTGTTGATGGCTT","561307.5.peg.2271","1415"
"17783",1116,1848,732,"CCATCATACTCAGCACTGTC","GTTGTAGGTGTTGATGGCTT","561307.5.peg.2271","1415"
"17784",1198,1848,650,"TCTTAAATATCCATGTGGAT","GTTGTAGGTGTTGATGGCTT","561307.5.peg.2271","1415"
"17785",540,1854,1314,"TATTGCGTTTCAAGAGCTGC","TATTTGTTGTAGGTGTTGA","561307.5.peg.2271","1415"
"17786",1193,1854,661,"AATATCCATGTGGATCGGCA","TATTTGTTGTAGGTGTTGA","561307.5.peg.2271","1415"
"17787",960,1854,894,"CCCCAAGATAAGTAATCCGT","TATTTGTTGTAGGTGTTGA","561307.5.peg.2271","1415"
"17788",576,1854,1278,"GCTGATGTAGTTGCAGCTTT","TATTTGTTGTAGGTGTTGA","561307.5.peg.2271","1415"
"17789",1296,1854,558,"GTTGTAGATTGCGTACCCCA","TATTTGTTGTAGGTGTTGA","561307.5.peg.2271","1415"
"17790",402,1854,1452,"GTGCTTGTTGACTTTGCAAC","TATTTGTTGTAGGTGTTGA","561307.5.peg.2271","1415"
"17791",1001,1854,853,"TTCAACATTGATGAATCTA","TATTTGTTGTAGGTGTTGA","561307.5.peg.2271","1415"
"17792",1198,1854,656,"TCTTAAATATCCATGTGGAT","TATTTGTTGTAGGTGTTGA","561307.5.peg.2271","1415"
"17793",791,1854,1063,"CGTTACGGTATGCGTATTTA","TATTTGTTGTAGGTGTTGA","561307.5.peg.2271","1415"
"17794",1665,1854,189,"ACTTGTTTAGATGTACCCCA","TATTTGTTGTAGGTGTTGA","561307.5.peg.2271","1415"
"17795",825,1854,1029,"TCATGAACTACGATACCTTC","TATTTGTTGTAGGTGTTGA","561307.5.peg.2271","1415"
"17796",1341,1854,513,"GATGGTTTCGACGGTGTTGT","TATTTGTTGTAGGTGTTGA","561307.5.peg.2271","1415"
"17797",1116,1854,738,"CCATCATACTCAGCACTGTC","TATTTGTTGTAGGTGTTGA","561307.5.peg.2271","1415"
"17798",1715,1854,139,"GCTTTGAAGCCTTAAATGTT","TATTTGTTGTAGGTGTTGA","561307.5.peg.2271","1415"
"17799",806,1854,1048,"CAGGACGACCTACGCCGTTA","TATTTGTTGTAGGTGTTGA","561307.5.peg.2271","1415"
"17800",657,1854,1197,"GGTGTTGCAGCAACTGATCT","TATTTGTTGTAGGTGTTGA","561307.5.peg.2271","1415"
"17801",1350,1854,504,"TTACCAGTTGATGGTTTCGA","TATTTGTTGTAGGTGTTGA","561307.5.peg.2271","1415"
"17802",78,1854,1776,"AGCGTTAATGCAACCATTGA","TATTTGTTGTAGGTGTTGA","561307.5.peg.2271","1415"
"17803",198,10,188,"TCAAAGTATATTCAATCGC","CTTTAATGTTGATGACTGGG","561307.5.peg.2273","1417"
"17804",265,10,255,"CGAAGCATTAATACTACCAC","CTTTAATGTTGATGACTGGG","561307.5.peg.2273","1417"
"17805",364,10,354,"AAGATAACCGCGTGCACCTT","CTTTAATGTTGATGACTGGG","561307.5.peg.2273","1417"
"17806",442,10,432,"GAATCCTCCTATACTGCTTC","CTTTAATGTTGATGACTGGG","561307.5.peg.2273","1417"
"17807",411,10,401,"GCATAACTTTCAGCAATAGA","CTTTAATGTTGATGACTGGG","561307.5.peg.2273","1417"
"17808",10,198,188,"CTTTAATGTTGATGACTGGG","TCAAAGTATATTCAATCGC","561307.5.peg.2273","1417"
"17809",364,198,166,"AAGATAACCGCGTGCACCTT","TCAAAGTATATTCAATCGC","561307.5.peg.2273","1417"
"17810",442,198,244,"GAATCCTCCTATACTGCTTC","TCAAAGTATATTCAATCGC","561307.5.peg.2273","1417"
"17811",411,198,213,"GCATAACTTTCAGCAATAGA","TCAAAGTATATTCAATCGC","561307.5.peg.2273","1417"
"17812",411,265,146,"GCATAACTTTCAGCAATAGA","CGAAGCATTAATACTACCAC","561307.5.peg.2273","1417"
"17813",10,265,255,"CTTTAATGTTGATGACTGGG","CGAAGCATTAATACTACCAC","561307.5.peg.2273","1417"
"17814",442,265,177,"GAATCCTCCTATACTGCTTC","CGAAGCATTAATACTACCAC","561307.5.peg.2273","1417"
"17815",10,364,354,"CTTTAATGTTGATGACTGGG","AAGATAACCGCGTGCACCTT","561307.5.peg.2273","1417"
"17816",198,364,166,"TCAAAGTATATTCAATCGC","AAGATAACCGCGTGCACCTT","561307.5.peg.2273","1417"
"17817",10,411,401,"CTTTAATGTTGATGACTGGG","GCATAACTTTCAGCAATAGA","561307.5.peg.2273","1417"
"17818",265,411,146,"CGAAGCATTAATACTACCAC","GCATAACTTTCAGCAATAGA","561307.5.peg.2273","1417"
"17819",198,411,213,"TCAAAGTATATTCAATCGC","GCATAACTTTCAGCAATAGA","561307.5.peg.2273","1417"
"17820",10,442,432,"CTTTAATGTTGATGACTGGG","GAATCCTCCTATACTGCTTC","561307.5.peg.2273","1417"
"17821",198,442,244,"TCAAAGTATATTCAATCGC","GAATCCTCCTATACTGCTTC","561307.5.peg.2273","1417"
"17822",265,442,177,"CGAAGCATTAATACTACCAC","GAATCCTCCTATACTGCTTC","561307.5.peg.2273","1417"
"17823",327,8,319,"TATGTACCACCATATTGAAC","GGTTTATTGCAATACAAAGG","561307.5.peg.2274","1418"
"17824",188,8,180,"TTAGAACTGCTCGATACGAA","GGTTTATTGCAATACAAAGG","561307.5.peg.2274","1418"
"17825",109,8,101,"GACATTACGATATGTCTCTT","GGTTTATTGCAATACAAAGG","561307.5.peg.2274","1418"
"17826",188,10,178,"TTAGAACTGCTCGATACGAA","CTGGTTTATTGCAATACAAA","561307.5.peg.2274","1418"
"17827",327,10,317,"TATGTACCACCATATTGAAC","CTGGTTTATTGCAATACAAA","561307.5.peg.2274","1418"
"17828",8,109,101,"GGTTTATTGCAATACAAAGG","GACATTACGATATGTCTCTT","561307.5.peg.2274","1418"
"17829",327,109,218,"TATGTACCACCATATTGAAC","GACATTACGATATGTCTCTT","561307.5.peg.2274","1418"
"17830",8,188,180,"GGTTTATTGCAATACAAAGG","TTAGAACTGCTCGATACGAA","561307.5.peg.2274","1418"
"17831",327,188,139,"TATGTACCACCATATTGAAC","TTAGAACTGCTCGATACGAA","561307.5.peg.2274","1418"
"17832",10,188,178,"CTGGTTTATTGCAATACAAA","TTAGAACTGCTCGATACGAA","561307.5.peg.2274","1418"
"17833",109,327,218,"GACATTACGATATGTCTCTT","TATGTACCACCATATTGAAC","561307.5.peg.2274","1418"
"17834",10,327,317,"CTGGTTTATTGCAATACAAA","TATGTACCACCATATTGAAC","561307.5.peg.2274","1418"
"17835",8,327,319,"GGTTTATTGCAATACAAAGG","TATGTACCACCATATTGAAC","561307.5.peg.2274","1418"
"17836",188,327,139,"TTAGAACTGCTCGATACGAA","TATGTACCACCATATTGAAC","561307.5.peg.2274","1418"
"17837",209,4,205,"GATGGTCATAATTGGTTTCT","ACATGATGAGAAAGGAAAT","561307.5.peg.2276","1420"
"17838",303,4,299,"TGACTAGCATAATCATATGT","ACATGATGAGAAAGGAAAT","561307.5.peg.2276","1420"
"17839",227,4,223,"CATTATCGAATGCAAATGGA","ACATGATGAGAAAGGAAAT","561307.5.peg.2276","1420"
"17840",217,4,213,"TGCAAATGGATGGTCATAAT","ACATGATGAGAAAGGAAAT","561307.5.peg.2276","1420"
"17841",217,9,208,"TGCAAATGGATGGTCATAAT","TCATGTTGTTTGGATATATC","561307.5.peg.2276","1420"
"17842",209,9,200,"GATGGTCATAATTGGTTTCT","TCATGTTGTTTGGATATATC","561307.5.peg.2276","1420"
"17843",303,9,294,"TGACTAGCATAATCATATGT","TCATGTTGTTTGGATATATC","561307.5.peg.2276","1420"
"17844",227,9,218,"CATTATCGAATGCAAATGGA","TCATGTTGTTTGGATATATC","561307.5.peg.2276","1420"
"17845",227,11,216,"CATTATCGAATGCAAATGGA","TCCAAACAACATGATGAGAA","561307.5.peg.2276","1420"
"17846",217,11,206,"TGCAAATGGATGGTCATAAT","TCCAAACAACATGATGAGAA","561307.5.peg.2276","1420"
"17847",209,11,198,"GATGGTCATAATTGGTTTCT","TCCAAACAACATGATGAGAA","561307.5.peg.2276","1420"
"17848",303,11,292,"TGACTAGCATAATCATATGT","TCCAAACAACATGATGAGAA","561307.5.peg.2276","1420"
"17849",4,209,205,"ACATGATGAGAAAGGAAAT","GATGGTCATAATTGGTTTCT","561307.5.peg.2276","1420"
"17850",9,209,200,"TCATGTTGTTTGGATATATC","GATGGTCATAATTGGTTTCT","561307.5.peg.2276","1420"
"17851",11,209,198,"TCCAAACAACATGATGAGAA","GATGGTCATAATTGGTTTCT","561307.5.peg.2276","1420"
"17852",9,217,208,"TCATGTTGTTTGGATATATC","TGCAAATGGATGGTCATAAT","561307.5.peg.2276","1420"
"17853",11,217,206,"TCCAAACAACATGATGAGAA","TGCAAATGGATGGTCATAAT","561307.5.peg.2276","1420"
"17854",4,217,213,"ACATGATGAGAAAGGAAAT","TGCAAATGGATGGTCATAAT","561307.5.peg.2276","1420"
"17855",11,227,216,"TCCAAACAACATGATGAGAA","CATTATCGAATGCAAATGGA","561307.5.peg.2276","1420"
"17856",9,227,218,"TCATGTTGTTTGGATATATC","CATTATCGAATGCAAATGGA","561307.5.peg.2276","1420"
"17857",4,227,223,"ACATGATGAGAAAGGAAAT","CATTATCGAATGCAAATGGA","561307.5.peg.2276","1420"
"17858",11,303,292,"TCCAAACAACATGATGAGAA","TGACTAGCATAATCATATGT","561307.5.peg.2276","1420"
"17859",4,303,299,"ACATGATGAGAAAGGAAAT","TGACTAGCATAATCATATGT","561307.5.peg.2276","1420"
"17860",9,303,294,"TCATGTTGTTTGGATATATC","TGACTAGCATAATCATATGT","561307.5.peg.2276","1420"
"17861",652,523,129,"TTGACAGCAACCGCCTCTGT","TTCACGCATTTCCATCGCGC","561307.5.peg.2277","1421"
"17862",523,652,129,"TTCACGCATTTCCATCGCGC","TTGACAGCAACCGCCTCTGT","561307.5.peg.2277","1421"
"17863",333,72,261,"TTCACATACATTACTACTGC","TCCATATGGCTTAATGACTT","561307.5.peg.2278","1422"
"17864",369,72,297,"GCATTCCAATGAAGTGGTAT","TCCATATGGCTTAATGACTT","561307.5.peg.2278","1422"
"17865",375,72,303,"GTCTCTGCATTCCAATGAAG","TCCATATGGCTTAATGACTT","561307.5.peg.2278","1422"
"17866",333,159,174,"TTCACATACATTACTACTGC","TGTTGTCTATTGAATTCCCC","561307.5.peg.2278","1422"
"17867",369,159,210,"GCATTCCAATGAAGTGGTAT","TGTTGTCTATTGAATTCCCC","561307.5.peg.2278","1422"
"17868",375,159,216,"GTCTCTGCATTCCAATGAAG","TGTTGTCTATTGAATTCCCC","561307.5.peg.2278","1422"
"17869",72,333,261,"TCCATATGGCTTAATGACTT","TTCACATACATTACTACTGC","561307.5.peg.2278","1422"
"17870",159,333,174,"TGTTGTCTATTGAATTCCCC","TTCACATACATTACTACTGC","561307.5.peg.2278","1422"
"17871",72,369,297,"TCCATATGGCTTAATGACTT","GCATTCCAATGAAGTGGTAT","561307.5.peg.2278","1422"
"17872",159,369,210,"TGTTGTCTATTGAATTCCCC","GCATTCCAATGAAGTGGTAT","561307.5.peg.2278","1422"
"17873",72,375,303,"TCCATATGGCTTAATGACTT","GTCTCTGCATTCCAATGAAG","561307.5.peg.2278","1422"
"17874",159,375,216,"TGTTGTCTATTGAATTCCCC","GTCTCTGCATTCCAATGAAG","561307.5.peg.2278","1422"
"17875",417,138,279,"TCGTAACGTACAATTTATC","TCATCATCAATTGGCACTAA","561307.5.peg.2283","1428"
"17876",936,138,798,"TACCCTCTACCTTCATTGGC","TCATCATCAATTGGCACTAA","561307.5.peg.2283","1428"
"17877",444,138,306,"TTGTATGCTTCCATATCTTC","TCATCATCAATTGGCACTAA","561307.5.peg.2283","1428"
"17878",606,138,468,"CCTGGATACATTTCTTCTGC","TCATCATCAATTGGCACTAA","561307.5.peg.2283","1428"
"17879",893,138,755,"CAAATGCAATCGTACGAATG","TCATCATCAATTGGCACTAA","561307.5.peg.2283","1428"
"17880",940,138,802,"TACATACCCTCTACCTTCAT","TCATCATCAATTGGCACTAA","561307.5.peg.2283","1428"
"17881",546,138,408,"ATCTCAGTGTTCGGTCCTGA","TCATCATCAATTGGCACTAA","561307.5.peg.2283","1428"
"17882",138,417,279,"TCATCATCAATTGGCACTAA","TCGTAACGTACAATTTATC","561307.5.peg.2283","1428"
"17883",936,417,519,"TACCCTCTACCTTCATTGGC","TCGTAACGTACAATTTATC","561307.5.peg.2283","1428"
"17884",940,417,523,"TACATACCCTCTACCTTCAT","TCGTAACGTACAATTTATC","561307.5.peg.2283","1428"
"17885",893,417,476,"CAAATGCAATCGTACGAATG","TCGTAACGTACAATTTATC","561307.5.peg.2283","1428"
"17886",546,417,129,"ATCTCAGTGTTCGGTCCTGA","TCGTAACGTACAATTTATC","561307.5.peg.2283","1428"
"17887",606,417,189,"CCTGGATACATTTCTTCTGC","TCGTAACGTACAATTTATC","561307.5.peg.2283","1428"
"17888",546,444,102,"ATCTCAGTGTTCGGTCCTGA","TTGTATGCTTCCATATCTTC","561307.5.peg.2283","1428"
"17889",936,444,492,"TACCCTCTACCTTCATTGGC","TTGTATGCTTCCATATCTTC","561307.5.peg.2283","1428"
"17890",893,444,449,"CAAATGCAATCGTACGAATG","TTGTATGCTTCCATATCTTC","561307.5.peg.2283","1428"
"17891",606,444,162,"CCTGGATACATTTCTTCTGC","TTGTATGCTTCCATATCTTC","561307.5.peg.2283","1428"
"17892",940,444,496,"TACATACCCTCTACCTTCAT","TTGTATGCTTCCATATCTTC","561307.5.peg.2283","1428"
"17893",138,444,306,"TCATCATCAATTGGCACTAA","TTGTATGCTTCCATATCTTC","561307.5.peg.2283","1428"
"17894",417,546,129,"TCGTAACGTACAATTTATC","ATCTCAGTGTTCGGTCCTGA","561307.5.peg.2283","1428"
"17895",444,546,102,"TTGTATGCTTCCATATCTTC","ATCTCAGTGTTCGGTCCTGA","561307.5.peg.2283","1428"
"17896",936,546,390,"TACCCTCTACCTTCATTGGC","ATCTCAGTGTTCGGTCCTGA","561307.5.peg.2283","1428"
"17897",893,546,347,"CAAATGCAATCGTACGAATG","ATCTCAGTGTTCGGTCCTGA","561307.5.peg.2283","1428"
"17898",138,546,408,"TCATCATCAATTGGCACTAA","ATCTCAGTGTTCGGTCCTGA","561307.5.peg.2283","1428"
"17899",940,546,394,"TACATACCCTCTACCTTCAT","ATCTCAGTGTTCGGTCCTGA","561307.5.peg.2283","1428"
"17900",940,606,334,"TACATACCCTCTACCTTCAT","CCTGGATACATTTCTTCTGC","561307.5.peg.2283","1428"
"17901",138,606,468,"TCATCATCAATTGGCACTAA","CCTGGATACATTTCTTCTGC","561307.5.peg.2283","1428"
"17902",936,606,330,"TACCCTCTACCTTCATTGGC","CCTGGATACATTTCTTCTGC","561307.5.peg.2283","1428"
"17903",444,606,162,"TTGTATGCTTCCATATCTTC","CCTGGATACATTTCTTCTGC","561307.5.peg.2283","1428"
"17904",417,606,189,"TCGTAACGTACAATTTATC","CCTGGATACATTTCTTCTGC","561307.5.peg.2283","1428"
"17905",893,606,287,"CAAATGCAATCGTACGAATG","CCTGGATACATTTCTTCTGC","561307.5.peg.2283","1428"
"17906",138,893,755,"TCATCATCAATTGGCACTAA","CAAATGCAATCGTACGAATG","561307.5.peg.2283","1428"
"17907",606,893,287,"CCTGGATACATTTCTTCTGC","CAAATGCAATCGTACGAATG","561307.5.peg.2283","1428"
"17908",546,893,347,"ATCTCAGTGTTCGGTCCTGA","CAAATGCAATCGTACGAATG","561307.5.peg.2283","1428"
"17909",444,893,449,"TTGTATGCTTCCATATCTTC","CAAATGCAATCGTACGAATG","561307.5.peg.2283","1428"
"17910",417,893,476,"TCGTAACGTACAATTTATC","CAAATGCAATCGTACGAATG","561307.5.peg.2283","1428"
"17911",138,936,798,"TCATCATCAATTGGCACTAA","TACCCTCTACCTTCATTGGC","561307.5.peg.2283","1428"
"17912",417,936,519,"TCGTAACGTACAATTTATC","TACCCTCTACCTTCATTGGC","561307.5.peg.2283","1428"
"17913",546,936,390,"ATCTCAGTGTTCGGTCCTGA","TACCCTCTACCTTCATTGGC","561307.5.peg.2283","1428"
"17914",444,936,492,"TTGTATGCTTCCATATCTTC","TACCCTCTACCTTCATTGGC","561307.5.peg.2283","1428"
"17915",606,936,330,"CCTGGATACATTTCTTCTGC","TACCCTCTACCTTCATTGGC","561307.5.peg.2283","1428"
"17916",606,940,334,"CCTGGATACATTTCTTCTGC","TACATACCCTCTACCTTCAT","561307.5.peg.2283","1428"
"17917",546,940,394,"ATCTCAGTGTTCGGTCCTGA","TACATACCCTCTACCTTCAT","561307.5.peg.2283","1428"
"17918",138,940,802,"TCATCATCAATTGGCACTAA","TACATACCCTCTACCTTCAT","561307.5.peg.2283","1428"
"17919",417,940,523,"TCGTAACGTACAATTTATC","TACATACCCTCTACCTTCAT","561307.5.peg.2283","1428"
"17920",444,940,496,"TTGTATGCTTCCATATCTTC","TACATACCCTCTACCTTCAT","561307.5.peg.2283","1428"
"17921",309,186,123,"TAATTGCTTCTTTCGTTTG","GGAAGAAACCCTACAACAGT","561307.5.peg.2284","1429"
"17922",1254,186,1068,"CTCTTAGACGCTCTTCCTGT","GGAAGAAACCCTACAACAGT","561307.5.peg.2284","1429"
"17923",309,207,102,"TAATTGCTTCTTTCGTTTG","ACATCGCCTTCAACAATATT","561307.5.peg.2284","1429"
"17924",1254,207,1047,"CTCTTAGACGCTCTTCCTGT","ACATCGCCTTCAACAATATT","561307.5.peg.2284","1429"
"17925",186,309,123,"GGAAGAAACCCTACAACAGT","TAATTGCTTCTTTCGTTTG","561307.5.peg.2284","1429"
"17926",1254,309,945,"CTCTTAGACGCTCTTCCTGT","TAATTGCTTCTTTCGTTTG","561307.5.peg.2284","1429"
"17927",207,309,102,"ACATCGCCTTCAACAATATT","TAATTGCTTCTTTCGTTTG","561307.5.peg.2284","1429"
"17928",207,1254,1047,"ACATCGCCTTCAACAATATT","CTCTTAGACGCTCTTCCTGT","561307.5.peg.2284","1429"
"17929",186,1254,1068,"GGAAGAAACCCTACAACAGT","CTCTTAGACGCTCTTCCTGT","561307.5.peg.2284","1429"
"17930",309,1254,945,"TAATTGCTTCTTTCGTTTG","CTCTTAGACGCTCTTCCTGT","561307.5.peg.2284","1429"
"17931",566,93,473,"TTGCTTGAACCGCATCAACA","ATCATCGCATCTACTACTTC","561307.5.peg.2287","1432"
"17932",93,566,473,"ATCATCGCATCTACTACTTC","TTGCTTGAACCGCATCAACA","561307.5.peg.2287","1432"
"17933",188,77,111,"TTACTAGGTTGGGAGCGTTA","CACCTTCTCGAATAGGGACA","561307.5.peg.2288","1433"
"17934",381,77,304,"GCGGTCATCATATCTGTTCC","CACCTTCTCGAATAGGGACA","561307.5.peg.2288","1433"
"17935",348,77,271,"AATCCTAAATCGACACGATT","CACCTTCTCGAATAGGGACA","561307.5.peg.2288","1433"
"17936",447,77,370,"GTAATAATGAAACCTCTTC","CACCTTCTCGAATAGGGACA","561307.5.peg.2288","1433"
"17937",198,77,121,"GTTGCTGAACTTACTAGGTT","CACCTTCTCGAATAGGGACA","561307.5.peg.2288","1433"
"17938",482,77,405,"CATATGCTTGTTGGTGAGCA","CACCTTCTCGAATAGGGACA","561307.5.peg.2288","1433"
"17939",203,77,126,"AAGCAGTTGCTGAACTTACT","CACCTTCTCGAATAGGGACA","561307.5.peg.2288","1433"
"17940",491,77,414,"AAGCACGAACATATGCTTGT","CACCTTCTCGAATAGGGACA","561307.5.peg.2288","1433"
"17941",400,77,323,"ATCTCGTCTTAATGCACTTG","CACCTTCTCGAATAGGGACA","561307.5.peg.2288","1433"
"17942",381,83,298,"GCGGTCATCATATCTGTTCC","CATCTTCACCTTCTCGAATA","561307.5.peg.2288","1433"
"17943",198,83,115,"GTTGCTGAACTTACTAGGTT","CATCTTCACCTTCTCGAATA","561307.5.peg.2288","1433"
"17944",482,83,399,"CATATGCTTGTTGGTGAGCA","CATCTTCACCTTCTCGAATA","561307.5.peg.2288","1433"
"17945",491,83,408,"AAGCACGAACATATGCTTGT","CATCTTCACCTTCTCGAATA","561307.5.peg.2288","1433"
"17946",400,83,317,"ATCTCGTCTTAATGCACTTG","CATCTTCACCTTCTCGAATA","561307.5.peg.2288","1433"
"17947",447,83,364,"GTAATAATGAAACCTCTTC","CATCTTCACCTTCTCGAATA","561307.5.peg.2288","1433"
"17948",348,83,265,"AATCCTAAATCGACACGATT","CATCTTCACCTTCTCGAATA","561307.5.peg.2288","1433"
"17949",203,83,120,"AAGCAGTTGCTGAACTTACT","CATCTTCACCTTCTCGAATA","561307.5.peg.2288","1433"
"17950",188,83,105,"TTACTAGGTTGGGAGCGTTA","CATCTTCACCTTCTCGAATA","561307.5.peg.2288","1433"
"17951",77,188,111,"CACCTTCTCGAATAGGGACA","TTACTAGGTTGGGAGCGTTA","561307.5.peg.2288","1433"
"17952",482,188,294,"CATATGCTTGTTGGTGAGCA","TTACTAGGTTGGGAGCGTTA","561307.5.peg.2288","1433"
"17953",83,188,105,"CATCTTCACCTTCTCGAATA","TTACTAGGTTGGGAGCGTTA","561307.5.peg.2288","1433"
"17954",447,188,259,"GTAATAATGAAACCTCTTC","TTACTAGGTTGGGAGCGTTA","561307.5.peg.2288","1433"
"17955",400,188,212,"ATCTCGTCTTAATGCACTTG","TTACTAGGTTGGGAGCGTTA","561307.5.peg.2288","1433"
"17956",348,188,160,"AATCCTAAATCGACACGATT","TTACTAGGTTGGGAGCGTTA","561307.5.peg.2288","1433"
"17957",491,188,303,"AAGCACGAACATATGCTTGT","TTACTAGGTTGGGAGCGTTA","561307.5.peg.2288","1433"
"17958",381,188,193,"GCGGTCATCATATCTGTTCC","TTACTAGGTTGGGAGCGTTA","561307.5.peg.2288","1433"
"17959",482,198,284,"CATATGCTTGTTGGTGAGCA","GTTGCTGAACTTACTAGGTT","561307.5.peg.2288","1433"
"17960",77,198,121,"CACCTTCTCGAATAGGGACA","GTTGCTGAACTTACTAGGTT","561307.5.peg.2288","1433"
"17961",491,198,293,"AAGCACGAACATATGCTTGT","GTTGCTGAACTTACTAGGTT","561307.5.peg.2288","1433"
"17962",83,198,115,"CATCTTCACCTTCTCGAATA","GTTGCTGAACTTACTAGGTT","561307.5.peg.2288","1433"
"17963",381,198,183,"GCGGTCATCATATCTGTTCC","GTTGCTGAACTTACTAGGTT","561307.5.peg.2288","1433"
"17964",447,198,249,"GTAATAATGAAACCTCTTC","GTTGCTGAACTTACTAGGTT","561307.5.peg.2288","1433"
"17965",348,198,150,"AATCCTAAATCGACACGATT","GTTGCTGAACTTACTAGGTT","561307.5.peg.2288","1433"
"17966",400,198,202,"ATCTCGTCTTAATGCACTTG","GTTGCTGAACTTACTAGGTT","561307.5.peg.2288","1433"
"17967",400,203,197,"ATCTCGTCTTAATGCACTTG","AAGCAGTTGCTGAACTTACT","561307.5.peg.2288","1433"
"17968",482,203,279,"CATATGCTTGTTGGTGAGCA","AAGCAGTTGCTGAACTTACT","561307.5.peg.2288","1433"
"17969",83,203,120,"CATCTTCACCTTCTCGAATA","AAGCAGTTGCTGAACTTACT","561307.5.peg.2288","1433"
"17970",77,203,126,"CACCTTCTCGAATAGGGACA","AAGCAGTTGCTGAACTTACT","561307.5.peg.2288","1433"
"17971",348,203,145,"AATCCTAAATCGACACGATT","AAGCAGTTGCTGAACTTACT","561307.5.peg.2288","1433"
"17972",491,203,288,"AAGCACGAACATATGCTTGT","AAGCAGTTGCTGAACTTACT","561307.5.peg.2288","1433"
"17973",447,203,244,"GTAATAATGAAACCTCTTC","AAGCAGTTGCTGAACTTACT","561307.5.peg.2288","1433"
"17974",381,203,178,"GCGGTCATCATATCTGTTCC","AAGCAGTTGCTGAACTTACT","561307.5.peg.2288","1433"
"17975",77,348,271,"CACCTTCTCGAATAGGGACA","AATCCTAAATCGACACGATT","561307.5.peg.2288","1433"
"17976",482,348,134,"CATATGCTTGTTGGTGAGCA","AATCCTAAATCGACACGATT","561307.5.peg.2288","1433"
"17977",198,348,150,"GTTGCTGAACTTACTAGGTT","AATCCTAAATCGACACGATT","561307.5.peg.2288","1433"
"17978",83,348,265,"CATCTTCACCTTCTCGAATA","AATCCTAAATCGACACGATT","561307.5.peg.2288","1433"
"17979",188,348,160,"TTACTAGGTTGGGAGCGTTA","AATCCTAAATCGACACGATT","561307.5.peg.2288","1433"
"17980",203,348,145,"AAGCAGTTGCTGAACTTACT","AATCCTAAATCGACACGATT","561307.5.peg.2288","1433"
"17981",491,348,143,"AAGCACGAACATATGCTTGT","AATCCTAAATCGACACGATT","561307.5.peg.2288","1433"
"17982",83,381,298,"CATCTTCACCTTCTCGAATA","GCGGTCATCATATCTGTTCC","561307.5.peg.2288","1433"
"17983",77,381,304,"CACCTTCTCGAATAGGGACA","GCGGTCATCATATCTGTTCC","561307.5.peg.2288","1433"
"17984",198,381,183,"GTTGCTGAACTTACTAGGTT","GCGGTCATCATATCTGTTCC","561307.5.peg.2288","1433"
"17985",482,381,101,"CATATGCTTGTTGGTGAGCA","GCGGTCATCATATCTGTTCC","561307.5.peg.2288","1433"
"17986",203,381,178,"AAGCAGTTGCTGAACTTACT","GCGGTCATCATATCTGTTCC","561307.5.peg.2288","1433"
"17987",491,381,110,"AAGCACGAACATATGCTTGT","GCGGTCATCATATCTGTTCC","561307.5.peg.2288","1433"
"17988",188,381,193,"TTACTAGGTTGGGAGCGTTA","GCGGTCATCATATCTGTTCC","561307.5.peg.2288","1433"
"17989",188,400,212,"TTACTAGGTTGGGAGCGTTA","ATCTCGTCTTAATGCACTTG","561307.5.peg.2288","1433"
"17990",198,400,202,"GTTGCTGAACTTACTAGGTT","ATCTCGTCTTAATGCACTTG","561307.5.peg.2288","1433"
"17991",77,400,323,"CACCTTCTCGAATAGGGACA","ATCTCGTCTTAATGCACTTG","561307.5.peg.2288","1433"
"17992",83,400,317,"CATCTTCACCTTCTCGAATA","ATCTCGTCTTAATGCACTTG","561307.5.peg.2288","1433"
"17993",203,400,197,"AAGCAGTTGCTGAACTTACT","ATCTCGTCTTAATGCACTTG","561307.5.peg.2288","1433"
"17994",77,447,370,"CACCTTCTCGAATAGGGACA","GTAATAATGAAACCTCTTC","561307.5.peg.2288","1433"
"17995",203,447,244,"AAGCAGTTGCTGAACTTACT","GTAATAATGAAACCTCTTC","561307.5.peg.2288","1433"
"17996",198,447,249,"GTTGCTGAACTTACTAGGTT","GTAATAATGAAACCTCTTC","561307.5.peg.2288","1433"
"17997",188,447,259,"TTACTAGGTTGGGAGCGTTA","GTAATAATGAAACCTCTTC","561307.5.peg.2288","1433"
"17998",83,447,364,"CATCTTCACCTTCTCGAATA","GTAATAATGAAACCTCTTC","561307.5.peg.2288","1433"
"17999",203,482,279,"AAGCAGTTGCTGAACTTACT","CATATGCTTGTTGGTGAGCA","561307.5.peg.2288","1433"
"18000",188,482,294,"TTACTAGGTTGGGAGCGTTA","CATATGCTTGTTGGTGAGCA","561307.5.peg.2288","1433"
"18001",83,482,399,"CATCTTCACCTTCTCGAATA","CATATGCTTGTTGGTGAGCA","561307.5.peg.2288","1433"
"18002",348,482,134,"AATCCTAAATCGACACGATT","CATATGCTTGTTGGTGAGCA","561307.5.peg.2288","1433"
"18003",198,482,284,"GTTGCTGAACTTACTAGGTT","CATATGCTTGTTGGTGAGCA","561307.5.peg.2288","1433"
"18004",381,482,101,"GCGGTCATCATATCTGTTCC","CATATGCTTGTTGGTGAGCA","561307.5.peg.2288","1433"
"18005",77,482,405,"CACCTTCTCGAATAGGGACA","CATATGCTTGTTGGTGAGCA","561307.5.peg.2288","1433"
"18006",83,491,408,"CATCTTCACCTTCTCGAATA","AAGCACGAACATATGCTTGT","561307.5.peg.2288","1433"
"18007",381,491,110,"GCGGTCATCATATCTGTTCC","AAGCACGAACATATGCTTGT","561307.5.peg.2288","1433"
"18008",198,491,293,"GTTGCTGAACTTACTAGGTT","AAGCACGAACATATGCTTGT","561307.5.peg.2288","1433"
"18009",77,491,414,"CACCTTCTCGAATAGGGACA","AAGCACGAACATATGCTTGT","561307.5.peg.2288","1433"
"18010",203,491,288,"AAGCAGTTGCTGAACTTACT","AAGCACGAACATATGCTTGT","561307.5.peg.2288","1433"
"18011",188,491,303,"TTACTAGGTTGGGAGCGTTA","AAGCACGAACATATGCTTGT","561307.5.peg.2288","1433"
"18012",348,491,143,"AATCCTAAATCGACACGATT","AAGCACGAACATATGCTTGT","561307.5.peg.2288","1433"
"18013",177,7,170,"TGTACAGTCCCGGGATCACC","TAGAAGTTCAATCTATAGG","561307.5.peg.229","1435"
"18014",186,7,179,"ATTGAGTGTTGTACAGTCCC","TAGAAGTTCAATCTATAGG","561307.5.peg.229","1435"
"18015",7,177,170,"TAGAAGTTCAATCTATAGG","TGTACAGTCCCGGGATCACC","561307.5.peg.229","1435"
"18016",7,186,179,"TAGAAGTTCAATCTATAGG","ATTGAGTGTTGTACAGTCCC","561307.5.peg.229","1435"
"18017",459,220,239,"TGCGCTCTTGAACGAATCGC","CGTACTGCCCGAAATTGCTT","561307.5.peg.2292","1438"
"18018",620,220,400,"ACGCACTACGAACATCACCT","CGTACTGCCCGAAATTGCTT","561307.5.peg.2292","1438"
"18019",441,220,221,"GCTGGATTGATAGCATGATA","CGTACTGCCCGAAATTGCTT","561307.5.peg.2292","1438"
"18020",498,220,278,"CGCACATCTTCGTCATTTAA","CGTACTGCCCGAAATTGCTT","561307.5.peg.2292","1438"
"18021",521,220,301,"CTATTGCACGAGTTAACGCT","CGTACTGCCCGAAATTGCTT","561307.5.peg.2292","1438"
"18022",220,441,221,"CGTACTGCCCGAAATTGCTT","GCTGGATTGATAGCATGATA","561307.5.peg.2292","1438"
"18023",620,441,179,"ACGCACTACGAACATCACCT","GCTGGATTGATAGCATGATA","561307.5.peg.2292","1438"
"18024",220,459,239,"CGTACTGCCCGAAATTGCTT","TGCGCTCTTGAACGAATCGC","561307.5.peg.2292","1438"
"18025",620,459,161,"ACGCACTACGAACATCACCT","TGCGCTCTTGAACGAATCGC","561307.5.peg.2292","1438"
"18026",220,498,278,"CGTACTGCCCGAAATTGCTT","CGCACATCTTCGTCATTTAA","561307.5.peg.2292","1438"
"18027",620,498,122,"ACGCACTACGAACATCACCT","CGCACATCTTCGTCATTTAA","561307.5.peg.2292","1438"
"18028",220,521,301,"CGTACTGCCCGAAATTGCTT","CTATTGCACGAGTTAACGCT","561307.5.peg.2292","1438"
"18029",459,620,161,"TGCGCTCTTGAACGAATCGC","ACGCACTACGAACATCACCT","561307.5.peg.2292","1438"
"18030",220,620,400,"CGTACTGCCCGAAATTGCTT","ACGCACTACGAACATCACCT","561307.5.peg.2292","1438"
"18031",498,620,122,"CGCACATCTTCGTCATTTAA","ACGCACTACGAACATCACCT","561307.5.peg.2292","1438"
"18032",441,620,179,"GCTGGATTGATAGCATGATA","ACGCACTACGAACATCACCT","561307.5.peg.2292","1438"
"18033",747,329,418,"TATCGACTTGTGTAAATTC","TGTAACTTGTACTTCAACT","561307.5.peg.2294","1440"
"18034",872,329,543,"CTTCTTTATATGTCATGCGT","TGTAACTTGTACTTCAACT","561307.5.peg.2294","1440"
"18035",576,329,247,"AAATAGTCACGTGCACCCTC","TGTAACTTGTACTTCAACT","561307.5.peg.2294","1440"
"18036",555,329,226,"GGTGTTGACTTCGTTAGTAC","TGTAACTTGTACTTCAACT","561307.5.peg.2294","1440"
"18037",603,329,274,"TCACCATCATGAACACGAGA","TGTAACTTGTACTTCAACT","561307.5.peg.2294","1440"
"18038",440,329,111,"GACGACGTAAATCTAAATAA","TGTAACTTGTACTTCAACT","561307.5.peg.2294","1440"
"18039",716,329,387,"CTGCACGTAAATCTTCGTCA","TGTAACTTGTACTTCAACT","561307.5.peg.2294","1440"
"18040",872,440,432,"CTTCTTTATATGTCATGCGT","GACGACGTAAATCTAAATAA","561307.5.peg.2294","1440"
"18041",576,440,136,"AAATAGTCACGTGCACCCTC","GACGACGTAAATCTAAATAA","561307.5.peg.2294","1440"
"18042",747,440,307,"TATCGACTTGTGTAAATTC","GACGACGTAAATCTAAATAA","561307.5.peg.2294","1440"
"18043",555,440,115,"GGTGTTGACTTCGTTAGTAC","GACGACGTAAATCTAAATAA","561307.5.peg.2294","1440"
"18044",716,440,276,"CTGCACGTAAATCTTCGTCA","GACGACGTAAATCTAAATAA","561307.5.peg.2294","1440"
"18045",603,440,163,"TCACCATCATGAACACGAGA","GACGACGTAAATCTAAATAA","561307.5.peg.2294","1440"
"18046",329,440,111,"TGTAACTTGTACTTCAACT","GACGACGTAAATCTAAATAA","561307.5.peg.2294","1440"
"18047",716,555,161,"CTGCACGTAAATCTTCGTCA","GGTGTTGACTTCGTTAGTAC","561307.5.peg.2294","1440"
"18048",747,555,192,"TATCGACTTGTGTAAATTC","GGTGTTGACTTCGTTAGTAC","561307.5.peg.2294","1440"
"18049",440,555,115,"GACGACGTAAATCTAAATAA","GGTGTTGACTTCGTTAGTAC","561307.5.peg.2294","1440"
"18050",872,555,317,"CTTCTTTATATGTCATGCGT","GGTGTTGACTTCGTTAGTAC","561307.5.peg.2294","1440"
"18051",329,555,226,"TGTAACTTGTACTTCAACT","GGTGTTGACTTCGTTAGTAC","561307.5.peg.2294","1440"
"18052",747,576,171,"TATCGACTTGTGTAAATTC","AAATAGTCACGTGCACCCTC","561307.5.peg.2294","1440"
"18053",329,576,247,"TGTAACTTGTACTTCAACT","AAATAGTCACGTGCACCCTC","561307.5.peg.2294","1440"
"18054",872,576,296,"CTTCTTTATATGTCATGCGT","AAATAGTCACGTGCACCCTC","561307.5.peg.2294","1440"
"18055",440,576,136,"GACGACGTAAATCTAAATAA","AAATAGTCACGTGCACCCTC","561307.5.peg.2294","1440"
"18056",716,576,140,"CTGCACGTAAATCTTCGTCA","AAATAGTCACGTGCACCCTC","561307.5.peg.2294","1440"
"18057",329,603,274,"TGTAACTTGTACTTCAACT","TCACCATCATGAACACGAGA","561307.5.peg.2294","1440"
"18058",747,603,144,"TATCGACTTGTGTAAATTC","TCACCATCATGAACACGAGA","561307.5.peg.2294","1440"
"18059",872,603,269,"CTTCTTTATATGTCATGCGT","TCACCATCATGAACACGAGA","561307.5.peg.2294","1440"
"18060",716,603,113,"CTGCACGTAAATCTTCGTCA","TCACCATCATGAACACGAGA","561307.5.peg.2294","1440"
"18061",440,603,163,"GACGACGTAAATCTAAATAA","TCACCATCATGAACACGAGA","561307.5.peg.2294","1440"
"18062",329,716,387,"TGTAACTTGTACTTCAACT","CTGCACGTAAATCTTCGTCA","561307.5.peg.2294","1440"
"18063",603,716,113,"TCACCATCATGAACACGAGA","CTGCACGTAAATCTTCGTCA","561307.5.peg.2294","1440"
"18064",576,716,140,"AAATAGTCACGTGCACCCTC","CTGCACGTAAATCTTCGTCA","561307.5.peg.2294","1440"
"18065",555,716,161,"GGTGTTGACTTCGTTAGTAC","CTGCACGTAAATCTTCGTCA","561307.5.peg.2294","1440"
"18066",440,716,276,"GACGACGTAAATCTAAATAA","CTGCACGTAAATCTTCGTCA","561307.5.peg.2294","1440"
"18067",872,716,156,"CTTCTTTATATGTCATGCGT","CTGCACGTAAATCTTCGTCA","561307.5.peg.2294","1440"
"18068",576,747,171,"AAATAGTCACGTGCACCCTC","TATCGACTTGTGTAAATTC","561307.5.peg.2294","1440"
"18069",440,747,307,"GACGACGTAAATCTAAATAA","TATCGACTTGTGTAAATTC","561307.5.peg.2294","1440"
"18070",555,747,192,"GGTGTTGACTTCGTTAGTAC","TATCGACTTGTGTAAATTC","561307.5.peg.2294","1440"
"18071",872,747,125,"CTTCTTTATATGTCATGCGT","TATCGACTTGTGTAAATTC","561307.5.peg.2294","1440"
"18072",603,747,144,"TCACCATCATGAACACGAGA","TATCGACTTGTGTAAATTC","561307.5.peg.2294","1440"
"18073",329,747,418,"TGTAACTTGTACTTCAACT","TATCGACTTGTGTAAATTC","561307.5.peg.2294","1440"
"18074",576,872,296,"AAATAGTCACGTGCACCCTC","CTTCTTTATATGTCATGCGT","561307.5.peg.2294","1440"
"18075",440,872,432,"GACGACGTAAATCTAAATAA","CTTCTTTATATGTCATGCGT","561307.5.peg.2294","1440"
"18076",603,872,269,"TCACCATCATGAACACGAGA","CTTCTTTATATGTCATGCGT","561307.5.peg.2294","1440"
"18077",329,872,543,"TGTAACTTGTACTTCAACT","CTTCTTTATATGTCATGCGT","561307.5.peg.2294","1440"
"18078",747,872,125,"TATCGACTTGTGTAAATTC","CTTCTTTATATGTCATGCGT","561307.5.peg.2294","1440"
"18079",555,872,317,"GGTGTTGACTTCGTTAGTAC","CTTCTTTATATGTCATGCGT","561307.5.peg.2294","1440"
"18080",716,872,156,"CTGCACGTAAATCTTCGTCA","CTTCTTTATATGTCATGCGT","561307.5.peg.2294","1440"
"18081",285,87,198,"ACAACTGCAGCTGTTCCCTC","CGCCATTTCTTTGAATCTTC","561307.5.peg.2295","1441"
"18082",375,87,288,"TACGTTCATATCTAAACAT","CGCCATTTCTTTGAATCTTC","561307.5.peg.2295","1441"
"18083",459,87,372,"AATACTTCTGCATCTACGCT","CGCCATTTCTTTGAATCTTC","561307.5.peg.2295","1441"
"18084",87,285,198,"CGCCATTTCTTTGAATCTTC","ACAACTGCAGCTGTTCCCTC","561307.5.peg.2295","1441"
"18085",459,285,174,"AATACTTCTGCATCTACGCT","ACAACTGCAGCTGTTCCCTC","561307.5.peg.2295","1441"
"18086",87,375,288,"CGCCATTTCTTTGAATCTTC","TACGTTCATATCTAAACAT","561307.5.peg.2295","1441"
"18087",87,459,372,"CGCCATTTCTTTGAATCTTC","AATACTTCTGCATCTACGCT","561307.5.peg.2295","1441"
"18088",285,459,174,"ACAACTGCAGCTGTTCCCTC","AATACTTCTGCATCTACGCT","561307.5.peg.2295","1441"
"18089",426,10,416,"TGGTCACTACCTCCATGACC","TTATTTATGAAAGTCAGGA","561307.5.peg.2296","1442"
"18090",446,10,436,"TAGTATTGCTTGAAGCACCC","TTATTTATGAAAGTCAGGA","561307.5.peg.2296","1442"
"18091",10,426,416,"TTATTTATGAAAGTCAGGA","TGGTCACTACCTCCATGACC","561307.5.peg.2296","1442"
"18092",10,446,436,"TTATTTATGAAAGTCAGGA","TAGTATTGCTTGAAGCACCC","561307.5.peg.2296","1442"
"18093",195,66,129,"GTATAGGATGCATAATGTA","AGAACTTCGTCTGCACTATA","561307.5.peg.2298","1444"
"18094",1001,66,935,"TTTCGAGCGGGTCTCCATTT","AGAACTTCGTCTGCACTATA","561307.5.peg.2298","1444"
"18095",740,66,674,"TATCGCCTTCGATATTCATT","AGAACTTCGTCTGCACTATA","561307.5.peg.2298","1444"
"18096",567,66,501,"ATACCAAGACGATGTGCTAA","AGAACTTCGTCTGCACTATA","561307.5.peg.2298","1444"
"18097",1013,66,947,"TTCGTATTTGGATTTCGAGC","AGAACTTCGTCTGCACTATA","561307.5.peg.2298","1444"
"18098",1025,66,959,"GCATATCAAACGTTCGTATT","AGAACTTCGTCTGCACTATA","561307.5.peg.2298","1444"
"18099",502,66,436,"TTCGCGCGGCATGGCTTTCA","AGAACTTCGTCTGCACTATA","561307.5.peg.2298","1444"
"18100",66,195,129,"AGAACTTCGTCTGCACTATA","GTATAGGATGCATAATGTA","561307.5.peg.2298","1444"
"18101",502,195,307,"TTCGCGCGGCATGGCTTTCA","GTATAGGATGCATAATGTA","561307.5.peg.2298","1444"
"18102",740,195,545,"TATCGCCTTCGATATTCATT","GTATAGGATGCATAATGTA","561307.5.peg.2298","1444"
"18103",1001,195,806,"TTTCGAGCGGGTCTCCATTT","GTATAGGATGCATAATGTA","561307.5.peg.2298","1444"
"18104",1013,195,818,"TTCGTATTTGGATTTCGAGC","GTATAGGATGCATAATGTA","561307.5.peg.2298","1444"
"18105",1025,195,830,"GCATATCAAACGTTCGTATT","GTATAGGATGCATAATGTA","561307.5.peg.2298","1444"
"18106",567,195,372,"ATACCAAGACGATGTGCTAA","GTATAGGATGCATAATGTA","561307.5.peg.2298","1444"
"18107",66,502,436,"AGAACTTCGTCTGCACTATA","TTCGCGCGGCATGGCTTTCA","561307.5.peg.2298","1444"
"18108",195,502,307,"GTATAGGATGCATAATGTA","TTCGCGCGGCATGGCTTTCA","561307.5.peg.2298","1444"
"18109",1001,502,499,"TTTCGAGCGGGTCTCCATTT","TTCGCGCGGCATGGCTTTCA","561307.5.peg.2298","1444"
"18110",1025,502,523,"GCATATCAAACGTTCGTATT","TTCGCGCGGCATGGCTTTCA","561307.5.peg.2298","1444"
"18111",1013,502,511,"TTCGTATTTGGATTTCGAGC","TTCGCGCGGCATGGCTTTCA","561307.5.peg.2298","1444"
"18112",740,502,238,"TATCGCCTTCGATATTCATT","TTCGCGCGGCATGGCTTTCA","561307.5.peg.2298","1444"
"18113",195,567,372,"GTATAGGATGCATAATGTA","ATACCAAGACGATGTGCTAA","561307.5.peg.2298","1444"
"18114",1013,567,446,"TTCGTATTTGGATTTCGAGC","ATACCAAGACGATGTGCTAA","561307.5.peg.2298","1444"
"18115",1025,567,458,"GCATATCAAACGTTCGTATT","ATACCAAGACGATGTGCTAA","561307.5.peg.2298","1444"
"18116",740,567,173,"TATCGCCTTCGATATTCATT","ATACCAAGACGATGTGCTAA","561307.5.peg.2298","1444"
"18117",1001,567,434,"TTTCGAGCGGGTCTCCATTT","ATACCAAGACGATGTGCTAA","561307.5.peg.2298","1444"
"18118",66,567,501,"AGAACTTCGTCTGCACTATA","ATACCAAGACGATGTGCTAA","561307.5.peg.2298","1444"
"18119",66,740,674,"AGAACTTCGTCTGCACTATA","TATCGCCTTCGATATTCATT","561307.5.peg.2298","1444"
"18120",1013,740,273,"TTCGTATTTGGATTTCGAGC","TATCGCCTTCGATATTCATT","561307.5.peg.2298","1444"
"18121",502,740,238,"TTCGCGCGGCATGGCTTTCA","TATCGCCTTCGATATTCATT","561307.5.peg.2298","1444"
"18122",1025,740,285,"GCATATCAAACGTTCGTATT","TATCGCCTTCGATATTCATT","561307.5.peg.2298","1444"
"18123",1001,740,261,"TTTCGAGCGGGTCTCCATTT","TATCGCCTTCGATATTCATT","561307.5.peg.2298","1444"
"18124",195,740,545,"GTATAGGATGCATAATGTA","TATCGCCTTCGATATTCATT","561307.5.peg.2298","1444"
"18125",567,740,173,"ATACCAAGACGATGTGCTAA","TATCGCCTTCGATATTCATT","561307.5.peg.2298","1444"
"18126",567,1001,434,"ATACCAAGACGATGTGCTAA","TTTCGAGCGGGTCTCCATTT","561307.5.peg.2298","1444"
"18127",740,1001,261,"TATCGCCTTCGATATTCATT","TTTCGAGCGGGTCTCCATTT","561307.5.peg.2298","1444"
"18128",502,1001,499,"TTCGCGCGGCATGGCTTTCA","TTTCGAGCGGGTCTCCATTT","561307.5.peg.2298","1444"
"18129",66,1001,935,"AGAACTTCGTCTGCACTATA","TTTCGAGCGGGTCTCCATTT","561307.5.peg.2298","1444"
"18130",195,1001,806,"GTATAGGATGCATAATGTA","TTTCGAGCGGGTCTCCATTT","561307.5.peg.2298","1444"
"18131",502,1013,511,"TTCGCGCGGCATGGCTTTCA","TTCGTATTTGGATTTCGAGC","561307.5.peg.2298","1444"
"18132",567,1013,446,"ATACCAAGACGATGTGCTAA","TTCGTATTTGGATTTCGAGC","561307.5.peg.2298","1444"
"18133",66,1013,947,"AGAACTTCGTCTGCACTATA","TTCGTATTTGGATTTCGAGC","561307.5.peg.2298","1444"
"18134",195,1013,818,"GTATAGGATGCATAATGTA","TTCGTATTTGGATTTCGAGC","561307.5.peg.2298","1444"
"18135",740,1013,273,"TATCGCCTTCGATATTCATT","TTCGTATTTGGATTTCGAGC","561307.5.peg.2298","1444"
"18136",195,1025,830,"GTATAGGATGCATAATGTA","GCATATCAAACGTTCGTATT","561307.5.peg.2298","1444"
"18137",567,1025,458,"ATACCAAGACGATGTGCTAA","GCATATCAAACGTTCGTATT","561307.5.peg.2298","1444"
"18138",502,1025,523,"TTCGCGCGGCATGGCTTTCA","GCATATCAAACGTTCGTATT","561307.5.peg.2298","1444"
"18139",740,1025,285,"TATCGCCTTCGATATTCATT","GCATATCAAACGTTCGTATT","561307.5.peg.2298","1444"
"18140",66,1025,959,"AGAACTTCGTCTGCACTATA","GCATATCAAACGTTCGTATT","561307.5.peg.2298","1444"
"18141",213,9,204,"ATGATAAAGCCACGCGCTTC","ATTGTCGTGAGCAATTTAGG","561307.5.peg.2299","1445"
"18142",213,12,201,"ATGATAAAGCCACGCGCTTC","ACAATTGTCGTGAGCAATTT","561307.5.peg.2299","1445"
"18143",213,96,117,"ATGATAAAGCCACGCGCTTC","ATATCCTTGAAACTAACACC","561307.5.peg.2299","1445"
"18144",9,213,204,"ATTGTCGTGAGCAATTTAGG","ATGATAAAGCCACGCGCTTC","561307.5.peg.2299","1445"
"18145",12,213,201,"ACAATTGTCGTGAGCAATTT","ATGATAAAGCCACGCGCTTC","561307.5.peg.2299","1445"
"18146",96,213,117,"ATATCCTTGAAACTAACACC","ATGATAAAGCCACGCGCTTC","561307.5.peg.2299","1445"
"18147",117,2,115,"GTATCAGTAGGAACAATCAC","AGTAAATCCACTGTATCTTC","561307.5.peg.23","1446"
"18148",162,2,160,"TCGATACAAAGATCGTTGTT","AGTAAATCCACTGTATCTTC","561307.5.peg.23","1446"
"18149",246,2,244,"CCATACAATTTCCAATCCTC","AGTAAATCCACTGTATCTTC","561307.5.peg.23","1446"
"18150",2,117,115,"AGTAAATCCACTGTATCTTC","GTATCAGTAGGAACAATCAC","561307.5.peg.23","1446"
"18151",246,117,129,"CCATACAATTTCCAATCCTC","GTATCAGTAGGAACAATCAC","561307.5.peg.23","1446"
"18152",2,162,160,"AGTAAATCCACTGTATCTTC","TCGATACAAAGATCGTTGTT","561307.5.peg.23","1446"
"18153",2,246,244,"AGTAAATCCACTGTATCTTC","CCATACAATTTCCAATCCTC","561307.5.peg.23","1446"
"18154",117,246,129,"GTATCAGTAGGAACAATCAC","CCATACAATTTCCAATCCTC","561307.5.peg.23","1446"
"18155",127,11,116,"ATCGTGACTACTAGATAGAT","TAATATAGACACTAGAAGG","561307.5.peg.230","1447"
"18156",127,14,113,"ATCGTGACTACTAGATAGAT","GCATAATATAGACACTAGA","561307.5.peg.230","1447"
"18157",11,127,116,"TAATATAGACACTAGAAGG","ATCGTGACTACTAGATAGAT","561307.5.peg.230","1447"
"18158",14,127,113,"GCATAATATAGACACTAGA","ATCGTGACTACTAGATAGAT","561307.5.peg.230","1447"
"18159",629,87,542,"CACCTGCACCACACAATTGT","TCATCACTTATGTATTCAGC","561307.5.peg.2300","1448"
"18160",420,87,333,"TTCTAAATGCTAGTTCGTT","TCATCACTTATGTATTCAGC","561307.5.peg.2300","1448"
"18161",393,87,306,"TATCCTTCGGTAAAGCGGTT","TCATCACTTATGTATTCAGC","561307.5.peg.2300","1448"
"18162",600,87,513,"AATTAAACGATGGATGCAT","TCATCACTTATGTATTCAGC","561307.5.peg.2300","1448"
"18163",885,87,798,"CGACCTACAGCATTAAGTCT","TCATCACTTATGTATTCAGC","561307.5.peg.2300","1448"
"18164",804,87,717,"AGCAATGCTTTAACAGAGGT","TCATCACTTATGTATTCAGC","561307.5.peg.2300","1448"
"18165",406,87,319,"TTCGTTTGGTCCATATCCTT","TCATCACTTATGTATTCAGC","561307.5.peg.2300","1448"
"18166",724,87,637,"TAAGGATACTAAATCCGCAA","TCATCACTTATGTATTCAGC","561307.5.peg.2300","1448"
"18167",398,87,311,"GTCCATATCCTTCGGTAAAG","TCATCACTTATGTATTCAGC","561307.5.peg.2300","1448"
"18168",319,87,232,"TGTAGTTGCGGTAACACCGT","TCATCACTTATGTATTCAGC","561307.5.peg.2300","1448"
"18169",609,87,522,"TGGAACGGATAATTAAACGA","TCATCACTTATGTATTCAGC","561307.5.peg.2300","1448"
"18170",296,87,209,"CATCGTAATCACCATAAACT","TCATCACTTATGTATTCAGC","561307.5.peg.2300","1448"
"18171",724,296,428,"TAAGGATACTAAATCCGCAA","CATCGTAATCACCATAAACT","561307.5.peg.2300","1448"
"18172",885,296,589,"CGACCTACAGCATTAAGTCT","CATCGTAATCACCATAAACT","561307.5.peg.2300","1448"
"18173",804,296,508,"AGCAATGCTTTAACAGAGGT","CATCGTAATCACCATAAACT","561307.5.peg.2300","1448"
"18174",87,296,209,"TCATCACTTATGTATTCAGC","CATCGTAATCACCATAAACT","561307.5.peg.2300","1448"
"18175",629,296,333,"CACCTGCACCACACAATTGT","CATCGTAATCACCATAAACT","561307.5.peg.2300","1448"
"18176",609,296,313,"TGGAACGGATAATTAAACGA","CATCGTAATCACCATAAACT","561307.5.peg.2300","1448"
"18177",420,296,124,"TTCTAAATGCTAGTTCGTT","CATCGTAATCACCATAAACT","561307.5.peg.2300","1448"
"18178",398,296,102,"GTCCATATCCTTCGGTAAAG","CATCGTAATCACCATAAACT","561307.5.peg.2300","1448"
"18179",406,296,110,"TTCGTTTGGTCCATATCCTT","CATCGTAATCACCATAAACT","561307.5.peg.2300","1448"
"18180",600,296,304,"AATTAAACGATGGATGCAT","CATCGTAATCACCATAAACT","561307.5.peg.2300","1448"
"18181",420,319,101,"TTCTAAATGCTAGTTCGTT","TGTAGTTGCGGTAACACCGT","561307.5.peg.2300","1448"
"18182",885,319,566,"CGACCTACAGCATTAAGTCT","TGTAGTTGCGGTAACACCGT","561307.5.peg.2300","1448"
"18183",804,319,485,"AGCAATGCTTTAACAGAGGT","TGTAGTTGCGGTAACACCGT","561307.5.peg.2300","1448"
"18184",724,319,405,"TAAGGATACTAAATCCGCAA","TGTAGTTGCGGTAACACCGT","561307.5.peg.2300","1448"
"18185",600,319,281,"AATTAAACGATGGATGCAT","TGTAGTTGCGGTAACACCGT","561307.5.peg.2300","1448"
"18186",629,319,310,"CACCTGCACCACACAATTGT","TGTAGTTGCGGTAACACCGT","561307.5.peg.2300","1448"
"18187",609,319,290,"TGGAACGGATAATTAAACGA","TGTAGTTGCGGTAACACCGT","561307.5.peg.2300","1448"
"18188",87,319,232,"TCATCACTTATGTATTCAGC","TGTAGTTGCGGTAACACCGT","561307.5.peg.2300","1448"
"18189",724,393,331,"TAAGGATACTAAATCCGCAA","TATCCTTCGGTAAAGCGGTT","561307.5.peg.2300","1448"
"18190",804,393,411,"AGCAATGCTTTAACAGAGGT","TATCCTTCGGTAAAGCGGTT","561307.5.peg.2300","1448"
"18191",885,393,492,"CGACCTACAGCATTAAGTCT","TATCCTTCGGTAAAGCGGTT","561307.5.peg.2300","1448"
"18192",629,393,236,"CACCTGCACCACACAATTGT","TATCCTTCGGTAAAGCGGTT","561307.5.peg.2300","1448"
"18193",600,393,207,"AATTAAACGATGGATGCAT","TATCCTTCGGTAAAGCGGTT","561307.5.peg.2300","1448"
"18194",609,393,216,"TGGAACGGATAATTAAACGA","TATCCTTCGGTAAAGCGGTT","561307.5.peg.2300","1448"
"18195",87,393,306,"TCATCACTTATGTATTCAGC","TATCCTTCGGTAAAGCGGTT","561307.5.peg.2300","1448"
"18196",629,398,231,"CACCTGCACCACACAATTGT","GTCCATATCCTTCGGTAAAG","561307.5.peg.2300","1448"
"18197",87,398,311,"TCATCACTTATGTATTCAGC","GTCCATATCCTTCGGTAAAG","561307.5.peg.2300","1448"
"18198",296,398,102,"CATCGTAATCACCATAAACT","GTCCATATCCTTCGGTAAAG","561307.5.peg.2300","1448"
"18199",724,398,326,"TAAGGATACTAAATCCGCAA","GTCCATATCCTTCGGTAAAG","561307.5.peg.2300","1448"
"18200",600,398,202,"AATTAAACGATGGATGCAT","GTCCATATCCTTCGGTAAAG","561307.5.peg.2300","1448"
"18201",609,398,211,"TGGAACGGATAATTAAACGA","GTCCATATCCTTCGGTAAAG","561307.5.peg.2300","1448"
"18202",885,398,487,"CGACCTACAGCATTAAGTCT","GTCCATATCCTTCGGTAAAG","561307.5.peg.2300","1448"
"18203",804,398,406,"AGCAATGCTTTAACAGAGGT","GTCCATATCCTTCGGTAAAG","561307.5.peg.2300","1448"
"18204",87,406,319,"TCATCACTTATGTATTCAGC","TTCGTTTGGTCCATATCCTT","561307.5.peg.2300","1448"
"18205",296,406,110,"CATCGTAATCACCATAAACT","TTCGTTTGGTCCATATCCTT","561307.5.peg.2300","1448"
"18206",629,406,223,"CACCTGCACCACACAATTGT","TTCGTTTGGTCCATATCCTT","561307.5.peg.2300","1448"
"18207",724,406,318,"TAAGGATACTAAATCCGCAA","TTCGTTTGGTCCATATCCTT","561307.5.peg.2300","1448"
"18208",804,406,398,"AGCAATGCTTTAACAGAGGT","TTCGTTTGGTCCATATCCTT","561307.5.peg.2300","1448"
"18209",885,406,479,"CGACCTACAGCATTAAGTCT","TTCGTTTGGTCCATATCCTT","561307.5.peg.2300","1448"
"18210",600,406,194,"AATTAAACGATGGATGCAT","TTCGTTTGGTCCATATCCTT","561307.5.peg.2300","1448"
"18211",609,406,203,"TGGAACGGATAATTAAACGA","TTCGTTTGGTCCATATCCTT","561307.5.peg.2300","1448"
"18212",609,420,189,"TGGAACGGATAATTAAACGA","TTCTAAATGCTAGTTCGTT","561307.5.peg.2300","1448"
"18213",296,420,124,"CATCGTAATCACCATAAACT","TTCTAAATGCTAGTTCGTT","561307.5.peg.2300","1448"
"18214",885,420,465,"CGACCTACAGCATTAAGTCT","TTCTAAATGCTAGTTCGTT","561307.5.peg.2300","1448"
"18215",87,420,333,"TCATCACTTATGTATTCAGC","TTCTAAATGCTAGTTCGTT","561307.5.peg.2300","1448"
"18216",629,420,209,"CACCTGCACCACACAATTGT","TTCTAAATGCTAGTTCGTT","561307.5.peg.2300","1448"
"18217",804,420,384,"AGCAATGCTTTAACAGAGGT","TTCTAAATGCTAGTTCGTT","561307.5.peg.2300","1448"
"18218",724,420,304,"TAAGGATACTAAATCCGCAA","TTCTAAATGCTAGTTCGTT","561307.5.peg.2300","1448"
"18219",319,420,101,"TGTAGTTGCGGTAACACCGT","TTCTAAATGCTAGTTCGTT","561307.5.peg.2300","1448"
"18220",600,420,180,"AATTAAACGATGGATGCAT","TTCTAAATGCTAGTTCGTT","561307.5.peg.2300","1448"
"18221",885,600,285,"CGACCTACAGCATTAAGTCT","AATTAAACGATGGATGCAT","561307.5.peg.2300","1448"
"18222",724,600,124,"TAAGGATACTAAATCCGCAA","AATTAAACGATGGATGCAT","561307.5.peg.2300","1448"
"18223",398,600,202,"GTCCATATCCTTCGGTAAAG","AATTAAACGATGGATGCAT","561307.5.peg.2300","1448"
"18224",296,600,304,"CATCGTAATCACCATAAACT","AATTAAACGATGGATGCAT","561307.5.peg.2300","1448"
"18225",406,600,194,"TTCGTTTGGTCCATATCCTT","AATTAAACGATGGATGCAT","561307.5.peg.2300","1448"
"18226",393,600,207,"TATCCTTCGGTAAAGCGGTT","AATTAAACGATGGATGCAT","561307.5.peg.2300","1448"
"18227",87,600,513,"TCATCACTTATGTATTCAGC","AATTAAACGATGGATGCAT","561307.5.peg.2300","1448"
"18228",319,600,281,"TGTAGTTGCGGTAACACCGT","AATTAAACGATGGATGCAT","561307.5.peg.2300","1448"
"18229",804,600,204,"AGCAATGCTTTAACAGAGGT","AATTAAACGATGGATGCAT","561307.5.peg.2300","1448"
"18230",420,600,180,"TTCTAAATGCTAGTTCGTT","AATTAAACGATGGATGCAT","561307.5.peg.2300","1448"
"18231",885,609,276,"CGACCTACAGCATTAAGTCT","TGGAACGGATAATTAAACGA","561307.5.peg.2300","1448"
"18232",724,609,115,"TAAGGATACTAAATCCGCAA","TGGAACGGATAATTAAACGA","561307.5.peg.2300","1448"
"18233",393,609,216,"TATCCTTCGGTAAAGCGGTT","TGGAACGGATAATTAAACGA","561307.5.peg.2300","1448"
"18234",319,609,290,"TGTAGTTGCGGTAACACCGT","TGGAACGGATAATTAAACGA","561307.5.peg.2300","1448"
"18235",804,609,195,"AGCAATGCTTTAACAGAGGT","TGGAACGGATAATTAAACGA","561307.5.peg.2300","1448"
"18236",420,609,189,"TTCTAAATGCTAGTTCGTT","TGGAACGGATAATTAAACGA","561307.5.peg.2300","1448"
"18237",87,609,522,"TCATCACTTATGTATTCAGC","TGGAACGGATAATTAAACGA","561307.5.peg.2300","1448"
"18238",296,609,313,"CATCGTAATCACCATAAACT","TGGAACGGATAATTAAACGA","561307.5.peg.2300","1448"
"18239",398,609,211,"GTCCATATCCTTCGGTAAAG","TGGAACGGATAATTAAACGA","561307.5.peg.2300","1448"
"18240",406,609,203,"TTCGTTTGGTCCATATCCTT","TGGAACGGATAATTAAACGA","561307.5.peg.2300","1448"
"18241",420,629,209,"TTCTAAATGCTAGTTCGTT","CACCTGCACCACACAATTGT","561307.5.peg.2300","1448"
"18242",319,629,310,"TGTAGTTGCGGTAACACCGT","CACCTGCACCACACAATTGT","561307.5.peg.2300","1448"
"18243",406,629,223,"TTCGTTTGGTCCATATCCTT","CACCTGCACCACACAATTGT","561307.5.peg.2300","1448"
"18244",804,629,175,"AGCAATGCTTTAACAGAGGT","CACCTGCACCACACAATTGT","561307.5.peg.2300","1448"
"18245",885,629,256,"CGACCTACAGCATTAAGTCT","CACCTGCACCACACAATTGT","561307.5.peg.2300","1448"
"18246",87,629,542,"TCATCACTTATGTATTCAGC","CACCTGCACCACACAATTGT","561307.5.peg.2300","1448"
"18247",393,629,236,"TATCCTTCGGTAAAGCGGTT","CACCTGCACCACACAATTGT","561307.5.peg.2300","1448"
"18248",398,629,231,"GTCCATATCCTTCGGTAAAG","CACCTGCACCACACAATTGT","561307.5.peg.2300","1448"
"18249",296,629,333,"CATCGTAATCACCATAAACT","CACCTGCACCACACAATTGT","561307.5.peg.2300","1448"
"18250",296,724,428,"CATCGTAATCACCATAAACT","TAAGGATACTAAATCCGCAA","561307.5.peg.2300","1448"
"18251",609,724,115,"TGGAACGGATAATTAAACGA","TAAGGATACTAAATCCGCAA","561307.5.peg.2300","1448"
"18252",319,724,405,"TGTAGTTGCGGTAACACCGT","TAAGGATACTAAATCCGCAA","561307.5.peg.2300","1448"
"18253",398,724,326,"GTCCATATCCTTCGGTAAAG","TAAGGATACTAAATCCGCAA","561307.5.peg.2300","1448"
"18254",885,724,161,"CGACCTACAGCATTAAGTCT","TAAGGATACTAAATCCGCAA","561307.5.peg.2300","1448"
"18255",393,724,331,"TATCCTTCGGTAAAGCGGTT","TAAGGATACTAAATCCGCAA","561307.5.peg.2300","1448"
"18256",600,724,124,"AATTAAACGATGGATGCAT","TAAGGATACTAAATCCGCAA","561307.5.peg.2300","1448"
"18257",87,724,637,"TCATCACTTATGTATTCAGC","TAAGGATACTAAATCCGCAA","561307.5.peg.2300","1448"
"18258",420,724,304,"TTCTAAATGCTAGTTCGTT","TAAGGATACTAAATCCGCAA","561307.5.peg.2300","1448"
"18259",406,724,318,"TTCGTTTGGTCCATATCCTT","TAAGGATACTAAATCCGCAA","561307.5.peg.2300","1448"
"18260",87,804,717,"TCATCACTTATGTATTCAGC","AGCAATGCTTTAACAGAGGT","561307.5.peg.2300","1448"
"18261",406,804,398,"TTCGTTTGGTCCATATCCTT","AGCAATGCTTTAACAGAGGT","561307.5.peg.2300","1448"
"18262",398,804,406,"GTCCATATCCTTCGGTAAAG","AGCAATGCTTTAACAGAGGT","561307.5.peg.2300","1448"
"18263",319,804,485,"TGTAGTTGCGGTAACACCGT","AGCAATGCTTTAACAGAGGT","561307.5.peg.2300","1448"
"18264",296,804,508,"CATCGTAATCACCATAAACT","AGCAATGCTTTAACAGAGGT","561307.5.peg.2300","1448"
"18265",629,804,175,"CACCTGCACCACACAATTGT","AGCAATGCTTTAACAGAGGT","561307.5.peg.2300","1448"
"18266",393,804,411,"TATCCTTCGGTAAAGCGGTT","AGCAATGCTTTAACAGAGGT","561307.5.peg.2300","1448"
"18267",609,804,195,"TGGAACGGATAATTAAACGA","AGCAATGCTTTAACAGAGGT","561307.5.peg.2300","1448"
"18268",600,804,204,"AATTAAACGATGGATGCAT","AGCAATGCTTTAACAGAGGT","561307.5.peg.2300","1448"
"18269",420,804,384,"TTCTAAATGCTAGTTCGTT","AGCAATGCTTTAACAGAGGT","561307.5.peg.2300","1448"
"18270",87,885,798,"TCATCACTTATGTATTCAGC","CGACCTACAGCATTAAGTCT","561307.5.peg.2300","1448"
"18271",406,885,479,"TTCGTTTGGTCCATATCCTT","CGACCTACAGCATTAAGTCT","561307.5.peg.2300","1448"
"18272",600,885,285,"AATTAAACGATGGATGCAT","CGACCTACAGCATTAAGTCT","561307.5.peg.2300","1448"
"18273",724,885,161,"TAAGGATACTAAATCCGCAA","CGACCTACAGCATTAAGTCT","561307.5.peg.2300","1448"
"18274",420,885,465,"TTCTAAATGCTAGTTCGTT","CGACCTACAGCATTAAGTCT","561307.5.peg.2300","1448"
"18275",319,885,566,"TGTAGTTGCGGTAACACCGT","CGACCTACAGCATTAAGTCT","561307.5.peg.2300","1448"
"18276",398,885,487,"GTCCATATCCTTCGGTAAAG","CGACCTACAGCATTAAGTCT","561307.5.peg.2300","1448"
"18277",296,885,589,"CATCGTAATCACCATAAACT","CGACCTACAGCATTAAGTCT","561307.5.peg.2300","1448"
"18278",393,885,492,"TATCCTTCGGTAAAGCGGTT","CGACCTACAGCATTAAGTCT","561307.5.peg.2300","1448"
"18279",629,885,256,"CACCTGCACCACACAATTGT","CGACCTACAGCATTAAGTCT","561307.5.peg.2300","1448"
"18280",609,885,276,"TGGAACGGATAATTAAACGA","CGACCTACAGCATTAAGTCT","561307.5.peg.2300","1448"
"18281",987,106,881,"AATACCAACGCCGCTAATCC","TTTATAAGTTGCAGCCATTC","561307.5.peg.2301","1449"
"18282",629,106,523,"TGCTGCAGAAATAAATTTA","TTTATAAGTTGCAGCCATTC","561307.5.peg.2301","1449"
"18283",900,106,794,"GCAATAATCGCTACTAAACC","TTTATAAGTTGCAGCCATTC","561307.5.peg.2301","1449"
"18284",1033,106,927,"CGCTCATACATGATAATAT","TTTATAAGTTGCAGCCATTC","561307.5.peg.2301","1449"
"18285",805,106,699,"TAATGCATCTTGACCAAATT","TTTATAAGTTGCAGCCATTC","561307.5.peg.2301","1449"
"18286",970,106,864,"TCCTGGTAAAGTTAGAACCC","TTTATAAGTTGCAGCCATTC","561307.5.peg.2301","1449"
"18287",1162,106,1056,"GAAGAAGAATAATACTGCTG","TTTATAAGTTGCAGCCATTC","561307.5.peg.2301","1449"
"18288",106,629,523,"TTTATAAGTTGCAGCCATTC","TGCTGCAGAAATAAATTTA","561307.5.peg.2301","1449"
"18289",970,629,341,"TCCTGGTAAAGTTAGAACCC","TGCTGCAGAAATAAATTTA","561307.5.peg.2301","1449"
"18290",987,629,358,"AATACCAACGCCGCTAATCC","TGCTGCAGAAATAAATTTA","561307.5.peg.2301","1449"
"18291",1162,629,533,"GAAGAAGAATAATACTGCTG","TGCTGCAGAAATAAATTTA","561307.5.peg.2301","1449"
"18292",900,629,271,"GCAATAATCGCTACTAAACC","TGCTGCAGAAATAAATTTA","561307.5.peg.2301","1449"
"18293",805,629,176,"TAATGCATCTTGACCAAATT","TGCTGCAGAAATAAATTTA","561307.5.peg.2301","1449"
"18294",1033,629,404,"CGCTCATACATGATAATAT","TGCTGCAGAAATAAATTTA","561307.5.peg.2301","1449"
"18295",106,805,699,"TTTATAAGTTGCAGCCATTC","TAATGCATCTTGACCAAATT","561307.5.peg.2301","1449"
"18296",629,805,176,"TGCTGCAGAAATAAATTTA","TAATGCATCTTGACCAAATT","561307.5.peg.2301","1449"
"18297",1033,805,228,"CGCTCATACATGATAATAT","TAATGCATCTTGACCAAATT","561307.5.peg.2301","1449"
"18298",1162,805,357,"GAAGAAGAATAATACTGCTG","TAATGCATCTTGACCAAATT","561307.5.peg.2301","1449"
"18299",970,805,165,"TCCTGGTAAAGTTAGAACCC","TAATGCATCTTGACCAAATT","561307.5.peg.2301","1449"
"18300",987,805,182,"AATACCAACGCCGCTAATCC","TAATGCATCTTGACCAAATT","561307.5.peg.2301","1449"
"18301",629,900,271,"TGCTGCAGAAATAAATTTA","GCAATAATCGCTACTAAACC","561307.5.peg.2301","1449"
"18302",106,900,794,"TTTATAAGTTGCAGCCATTC","GCAATAATCGCTACTAAACC","561307.5.peg.2301","1449"
"18303",1162,900,262,"GAAGAAGAATAATACTGCTG","GCAATAATCGCTACTAAACC","561307.5.peg.2301","1449"
"18304",1033,900,133,"CGCTCATACATGATAATAT","GCAATAATCGCTACTAAACC","561307.5.peg.2301","1449"
"18305",805,970,165,"TAATGCATCTTGACCAAATT","TCCTGGTAAAGTTAGAACCC","561307.5.peg.2301","1449"
"18306",1162,970,192,"GAAGAAGAATAATACTGCTG","TCCTGGTAAAGTTAGAACCC","561307.5.peg.2301","1449"
"18307",629,970,341,"TGCTGCAGAAATAAATTTA","TCCTGGTAAAGTTAGAACCC","561307.5.peg.2301","1449"
"18308",106,970,864,"TTTATAAGTTGCAGCCATTC","TCCTGGTAAAGTTAGAACCC","561307.5.peg.2301","1449"
"18309",106,987,881,"TTTATAAGTTGCAGCCATTC","AATACCAACGCCGCTAATCC","561307.5.peg.2301","1449"
"18310",1162,987,175,"GAAGAAGAATAATACTGCTG","AATACCAACGCCGCTAATCC","561307.5.peg.2301","1449"
"18311",629,987,358,"TGCTGCAGAAATAAATTTA","AATACCAACGCCGCTAATCC","561307.5.peg.2301","1449"
"18312",805,987,182,"TAATGCATCTTGACCAAATT","AATACCAACGCCGCTAATCC","561307.5.peg.2301","1449"
"18313",629,1033,404,"TGCTGCAGAAATAAATTTA","CGCTCATACATGATAATAT","561307.5.peg.2301","1449"
"18314",106,1033,927,"TTTATAAGTTGCAGCCATTC","CGCTCATACATGATAATAT","561307.5.peg.2301","1449"
"18315",805,1033,228,"TAATGCATCTTGACCAAATT","CGCTCATACATGATAATAT","561307.5.peg.2301","1449"
"18316",1162,1033,129,"GAAGAAGAATAATACTGCTG","CGCTCATACATGATAATAT","561307.5.peg.2301","1449"
"18317",900,1033,133,"GCAATAATCGCTACTAAACC","CGCTCATACATGATAATAT","561307.5.peg.2301","1449"
"18318",987,1162,175,"AATACCAACGCCGCTAATCC","GAAGAAGAATAATACTGCTG","561307.5.peg.2301","1449"
"18319",629,1162,533,"TGCTGCAGAAATAAATTTA","GAAGAAGAATAATACTGCTG","561307.5.peg.2301","1449"
"18320",900,1162,262,"GCAATAATCGCTACTAAACC","GAAGAAGAATAATACTGCTG","561307.5.peg.2301","1449"
"18321",106,1162,1056,"TTTATAAGTTGCAGCCATTC","GAAGAAGAATAATACTGCTG","561307.5.peg.2301","1449"
"18322",805,1162,357,"TAATGCATCTTGACCAAATT","GAAGAAGAATAATACTGCTG","561307.5.peg.2301","1449"
"18323",970,1162,192,"TCCTGGTAAAGTTAGAACCC","GAAGAAGAATAATACTGCTG","561307.5.peg.2301","1449"
"18324",1033,1162,129,"CGCTCATACATGATAATAT","GAAGAAGAATAATACTGCTG","561307.5.peg.2301","1449"
"18325",501,54,447,"TCATATTCAGCAGGCATCGG","ATGTGTTCGTATGTTACTGC","561307.5.peg.2303","1451"
"18326",156,54,102,"ACGGTTGCTTTAGTACCAAC","ATGTGTTCGTATGTTACTGC","561307.5.peg.2303","1451"
"18327",504,54,450,"TAATCATATTCAGCAGGCAT","ATGTGTTCGTATGTTACTGC","561307.5.peg.2303","1451"
"18328",591,54,537,"CCGAACAATGCTTGATCTTC","ATGTGTTCGTATGTTACTGC","561307.5.peg.2303","1451"
"18329",318,54,264,"CCGCCTGAATCTGTAAGAAT","ATGTGTTCGTATGTTACTGC","561307.5.peg.2303","1451"
"18330",258,54,204,"GTTTGATAATATCATTTCC","ATGTGTTCGTATGTTACTGC","561307.5.peg.2303","1451"
"18331",192,54,138,"CAATTTGTCTTAACTCTTC","ATGTGTTCGTATGTTACTGC","561307.5.peg.2303","1451"
"18332",504,123,381,"TAATCATATTCAGCAGGCAT","GGTGTTTCAAATGAACCGTG","561307.5.peg.2303","1451"
"18333",318,123,195,"CCGCCTGAATCTGTAAGAAT","GGTGTTTCAAATGAACCGTG","561307.5.peg.2303","1451"
"18334",258,123,135,"GTTTGATAATATCATTTCC","GGTGTTTCAAATGAACCGTG","561307.5.peg.2303","1451"
"18335",501,123,378,"TCATATTCAGCAGGCATCGG","GGTGTTTCAAATGAACCGTG","561307.5.peg.2303","1451"
"18336",591,123,468,"CCGAACAATGCTTGATCTTC","GGTGTTTCAAATGAACCGTG","561307.5.peg.2303","1451"
"18337",318,144,174,"CCGCCTGAATCTGTAAGAAT","GTACCAACTGGCATAAACAT","561307.5.peg.2303","1451"
"18338",258,144,114,"GTTTGATAATATCATTTCC","GTACCAACTGGCATAAACAT","561307.5.peg.2303","1451"
"18339",591,144,447,"CCGAACAATGCTTGATCTTC","GTACCAACTGGCATAAACAT","561307.5.peg.2303","1451"
"18340",501,144,357,"TCATATTCAGCAGGCATCGG","GTACCAACTGGCATAAACAT","561307.5.peg.2303","1451"
"18341",504,144,360,"TAATCATATTCAGCAGGCAT","GTACCAACTGGCATAAACAT","561307.5.peg.2303","1451"
"18342",54,156,102,"ATGTGTTCGTATGTTACTGC","ACGGTTGCTTTAGTACCAAC","561307.5.peg.2303","1451"
"18343",591,156,435,"CCGAACAATGCTTGATCTTC","ACGGTTGCTTTAGTACCAAC","561307.5.peg.2303","1451"
"18344",258,156,102,"GTTTGATAATATCATTTCC","ACGGTTGCTTTAGTACCAAC","561307.5.peg.2303","1451"
"18345",504,156,348,"TAATCATATTCAGCAGGCAT","ACGGTTGCTTTAGTACCAAC","561307.5.peg.2303","1451"
"18346",318,156,162,"CCGCCTGAATCTGTAAGAAT","ACGGTTGCTTTAGTACCAAC","561307.5.peg.2303","1451"
"18347",501,156,345,"TCATATTCAGCAGGCATCGG","ACGGTTGCTTTAGTACCAAC","561307.5.peg.2303","1451"
"18348",501,192,309,"TCATATTCAGCAGGCATCGG","CAATTTGTCTTAACTCTTC","561307.5.peg.2303","1451"
"18349",504,192,312,"TAATCATATTCAGCAGGCAT","CAATTTGTCTTAACTCTTC","561307.5.peg.2303","1451"
"18350",318,192,126,"CCGCCTGAATCTGTAAGAAT","CAATTTGTCTTAACTCTTC","561307.5.peg.2303","1451"
"18351",54,192,138,"ATGTGTTCGTATGTTACTGC","CAATTTGTCTTAACTCTTC","561307.5.peg.2303","1451"
"18352",591,192,399,"CCGAACAATGCTTGATCTTC","CAATTTGTCTTAACTCTTC","561307.5.peg.2303","1451"
"18353",156,258,102,"ACGGTTGCTTTAGTACCAAC","GTTTGATAATATCATTTCC","561307.5.peg.2303","1451"
"18354",54,258,204,"ATGTGTTCGTATGTTACTGC","GTTTGATAATATCATTTCC","561307.5.peg.2303","1451"
"18355",591,258,333,"CCGAACAATGCTTGATCTTC","GTTTGATAATATCATTTCC","561307.5.peg.2303","1451"
"18356",144,258,114,"GTACCAACTGGCATAAACAT","GTTTGATAATATCATTTCC","561307.5.peg.2303","1451"
"18357",504,258,246,"TAATCATATTCAGCAGGCAT","GTTTGATAATATCATTTCC","561307.5.peg.2303","1451"
"18358",501,258,243,"TCATATTCAGCAGGCATCGG","GTTTGATAATATCATTTCC","561307.5.peg.2303","1451"
"18359",123,258,135,"GGTGTTTCAAATGAACCGTG","GTTTGATAATATCATTTCC","561307.5.peg.2303","1451"
"18360",54,318,264,"ATGTGTTCGTATGTTACTGC","CCGCCTGAATCTGTAAGAAT","561307.5.peg.2303","1451"
"18361",504,318,186,"TAATCATATTCAGCAGGCAT","CCGCCTGAATCTGTAAGAAT","561307.5.peg.2303","1451"
"18362",144,318,174,"GTACCAACTGGCATAAACAT","CCGCCTGAATCTGTAAGAAT","561307.5.peg.2303","1451"
"18363",192,318,126,"CAATTTGTCTTAACTCTTC","CCGCCTGAATCTGTAAGAAT","561307.5.peg.2303","1451"
"18364",156,318,162,"ACGGTTGCTTTAGTACCAAC","CCGCCTGAATCTGTAAGAAT","561307.5.peg.2303","1451"
"18365",591,318,273,"CCGAACAATGCTTGATCTTC","CCGCCTGAATCTGTAAGAAT","561307.5.peg.2303","1451"
"18366",501,318,183,"TCATATTCAGCAGGCATCGG","CCGCCTGAATCTGTAAGAAT","561307.5.peg.2303","1451"
"18367",123,318,195,"GGTGTTTCAAATGAACCGTG","CCGCCTGAATCTGTAAGAAT","561307.5.peg.2303","1451"
"18368",258,501,243,"GTTTGATAATATCATTTCC","TCATATTCAGCAGGCATCGG","561307.5.peg.2303","1451"
"18369",144,501,357,"GTACCAACTGGCATAAACAT","TCATATTCAGCAGGCATCGG","561307.5.peg.2303","1451"
"18370",123,501,378,"GGTGTTTCAAATGAACCGTG","TCATATTCAGCAGGCATCGG","561307.5.peg.2303","1451"
"18371",54,501,447,"ATGTGTTCGTATGTTACTGC","TCATATTCAGCAGGCATCGG","561307.5.peg.2303","1451"
"18372",192,501,309,"CAATTTGTCTTAACTCTTC","TCATATTCAGCAGGCATCGG","561307.5.peg.2303","1451"
"18373",156,501,345,"ACGGTTGCTTTAGTACCAAC","TCATATTCAGCAGGCATCGG","561307.5.peg.2303","1451"
"18374",318,501,183,"CCGCCTGAATCTGTAAGAAT","TCATATTCAGCAGGCATCGG","561307.5.peg.2303","1451"
"18375",156,504,348,"ACGGTTGCTTTAGTACCAAC","TAATCATATTCAGCAGGCAT","561307.5.peg.2303","1451"
"18376",144,504,360,"GTACCAACTGGCATAAACAT","TAATCATATTCAGCAGGCAT","561307.5.peg.2303","1451"
"18377",318,504,186,"CCGCCTGAATCTGTAAGAAT","TAATCATATTCAGCAGGCAT","561307.5.peg.2303","1451"
"18378",54,504,450,"ATGTGTTCGTATGTTACTGC","TAATCATATTCAGCAGGCAT","561307.5.peg.2303","1451"
"18379",123,504,381,"GGTGTTTCAAATGAACCGTG","TAATCATATTCAGCAGGCAT","561307.5.peg.2303","1451"
"18380",258,504,246,"GTTTGATAATATCATTTCC","TAATCATATTCAGCAGGCAT","561307.5.peg.2303","1451"
"18381",192,504,312,"CAATTTGTCTTAACTCTTC","TAATCATATTCAGCAGGCAT","561307.5.peg.2303","1451"
"18382",54,591,537,"ATGTGTTCGTATGTTACTGC","CCGAACAATGCTTGATCTTC","561307.5.peg.2303","1451"
"18383",144,591,447,"GTACCAACTGGCATAAACAT","CCGAACAATGCTTGATCTTC","561307.5.peg.2303","1451"
"18384",192,591,399,"CAATTTGTCTTAACTCTTC","CCGAACAATGCTTGATCTTC","561307.5.peg.2303","1451"
"18385",318,591,273,"CCGCCTGAATCTGTAAGAAT","CCGAACAATGCTTGATCTTC","561307.5.peg.2303","1451"
"18386",258,591,333,"GTTTGATAATATCATTTCC","CCGAACAATGCTTGATCTTC","561307.5.peg.2303","1451"
"18387",123,591,468,"GGTGTTTCAAATGAACCGTG","CCGAACAATGCTTGATCTTC","561307.5.peg.2303","1451"
"18388",156,591,435,"ACGGTTGCTTTAGTACCAAC","CCGAACAATGCTTGATCTTC","561307.5.peg.2303","1451"
"18389",495,204,291,"TCTTTGATGTATGGTGGCAG","TTAAGCACTAATGTATCACC","561307.5.peg.2304","1452"
"18390",504,204,300,"CTAAACGTTCTTTGATGTA","TTAAGCACTAATGTATCACC","561307.5.peg.2304","1452"
"18391",531,204,327,"AAACTGTTTGATAACGATC","TTAAGCACTAATGTATCACC","561307.5.peg.2304","1452"
"18392",204,495,291,"TTAAGCACTAATGTATCACC","TCTTTGATGTATGGTGGCAG","561307.5.peg.2304","1452"
"18393",204,504,300,"TTAAGCACTAATGTATCACC","CTAAACGTTCTTTGATGTA","561307.5.peg.2304","1452"
"18394",204,531,327,"TTAAGCACTAATGTATCACC","AAACTGTTTGATAACGATC","561307.5.peg.2304","1452"
"18395",230,117,113,"TTGTCTTACCTAATCCAGGG","TATATTGTCGTAATCTCGT","561307.5.peg.2305","1453"
"18396",309,117,192,"TCACCAGGTCTTTCTAATGA","TATATTGTCGTAATCTCGT","561307.5.peg.2305","1453"
"18397",234,117,117,"AATGTTGTCTTACCTAATCC","TATATTGTCGTAATCTCGT","561307.5.peg.2305","1453"
"18398",232,117,115,"TGTTGTCTTACCTAATCCAG","TATATTGTCGTAATCTCGT","561307.5.peg.2305","1453"
"18399",488,117,371,"TGAATGGAGGTAAGTCGATA","TATATTGTCGTAATCTCGT","561307.5.peg.2305","1453"
"18400",501,117,384,"GCACCTACCAAAGTGAATGG","TATATTGTCGTAATCTCGT","561307.5.peg.2305","1453"
"18401",117,230,113,"TATATTGTCGTAATCTCGT","TTGTCTTACCTAATCCAGGG","561307.5.peg.2305","1453"
"18402",488,230,258,"TGAATGGAGGTAAGTCGATA","TTGTCTTACCTAATCCAGGG","561307.5.peg.2305","1453"
"18403",501,230,271,"GCACCTACCAAAGTGAATGG","TTGTCTTACCTAATCCAGGG","561307.5.peg.2305","1453"
"18404",488,232,256,"TGAATGGAGGTAAGTCGATA","TGTTGTCTTACCTAATCCAG","561307.5.peg.2305","1453"
"18405",501,232,269,"GCACCTACCAAAGTGAATGG","TGTTGTCTTACCTAATCCAG","561307.5.peg.2305","1453"
"18406",117,232,115,"TATATTGTCGTAATCTCGT","TGTTGTCTTACCTAATCCAG","561307.5.peg.2305","1453"
"18407",501,234,267,"GCACCTACCAAAGTGAATGG","AATGTTGTCTTACCTAATCC","561307.5.peg.2305","1453"
"18408",488,234,254,"TGAATGGAGGTAAGTCGATA","AATGTTGTCTTACCTAATCC","561307.5.peg.2305","1453"
"18409",117,234,117,"TATATTGTCGTAATCTCGT","AATGTTGTCTTACCTAATCC","561307.5.peg.2305","1453"
"18410",501,309,192,"GCACCTACCAAAGTGAATGG","TCACCAGGTCTTTCTAATGA","561307.5.peg.2305","1453"
"18411",117,309,192,"TATATTGTCGTAATCTCGT","TCACCAGGTCTTTCTAATGA","561307.5.peg.2305","1453"
"18412",488,309,179,"TGAATGGAGGTAAGTCGATA","TCACCAGGTCTTTCTAATGA","561307.5.peg.2305","1453"
"18413",117,488,371,"TATATTGTCGTAATCTCGT","TGAATGGAGGTAAGTCGATA","561307.5.peg.2305","1453"
"18414",234,488,254,"AATGTTGTCTTACCTAATCC","TGAATGGAGGTAAGTCGATA","561307.5.peg.2305","1453"
"18415",230,488,258,"TTGTCTTACCTAATCCAGGG","TGAATGGAGGTAAGTCGATA","561307.5.peg.2305","1453"
"18416",309,488,179,"TCACCAGGTCTTTCTAATGA","TGAATGGAGGTAAGTCGATA","561307.5.peg.2305","1453"
"18417",232,488,256,"TGTTGTCTTACCTAATCCAG","TGAATGGAGGTAAGTCGATA","561307.5.peg.2305","1453"
"18418",117,501,384,"TATATTGTCGTAATCTCGT","GCACCTACCAAAGTGAATGG","561307.5.peg.2305","1453"
"18419",234,501,267,"AATGTTGTCTTACCTAATCC","GCACCTACCAAAGTGAATGG","561307.5.peg.2305","1453"
"18420",232,501,269,"TGTTGTCTTACCTAATCCAG","GCACCTACCAAAGTGAATGG","561307.5.peg.2305","1453"
"18421",230,501,271,"TTGTCTTACCTAATCCAGGG","GCACCTACCAAAGTGAATGG","561307.5.peg.2305","1453"
"18422",309,501,192,"TCACCAGGTCTTTCTAATGA","GCACCTACCAAAGTGAATGG","561307.5.peg.2305","1453"
"18423",633,85,548,"GTTGAAACAACACCTAGATT","AATACCATTACCACCATCAC","561307.5.peg.2308","1456"
"18424",444,85,359,"AAGTCAGGTGCAGGGTTTCT","AATACCATTACCACCATCAC","561307.5.peg.2308","1456"
"18425",452,85,367,"TTTCACTGAAGTCAGGTGCA","AATACCATTACCACCATCAC","561307.5.peg.2308","1456"
"18426",548,85,463,"AAGTCGATTTACCCACACTA","AATACCATTACCACCATCAC","561307.5.peg.2308","1456"
"18427",266,85,181,"ACCATGCATATTACTACTT","AATACCATTACCACCATCAC","561307.5.peg.2308","1456"
"18428",483,85,398,"GATACATCTAATTCCTCACC","AATACCATTACCACCATCAC","561307.5.peg.2308","1456"
"18429",483,135,348,"GATACATCTAATTCCTCACC","CCGCCAGCTGGTCCACCAAA","561307.5.peg.2308","1456"
"18430",266,135,131,"ACCATGCATATTACTACTT","CCGCCAGCTGGTCCACCAAA","561307.5.peg.2308","1456"
"18431",444,135,309,"AAGTCAGGTGCAGGGTTTCT","CCGCCAGCTGGTCCACCAAA","561307.5.peg.2308","1456"
"18432",452,135,317,"TTTCACTGAAGTCAGGTGCA","CCGCCAGCTGGTCCACCAAA","561307.5.peg.2308","1456"
"18433",548,135,413,"AAGTCGATTTACCCACACTA","CCGCCAGCTGGTCCACCAAA","561307.5.peg.2308","1456"
"18434",633,135,498,"GTTGAAACAACACCTAGATT","CCGCCAGCTGGTCCACCAAA","561307.5.peg.2308","1456"
"18435",452,147,305,"TTTCACTGAAGTCAGGTGCA","TTACCACCGTCACCGCCAGC","561307.5.peg.2308","1456"
"18436",444,147,297,"AAGTCAGGTGCAGGGTTTCT","TTACCACCGTCACCGCCAGC","561307.5.peg.2308","1456"
"18437",548,147,401,"AAGTCGATTTACCCACACTA","TTACCACCGTCACCGCCAGC","561307.5.peg.2308","1456"
"18438",633,147,486,"GTTGAAACAACACCTAGATT","TTACCACCGTCACCGCCAGC","561307.5.peg.2308","1456"
"18439",266,147,119,"ACCATGCATATTACTACTT","TTACCACCGTCACCGCCAGC","561307.5.peg.2308","1456"
"18440",483,147,336,"GATACATCTAATTCCTCACC","TTACCACCGTCACCGCCAGC","561307.5.peg.2308","1456"
"18441",85,266,181,"AATACCATTACCACCATCAC","ACCATGCATATTACTACTT","561307.5.peg.2308","1456"
"18442",147,266,119,"TTACCACCGTCACCGCCAGC","ACCATGCATATTACTACTT","561307.5.peg.2308","1456"
"18443",548,266,282,"AAGTCGATTTACCCACACTA","ACCATGCATATTACTACTT","561307.5.peg.2308","1456"
"18444",135,266,131,"CCGCCAGCTGGTCCACCAAA","ACCATGCATATTACTACTT","561307.5.peg.2308","1456"
"18445",452,266,186,"TTTCACTGAAGTCAGGTGCA","ACCATGCATATTACTACTT","561307.5.peg.2308","1456"
"18446",483,266,217,"GATACATCTAATTCCTCACC","ACCATGCATATTACTACTT","561307.5.peg.2308","1456"
"18447",444,266,178,"AAGTCAGGTGCAGGGTTTCT","ACCATGCATATTACTACTT","561307.5.peg.2308","1456"
"18448",633,266,367,"GTTGAAACAACACCTAGATT","ACCATGCATATTACTACTT","561307.5.peg.2308","1456"
"18449",548,444,104,"AAGTCGATTTACCCACACTA","AAGTCAGGTGCAGGGTTTCT","561307.5.peg.2308","1456"
"18450",266,444,178,"ACCATGCATATTACTACTT","AAGTCAGGTGCAGGGTTTCT","561307.5.peg.2308","1456"
"18451",633,444,189,"GTTGAAACAACACCTAGATT","AAGTCAGGTGCAGGGTTTCT","561307.5.peg.2308","1456"
"18452",85,444,359,"AATACCATTACCACCATCAC","AAGTCAGGTGCAGGGTTTCT","561307.5.peg.2308","1456"
"18453",147,444,297,"TTACCACCGTCACCGCCAGC","AAGTCAGGTGCAGGGTTTCT","561307.5.peg.2308","1456"
"18454",135,444,309,"CCGCCAGCTGGTCCACCAAA","AAGTCAGGTGCAGGGTTTCT","561307.5.peg.2308","1456"
"18455",85,452,367,"AATACCATTACCACCATCAC","TTTCACTGAAGTCAGGTGCA","561307.5.peg.2308","1456"
"18456",147,452,305,"TTACCACCGTCACCGCCAGC","TTTCACTGAAGTCAGGTGCA","561307.5.peg.2308","1456"
"18457",633,452,181,"GTTGAAACAACACCTAGATT","TTTCACTGAAGTCAGGTGCA","561307.5.peg.2308","1456"
"18458",135,452,317,"CCGCCAGCTGGTCCACCAAA","TTTCACTGAAGTCAGGTGCA","561307.5.peg.2308","1456"
"18459",266,452,186,"ACCATGCATATTACTACTT","TTTCACTGAAGTCAGGTGCA","561307.5.peg.2308","1456"
"18460",135,483,348,"CCGCCAGCTGGTCCACCAAA","GATACATCTAATTCCTCACC","561307.5.peg.2308","1456"
"18461",85,483,398,"AATACCATTACCACCATCAC","GATACATCTAATTCCTCACC","561307.5.peg.2308","1456"
"18462",266,483,217,"ACCATGCATATTACTACTT","GATACATCTAATTCCTCACC","561307.5.peg.2308","1456"
"18463",633,483,150,"GTTGAAACAACACCTAGATT","GATACATCTAATTCCTCACC","561307.5.peg.2308","1456"
"18464",147,483,336,"TTACCACCGTCACCGCCAGC","GATACATCTAATTCCTCACC","561307.5.peg.2308","1456"
"18465",147,548,401,"TTACCACCGTCACCGCCAGC","AAGTCGATTTACCCACACTA","561307.5.peg.2308","1456"
"18466",444,548,104,"AAGTCAGGTGCAGGGTTTCT","AAGTCGATTTACCCACACTA","561307.5.peg.2308","1456"
"18467",85,548,463,"AATACCATTACCACCATCAC","AAGTCGATTTACCCACACTA","561307.5.peg.2308","1456"
"18468",135,548,413,"CCGCCAGCTGGTCCACCAAA","AAGTCGATTTACCCACACTA","561307.5.peg.2308","1456"
"18469",266,548,282,"ACCATGCATATTACTACTT","AAGTCGATTTACCCACACTA","561307.5.peg.2308","1456"
"18470",266,633,367,"ACCATGCATATTACTACTT","GTTGAAACAACACCTAGATT","561307.5.peg.2308","1456"
"18471",147,633,486,"TTACCACCGTCACCGCCAGC","GTTGAAACAACACCTAGATT","561307.5.peg.2308","1456"
"18472",135,633,498,"CCGCCAGCTGGTCCACCAAA","GTTGAAACAACACCTAGATT","561307.5.peg.2308","1456"
"18473",85,633,548,"AATACCATTACCACCATCAC","GTTGAAACAACACCTAGATT","561307.5.peg.2308","1456"
"18474",483,633,150,"GATACATCTAATTCCTCACC","GTTGAAACAACACCTAGATT","561307.5.peg.2308","1456"
"18475",444,633,189,"AAGTCAGGTGCAGGGTTTCT","GTTGAAACAACACCTAGATT","561307.5.peg.2308","1456"
"18476",452,633,181,"TTTCACTGAAGTCAGGTGCA","GTTGAAACAACACCTAGATT","561307.5.peg.2308","1456"
"18477",123,8,115,"TCAAACTTACCTATGTGCAT","AATTCCTGATGATGAAAGCA","561307.5.peg.2312","1461"
"18478",8,123,115,"AATTCCTGATGATGAAAGCA","TCAAACTTACCTATGTGCAT","561307.5.peg.2312","1461"
"18479",287,1,286,"GTTGGTTCTTAGATTCTAAC","TTGACATAATAGAGGTGTTC","561307.5.peg.2313","1462"
"18480",405,1,404,"ATTGTATTCATCCACTGATC","TTGACATAATAGAGGTGTTC","561307.5.peg.2313","1462"
"18481",130,1,129,"TGATTGAGATTGTGAACGTA","TTGACATAATAGAGGTGTTC","561307.5.peg.2313","1462"
"18482",1,130,129,"TTGACATAATAGAGGTGTTC","TGATTGAGATTGTGAACGTA","561307.5.peg.2313","1462"
"18483",287,130,157,"GTTGGTTCTTAGATTCTAAC","TGATTGAGATTGTGAACGTA","561307.5.peg.2313","1462"
"18484",405,130,275,"ATTGTATTCATCCACTGATC","TGATTGAGATTGTGAACGTA","561307.5.peg.2313","1462"
"18485",1,287,286,"TTGACATAATAGAGGTGTTC","GTTGGTTCTTAGATTCTAAC","561307.5.peg.2313","1462"
"18486",405,287,118,"ATTGTATTCATCCACTGATC","GTTGGTTCTTAGATTCTAAC","561307.5.peg.2313","1462"
"18487",130,287,157,"TGATTGAGATTGTGAACGTA","GTTGGTTCTTAGATTCTAAC","561307.5.peg.2313","1462"
"18488",1,405,404,"TTGACATAATAGAGGTGTTC","ATTGTATTCATCCACTGATC","561307.5.peg.2313","1462"
"18489",130,405,275,"TGATTGAGATTGTGAACGTA","ATTGTATTCATCCACTGATC","561307.5.peg.2313","1462"
"18490",287,405,118,"GTTGGTTCTTAGATTCTAAC","ATTGTATTCATCCACTGATC","561307.5.peg.2313","1462"
"18491",162,7,155,"GATCATTATCGTGATTTAC","AATTAGATGAAGACATTGG","561307.5.peg.2315","1464"
"18492",204,7,197,"ACATGTTGGGCATCATTAGT","AATTAGATGAAGACATTGG","561307.5.peg.2315","1464"
"18493",217,7,210,"ACCACTTACATAAACATGTT","AATTAGATGAAGACATTGG","561307.5.peg.2315","1464"
"18494",7,162,155,"AATTAGATGAAGACATTGG","GATCATTATCGTGATTTAC","561307.5.peg.2315","1464"
"18495",7,204,197,"AATTAGATGAAGACATTGG","ACATGTTGGGCATCATTAGT","561307.5.peg.2315","1464"
"18496",7,217,210,"AATTAGATGAAGACATTGG","ACCACTTACATAAACATGTT","561307.5.peg.2315","1464"
"18497",366,84,282,"TATAATCAGCAACATCACT","TGGCTTAACAAACGTTCTCT","561307.5.peg.2317","1466"
"18498",84,366,282,"TGGCTTAACAAACGTTCTCT","TATAATCAGCAACATCACT","561307.5.peg.2317","1466"
"18499",360,59,301,"CGTTCCATCATTTCACTTAC","GTATCCAATACAAGCTCTCT","561307.5.peg.2319","1468"
"18500",624,59,565,"GCATATATCACTGGAACGTT","GTATCCAATACAAGCTCTCT","561307.5.peg.2319","1468"
"18501",218,59,159,"TTCAACTAAAGCTGTTCTA","GTATCCAATACAAGCTCTCT","561307.5.peg.2319","1468"
"18502",59,218,159,"GTATCCAATACAAGCTCTCT","TTCAACTAAAGCTGTTCTA","561307.5.peg.2319","1468"
"18503",360,218,142,"CGTTCCATCATTTCACTTAC","TTCAACTAAAGCTGTTCTA","561307.5.peg.2319","1468"
"18504",624,218,406,"GCATATATCACTGGAACGTT","TTCAACTAAAGCTGTTCTA","561307.5.peg.2319","1468"
"18505",59,360,301,"GTATCCAATACAAGCTCTCT","CGTTCCATCATTTCACTTAC","561307.5.peg.2319","1468"
"18506",624,360,264,"GCATATATCACTGGAACGTT","CGTTCCATCATTTCACTTAC","561307.5.peg.2319","1468"
"18507",218,360,142,"TTCAACTAAAGCTGTTCTA","CGTTCCATCATTTCACTTAC","561307.5.peg.2319","1468"
"18508",59,624,565,"GTATCCAATACAAGCTCTCT","GCATATATCACTGGAACGTT","561307.5.peg.2319","1468"
"18509",218,624,406,"TTCAACTAAAGCTGTTCTA","GCATATATCACTGGAACGTT","561307.5.peg.2319","1468"
"18510",360,624,264,"CGTTCCATCATTTCACTTAC","GCATATATCACTGGAACGTT","561307.5.peg.2319","1468"
"18511",285,75,210,"ATACCAGCATGATCCATACC","CGTCCCGCTTCAACTTCACG","561307.5.peg.2320","1470"
"18512",582,75,507,"GATAAAGCTGTACGTGCTTT","CGTCCCGCTTCAACTTCACG","561307.5.peg.2320","1470"
"18513",660,75,585,"AAACCTTCACCATCAGCGTA","CGTCCCGCTTCAACTTCACG","561307.5.peg.2320","1470"
"18514",873,75,798,"AAATCATTAGGGTCATGTGC","CGTCCCGCTTCAACTTCACG","561307.5.peg.2320","1470"
"18515",792,75,717,"GGCAGTTCGCGTCCTACGAT","CGTCCCGCTTCAACTTCACG","561307.5.peg.2320","1470"
"18516",177,75,102,"ATTTACCAGTTACATTTGG","CGTCCCGCTTCAACTTCACG","561307.5.peg.2320","1470"
"18517",1290,75,1215,"GTTTCTTTATGATACCAAGC","CGTCCCGCTTCAACTTCACG","561307.5.peg.2320","1470"
"18518",1200,75,1125,"AATGTATGTTCGAAACGTTG","CGTCCCGCTTCAACTTCACG","561307.5.peg.2320","1470"
"18519",285,173,112,"ATACCAGCATGATCCATACC","TACCAGTTACATTTGGTGGC","561307.5.peg.2320","1470"
"18520",873,173,700,"AAATCATTAGGGTCATGTGC","TACCAGTTACATTTGGTGGC","561307.5.peg.2320","1470"
"18521",1200,173,1027,"AATGTATGTTCGAAACGTTG","TACCAGTTACATTTGGTGGC","561307.5.peg.2320","1470"
"18522",792,173,619,"GGCAGTTCGCGTCCTACGAT","TACCAGTTACATTTGGTGGC","561307.5.peg.2320","1470"
"18523",582,173,409,"GATAAAGCTGTACGTGCTTT","TACCAGTTACATTTGGTGGC","561307.5.peg.2320","1470"
"18524",1290,173,1117,"GTTTCTTTATGATACCAAGC","TACCAGTTACATTTGGTGGC","561307.5.peg.2320","1470"
"18525",660,173,487,"AAACCTTCACCATCAGCGTA","TACCAGTTACATTTGGTGGC","561307.5.peg.2320","1470"
"18526",75,177,102,"CGTCCCGCTTCAACTTCACG","ATTTACCAGTTACATTTGG","561307.5.peg.2320","1470"
"18527",660,177,483,"AAACCTTCACCATCAGCGTA","ATTTACCAGTTACATTTGG","561307.5.peg.2320","1470"
"18528",582,177,405,"GATAAAGCTGTACGTGCTTT","ATTTACCAGTTACATTTGG","561307.5.peg.2320","1470"
"18529",1290,177,1113,"GTTTCTTTATGATACCAAGC","ATTTACCAGTTACATTTGG","561307.5.peg.2320","1470"
"18530",285,177,108,"ATACCAGCATGATCCATACC","ATTTACCAGTTACATTTGG","561307.5.peg.2320","1470"
"18531",792,177,615,"GGCAGTTCGCGTCCTACGAT","ATTTACCAGTTACATTTGG","561307.5.peg.2320","1470"
"18532",873,177,696,"AAATCATTAGGGTCATGTGC","ATTTACCAGTTACATTTGG","561307.5.peg.2320","1470"
"18533",1200,177,1023,"AATGTATGTTCGAAACGTTG","ATTTACCAGTTACATTTGG","561307.5.peg.2320","1470"
"18534",660,285,375,"AAACCTTCACCATCAGCGTA","ATACCAGCATGATCCATACC","561307.5.peg.2320","1470"
"18535",792,285,507,"GGCAGTTCGCGTCCTACGAT","ATACCAGCATGATCCATACC","561307.5.peg.2320","1470"
"18536",1290,285,1005,"GTTTCTTTATGATACCAAGC","ATACCAGCATGATCCATACC","561307.5.peg.2320","1470"
"18537",1200,285,915,"AATGTATGTTCGAAACGTTG","ATACCAGCATGATCCATACC","561307.5.peg.2320","1470"
"18538",173,285,112,"TACCAGTTACATTTGGTGGC","ATACCAGCATGATCCATACC","561307.5.peg.2320","1470"
"18539",582,285,297,"GATAAAGCTGTACGTGCTTT","ATACCAGCATGATCCATACC","561307.5.peg.2320","1470"
"18540",75,285,210,"CGTCCCGCTTCAACTTCACG","ATACCAGCATGATCCATACC","561307.5.peg.2320","1470"
"18541",177,285,108,"ATTTACCAGTTACATTTGG","ATACCAGCATGATCCATACC","561307.5.peg.2320","1470"
"18542",873,285,588,"AAATCATTAGGGTCATGTGC","ATACCAGCATGATCCATACC","561307.5.peg.2320","1470"
"18543",75,582,507,"CGTCCCGCTTCAACTTCACG","GATAAAGCTGTACGTGCTTT","561307.5.peg.2320","1470"
"18544",1290,582,708,"GTTTCTTTATGATACCAAGC","GATAAAGCTGTACGTGCTTT","561307.5.peg.2320","1470"
"18545",177,582,405,"ATTTACCAGTTACATTTGG","GATAAAGCTGTACGTGCTTT","561307.5.peg.2320","1470"
"18546",1200,582,618,"AATGTATGTTCGAAACGTTG","GATAAAGCTGTACGTGCTTT","561307.5.peg.2320","1470"
"18547",792,582,210,"GGCAGTTCGCGTCCTACGAT","GATAAAGCTGTACGTGCTTT","561307.5.peg.2320","1470"
"18548",873,582,291,"AAATCATTAGGGTCATGTGC","GATAAAGCTGTACGTGCTTT","561307.5.peg.2320","1470"
"18549",285,582,297,"ATACCAGCATGATCCATACC","GATAAAGCTGTACGTGCTTT","561307.5.peg.2320","1470"
"18550",173,582,409,"TACCAGTTACATTTGGTGGC","GATAAAGCTGTACGTGCTTT","561307.5.peg.2320","1470"
"18551",1200,660,540,"AATGTATGTTCGAAACGTTG","AAACCTTCACCATCAGCGTA","561307.5.peg.2320","1470"
"18552",873,660,213,"AAATCATTAGGGTCATGTGC","AAACCTTCACCATCAGCGTA","561307.5.peg.2320","1470"
"18553",792,660,132,"GGCAGTTCGCGTCCTACGAT","AAACCTTCACCATCAGCGTA","561307.5.peg.2320","1470"
"18554",177,660,483,"ATTTACCAGTTACATTTGG","AAACCTTCACCATCAGCGTA","561307.5.peg.2320","1470"
"18555",1290,660,630,"GTTTCTTTATGATACCAAGC","AAACCTTCACCATCAGCGTA","561307.5.peg.2320","1470"
"18556",75,660,585,"CGTCCCGCTTCAACTTCACG","AAACCTTCACCATCAGCGTA","561307.5.peg.2320","1470"
"18557",173,660,487,"TACCAGTTACATTTGGTGGC","AAACCTTCACCATCAGCGTA","561307.5.peg.2320","1470"
"18558",285,660,375,"ATACCAGCATGATCCATACC","AAACCTTCACCATCAGCGTA","561307.5.peg.2320","1470"
"18559",582,792,210,"GATAAAGCTGTACGTGCTTT","GGCAGTTCGCGTCCTACGAT","561307.5.peg.2320","1470"
"18560",285,792,507,"ATACCAGCATGATCCATACC","GGCAGTTCGCGTCCTACGAT","561307.5.peg.2320","1470"
"18561",75,792,717,"CGTCCCGCTTCAACTTCACG","GGCAGTTCGCGTCCTACGAT","561307.5.peg.2320","1470"
"18562",173,792,619,"TACCAGTTACATTTGGTGGC","GGCAGTTCGCGTCCTACGAT","561307.5.peg.2320","1470"
"18563",1200,792,408,"AATGTATGTTCGAAACGTTG","GGCAGTTCGCGTCCTACGAT","561307.5.peg.2320","1470"
"18564",177,792,615,"ATTTACCAGTTACATTTGG","GGCAGTTCGCGTCCTACGAT","561307.5.peg.2320","1470"
"18565",660,792,132,"AAACCTTCACCATCAGCGTA","GGCAGTTCGCGTCCTACGAT","561307.5.peg.2320","1470"
"18566",1290,792,498,"GTTTCTTTATGATACCAAGC","GGCAGTTCGCGTCCTACGAT","561307.5.peg.2320","1470"
"18567",285,873,588,"ATACCAGCATGATCCATACC","AAATCATTAGGGTCATGTGC","561307.5.peg.2320","1470"
"18568",75,873,798,"CGTCCCGCTTCAACTTCACG","AAATCATTAGGGTCATGTGC","561307.5.peg.2320","1470"
"18569",177,873,696,"ATTTACCAGTTACATTTGG","AAATCATTAGGGTCATGTGC","561307.5.peg.2320","1470"
"18570",1290,873,417,"GTTTCTTTATGATACCAAGC","AAATCATTAGGGTCATGTGC","561307.5.peg.2320","1470"
"18571",1200,873,327,"AATGTATGTTCGAAACGTTG","AAATCATTAGGGTCATGTGC","561307.5.peg.2320","1470"
"18572",173,873,700,"TACCAGTTACATTTGGTGGC","AAATCATTAGGGTCATGTGC","561307.5.peg.2320","1470"
"18573",582,873,291,"GATAAAGCTGTACGTGCTTT","AAATCATTAGGGTCATGTGC","561307.5.peg.2320","1470"
"18574",660,873,213,"AAACCTTCACCATCAGCGTA","AAATCATTAGGGTCATGTGC","561307.5.peg.2320","1470"
"18575",177,1200,1023,"ATTTACCAGTTACATTTGG","AATGTATGTTCGAAACGTTG","561307.5.peg.2320","1470"
"18576",75,1200,1125,"CGTCCCGCTTCAACTTCACG","AATGTATGTTCGAAACGTTG","561307.5.peg.2320","1470"
"18577",660,1200,540,"AAACCTTCACCATCAGCGTA","AATGTATGTTCGAAACGTTG","561307.5.peg.2320","1470"
"18578",582,1200,618,"GATAAAGCTGTACGTGCTTT","AATGTATGTTCGAAACGTTG","561307.5.peg.2320","1470"
"18579",285,1200,915,"ATACCAGCATGATCCATACC","AATGTATGTTCGAAACGTTG","561307.5.peg.2320","1470"
"18580",873,1200,327,"AAATCATTAGGGTCATGTGC","AATGTATGTTCGAAACGTTG","561307.5.peg.2320","1470"
"18581",173,1200,1027,"TACCAGTTACATTTGGTGGC","AATGTATGTTCGAAACGTTG","561307.5.peg.2320","1470"
"18582",792,1200,408,"GGCAGTTCGCGTCCTACGAT","AATGTATGTTCGAAACGTTG","561307.5.peg.2320","1470"
"18583",177,1290,1113,"ATTTACCAGTTACATTTGG","GTTTCTTTATGATACCAAGC","561307.5.peg.2320","1470"
"18584",173,1290,1117,"TACCAGTTACATTTGGTGGC","GTTTCTTTATGATACCAAGC","561307.5.peg.2320","1470"
"18585",873,1290,417,"AAATCATTAGGGTCATGTGC","GTTTCTTTATGATACCAAGC","561307.5.peg.2320","1470"
"18586",660,1290,630,"AAACCTTCACCATCAGCGTA","GTTTCTTTATGATACCAAGC","561307.5.peg.2320","1470"
"18587",75,1290,1215,"CGTCCCGCTTCAACTTCACG","GTTTCTTTATGATACCAAGC","561307.5.peg.2320","1470"
"18588",792,1290,498,"GGCAGTTCGCGTCCTACGAT","GTTTCTTTATGATACCAAGC","561307.5.peg.2320","1470"
"18589",285,1290,1005,"ATACCAGCATGATCCATACC","GTTTCTTTATGATACCAAGC","561307.5.peg.2320","1470"
"18590",582,1290,708,"GATAAAGCTGTACGTGCTTT","GTTTCTTTATGATACCAAGC","561307.5.peg.2320","1470"
"18591",120,7,113,"AATGCCTTGCTATCATAGAG","AATAAGTCAATGTATAGGT","561307.5.peg.2321","1471"
"18592",265,7,258,"TAAGCGGTCGATATCTTGAG","AATAAGTCAATGTATAGGT","561307.5.peg.2321","1471"
"18593",297,7,290,"TACGATGATGAACGATATT","AATAAGTCAATGTATAGGT","561307.5.peg.2321","1471"
"18594",297,81,216,"TACGATGATGAACGATATT","TCATGATAGTCTAAGTAGAC","561307.5.peg.2321","1471"
"18595",265,81,184,"TAAGCGGTCGATATCTTGAG","TCATGATAGTCTAAGTAGAC","561307.5.peg.2321","1471"
"18596",7,120,113,"AATAAGTCAATGTATAGGT","AATGCCTTGCTATCATAGAG","561307.5.peg.2321","1471"
"18597",265,120,145,"TAAGCGGTCGATATCTTGAG","AATGCCTTGCTATCATAGAG","561307.5.peg.2321","1471"
"18598",297,120,177,"TACGATGATGAACGATATT","AATGCCTTGCTATCATAGAG","561307.5.peg.2321","1471"
"18599",7,265,258,"AATAAGTCAATGTATAGGT","TAAGCGGTCGATATCTTGAG","561307.5.peg.2321","1471"
"18600",120,265,145,"AATGCCTTGCTATCATAGAG","TAAGCGGTCGATATCTTGAG","561307.5.peg.2321","1471"
"18601",81,265,184,"TCATGATAGTCTAAGTAGAC","TAAGCGGTCGATATCTTGAG","561307.5.peg.2321","1471"
"18602",7,297,290,"AATAAGTCAATGTATAGGT","TACGATGATGAACGATATT","561307.5.peg.2321","1471"
"18603",81,297,216,"TCATGATAGTCTAAGTAGAC","TACGATGATGAACGATATT","561307.5.peg.2321","1471"
"18604",120,297,177,"AATGCCTTGCTATCATAGAG","TACGATGATGAACGATATT","561307.5.peg.2321","1471"
"18605",543,24,519,"TCAGGCACACCAGGAGAATC","AAATTCCTCCTACAGTTTA","561307.5.peg.2324","1474"
"18606",552,24,528,"GCAATACCTTCAGGCACACC","AAATTCCTCCTACAGTTTA","561307.5.peg.2324","1474"
"18607",594,24,570,"GTGCATCTAAATCATTGTA","AAATTCCTCCTACAGTTTA","561307.5.peg.2324","1474"
"18608",543,102,441,"TCAGGCACACCAGGAGAATC","ACTGGACTATTTACACCACC","561307.5.peg.2324","1474"
"18609",594,102,492,"GTGCATCTAAATCATTGTA","ACTGGACTATTTACACCACC","561307.5.peg.2324","1474"
"18610",552,102,450,"GCAATACCTTCAGGCACACC","ACTGGACTATTTACACCACC","561307.5.peg.2324","1474"
"18611",543,120,423,"TCAGGCACACCAGGAGAATC","ACTGATTTAAATGCGCGTAC","561307.5.peg.2324","1474"
"18612",594,120,474,"GTGCATCTAAATCATTGTA","ACTGATTTAAATGCGCGTAC","561307.5.peg.2324","1474"
"18613",552,120,432,"GCAATACCTTCAGGCACACC","ACTGATTTAAATGCGCGTAC","561307.5.peg.2324","1474"
"18614",24,543,519,"AAATTCCTCCTACAGTTTA","TCAGGCACACCAGGAGAATC","561307.5.peg.2324","1474"
"18615",102,543,441,"ACTGGACTATTTACACCACC","TCAGGCACACCAGGAGAATC","561307.5.peg.2324","1474"
"18616",120,543,423,"ACTGATTTAAATGCGCGTAC","TCAGGCACACCAGGAGAATC","561307.5.peg.2324","1474"
"18617",24,552,528,"AAATTCCTCCTACAGTTTA","GCAATACCTTCAGGCACACC","561307.5.peg.2324","1474"
"18618",120,552,432,"ACTGATTTAAATGCGCGTAC","GCAATACCTTCAGGCACACC","561307.5.peg.2324","1474"
"18619",102,552,450,"ACTGGACTATTTACACCACC","GCAATACCTTCAGGCACACC","561307.5.peg.2324","1474"
"18620",24,594,570,"AAATTCCTCCTACAGTTTA","GTGCATCTAAATCATTGTA","561307.5.peg.2324","1474"
"18621",120,594,474,"ACTGATTTAAATGCGCGTAC","GTGCATCTAAATCATTGTA","561307.5.peg.2324","1474"
"18622",102,594,492,"ACTGGACTATTTACACCACC","GTGCATCTAAATCATTGTA","561307.5.peg.2324","1474"
"18623",449,195,254,"CATTGTCAACGTCATGTGTA","AAACTGATTTGGTATACACC","561307.5.peg.2325","1475"
"18624",195,449,254,"AAACTGATTTGGTATACACC","CATTGTCAACGTCATGTGTA","561307.5.peg.2325","1475"
"18625",300,9,291,"AAACCTTCCGGAATTACACT","TAGAGCAATCCGTTCCTAGG","561307.5.peg.2327","1477"
"18626",312,9,303,"CAACCTAATGTTAAACCTTC","TAGAGCAATCCGTTCCTAGG","561307.5.peg.2327","1477"
"18627",387,9,378,"CCTTCTGGCAATTGGGATAG","TAGAGCAATCCGTTCCTAGG","561307.5.peg.2327","1477"
"18628",394,9,385,"AATACTGCCTTCTGGCAATT","TAGAGCAATCCGTTCCTAGG","561307.5.peg.2327","1477"
"18629",300,12,288,"AAACCTTCCGGAATTACACT","ATCTAGAGCAATCCGTTCCT","561307.5.peg.2327","1477"
"18630",312,12,300,"CAACCTAATGTTAAACCTTC","ATCTAGAGCAATCCGTTCCT","561307.5.peg.2327","1477"
"18631",387,12,375,"CCTTCTGGCAATTGGGATAG","ATCTAGAGCAATCCGTTCCT","561307.5.peg.2327","1477"
"18632",394,12,382,"AATACTGCCTTCTGGCAATT","ATCTAGAGCAATCCGTTCCT","561307.5.peg.2327","1477"
"18633",300,29,271,"AAACCTTCCGGAATTACACT","TGTTCAATTCCTCCTAGGAA","561307.5.peg.2327","1477"
"18634",312,29,283,"CAACCTAATGTTAAACCTTC","TGTTCAATTCCTCCTAGGAA","561307.5.peg.2327","1477"
"18635",387,29,358,"CCTTCTGGCAATTGGGATAG","TGTTCAATTCCTCCTAGGAA","561307.5.peg.2327","1477"
"18636",394,29,365,"AATACTGCCTTCTGGCAATT","TGTTCAATTCCTCCTAGGAA","561307.5.peg.2327","1477"
"18637",300,34,266,"AAACCTTCCGGAATTACACT","ACGCATGTTCAATTCCTCCT","561307.5.peg.2327","1477"
"18638",312,34,278,"CAACCTAATGTTAAACCTTC","ACGCATGTTCAATTCCTCCT","561307.5.peg.2327","1477"
"18639",387,34,353,"CCTTCTGGCAATTGGGATAG","ACGCATGTTCAATTCCTCCT","561307.5.peg.2327","1477"
"18640",394,34,360,"AATACTGCCTTCTGGCAATT","ACGCATGTTCAATTCCTCCT","561307.5.peg.2327","1477"
"18641",9,300,291,"TAGAGCAATCCGTTCCTAGG","AAACCTTCCGGAATTACACT","561307.5.peg.2327","1477"
"18642",12,300,288,"ATCTAGAGCAATCCGTTCCT","AAACCTTCCGGAATTACACT","561307.5.peg.2327","1477"
"18643",29,300,271,"TGTTCAATTCCTCCTAGGAA","AAACCTTCCGGAATTACACT","561307.5.peg.2327","1477"
"18644",34,300,266,"ACGCATGTTCAATTCCTCCT","AAACCTTCCGGAATTACACT","561307.5.peg.2327","1477"
"18645",9,312,303,"TAGAGCAATCCGTTCCTAGG","CAACCTAATGTTAAACCTTC","561307.5.peg.2327","1477"
"18646",12,312,300,"ATCTAGAGCAATCCGTTCCT","CAACCTAATGTTAAACCTTC","561307.5.peg.2327","1477"
"18647",29,312,283,"TGTTCAATTCCTCCTAGGAA","CAACCTAATGTTAAACCTTC","561307.5.peg.2327","1477"
"18648",34,312,278,"ACGCATGTTCAATTCCTCCT","CAACCTAATGTTAAACCTTC","561307.5.peg.2327","1477"
"18649",9,387,378,"TAGAGCAATCCGTTCCTAGG","CCTTCTGGCAATTGGGATAG","561307.5.peg.2327","1477"
"18650",12,387,375,"ATCTAGAGCAATCCGTTCCT","CCTTCTGGCAATTGGGATAG","561307.5.peg.2327","1477"
"18651",29,387,358,"TGTTCAATTCCTCCTAGGAA","CCTTCTGGCAATTGGGATAG","561307.5.peg.2327","1477"
"18652",34,387,353,"ACGCATGTTCAATTCCTCCT","CCTTCTGGCAATTGGGATAG","561307.5.peg.2327","1477"
"18653",9,394,385,"TAGAGCAATCCGTTCCTAGG","AATACTGCCTTCTGGCAATT","561307.5.peg.2327","1477"
"18654",12,394,382,"ATCTAGAGCAATCCGTTCCT","AATACTGCCTTCTGGCAATT","561307.5.peg.2327","1477"
"18655",29,394,365,"TGTTCAATTCCTCCTAGGAA","AATACTGCCTTCTGGCAATT","561307.5.peg.2327","1477"
"18656",34,394,360,"ACGCATGTTCAATTCCTCCT","AATACTGCCTTCTGGCAATT","561307.5.peg.2327","1477"
"18657",393,243,150,"CCTTATTAGTATAATGTGT","ACATCTGAAATAGACCCTAA","561307.5.peg.2328","1478"
"18658",243,393,150,"ACATCTGAAATAGACCCTAA","CCTTATTAGTATAATGTGT","561307.5.peg.2328","1478"
"18659",130,9,121,"ATCTTCATGGGCAATTCGTA","GTATTGTTAGTATATATGG","561307.5.peg.2329","1479"
"18660",9,130,121,"GTATTGTTAGTATATATGG","ATCTTCATGGGCAATTCGTA","561307.5.peg.2329","1479"
"18661",580,99,481,"ATTATGACAAATACCGCCTC","GCTGCTTGACCTATGATAAT","561307.5.peg.233","1480"
"18662",474,99,375,"ACAATGTCACTCTCTGGTAC","GCTGCTTGACCTATGATAAT","561307.5.peg.233","1480"
"18663",201,99,102,"TTATCAGTCATGATTGTCGC","GCTGCTTGACCTATGATAAT","561307.5.peg.233","1480"
"18664",297,99,198,"AAAGTTGGAAGTAAAGCGTC","GCTGCTTGACCTATGATAAT","561307.5.peg.233","1480"
"18665",648,99,549,"TCTAATAAACATTGCGTTGC","GCTGCTTGACCTATGATAAT","561307.5.peg.233","1480"
"18666",1059,99,960,"GCATAAGATGTTCCTGTAAT","GCTGCTTGACCTATGATAAT","561307.5.peg.233","1480"
"18667",480,99,381,"GTATTTACAATGTCACTCTC","GCTGCTTGACCTATGATAAT","561307.5.peg.233","1480"
"18668",1599,99,1500,"GTATCAACCATCTTGTAAAC","GCTGCTTGACCTATGATAAT","561307.5.peg.233","1480"
"18669",558,99,459,"GTACCACCCATCGTAAATGC","GCTGCTTGACCTATGATAAT","561307.5.peg.233","1480"
"18670",733,99,634,"TTCCATGTTACATACAACGA","GCTGCTTGACCTATGATAAT","561307.5.peg.233","1480"
"18671",1201,99,1102,"TTCTTCGTAAGTTCGACCAA","GCTGCTTGACCTATGATAAT","561307.5.peg.233","1480"
"18672",389,99,290,"TAGCTCAGTTCCTAATAAT","GCTGCTTGACCTATGATAAT","561307.5.peg.233","1480"
"18673",542,99,443,"ATGCCGGTCTAACAATTAGC","GCTGCTTGACCTATGATAAT","561307.5.peg.233","1480"
"18674",951,99,852,"GCTGATGAACGTGATACACG","GCTGCTTGACCTATGATAAT","561307.5.peg.233","1480"
"18675",1278,99,1179,"AGATCGAAGCTTTCACCATT","GCTGCTTGACCTATGATAAT","561307.5.peg.233","1480"
"18676",542,201,341,"ATGCCGGTCTAACAATTAGC","TTATCAGTCATGATTGTCGC","561307.5.peg.233","1480"
"18677",580,201,379,"ATTATGACAAATACCGCCTC","TTATCAGTCATGATTGTCGC","561307.5.peg.233","1480"
"18678",648,201,447,"TCTAATAAACATTGCGTTGC","TTATCAGTCATGATTGTCGC","561307.5.peg.233","1480"
"18679",1599,201,1398,"GTATCAACCATCTTGTAAAC","TTATCAGTCATGATTGTCGC","561307.5.peg.233","1480"
"18680",1201,201,1000,"TTCTTCGTAAGTTCGACCAA","TTATCAGTCATGATTGTCGC","561307.5.peg.233","1480"
"18681",389,201,188,"TAGCTCAGTTCCTAATAAT","TTATCAGTCATGATTGTCGC","561307.5.peg.233","1480"
"18682",558,201,357,"GTACCACCCATCGTAAATGC","TTATCAGTCATGATTGTCGC","561307.5.peg.233","1480"
"18683",951,201,750,"GCTGATGAACGTGATACACG","TTATCAGTCATGATTGTCGC","561307.5.peg.233","1480"
"18684",1059,201,858,"GCATAAGATGTTCCTGTAAT","TTATCAGTCATGATTGTCGC","561307.5.peg.233","1480"
"18685",99,201,102,"GCTGCTTGACCTATGATAAT","TTATCAGTCATGATTGTCGC","561307.5.peg.233","1480"
"18686",1278,201,1077,"AGATCGAAGCTTTCACCATT","TTATCAGTCATGATTGTCGC","561307.5.peg.233","1480"
"18687",733,201,532,"TTCCATGTTACATACAACGA","TTATCAGTCATGATTGTCGC","561307.5.peg.233","1480"
"18688",474,201,273,"ACAATGTCACTCTCTGGTAC","TTATCAGTCATGATTGTCGC","561307.5.peg.233","1480"
"18689",480,201,279,"GTATTTACAATGTCACTCTC","TTATCAGTCATGATTGTCGC","561307.5.peg.233","1480"
"18690",951,297,654,"GCTGATGAACGTGATACACG","AAAGTTGGAAGTAAAGCGTC","561307.5.peg.233","1480"
"18691",733,297,436,"TTCCATGTTACATACAACGA","AAAGTTGGAAGTAAAGCGTC","561307.5.peg.233","1480"
"18692",99,297,198,"GCTGCTTGACCTATGATAAT","AAAGTTGGAAGTAAAGCGTC","561307.5.peg.233","1480"
"18693",648,297,351,"TCTAATAAACATTGCGTTGC","AAAGTTGGAAGTAAAGCGTC","561307.5.peg.233","1480"
"18694",542,297,245,"ATGCCGGTCTAACAATTAGC","AAAGTTGGAAGTAAAGCGTC","561307.5.peg.233","1480"
"18695",1599,297,1302,"GTATCAACCATCTTGTAAAC","AAAGTTGGAAGTAAAGCGTC","561307.5.peg.233","1480"
"18696",1278,297,981,"AGATCGAAGCTTTCACCATT","AAAGTTGGAAGTAAAGCGTC","561307.5.peg.233","1480"
"18697",480,297,183,"GTATTTACAATGTCACTCTC","AAAGTTGGAAGTAAAGCGTC","561307.5.peg.233","1480"
"18698",558,297,261,"GTACCACCCATCGTAAATGC","AAAGTTGGAAGTAAAGCGTC","561307.5.peg.233","1480"
"18699",580,297,283,"ATTATGACAAATACCGCCTC","AAAGTTGGAAGTAAAGCGTC","561307.5.peg.233","1480"
"18700",1201,297,904,"TTCTTCGTAAGTTCGACCAA","AAAGTTGGAAGTAAAGCGTC","561307.5.peg.233","1480"
"18701",1059,297,762,"GCATAAGATGTTCCTGTAAT","AAAGTTGGAAGTAAAGCGTC","561307.5.peg.233","1480"
"18702",474,297,177,"ACAATGTCACTCTCTGGTAC","AAAGTTGGAAGTAAAGCGTC","561307.5.peg.233","1480"
"18703",558,389,169,"GTACCACCCATCGTAAATGC","TAGCTCAGTTCCTAATAAT","561307.5.peg.233","1480"
"18704",1201,389,812,"TTCTTCGTAAGTTCGACCAA","TAGCTCAGTTCCTAATAAT","561307.5.peg.233","1480"
"18705",951,389,562,"GCTGATGAACGTGATACACG","TAGCTCAGTTCCTAATAAT","561307.5.peg.233","1480"
"18706",542,389,153,"ATGCCGGTCTAACAATTAGC","TAGCTCAGTTCCTAATAAT","561307.5.peg.233","1480"
"18707",1278,389,889,"AGATCGAAGCTTTCACCATT","TAGCTCAGTTCCTAATAAT","561307.5.peg.233","1480"
"18708",1599,389,1210,"GTATCAACCATCTTGTAAAC","TAGCTCAGTTCCTAATAAT","561307.5.peg.233","1480"
"18709",648,389,259,"TCTAATAAACATTGCGTTGC","TAGCTCAGTTCCTAATAAT","561307.5.peg.233","1480"
"18710",733,389,344,"TTCCATGTTACATACAACGA","TAGCTCAGTTCCTAATAAT","561307.5.peg.233","1480"
"18711",99,389,290,"GCTGCTTGACCTATGATAAT","TAGCTCAGTTCCTAATAAT","561307.5.peg.233","1480"
"18712",580,389,191,"ATTATGACAAATACCGCCTC","TAGCTCAGTTCCTAATAAT","561307.5.peg.233","1480"
"18713",1059,389,670,"GCATAAGATGTTCCTGTAAT","TAGCTCAGTTCCTAATAAT","561307.5.peg.233","1480"
"18714",201,389,188,"TTATCAGTCATGATTGTCGC","TAGCTCAGTTCCTAATAAT","561307.5.peg.233","1480"
"18715",1201,474,727,"TTCTTCGTAAGTTCGACCAA","ACAATGTCACTCTCTGGTAC","561307.5.peg.233","1480"
"18716",99,474,375,"GCTGCTTGACCTATGATAAT","ACAATGTCACTCTCTGGTAC","561307.5.peg.233","1480"
"18717",733,474,259,"TTCCATGTTACATACAACGA","ACAATGTCACTCTCTGGTAC","561307.5.peg.233","1480"
"18718",297,474,177,"AAAGTTGGAAGTAAAGCGTC","ACAATGTCACTCTCTGGTAC","561307.5.peg.233","1480"
"18719",951,474,477,"GCTGATGAACGTGATACACG","ACAATGTCACTCTCTGGTAC","561307.5.peg.233","1480"
"18720",1059,474,585,"GCATAAGATGTTCCTGTAAT","ACAATGTCACTCTCTGGTAC","561307.5.peg.233","1480"
"18721",201,474,273,"TTATCAGTCATGATTGTCGC","ACAATGTCACTCTCTGGTAC","561307.5.peg.233","1480"
"18722",1278,474,804,"AGATCGAAGCTTTCACCATT","ACAATGTCACTCTCTGGTAC","561307.5.peg.233","1480"
"18723",1599,474,1125,"GTATCAACCATCTTGTAAAC","ACAATGTCACTCTCTGGTAC","561307.5.peg.233","1480"
"18724",648,474,174,"TCTAATAAACATTGCGTTGC","ACAATGTCACTCTCTGGTAC","561307.5.peg.233","1480"
"18725",580,474,106,"ATTATGACAAATACCGCCTC","ACAATGTCACTCTCTGGTAC","561307.5.peg.233","1480"
"18726",1599,480,1119,"GTATCAACCATCTTGTAAAC","GTATTTACAATGTCACTCTC","561307.5.peg.233","1480"
"18727",1059,480,579,"GCATAAGATGTTCCTGTAAT","GTATTTACAATGTCACTCTC","561307.5.peg.233","1480"
"18728",648,480,168,"TCTAATAAACATTGCGTTGC","GTATTTACAATGTCACTCTC","561307.5.peg.233","1480"
"18729",201,480,279,"TTATCAGTCATGATTGTCGC","GTATTTACAATGTCACTCTC","561307.5.peg.233","1480"
"18730",951,480,471,"GCTGATGAACGTGATACACG","GTATTTACAATGTCACTCTC","561307.5.peg.233","1480"
"18731",1278,480,798,"AGATCGAAGCTTTCACCATT","GTATTTACAATGTCACTCTC","561307.5.peg.233","1480"
"18732",733,480,253,"TTCCATGTTACATACAACGA","GTATTTACAATGTCACTCTC","561307.5.peg.233","1480"
"18733",1201,480,721,"TTCTTCGTAAGTTCGACCAA","GTATTTACAATGTCACTCTC","561307.5.peg.233","1480"
"18734",99,480,381,"GCTGCTTGACCTATGATAAT","GTATTTACAATGTCACTCTC","561307.5.peg.233","1480"
"18735",580,480,100,"ATTATGACAAATACCGCCTC","GTATTTACAATGTCACTCTC","561307.5.peg.233","1480"
"18736",297,480,183,"AAAGTTGGAAGTAAAGCGTC","GTATTTACAATGTCACTCTC","561307.5.peg.233","1480"
"18737",648,542,106,"TCTAATAAACATTGCGTTGC","ATGCCGGTCTAACAATTAGC","561307.5.peg.233","1480"
"18738",1278,542,736,"AGATCGAAGCTTTCACCATT","ATGCCGGTCTAACAATTAGC","561307.5.peg.233","1480"
"18739",1201,542,659,"TTCTTCGTAAGTTCGACCAA","ATGCCGGTCTAACAATTAGC","561307.5.peg.233","1480"
"18740",99,542,443,"GCTGCTTGACCTATGATAAT","ATGCCGGTCTAACAATTAGC","561307.5.peg.233","1480"
"18741",201,542,341,"TTATCAGTCATGATTGTCGC","ATGCCGGTCTAACAATTAGC","561307.5.peg.233","1480"
"18742",951,542,409,"GCTGATGAACGTGATACACG","ATGCCGGTCTAACAATTAGC","561307.5.peg.233","1480"
"18743",733,542,191,"TTCCATGTTACATACAACGA","ATGCCGGTCTAACAATTAGC","561307.5.peg.233","1480"
"18744",1599,542,1057,"GTATCAACCATCTTGTAAAC","ATGCCGGTCTAACAATTAGC","561307.5.peg.233","1480"
"18745",1059,542,517,"GCATAAGATGTTCCTGTAAT","ATGCCGGTCTAACAATTAGC","561307.5.peg.233","1480"
"18746",389,542,153,"TAGCTCAGTTCCTAATAAT","ATGCCGGTCTAACAATTAGC","561307.5.peg.233","1480"
"18747",297,542,245,"AAAGTTGGAAGTAAAGCGTC","ATGCCGGTCTAACAATTAGC","561307.5.peg.233","1480"
"18748",99,558,459,"GCTGCTTGACCTATGATAAT","GTACCACCCATCGTAAATGC","561307.5.peg.233","1480"
"18749",297,558,261,"AAAGTTGGAAGTAAAGCGTC","GTACCACCCATCGTAAATGC","561307.5.peg.233","1480"
"18750",1599,558,1041,"GTATCAACCATCTTGTAAAC","GTACCACCCATCGTAAATGC","561307.5.peg.233","1480"
"18751",951,558,393,"GCTGATGAACGTGATACACG","GTACCACCCATCGTAAATGC","561307.5.peg.233","1480"
"18752",1278,558,720,"AGATCGAAGCTTTCACCATT","GTACCACCCATCGTAAATGC","561307.5.peg.233","1480"
"18753",201,558,357,"TTATCAGTCATGATTGTCGC","GTACCACCCATCGTAAATGC","561307.5.peg.233","1480"
"18754",1201,558,643,"TTCTTCGTAAGTTCGACCAA","GTACCACCCATCGTAAATGC","561307.5.peg.233","1480"
"18755",733,558,175,"TTCCATGTTACATACAACGA","GTACCACCCATCGTAAATGC","561307.5.peg.233","1480"
"18756",389,558,169,"TAGCTCAGTTCCTAATAAT","GTACCACCCATCGTAAATGC","561307.5.peg.233","1480"
"18757",1059,558,501,"GCATAAGATGTTCCTGTAAT","GTACCACCCATCGTAAATGC","561307.5.peg.233","1480"
"18758",201,580,379,"TTATCAGTCATGATTGTCGC","ATTATGACAAATACCGCCTC","561307.5.peg.233","1480"
"18759",480,580,100,"GTATTTACAATGTCACTCTC","ATTATGACAAATACCGCCTC","561307.5.peg.233","1480"
"18760",1278,580,698,"AGATCGAAGCTTTCACCATT","ATTATGACAAATACCGCCTC","561307.5.peg.233","1480"
"18761",733,580,153,"TTCCATGTTACATACAACGA","ATTATGACAAATACCGCCTC","561307.5.peg.233","1480"
"18762",1599,580,1019,"GTATCAACCATCTTGTAAAC","ATTATGACAAATACCGCCTC","561307.5.peg.233","1480"
"18763",1201,580,621,"TTCTTCGTAAGTTCGACCAA","ATTATGACAAATACCGCCTC","561307.5.peg.233","1480"
"18764",389,580,191,"TAGCTCAGTTCCTAATAAT","ATTATGACAAATACCGCCTC","561307.5.peg.233","1480"
"18765",1059,580,479,"GCATAAGATGTTCCTGTAAT","ATTATGACAAATACCGCCTC","561307.5.peg.233","1480"
"18766",951,580,371,"GCTGATGAACGTGATACACG","ATTATGACAAATACCGCCTC","561307.5.peg.233","1480"
"18767",99,580,481,"GCTGCTTGACCTATGATAAT","ATTATGACAAATACCGCCTC","561307.5.peg.233","1480"
"18768",297,580,283,"AAAGTTGGAAGTAAAGCGTC","ATTATGACAAATACCGCCTC","561307.5.peg.233","1480"
"18769",474,580,106,"ACAATGTCACTCTCTGGTAC","ATTATGACAAATACCGCCTC","561307.5.peg.233","1480"
"18770",99,648,549,"GCTGCTTGACCTATGATAAT","TCTAATAAACATTGCGTTGC","561307.5.peg.233","1480"
"18771",951,648,303,"GCTGATGAACGTGATACACG","TCTAATAAACATTGCGTTGC","561307.5.peg.233","1480"
"18772",542,648,106,"ATGCCGGTCTAACAATTAGC","TCTAATAAACATTGCGTTGC","561307.5.peg.233","1480"
"18773",201,648,447,"TTATCAGTCATGATTGTCGC","TCTAATAAACATTGCGTTGC","561307.5.peg.233","1480"
"18774",474,648,174,"ACAATGTCACTCTCTGGTAC","TCTAATAAACATTGCGTTGC","561307.5.peg.233","1480"
"18775",1599,648,951,"GTATCAACCATCTTGTAAAC","TCTAATAAACATTGCGTTGC","561307.5.peg.233","1480"
"18776",1278,648,630,"AGATCGAAGCTTTCACCATT","TCTAATAAACATTGCGTTGC","561307.5.peg.233","1480"
"18777",297,648,351,"AAAGTTGGAAGTAAAGCGTC","TCTAATAAACATTGCGTTGC","561307.5.peg.233","1480"
"18778",480,648,168,"GTATTTACAATGTCACTCTC","TCTAATAAACATTGCGTTGC","561307.5.peg.233","1480"
"18779",389,648,259,"TAGCTCAGTTCCTAATAAT","TCTAATAAACATTGCGTTGC","561307.5.peg.233","1480"
"18780",1201,648,553,"TTCTTCGTAAGTTCGACCAA","TCTAATAAACATTGCGTTGC","561307.5.peg.233","1480"
"18781",1059,648,411,"GCATAAGATGTTCCTGTAAT","TCTAATAAACATTGCGTTGC","561307.5.peg.233","1480"
"18782",297,733,436,"AAAGTTGGAAGTAAAGCGTC","TTCCATGTTACATACAACGA","561307.5.peg.233","1480"
"18783",201,733,532,"TTATCAGTCATGATTGTCGC","TTCCATGTTACATACAACGA","561307.5.peg.233","1480"
"18784",558,733,175,"GTACCACCCATCGTAAATGC","TTCCATGTTACATACAACGA","561307.5.peg.233","1480"
"18785",580,733,153,"ATTATGACAAATACCGCCTC","TTCCATGTTACATACAACGA","561307.5.peg.233","1480"
"18786",480,733,253,"GTATTTACAATGTCACTCTC","TTCCATGTTACATACAACGA","561307.5.peg.233","1480"
"18787",389,733,344,"TAGCTCAGTTCCTAATAAT","TTCCATGTTACATACAACGA","561307.5.peg.233","1480"
"18788",1059,733,326,"GCATAAGATGTTCCTGTAAT","TTCCATGTTACATACAACGA","561307.5.peg.233","1480"
"18789",542,733,191,"ATGCCGGTCTAACAATTAGC","TTCCATGTTACATACAACGA","561307.5.peg.233","1480"
"18790",1278,733,545,"AGATCGAAGCTTTCACCATT","TTCCATGTTACATACAACGA","561307.5.peg.233","1480"
"18791",99,733,634,"GCTGCTTGACCTATGATAAT","TTCCATGTTACATACAACGA","561307.5.peg.233","1480"
"18792",951,733,218,"GCTGATGAACGTGATACACG","TTCCATGTTACATACAACGA","561307.5.peg.233","1480"
"18793",474,733,259,"ACAATGTCACTCTCTGGTAC","TTCCATGTTACATACAACGA","561307.5.peg.233","1480"
"18794",1599,733,866,"GTATCAACCATCTTGTAAAC","TTCCATGTTACATACAACGA","561307.5.peg.233","1480"
"18795",1201,733,468,"TTCTTCGTAAGTTCGACCAA","TTCCATGTTACATACAACGA","561307.5.peg.233","1480"
"18796",99,951,852,"GCTGCTTGACCTATGATAAT","GCTGATGAACGTGATACACG","561307.5.peg.233","1480"
"18797",733,951,218,"TTCCATGTTACATACAACGA","GCTGATGAACGTGATACACG","561307.5.peg.233","1480"
"18798",1201,951,250,"TTCTTCGTAAGTTCGACCAA","GCTGATGAACGTGATACACG","561307.5.peg.233","1480"
"18799",1599,951,648,"GTATCAACCATCTTGTAAAC","GCTGATGAACGTGATACACG","561307.5.peg.233","1480"
"18800",1059,951,108,"GCATAAGATGTTCCTGTAAT","GCTGATGAACGTGATACACG","561307.5.peg.233","1480"
"18801",474,951,477,"ACAATGTCACTCTCTGGTAC","GCTGATGAACGTGATACACG","561307.5.peg.233","1480"
"18802",201,951,750,"TTATCAGTCATGATTGTCGC","GCTGATGAACGTGATACACG","561307.5.peg.233","1480"
"18803",297,951,654,"AAAGTTGGAAGTAAAGCGTC","GCTGATGAACGTGATACACG","561307.5.peg.233","1480"
"18804",480,951,471,"GTATTTACAATGTCACTCTC","GCTGATGAACGTGATACACG","561307.5.peg.233","1480"
"18805",558,951,393,"GTACCACCCATCGTAAATGC","GCTGATGAACGTGATACACG","561307.5.peg.233","1480"
"18806",648,951,303,"TCTAATAAACATTGCGTTGC","GCTGATGAACGTGATACACG","561307.5.peg.233","1480"
"18807",542,951,409,"ATGCCGGTCTAACAATTAGC","GCTGATGAACGTGATACACG","561307.5.peg.233","1480"
"18808",1278,951,327,"AGATCGAAGCTTTCACCATT","GCTGATGAACGTGATACACG","561307.5.peg.233","1480"
"18809",389,951,562,"TAGCTCAGTTCCTAATAAT","GCTGATGAACGTGATACACG","561307.5.peg.233","1480"
"18810",580,951,371,"ATTATGACAAATACCGCCTC","GCTGATGAACGTGATACACG","561307.5.peg.233","1480"
"18811",1599,1059,540,"GTATCAACCATCTTGTAAAC","GCATAAGATGTTCCTGTAAT","561307.5.peg.233","1480"
"18812",558,1059,501,"GTACCACCCATCGTAAATGC","GCATAAGATGTTCCTGTAAT","561307.5.peg.233","1480"
"18813",474,1059,585,"ACAATGTCACTCTCTGGTAC","GCATAAGATGTTCCTGTAAT","561307.5.peg.233","1480"
"18814",733,1059,326,"TTCCATGTTACATACAACGA","GCATAAGATGTTCCTGTAAT","561307.5.peg.233","1480"
"18815",99,1059,960,"GCTGCTTGACCTATGATAAT","GCATAAGATGTTCCTGTAAT","561307.5.peg.233","1480"
"18816",201,1059,858,"TTATCAGTCATGATTGTCGC","GCATAAGATGTTCCTGTAAT","561307.5.peg.233","1480"
"18817",1201,1059,142,"TTCTTCGTAAGTTCGACCAA","GCATAAGATGTTCCTGTAAT","561307.5.peg.233","1480"
"18818",542,1059,517,"ATGCCGGTCTAACAATTAGC","GCATAAGATGTTCCTGTAAT","561307.5.peg.233","1480"
"18819",297,1059,762,"AAAGTTGGAAGTAAAGCGTC","GCATAAGATGTTCCTGTAAT","561307.5.peg.233","1480"
"18820",480,1059,579,"GTATTTACAATGTCACTCTC","GCATAAGATGTTCCTGTAAT","561307.5.peg.233","1480"
"18821",389,1059,670,"TAGCTCAGTTCCTAATAAT","GCATAAGATGTTCCTGTAAT","561307.5.peg.233","1480"
"18822",951,1059,108,"GCTGATGAACGTGATACACG","GCATAAGATGTTCCTGTAAT","561307.5.peg.233","1480"
"18823",1278,1059,219,"AGATCGAAGCTTTCACCATT","GCATAAGATGTTCCTGTAAT","561307.5.peg.233","1480"
"18824",648,1059,411,"TCTAATAAACATTGCGTTGC","GCATAAGATGTTCCTGTAAT","561307.5.peg.233","1480"
"18825",580,1059,479,"ATTATGACAAATACCGCCTC","GCATAAGATGTTCCTGTAAT","561307.5.peg.233","1480"
"18826",558,1201,643,"GTACCACCCATCGTAAATGC","TTCTTCGTAAGTTCGACCAA","561307.5.peg.233","1480"
"18827",474,1201,727,"ACAATGTCACTCTCTGGTAC","TTCTTCGTAAGTTCGACCAA","561307.5.peg.233","1480"
"18828",99,1201,1102,"GCTGCTTGACCTATGATAAT","TTCTTCGTAAGTTCGACCAA","561307.5.peg.233","1480"
"18829",1059,1201,142,"GCATAAGATGTTCCTGTAAT","TTCTTCGTAAGTTCGACCAA","561307.5.peg.233","1480"
"18830",1599,1201,398,"GTATCAACCATCTTGTAAAC","TTCTTCGTAAGTTCGACCAA","561307.5.peg.233","1480"
"18831",951,1201,250,"GCTGATGAACGTGATACACG","TTCTTCGTAAGTTCGACCAA","561307.5.peg.233","1480"
"18832",648,1201,553,"TCTAATAAACATTGCGTTGC","TTCTTCGTAAGTTCGACCAA","561307.5.peg.233","1480"
"18833",580,1201,621,"ATTATGACAAATACCGCCTC","TTCTTCGTAAGTTCGACCAA","561307.5.peg.233","1480"
"18834",480,1201,721,"GTATTTACAATGTCACTCTC","TTCTTCGTAAGTTCGACCAA","561307.5.peg.233","1480"
"18835",389,1201,812,"TAGCTCAGTTCCTAATAAT","TTCTTCGTAAGTTCGACCAA","561307.5.peg.233","1480"
"18836",542,1201,659,"ATGCCGGTCTAACAATTAGC","TTCTTCGTAAGTTCGACCAA","561307.5.peg.233","1480"
"18837",733,1201,468,"TTCCATGTTACATACAACGA","TTCTTCGTAAGTTCGACCAA","561307.5.peg.233","1480"
"18838",201,1201,1000,"TTATCAGTCATGATTGTCGC","TTCTTCGTAAGTTCGACCAA","561307.5.peg.233","1480"
"18839",297,1201,904,"AAAGTTGGAAGTAAAGCGTC","TTCTTCGTAAGTTCGACCAA","561307.5.peg.233","1480"
"18840",480,1278,798,"GTATTTACAATGTCACTCTC","AGATCGAAGCTTTCACCATT","561307.5.peg.233","1480"
"18841",542,1278,736,"ATGCCGGTCTAACAATTAGC","AGATCGAAGCTTTCACCATT","561307.5.peg.233","1480"
"18842",733,1278,545,"TTCCATGTTACATACAACGA","AGATCGAAGCTTTCACCATT","561307.5.peg.233","1480"
"18843",99,1278,1179,"GCTGCTTGACCTATGATAAT","AGATCGAAGCTTTCACCATT","561307.5.peg.233","1480"
"18844",1059,1278,219,"GCATAAGATGTTCCTGTAAT","AGATCGAAGCTTTCACCATT","561307.5.peg.233","1480"
"18845",580,1278,698,"ATTATGACAAATACCGCCTC","AGATCGAAGCTTTCACCATT","561307.5.peg.233","1480"
"18846",389,1278,889,"TAGCTCAGTTCCTAATAAT","AGATCGAAGCTTTCACCATT","561307.5.peg.233","1480"
"18847",297,1278,981,"AAAGTTGGAAGTAAAGCGTC","AGATCGAAGCTTTCACCATT","561307.5.peg.233","1480"
"18848",648,1278,630,"TCTAATAAACATTGCGTTGC","AGATCGAAGCTTTCACCATT","561307.5.peg.233","1480"
"18849",951,1278,327,"GCTGATGAACGTGATACACG","AGATCGAAGCTTTCACCATT","561307.5.peg.233","1480"
"18850",201,1278,1077,"TTATCAGTCATGATTGTCGC","AGATCGAAGCTTTCACCATT","561307.5.peg.233","1480"
"18851",1599,1278,321,"GTATCAACCATCTTGTAAAC","AGATCGAAGCTTTCACCATT","561307.5.peg.233","1480"
"18852",558,1278,720,"GTACCACCCATCGTAAATGC","AGATCGAAGCTTTCACCATT","561307.5.peg.233","1480"
"18853",474,1278,804,"ACAATGTCACTCTCTGGTAC","AGATCGAAGCTTTCACCATT","561307.5.peg.233","1480"
"18854",474,1599,1125,"ACAATGTCACTCTCTGGTAC","GTATCAACCATCTTGTAAAC","561307.5.peg.233","1480"
"18855",201,1599,1398,"TTATCAGTCATGATTGTCGC","GTATCAACCATCTTGTAAAC","561307.5.peg.233","1480"
"18856",297,1599,1302,"AAAGTTGGAAGTAAAGCGTC","GTATCAACCATCTTGTAAAC","561307.5.peg.233","1480"
"18857",99,1599,1500,"GCTGCTTGACCTATGATAAT","GTATCAACCATCTTGTAAAC","561307.5.peg.233","1480"
"18858",480,1599,1119,"GTATTTACAATGTCACTCTC","GTATCAACCATCTTGTAAAC","561307.5.peg.233","1480"
"18859",1278,1599,321,"AGATCGAAGCTTTCACCATT","GTATCAACCATCTTGTAAAC","561307.5.peg.233","1480"
"18860",733,1599,866,"TTCCATGTTACATACAACGA","GTATCAACCATCTTGTAAAC","561307.5.peg.233","1480"
"18861",1059,1599,540,"GCATAAGATGTTCCTGTAAT","GTATCAACCATCTTGTAAAC","561307.5.peg.233","1480"
"18862",542,1599,1057,"ATGCCGGTCTAACAATTAGC","GTATCAACCATCTTGTAAAC","561307.5.peg.233","1480"
"18863",1201,1599,398,"TTCTTCGTAAGTTCGACCAA","GTATCAACCATCTTGTAAAC","561307.5.peg.233","1480"
"18864",648,1599,951,"TCTAATAAACATTGCGTTGC","GTATCAACCATCTTGTAAAC","561307.5.peg.233","1480"
"18865",951,1599,648,"GCTGATGAACGTGATACACG","GTATCAACCATCTTGTAAAC","561307.5.peg.233","1480"
"18866",580,1599,1019,"ATTATGACAAATACCGCCTC","GTATCAACCATCTTGTAAAC","561307.5.peg.233","1480"
"18867",389,1599,1210,"TAGCTCAGTTCCTAATAAT","GTATCAACCATCTTGTAAAC","561307.5.peg.233","1480"
"18868",558,1599,1041,"GTACCACCCATCGTAAATGC","GTATCAACCATCTTGTAAAC","561307.5.peg.233","1480"
"18869",285,111,174,"ACTTTAGCATATCCATACCC","ACTTCAGACAATTCTGTTTC","561307.5.peg.2330","1481"
"18870",111,285,174,"ACTTCAGACAATTCTGTTTC","ACTTTAGCATATCCATACCC","561307.5.peg.2330","1481"
"18871",323,11,312,"TTGTTGAATACGCTTATAG","GTATAGTCTTTAACGAATAG","561307.5.peg.2331","1482"
"18872",436,11,425,"TACATTCAACGTCTTGGCTA","GTATAGTCTTTAACGAATAG","561307.5.peg.2331","1482"
"18873",234,11,223,"CCATAATTTCTTTAGGAGT","GTATAGTCTTTAACGAATAG","561307.5.peg.2331","1482"
"18874",442,11,431,"AAATGGTACATTCAACGTCT","GTATAGTCTTTAACGAATAG","561307.5.peg.2331","1482"
"18875",11,234,223,"GTATAGTCTTTAACGAATAG","CCATAATTTCTTTAGGAGT","561307.5.peg.2331","1482"
"18876",436,234,202,"TACATTCAACGTCTTGGCTA","CCATAATTTCTTTAGGAGT","561307.5.peg.2331","1482"
"18877",442,234,208,"AAATGGTACATTCAACGTCT","CCATAATTTCTTTAGGAGT","561307.5.peg.2331","1482"
"18878",11,323,312,"GTATAGTCTTTAACGAATAG","TTGTTGAATACGCTTATAG","561307.5.peg.2331","1482"
"18879",436,323,113,"TACATTCAACGTCTTGGCTA","TTGTTGAATACGCTTATAG","561307.5.peg.2331","1482"
"18880",442,323,119,"AAATGGTACATTCAACGTCT","TTGTTGAATACGCTTATAG","561307.5.peg.2331","1482"
"18881",323,436,113,"TTGTTGAATACGCTTATAG","TACATTCAACGTCTTGGCTA","561307.5.peg.2331","1482"
"18882",11,436,425,"GTATAGTCTTTAACGAATAG","TACATTCAACGTCTTGGCTA","561307.5.peg.2331","1482"
"18883",234,436,202,"CCATAATTTCTTTAGGAGT","TACATTCAACGTCTTGGCTA","561307.5.peg.2331","1482"
"18884",11,442,431,"GTATAGTCTTTAACGAATAG","AAATGGTACATTCAACGTCT","561307.5.peg.2331","1482"
"18885",234,442,208,"CCATAATTTCTTTAGGAGT","AAATGGTACATTCAACGTCT","561307.5.peg.2331","1482"
"18886",323,442,119,"TTGTTGAATACGCTTATAG","AAATGGTACATTCAACGTCT","561307.5.peg.2331","1482"
"18887",390,174,216,"AGTCTCCTAATTTAACTTC","ACTTTACCTTTACGGAATCC","561307.5.peg.2332","1483"
"18888",321,174,147,"TTTGAGTAACACTTACTTC","ACTTTACCTTTACGGAATCC","561307.5.peg.2332","1483"
"18889",642,174,468,"TCTAATTGCTCTTCGAAACC","ACTTTACCTTTACGGAATCC","561307.5.peg.2332","1483"
"18890",479,174,305,"CAGCTAAATGTCCTAAGCTG","ACTTTACCTTTACGGAATCC","561307.5.peg.2332","1483"
"18891",174,321,147,"ACTTTACCTTTACGGAATCC","TTTGAGTAACACTTACTTC","561307.5.peg.2332","1483"
"18892",479,321,158,"CAGCTAAATGTCCTAAGCTG","TTTGAGTAACACTTACTTC","561307.5.peg.2332","1483"
"18893",642,321,321,"TCTAATTGCTCTTCGAAACC","TTTGAGTAACACTTACTTC","561307.5.peg.2332","1483"
"18894",174,390,216,"ACTTTACCTTTACGGAATCC","AGTCTCCTAATTTAACTTC","561307.5.peg.2332","1483"
"18895",642,390,252,"TCTAATTGCTCTTCGAAACC","AGTCTCCTAATTTAACTTC","561307.5.peg.2332","1483"
"18896",174,479,305,"ACTTTACCTTTACGGAATCC","CAGCTAAATGTCCTAAGCTG","561307.5.peg.2332","1483"
"18897",321,479,158,"TTTGAGTAACACTTACTTC","CAGCTAAATGTCCTAAGCTG","561307.5.peg.2332","1483"
"18898",642,479,163,"TCTAATTGCTCTTCGAAACC","CAGCTAAATGTCCTAAGCTG","561307.5.peg.2332","1483"
"18899",174,642,468,"ACTTTACCTTTACGGAATCC","TCTAATTGCTCTTCGAAACC","561307.5.peg.2332","1483"
"18900",390,642,252,"AGTCTCCTAATTTAACTTC","TCTAATTGCTCTTCGAAACC","561307.5.peg.2332","1483"
"18901",321,642,321,"TTTGAGTAACACTTACTTC","TCTAATTGCTCTTCGAAACC","561307.5.peg.2332","1483"
"18902",479,642,163,"CAGCTAAATGTCCTAAGCTG","TCTAATTGCTCTTCGAAACC","561307.5.peg.2332","1483"
"18903",191,9,182,"GTTTACGTTGACGACGGTCA","TCGGTAGGAATTACCTAAGG","561307.5.peg.2335","1486"
"18904",197,9,188,"AGTCACGTTTACGTTGACGA","TCGGTAGGAATTACCTAAGG","561307.5.peg.2335","1486"
"18905",191,12,179,"GTTTACGTTGACGACGGTCA","AAATCGGTAGGAATTACCTA","561307.5.peg.2335","1486"
"18906",197,12,185,"AGTCACGTTTACGTTGACGA","AAATCGGTAGGAATTACCTA","561307.5.peg.2335","1486"
"18907",191,24,167,"GTTTACGTTGACGACGGTCA","GAACAAATACAGAAATCGGT","561307.5.peg.2335","1486"
"18908",197,24,173,"AGTCACGTTTACGTTGACGA","GAACAAATACAGAAATCGGT","561307.5.peg.2335","1486"
"18909",191,54,137,"GTTTACGTTGACGACGGTCA","ACTGTTCCACCTTTAACTCG","561307.5.peg.2335","1486"
"18910",197,54,143,"AGTCACGTTTACGTTGACGA","ACTGTTCCACCTTTAACTCG","561307.5.peg.2335","1486"
"18911",9,191,182,"TCGGTAGGAATTACCTAAGG","GTTTACGTTGACGACGGTCA","561307.5.peg.2335","1486"
"18912",12,191,179,"AAATCGGTAGGAATTACCTA","GTTTACGTTGACGACGGTCA","561307.5.peg.2335","1486"
"18913",24,191,167,"GAACAAATACAGAAATCGGT","GTTTACGTTGACGACGGTCA","561307.5.peg.2335","1486"
"18914",54,191,137,"ACTGTTCCACCTTTAACTCG","GTTTACGTTGACGACGGTCA","561307.5.peg.2335","1486"
"18915",9,197,188,"TCGGTAGGAATTACCTAAGG","AGTCACGTTTACGTTGACGA","561307.5.peg.2335","1486"
"18916",12,197,185,"AAATCGGTAGGAATTACCTA","AGTCACGTTTACGTTGACGA","561307.5.peg.2335","1486"
"18917",24,197,173,"GAACAAATACAGAAATCGGT","AGTCACGTTTACGTTGACGA","561307.5.peg.2335","1486"
"18918",54,197,143,"ACTGTTCCACCTTTAACTCG","AGTCACGTTTACGTTGACGA","561307.5.peg.2335","1486"
"18919",423,321,102,"CAAGCGGGTATGCCTTGCAA","CCAAGCGCAAACCCTAAAGA","561307.5.peg.2338","1489"
"18920",438,321,117,"AACGCACTCCATGCCCAAGC","CCAAGCGCAAACCCTAAAGA","561307.5.peg.2338","1489"
"18921",765,321,444,"GCTTTCGGCACAGCACGTTC","CCAAGCGCAAACCCTAAAGA","561307.5.peg.2338","1489"
"18922",719,321,398,"TACCAATTAACTCAGTACCT","CCAAGCGCAAACCCTAAAGA","561307.5.peg.2338","1489"
"18923",645,321,324,"CCTAAGTTGCCACCAAGAAT","CCAAGCGCAAACCCTAAAGA","561307.5.peg.2338","1489"
"18924",321,423,102,"CCAAGCGCAAACCCTAAAGA","CAAGCGGGTATGCCTTGCAA","561307.5.peg.2338","1489"
"18925",765,423,342,"GCTTTCGGCACAGCACGTTC","CAAGCGGGTATGCCTTGCAA","561307.5.peg.2338","1489"
"18926",719,423,296,"TACCAATTAACTCAGTACCT","CAAGCGGGTATGCCTTGCAA","561307.5.peg.2338","1489"
"18927",645,423,222,"CCTAAGTTGCCACCAAGAAT","CAAGCGGGTATGCCTTGCAA","561307.5.peg.2338","1489"
"18928",645,438,207,"CCTAAGTTGCCACCAAGAAT","AACGCACTCCATGCCCAAGC","561307.5.peg.2338","1489"
"18929",321,438,117,"CCAAGCGCAAACCCTAAAGA","AACGCACTCCATGCCCAAGC","561307.5.peg.2338","1489"
"18930",765,438,327,"GCTTTCGGCACAGCACGTTC","AACGCACTCCATGCCCAAGC","561307.5.peg.2338","1489"
"18931",719,438,281,"TACCAATTAACTCAGTACCT","AACGCACTCCATGCCCAAGC","561307.5.peg.2338","1489"
"18932",438,645,207,"AACGCACTCCATGCCCAAGC","CCTAAGTTGCCACCAAGAAT","561307.5.peg.2338","1489"
"18933",321,645,324,"CCAAGCGCAAACCCTAAAGA","CCTAAGTTGCCACCAAGAAT","561307.5.peg.2338","1489"
"18934",423,645,222,"CAAGCGGGTATGCCTTGCAA","CCTAAGTTGCCACCAAGAAT","561307.5.peg.2338","1489"
"18935",765,645,120,"GCTTTCGGCACAGCACGTTC","CCTAAGTTGCCACCAAGAAT","561307.5.peg.2338","1489"
"18936",321,719,398,"CCAAGCGCAAACCCTAAAGA","TACCAATTAACTCAGTACCT","561307.5.peg.2338","1489"
"18937",423,719,296,"CAAGCGGGTATGCCTTGCAA","TACCAATTAACTCAGTACCT","561307.5.peg.2338","1489"
"18938",438,719,281,"AACGCACTCCATGCCCAAGC","TACCAATTAACTCAGTACCT","561307.5.peg.2338","1489"
"18939",438,765,327,"AACGCACTCCATGCCCAAGC","GCTTTCGGCACAGCACGTTC","561307.5.peg.2338","1489"
"18940",645,765,120,"CCTAAGTTGCCACCAAGAAT","GCTTTCGGCACAGCACGTTC","561307.5.peg.2338","1489"
"18941",423,765,342,"CAAGCGGGTATGCCTTGCAA","GCTTTCGGCACAGCACGTTC","561307.5.peg.2338","1489"
"18942",321,765,444,"CCAAGCGCAAACCCTAAAGA","GCTTTCGGCACAGCACGTTC","561307.5.peg.2338","1489"
"18943",342,166,176,"TAGAATCCACCTTCTATTAC","AAGTTGCCCGTTAAATTTGC","561307.5.peg.2339","1490"
"18944",852,166,686,"CGTCTAATTGTTGCACCGTT","AAGTTGCCCGTTAAATTTGC","561307.5.peg.2339","1490"
"18945",936,166,770,"AATCAACATTAGCAAGTAC","AAGTTGCCCGTTAAATTTGC","561307.5.peg.2339","1490"
"18946",840,166,674,"GCACCGTTAGGTAACCATAA","AAGTTGCCCGTTAAATTTGC","561307.5.peg.2339","1490"
"18947",923,166,757,"CAAGTACTGGTGTATAAACG","AAGTTGCCCGTTAAATTTGC","561307.5.peg.2339","1490"
"18948",818,166,652,"GCAAACCAGCACCAACTAAT","AAGTTGCCCGTTAAATTTGC","561307.5.peg.2339","1490"
"18949",342,204,138,"TAGAATCCACCTTCTATTAC","ATTGATCCATCAGTTTCAAG","561307.5.peg.2339","1490"
"18950",923,204,719,"CAAGTACTGGTGTATAAACG","ATTGATCCATCAGTTTCAAG","561307.5.peg.2339","1490"
"18951",936,204,732,"AATCAACATTAGCAAGTAC","ATTGATCCATCAGTTTCAAG","561307.5.peg.2339","1490"
"18952",818,204,614,"GCAAACCAGCACCAACTAAT","ATTGATCCATCAGTTTCAAG","561307.5.peg.2339","1490"
"18953",852,204,648,"CGTCTAATTGTTGCACCGTT","ATTGATCCATCAGTTTCAAG","561307.5.peg.2339","1490"
"18954",840,204,636,"GCACCGTTAGGTAACCATAA","ATTGATCCATCAGTTTCAAG","561307.5.peg.2339","1490"
"18955",204,342,138,"ATTGATCCATCAGTTTCAAG","TAGAATCCACCTTCTATTAC","561307.5.peg.2339","1490"
"18956",852,342,510,"CGTCTAATTGTTGCACCGTT","TAGAATCCACCTTCTATTAC","561307.5.peg.2339","1490"
"18957",936,342,594,"AATCAACATTAGCAAGTAC","TAGAATCCACCTTCTATTAC","561307.5.peg.2339","1490"
"18958",166,342,176,"AAGTTGCCCGTTAAATTTGC","TAGAATCCACCTTCTATTAC","561307.5.peg.2339","1490"
"18959",840,342,498,"GCACCGTTAGGTAACCATAA","TAGAATCCACCTTCTATTAC","561307.5.peg.2339","1490"
"18960",923,342,581,"CAAGTACTGGTGTATAAACG","TAGAATCCACCTTCTATTAC","561307.5.peg.2339","1490"
"18961",818,342,476,"GCAAACCAGCACCAACTAAT","TAGAATCCACCTTCTATTAC","561307.5.peg.2339","1490"
"18962",936,818,118,"AATCAACATTAGCAAGTAC","GCAAACCAGCACCAACTAAT","561307.5.peg.2339","1490"
"18963",166,818,652,"AAGTTGCCCGTTAAATTTGC","GCAAACCAGCACCAACTAAT","561307.5.peg.2339","1490"
"18964",204,818,614,"ATTGATCCATCAGTTTCAAG","GCAAACCAGCACCAACTAAT","561307.5.peg.2339","1490"
"18965",342,818,476,"TAGAATCCACCTTCTATTAC","GCAAACCAGCACCAACTAAT","561307.5.peg.2339","1490"
"18966",923,818,105,"CAAGTACTGGTGTATAAACG","GCAAACCAGCACCAACTAAT","561307.5.peg.2339","1490"
"18967",166,840,674,"AAGTTGCCCGTTAAATTTGC","GCACCGTTAGGTAACCATAA","561307.5.peg.2339","1490"
"18968",204,840,636,"ATTGATCCATCAGTTTCAAG","GCACCGTTAGGTAACCATAA","561307.5.peg.2339","1490"
"18969",342,840,498,"TAGAATCCACCTTCTATTAC","GCACCGTTAGGTAACCATAA","561307.5.peg.2339","1490"
"18970",166,852,686,"AAGTTGCCCGTTAAATTTGC","CGTCTAATTGTTGCACCGTT","561307.5.peg.2339","1490"
"18971",342,852,510,"TAGAATCCACCTTCTATTAC","CGTCTAATTGTTGCACCGTT","561307.5.peg.2339","1490"
"18972",204,852,648,"ATTGATCCATCAGTTTCAAG","CGTCTAATTGTTGCACCGTT","561307.5.peg.2339","1490"
"18973",166,923,757,"AAGTTGCCCGTTAAATTTGC","CAAGTACTGGTGTATAAACG","561307.5.peg.2339","1490"
"18974",342,923,581,"TAGAATCCACCTTCTATTAC","CAAGTACTGGTGTATAAACG","561307.5.peg.2339","1490"
"18975",204,923,719,"ATTGATCCATCAGTTTCAAG","CAAGTACTGGTGTATAAACG","561307.5.peg.2339","1490"
"18976",818,923,105,"GCAAACCAGCACCAACTAAT","CAAGTACTGGTGTATAAACG","561307.5.peg.2339","1490"
"18977",166,936,770,"AAGTTGCCCGTTAAATTTGC","AATCAACATTAGCAAGTAC","561307.5.peg.2339","1490"
"18978",204,936,732,"ATTGATCCATCAGTTTCAAG","AATCAACATTAGCAAGTAC","561307.5.peg.2339","1490"
"18979",818,936,118,"GCAAACCAGCACCAACTAAT","AATCAACATTAGCAAGTAC","561307.5.peg.2339","1490"
"18980",342,936,594,"TAGAATCCACCTTCTATTAC","AATCAACATTAGCAAGTAC","561307.5.peg.2339","1490"
"18981",273,10,263,"CTACAATACCGTTTAATGT","AGGCGAAGTTAAATTTGAGG","561307.5.peg.234","1491"
"18982",372,10,362,"GTATCAACACCTGCAATCCC","AGGCGAAGTTAAATTTGAGG","561307.5.peg.234","1491"
"18983",540,10,530,"TCCTTACCTGTCGAAACATA","AGGCGAAGTTAAATTTGAGG","561307.5.peg.234","1491"
"18984",540,12,528,"TCCTTACCTGTCGAAACATA","GAAGGCGAAGTTAAATTTGA","561307.5.peg.234","1491"
"18985",273,12,261,"CTACAATACCGTTTAATGT","GAAGGCGAAGTTAAATTTGA","561307.5.peg.234","1491"
"18986",372,12,360,"GTATCAACACCTGCAATCCC","GAAGGCGAAGTTAAATTTGA","561307.5.peg.234","1491"
"18987",372,104,268,"GTATCAACACCTGCAATCCC","TAAGTTATCAGATCCTAAA","561307.5.peg.234","1491"
"18988",273,104,169,"CTACAATACCGTTTAATGT","TAAGTTATCAGATCCTAAA","561307.5.peg.234","1491"
"18989",540,104,436,"TCCTTACCTGTCGAAACATA","TAAGTTATCAGATCCTAAA","561307.5.peg.234","1491"
"18990",10,273,263,"AGGCGAAGTTAAATTTGAGG","CTACAATACCGTTTAATGT","561307.5.peg.234","1491"
"18991",104,273,169,"TAAGTTATCAGATCCTAAA","CTACAATACCGTTTAATGT","561307.5.peg.234","1491"
"18992",12,273,261,"GAAGGCGAAGTTAAATTTGA","CTACAATACCGTTTAATGT","561307.5.peg.234","1491"
"18993",540,273,267,"TCCTTACCTGTCGAAACATA","CTACAATACCGTTTAATGT","561307.5.peg.234","1491"
"18994",10,372,362,"AGGCGAAGTTAAATTTGAGG","GTATCAACACCTGCAATCCC","561307.5.peg.234","1491"
"18995",540,372,168,"TCCTTACCTGTCGAAACATA","GTATCAACACCTGCAATCCC","561307.5.peg.234","1491"
"18996",104,372,268,"TAAGTTATCAGATCCTAAA","GTATCAACACCTGCAATCCC","561307.5.peg.234","1491"
"18997",12,372,360,"GAAGGCGAAGTTAAATTTGA","GTATCAACACCTGCAATCCC","561307.5.peg.234","1491"
"18998",10,540,530,"AGGCGAAGTTAAATTTGAGG","TCCTTACCTGTCGAAACATA","561307.5.peg.234","1491"
"18999",12,540,528,"GAAGGCGAAGTTAAATTTGA","TCCTTACCTGTCGAAACATA","561307.5.peg.234","1491"
"19000",372,540,168,"GTATCAACACCTGCAATCCC","TCCTTACCTGTCGAAACATA","561307.5.peg.234","1491"
"19001",104,540,436,"TAAGTTATCAGATCCTAAA","TCCTTACCTGTCGAAACATA","561307.5.peg.234","1491"
"19002",273,540,267,"CTACAATACCGTTTAATGT","TCCTTACCTGTCGAAACATA","561307.5.peg.234","1491"
"19003",458,267,191,"CTGCCATAGCTACATCAAGA","ACATGCCCCTTTACGAAATT","561307.5.peg.2340","1492"
"19004",267,458,191,"ACATGCCCCTTTACGAAATT","CTGCCATAGCTACATCAAGA","561307.5.peg.2340","1492"
"19005",594,64,530,"CCTTGGTACGGTTCATTAAT","TGGTCTTAAGCCGAATTCGA","561307.5.peg.2341","1493"
"19006",606,64,542,"GATAAATCGATACCTTGGTA","TGGTCTTAAGCCGAATTCGA","561307.5.peg.2341","1493"
"19007",700,64,636,"ATTAAACGCTTTGCATCTT","TGGTCTTAAGCCGAATTCGA","561307.5.peg.2341","1493"
"19008",606,162,444,"GATAAATCGATACCTTGGTA","ACTGCTTGCGTTCCAATTAG","561307.5.peg.2341","1493"
"19009",594,162,432,"CCTTGGTACGGTTCATTAAT","ACTGCTTGCGTTCCAATTAG","561307.5.peg.2341","1493"
"19010",700,162,538,"ATTAAACGCTTTGCATCTT","ACTGCTTGCGTTCCAATTAG","561307.5.peg.2341","1493"
"19011",64,594,530,"TGGTCTTAAGCCGAATTCGA","CCTTGGTACGGTTCATTAAT","561307.5.peg.2341","1493"
"19012",162,594,432,"ACTGCTTGCGTTCCAATTAG","CCTTGGTACGGTTCATTAAT","561307.5.peg.2341","1493"
"19013",700,594,106,"ATTAAACGCTTTGCATCTT","CCTTGGTACGGTTCATTAAT","561307.5.peg.2341","1493"
"19014",64,606,542,"TGGTCTTAAGCCGAATTCGA","GATAAATCGATACCTTGGTA","561307.5.peg.2341","1493"
"19015",162,606,444,"ACTGCTTGCGTTCCAATTAG","GATAAATCGATACCTTGGTA","561307.5.peg.2341","1493"
"19016",64,700,636,"TGGTCTTAAGCCGAATTCGA","ATTAAACGCTTTGCATCTT","561307.5.peg.2341","1493"
"19017",594,700,106,"CCTTGGTACGGTTCATTAAT","ATTAAACGCTTTGCATCTT","561307.5.peg.2341","1493"
"19018",162,700,538,"ACTGCTTGCGTTCCAATTAG","ATTAAACGCTTTGCATCTT","561307.5.peg.2341","1493"
"19019",162,9,153,"TTAAATGTGCAATTGTTTC","ATAACACATAAAGATCAAG","561307.5.peg.2343","1495"
"19020",300,9,291,"CGATATCTAATTCTTTCCA","ATAACACATAAAGATCAAG","561307.5.peg.2343","1495"
"19021",159,9,150,"AAATGTGCAATTGTTTCGGG","ATAACACATAAAGATCAAG","561307.5.peg.2343","1495"
"19022",367,9,358,"ACCTGCTTTAATATGTGCGA","ATAACACATAAAGATCAAG","561307.5.peg.2343","1495"
"19023",9,159,150,"ATAACACATAAAGATCAAG","AAATGTGCAATTGTTTCGGG","561307.5.peg.2343","1495"
"19024",300,159,141,"CGATATCTAATTCTTTCCA","AAATGTGCAATTGTTTCGGG","561307.5.peg.2343","1495"
"19025",367,159,208,"ACCTGCTTTAATATGTGCGA","AAATGTGCAATTGTTTCGGG","561307.5.peg.2343","1495"
"19026",9,162,153,"ATAACACATAAAGATCAAG","TTAAATGTGCAATTGTTTC","561307.5.peg.2343","1495"
"19027",300,162,138,"CGATATCTAATTCTTTCCA","TTAAATGTGCAATTGTTTC","561307.5.peg.2343","1495"
"19028",367,162,205,"ACCTGCTTTAATATGTGCGA","TTAAATGTGCAATTGTTTC","561307.5.peg.2343","1495"
"19029",162,300,138,"TTAAATGTGCAATTGTTTC","CGATATCTAATTCTTTCCA","561307.5.peg.2343","1495"
"19030",9,300,291,"ATAACACATAAAGATCAAG","CGATATCTAATTCTTTCCA","561307.5.peg.2343","1495"
"19031",159,300,141,"AAATGTGCAATTGTTTCGGG","CGATATCTAATTCTTTCCA","561307.5.peg.2343","1495"
"19032",9,367,358,"ATAACACATAAAGATCAAG","ACCTGCTTTAATATGTGCGA","561307.5.peg.2343","1495"
"19033",159,367,208,"AAATGTGCAATTGTTTCGGG","ACCTGCTTTAATATGTGCGA","561307.5.peg.2343","1495"
"19034",162,367,205,"TTAAATGTGCAATTGTTTC","ACCTGCTTTAATATGTGCGA","561307.5.peg.2343","1495"
"19035",318,54,264,"TCCATAATATCTCGCACGAT","CCTGTTAGACCAATAACTTT","561307.5.peg.2344","1496"
"19036",54,318,264,"CCTGTTAGACCAATAACTTT","TCCATAATATCTCGCACGAT","561307.5.peg.2344","1496"
"19037",229,31,198,"CTTCGTTCTACATTTGTAA","CAAGTTATGGTGCAACC","561307.5.peg.2345","1497"
"19038",366,31,335,"TGCCAATGCTTACGATAATT","CAAGTTATGGTGCAACC","561307.5.peg.2345","1497"
"19039",229,54,175,"CTTCGTTCTACATTTGTAA","TGTTCTACTTCTGGTAATTC","561307.5.peg.2345","1497"
"19040",366,54,312,"TGCCAATGCTTACGATAATT","TGTTCTACTTCTGGTAATTC","561307.5.peg.2345","1497"
"19041",31,229,198,"CAAGTTATGGTGCAACC","CTTCGTTCTACATTTGTAA","561307.5.peg.2345","1497"
"19042",366,229,137,"TGCCAATGCTTACGATAATT","CTTCGTTCTACATTTGTAA","561307.5.peg.2345","1497"
"19043",54,229,175,"TGTTCTACTTCTGGTAATTC","CTTCGTTCTACATTTGTAA","561307.5.peg.2345","1497"
"19044",54,366,312,"TGTTCTACTTCTGGTAATTC","TGCCAATGCTTACGATAATT","561307.5.peg.2345","1497"
"19045",31,366,335,"CAAGTTATGGTGCAACC","TGCCAATGCTTACGATAATT","561307.5.peg.2345","1497"
"19046",229,366,137,"CTTCGTTCTACATTTGTAA","TGCCAATGCTTACGATAATT","561307.5.peg.2345","1497"
"19047",288,111,177,"AATTGCTCACTTAGTTCAGG","CCTGCTTTGTTTGATAACAA","561307.5.peg.2346","1498"
"19048",1003,111,892,"ACCGTCTAATTCGAAATGGA","CCTGCTTTGTTTGATAACAA","561307.5.peg.2346","1498"
"19049",449,111,338,"TTGCAAGTTGTGTTAAATCT","CCTGCTTTGTTTGATAACAA","561307.5.peg.2346","1498"
"19050",668,111,557,"CACCTTCTACTGTGTCAAAT","CCTGCTTTGTTTGATAACAA","561307.5.peg.2346","1498"
"19051",1007,111,896,"TACCACCGTCTAATTCGAAA","CCTGCTTTGTTTGATAACAA","561307.5.peg.2346","1498"
"19052",291,111,180,"GGAAATTGCTCACTTAGTTC","CCTGCTTTGTTTGATAACAA","561307.5.peg.2346","1498"
"19053",668,288,380,"CACCTTCTACTGTGTCAAAT","AATTGCTCACTTAGTTCAGG","561307.5.peg.2346","1498"
"19054",449,288,161,"TTGCAAGTTGTGTTAAATCT","AATTGCTCACTTAGTTCAGG","561307.5.peg.2346","1498"
"19055",1007,288,719,"TACCACCGTCTAATTCGAAA","AATTGCTCACTTAGTTCAGG","561307.5.peg.2346","1498"
"19056",1003,288,715,"ACCGTCTAATTCGAAATGGA","AATTGCTCACTTAGTTCAGG","561307.5.peg.2346","1498"
"19057",111,288,177,"CCTGCTTTGTTTGATAACAA","AATTGCTCACTTAGTTCAGG","561307.5.peg.2346","1498"
"19058",111,291,180,"CCTGCTTTGTTTGATAACAA","GGAAATTGCTCACTTAGTTC","561307.5.peg.2346","1498"
"19059",1003,291,712,"ACCGTCTAATTCGAAATGGA","GGAAATTGCTCACTTAGTTC","561307.5.peg.2346","1498"
"19060",1007,291,716,"TACCACCGTCTAATTCGAAA","GGAAATTGCTCACTTAGTTC","561307.5.peg.2346","1498"
"19061",449,291,158,"TTGCAAGTTGTGTTAAATCT","GGAAATTGCTCACTTAGTTC","561307.5.peg.2346","1498"
"19062",668,291,377,"CACCTTCTACTGTGTCAAAT","GGAAATTGCTCACTTAGTTC","561307.5.peg.2346","1498"
"19063",111,449,338,"CCTGCTTTGTTTGATAACAA","TTGCAAGTTGTGTTAAATCT","561307.5.peg.2346","1498"
"19064",288,449,161,"AATTGCTCACTTAGTTCAGG","TTGCAAGTTGTGTTAAATCT","561307.5.peg.2346","1498"
"19065",668,449,219,"CACCTTCTACTGTGTCAAAT","TTGCAAGTTGTGTTAAATCT","561307.5.peg.2346","1498"
"19066",1007,449,558,"TACCACCGTCTAATTCGAAA","TTGCAAGTTGTGTTAAATCT","561307.5.peg.2346","1498"
"19067",1003,449,554,"ACCGTCTAATTCGAAATGGA","TTGCAAGTTGTGTTAAATCT","561307.5.peg.2346","1498"
"19068",291,449,158,"GGAAATTGCTCACTTAGTTC","TTGCAAGTTGTGTTAAATCT","561307.5.peg.2346","1498"
"19069",111,668,557,"CCTGCTTTGTTTGATAACAA","CACCTTCTACTGTGTCAAAT","561307.5.peg.2346","1498"
"19070",1003,668,335,"ACCGTCTAATTCGAAATGGA","CACCTTCTACTGTGTCAAAT","561307.5.peg.2346","1498"
"19071",1007,668,339,"TACCACCGTCTAATTCGAAA","CACCTTCTACTGTGTCAAAT","561307.5.peg.2346","1498"
"19072",288,668,380,"AATTGCTCACTTAGTTCAGG","CACCTTCTACTGTGTCAAAT","561307.5.peg.2346","1498"
"19073",291,668,377,"GGAAATTGCTCACTTAGTTC","CACCTTCTACTGTGTCAAAT","561307.5.peg.2346","1498"
"19074",449,668,219,"TTGCAAGTTGTGTTAAATCT","CACCTTCTACTGTGTCAAAT","561307.5.peg.2346","1498"
"19075",111,1003,892,"CCTGCTTTGTTTGATAACAA","ACCGTCTAATTCGAAATGGA","561307.5.peg.2346","1498"
"19076",291,1003,712,"GGAAATTGCTCACTTAGTTC","ACCGTCTAATTCGAAATGGA","561307.5.peg.2346","1498"
"19077",449,1003,554,"TTGCAAGTTGTGTTAAATCT","ACCGTCTAATTCGAAATGGA","561307.5.peg.2346","1498"
"19078",288,1003,715,"AATTGCTCACTTAGTTCAGG","ACCGTCTAATTCGAAATGGA","561307.5.peg.2346","1498"
"19079",668,1003,335,"CACCTTCTACTGTGTCAAAT","ACCGTCTAATTCGAAATGGA","561307.5.peg.2346","1498"
"19080",449,1007,558,"TTGCAAGTTGTGTTAAATCT","TACCACCGTCTAATTCGAAA","561307.5.peg.2346","1498"
"19081",288,1007,719,"AATTGCTCACTTAGTTCAGG","TACCACCGTCTAATTCGAAA","561307.5.peg.2346","1498"
"19082",111,1007,896,"CCTGCTTTGTTTGATAACAA","TACCACCGTCTAATTCGAAA","561307.5.peg.2346","1498"
"19083",668,1007,339,"CACCTTCTACTGTGTCAAAT","TACCACCGTCTAATTCGAAA","561307.5.peg.2346","1498"
"19084",291,1007,716,"GGAAATTGCTCACTTAGTTC","TACCACCGTCTAATTCGAAA","561307.5.peg.2346","1498"
"19085",281,31,250,"AAATGATGCCCATACTAATG","TTTCGACCTACAAGTTG","561307.5.peg.2347","1499"
"19086",507,31,476,"AATAGTACAGTAACACTTAC","TTTCGACCTACAAGTTG","561307.5.peg.2347","1499"
"19087",132,31,101,"TGTAAATCATCGTGCATGAG","TTTCGACCTACAAGTTG","561307.5.peg.2347","1499"
"19088",31,132,101,"TTTCGACCTACAAGTTG","TGTAAATCATCGTGCATGAG","561307.5.peg.2347","1499"
"19089",281,132,149,"AAATGATGCCCATACTAATG","TGTAAATCATCGTGCATGAG","561307.5.peg.2347","1499"
"19090",507,132,375,"AATAGTACAGTAACACTTAC","TGTAAATCATCGTGCATGAG","561307.5.peg.2347","1499"
"19091",31,281,250,"TTTCGACCTACAAGTTG","AAATGATGCCCATACTAATG","561307.5.peg.2347","1499"
"19092",507,281,226,"AATAGTACAGTAACACTTAC","AAATGATGCCCATACTAATG","561307.5.peg.2347","1499"
"19093",132,281,149,"TGTAAATCATCGTGCATGAG","AAATGATGCCCATACTAATG","561307.5.peg.2347","1499"
"19094",31,507,476,"TTTCGACCTACAAGTTG","AATAGTACAGTAACACTTAC","561307.5.peg.2347","1499"
"19095",132,507,375,"TGTAAATCATCGTGCATGAG","AATAGTACAGTAACACTTAC","561307.5.peg.2347","1499"
"19096",281,507,226,"AAATGATGCCCATACTAATG","AATAGTACAGTAACACTTAC","561307.5.peg.2347","1499"
"19097",500,41,459,"AAGTAACTTCTTGAATGGGA","TATCAATAACATTAAGCGG","561307.5.peg.2348","1500"
"19098",504,41,463,"GCATAAGTAACTTCTTGAAT","TATCAATAACATTAAGCGG","561307.5.peg.2348","1500"
"19099",500,44,456,"AAGTAACTTCTTGAATGGGA","GCTTATCAATAACATTAAG","561307.5.peg.2348","1500"
"19100",504,44,460,"GCATAAGTAACTTCTTGAAT","GCTTATCAATAACATTAAG","561307.5.peg.2348","1500"
"19101",41,500,459,"TATCAATAACATTAAGCGG","AAGTAACTTCTTGAATGGGA","561307.5.peg.2348","1500"
"19102",44,500,456,"GCTTATCAATAACATTAAG","AAGTAACTTCTTGAATGGGA","561307.5.peg.2348","1500"
"19103",41,504,463,"TATCAATAACATTAAGCGG","GCATAAGTAACTTCTTGAAT","561307.5.peg.2348","1500"
"19104",44,504,460,"GCTTATCAATAACATTAAG","GCATAAGTAACTTCTTGAAT","561307.5.peg.2348","1500"
"19105",663,147,516,"GAACAGATTCACAAATGTT","CCATTGCTTGGTTCAATTGC","561307.5.peg.235","1502"
"19106",571,147,424,"ATCTTCACAGTGTGCTACGA","CCATTGCTTGGTTCAATTGC","561307.5.peg.235","1502"
"19107",411,147,264,"CGTGTTGTAATTGAAGCATA","CCATTGCTTGGTTCAATTGC","561307.5.peg.235","1502"
"19108",324,147,177,"TCTGGTACCGGTCTTGTGTT","CCATTGCTTGGTTCAATTGC","561307.5.peg.235","1502"
"19109",336,147,189,"TGTTCTACAGAATCTGGTAC","CCATTGCTTGGTTCAATTGC","561307.5.peg.235","1502"
"19110",318,147,171,"ACCGGTCTTGTGTTAGGCAT","CCATTGCTTGGTTCAATTGC","561307.5.peg.235","1502"
"19111",654,147,507,"TCACAAATGTTTGGAATACC","CCATTGCTTGGTTCAATTGC","561307.5.peg.235","1502"
"19112",484,147,337,"ACCGTCATCTGTAAACGCAA","CCATTGCTTGGTTCAATTGC","561307.5.peg.235","1502"
"19113",571,159,412,"ATCTTCACAGTGTGCTACGA","ATGATGTCAACACCATTGCT","561307.5.peg.235","1502"
"19114",411,159,252,"CGTGTTGTAATTGAAGCATA","ATGATGTCAACACCATTGCT","561307.5.peg.235","1502"
"19115",336,159,177,"TGTTCTACAGAATCTGGTAC","ATGATGTCAACACCATTGCT","561307.5.peg.235","1502"
"19116",484,159,325,"ACCGTCATCTGTAAACGCAA","ATGATGTCAACACCATTGCT","561307.5.peg.235","1502"
"19117",324,159,165,"TCTGGTACCGGTCTTGTGTT","ATGATGTCAACACCATTGCT","561307.5.peg.235","1502"
"19118",318,159,159,"ACCGGTCTTGTGTTAGGCAT","ATGATGTCAACACCATTGCT","561307.5.peg.235","1502"
"19119",654,159,495,"TCACAAATGTTTGGAATACC","ATGATGTCAACACCATTGCT","561307.5.peg.235","1502"
"19120",663,159,504,"GAACAGATTCACAAATGTT","ATGATGTCAACACCATTGCT","561307.5.peg.235","1502"
"19121",654,243,411,"TCACAAATGTTTGGAATACC","GTCTCTTTATATTCACCACC","561307.5.peg.235","1502"
"19122",411,243,168,"CGTGTTGTAATTGAAGCATA","GTCTCTTTATATTCACCACC","561307.5.peg.235","1502"
"19123",571,243,328,"ATCTTCACAGTGTGCTACGA","GTCTCTTTATATTCACCACC","561307.5.peg.235","1502"
"19124",484,243,241,"ACCGTCATCTGTAAACGCAA","GTCTCTTTATATTCACCACC","561307.5.peg.235","1502"
"19125",663,243,420,"GAACAGATTCACAAATGTT","GTCTCTTTATATTCACCACC","561307.5.peg.235","1502"
"19126",571,318,253,"ATCTTCACAGTGTGCTACGA","ACCGGTCTTGTGTTAGGCAT","561307.5.peg.235","1502"
"19127",147,318,171,"CCATTGCTTGGTTCAATTGC","ACCGGTCTTGTGTTAGGCAT","561307.5.peg.235","1502"
"19128",654,318,336,"TCACAAATGTTTGGAATACC","ACCGGTCTTGTGTTAGGCAT","561307.5.peg.235","1502"
"19129",159,318,159,"ATGATGTCAACACCATTGCT","ACCGGTCTTGTGTTAGGCAT","561307.5.peg.235","1502"
"19130",484,318,166,"ACCGTCATCTGTAAACGCAA","ACCGGTCTTGTGTTAGGCAT","561307.5.peg.235","1502"
"19131",663,318,345,"GAACAGATTCACAAATGTT","ACCGGTCTTGTGTTAGGCAT","561307.5.peg.235","1502"
"19132",654,324,330,"TCACAAATGTTTGGAATACC","TCTGGTACCGGTCTTGTGTT","561307.5.peg.235","1502"
"19133",571,324,247,"ATCTTCACAGTGTGCTACGA","TCTGGTACCGGTCTTGTGTT","561307.5.peg.235","1502"
"19134",159,324,165,"ATGATGTCAACACCATTGCT","TCTGGTACCGGTCTTGTGTT","561307.5.peg.235","1502"
"19135",147,324,177,"CCATTGCTTGGTTCAATTGC","TCTGGTACCGGTCTTGTGTT","561307.5.peg.235","1502"
"19136",663,324,339,"GAACAGATTCACAAATGTT","TCTGGTACCGGTCTTGTGTT","561307.5.peg.235","1502"
"19137",484,324,160,"ACCGTCATCTGTAAACGCAA","TCTGGTACCGGTCTTGTGTT","561307.5.peg.235","1502"
"19138",484,336,148,"ACCGTCATCTGTAAACGCAA","TGTTCTACAGAATCTGGTAC","561307.5.peg.235","1502"
"19139",654,336,318,"TCACAAATGTTTGGAATACC","TGTTCTACAGAATCTGGTAC","561307.5.peg.235","1502"
"19140",147,336,189,"CCATTGCTTGGTTCAATTGC","TGTTCTACAGAATCTGGTAC","561307.5.peg.235","1502"
"19141",571,336,235,"ATCTTCACAGTGTGCTACGA","TGTTCTACAGAATCTGGTAC","561307.5.peg.235","1502"
"19142",159,336,177,"ATGATGTCAACACCATTGCT","TGTTCTACAGAATCTGGTAC","561307.5.peg.235","1502"
"19143",663,336,327,"GAACAGATTCACAAATGTT","TGTTCTACAGAATCTGGTAC","561307.5.peg.235","1502"
"19144",663,411,252,"GAACAGATTCACAAATGTT","CGTGTTGTAATTGAAGCATA","561307.5.peg.235","1502"
"19145",243,411,168,"GTCTCTTTATATTCACCACC","CGTGTTGTAATTGAAGCATA","561307.5.peg.235","1502"
"19146",654,411,243,"TCACAAATGTTTGGAATACC","CGTGTTGTAATTGAAGCATA","561307.5.peg.235","1502"
"19147",147,411,264,"CCATTGCTTGGTTCAATTGC","CGTGTTGTAATTGAAGCATA","561307.5.peg.235","1502"
"19148",571,411,160,"ATCTTCACAGTGTGCTACGA","CGTGTTGTAATTGAAGCATA","561307.5.peg.235","1502"
"19149",159,411,252,"ATGATGTCAACACCATTGCT","CGTGTTGTAATTGAAGCATA","561307.5.peg.235","1502"
"19150",336,484,148,"TGTTCTACAGAATCTGGTAC","ACCGTCATCTGTAAACGCAA","561307.5.peg.235","1502"
"19151",318,484,166,"ACCGGTCTTGTGTTAGGCAT","ACCGTCATCTGTAAACGCAA","561307.5.peg.235","1502"
"19152",324,484,160,"TCTGGTACCGGTCTTGTGTT","ACCGTCATCTGTAAACGCAA","561307.5.peg.235","1502"
"19153",663,484,179,"GAACAGATTCACAAATGTT","ACCGTCATCTGTAAACGCAA","561307.5.peg.235","1502"
"19154",159,484,325,"ATGATGTCAACACCATTGCT","ACCGTCATCTGTAAACGCAA","561307.5.peg.235","1502"
"19155",243,484,241,"GTCTCTTTATATTCACCACC","ACCGTCATCTGTAAACGCAA","561307.5.peg.235","1502"
"19156",147,484,337,"CCATTGCTTGGTTCAATTGC","ACCGTCATCTGTAAACGCAA","561307.5.peg.235","1502"
"19157",654,484,170,"TCACAAATGTTTGGAATACC","ACCGTCATCTGTAAACGCAA","561307.5.peg.235","1502"
"19158",147,571,424,"CCATTGCTTGGTTCAATTGC","ATCTTCACAGTGTGCTACGA","561307.5.peg.235","1502"
"19159",411,571,160,"CGTGTTGTAATTGAAGCATA","ATCTTCACAGTGTGCTACGA","561307.5.peg.235","1502"
"19160",336,571,235,"TGTTCTACAGAATCTGGTAC","ATCTTCACAGTGTGCTACGA","561307.5.peg.235","1502"
"19161",243,571,328,"GTCTCTTTATATTCACCACC","ATCTTCACAGTGTGCTACGA","561307.5.peg.235","1502"
"19162",159,571,412,"ATGATGTCAACACCATTGCT","ATCTTCACAGTGTGCTACGA","561307.5.peg.235","1502"
"19163",318,571,253,"ACCGGTCTTGTGTTAGGCAT","ATCTTCACAGTGTGCTACGA","561307.5.peg.235","1502"
"19164",324,571,247,"TCTGGTACCGGTCTTGTGTT","ATCTTCACAGTGTGCTACGA","561307.5.peg.235","1502"
"19165",159,654,495,"ATGATGTCAACACCATTGCT","TCACAAATGTTTGGAATACC","561307.5.peg.235","1502"
"19166",324,654,330,"TCTGGTACCGGTCTTGTGTT","TCACAAATGTTTGGAATACC","561307.5.peg.235","1502"
"19167",318,654,336,"ACCGGTCTTGTGTTAGGCAT","TCACAAATGTTTGGAATACC","561307.5.peg.235","1502"
"19168",336,654,318,"TGTTCTACAGAATCTGGTAC","TCACAAATGTTTGGAATACC","561307.5.peg.235","1502"
"19169",147,654,507,"CCATTGCTTGGTTCAATTGC","TCACAAATGTTTGGAATACC","561307.5.peg.235","1502"
"19170",243,654,411,"GTCTCTTTATATTCACCACC","TCACAAATGTTTGGAATACC","561307.5.peg.235","1502"
"19171",411,654,243,"CGTGTTGTAATTGAAGCATA","TCACAAATGTTTGGAATACC","561307.5.peg.235","1502"
"19172",484,654,170,"ACCGTCATCTGTAAACGCAA","TCACAAATGTTTGGAATACC","561307.5.peg.235","1502"
"19173",159,663,504,"ATGATGTCAACACCATTGCT","GAACAGATTCACAAATGTT","561307.5.peg.235","1502"
"19174",484,663,179,"ACCGTCATCTGTAAACGCAA","GAACAGATTCACAAATGTT","561307.5.peg.235","1502"
"19175",243,663,420,"GTCTCTTTATATTCACCACC","GAACAGATTCACAAATGTT","561307.5.peg.235","1502"
"19176",318,663,345,"ACCGGTCTTGTGTTAGGCAT","GAACAGATTCACAAATGTT","561307.5.peg.235","1502"
"19177",147,663,516,"CCATTGCTTGGTTCAATTGC","GAACAGATTCACAAATGTT","561307.5.peg.235","1502"
"19178",411,663,252,"CGTGTTGTAATTGAAGCATA","GAACAGATTCACAAATGTT","561307.5.peg.235","1502"
"19179",324,663,339,"TCTGGTACCGGTCTTGTGTT","GAACAGATTCACAAATGTT","561307.5.peg.235","1502"
"19180",336,663,327,"TGTTCTACAGAATCTGGTAC","GAACAGATTCACAAATGTT","561307.5.peg.235","1502"
"19181",273,141,132,"TTGTATCAAGTGTTTCTTG","CTTGCTGCCTTCCAAATATC","561307.5.peg.2350","1503"
"19182",336,141,195,"GATCTAATACCACCACCAAT","CTTGCTGCCTTCCAAATATC","561307.5.peg.2350","1503"
"19183",438,141,297,"ACATCTTGTGGACGTTTAAC","CTTGCTGCCTTCCAAATATC","561307.5.peg.2350","1503"
"19184",590,141,449,"TACCAATACCTGAAGTTTCT","CTTGCTGCCTTCCAAATATC","561307.5.peg.2350","1503"
"19185",408,141,267,"ACTCCTTTAAACCAACGTAC","CTTGCTGCCTTCCAAATATC","561307.5.peg.2350","1503"
"19186",336,164,172,"GATCTAATACCACCACCAAT","CAACAGCAGCATCTATAACT","561307.5.peg.2350","1503"
"19187",408,164,244,"ACTCCTTTAAACCAACGTAC","CAACAGCAGCATCTATAACT","561307.5.peg.2350","1503"
"19188",273,164,109,"TTGTATCAAGTGTTTCTTG","CAACAGCAGCATCTATAACT","561307.5.peg.2350","1503"
"19189",438,164,274,"ACATCTTGTGGACGTTTAAC","CAACAGCAGCATCTATAACT","561307.5.peg.2350","1503"
"19190",590,164,426,"TACCAATACCTGAAGTTTCT","CAACAGCAGCATCTATAACT","561307.5.peg.2350","1503"
"19191",590,273,317,"TACCAATACCTGAAGTTTCT","TTGTATCAAGTGTTTCTTG","561307.5.peg.2350","1503"
"19192",164,273,109,"CAACAGCAGCATCTATAACT","TTGTATCAAGTGTTTCTTG","561307.5.peg.2350","1503"
"19193",141,273,132,"CTTGCTGCCTTCCAAATATC","TTGTATCAAGTGTTTCTTG","561307.5.peg.2350","1503"
"19194",408,273,135,"ACTCCTTTAAACCAACGTAC","TTGTATCAAGTGTTTCTTG","561307.5.peg.2350","1503"
"19195",438,273,165,"ACATCTTGTGGACGTTTAAC","TTGTATCAAGTGTTTCTTG","561307.5.peg.2350","1503"
"19196",141,336,195,"CTTGCTGCCTTCCAAATATC","GATCTAATACCACCACCAAT","561307.5.peg.2350","1503"
"19197",164,336,172,"CAACAGCAGCATCTATAACT","GATCTAATACCACCACCAAT","561307.5.peg.2350","1503"
"19198",438,336,102,"ACATCTTGTGGACGTTTAAC","GATCTAATACCACCACCAAT","561307.5.peg.2350","1503"
"19199",590,336,254,"TACCAATACCTGAAGTTTCT","GATCTAATACCACCACCAAT","561307.5.peg.2350","1503"
"19200",141,408,267,"CTTGCTGCCTTCCAAATATC","ACTCCTTTAAACCAACGTAC","561307.5.peg.2350","1503"
"19201",590,408,182,"TACCAATACCTGAAGTTTCT","ACTCCTTTAAACCAACGTAC","561307.5.peg.2350","1503"
"19202",164,408,244,"CAACAGCAGCATCTATAACT","ACTCCTTTAAACCAACGTAC","561307.5.peg.2350","1503"
"19203",273,408,135,"TTGTATCAAGTGTTTCTTG","ACTCCTTTAAACCAACGTAC","561307.5.peg.2350","1503"
"19204",164,438,274,"CAACAGCAGCATCTATAACT","ACATCTTGTGGACGTTTAAC","561307.5.peg.2350","1503"
"19205",273,438,165,"TTGTATCAAGTGTTTCTTG","ACATCTTGTGGACGTTTAAC","561307.5.peg.2350","1503"
"19206",141,438,297,"CTTGCTGCCTTCCAAATATC","ACATCTTGTGGACGTTTAAC","561307.5.peg.2350","1503"
"19207",590,438,152,"TACCAATACCTGAAGTTTCT","ACATCTTGTGGACGTTTAAC","561307.5.peg.2350","1503"
"19208",336,438,102,"GATCTAATACCACCACCAAT","ACATCTTGTGGACGTTTAAC","561307.5.peg.2350","1503"
"19209",273,590,317,"TTGTATCAAGTGTTTCTTG","TACCAATACCTGAAGTTTCT","561307.5.peg.2350","1503"
"19210",141,590,449,"CTTGCTGCCTTCCAAATATC","TACCAATACCTGAAGTTTCT","561307.5.peg.2350","1503"
"19211",336,590,254,"GATCTAATACCACCACCAAT","TACCAATACCTGAAGTTTCT","561307.5.peg.2350","1503"
"19212",164,590,426,"CAACAGCAGCATCTATAACT","TACCAATACCTGAAGTTTCT","561307.5.peg.2350","1503"
"19213",438,590,152,"ACATCTTGTGGACGTTTAAC","TACCAATACCTGAAGTTTCT","561307.5.peg.2350","1503"
"19214",408,590,182,"ACTCCTTTAAACCAACGTAC","TACCAATACCTGAAGTTTCT","561307.5.peg.2350","1503"
"19215",246,61,185,"GACGTACGTAATGCTGTCAT","TAGATCATCAATATCATAGC","561307.5.peg.2351","1504"
"19216",405,61,344,"AAGTCAGGATTAGGCTTAAG","TAGATCATCAATATCATAGC","561307.5.peg.2351","1504"
"19217",446,61,385,"ATTCCCCACGTAACATATAT","TAGATCATCAATATCATAGC","561307.5.peg.2351","1504"
"19218",246,138,108,"GACGTACGTAATGCTGTCAT","TGAGCAAGCTCTTCTTCGTT","561307.5.peg.2351","1504"
"19219",446,138,308,"ATTCCCCACGTAACATATAT","TGAGCAAGCTCTTCTTCGTT","561307.5.peg.2351","1504"
"19220",405,138,267,"AAGTCAGGATTAGGCTTAAG","TGAGCAAGCTCTTCTTCGTT","561307.5.peg.2351","1504"
"19221",61,246,185,"TAGATCATCAATATCATAGC","GACGTACGTAATGCTGTCAT","561307.5.peg.2351","1504"
"19222",138,246,108,"TGAGCAAGCTCTTCTTCGTT","GACGTACGTAATGCTGTCAT","561307.5.peg.2351","1504"
"19223",405,246,159,"AAGTCAGGATTAGGCTTAAG","GACGTACGTAATGCTGTCAT","561307.5.peg.2351","1504"
"19224",446,246,200,"ATTCCCCACGTAACATATAT","GACGTACGTAATGCTGTCAT","561307.5.peg.2351","1504"
"19225",61,405,344,"TAGATCATCAATATCATAGC","AAGTCAGGATTAGGCTTAAG","561307.5.peg.2351","1504"
"19226",138,405,267,"TGAGCAAGCTCTTCTTCGTT","AAGTCAGGATTAGGCTTAAG","561307.5.peg.2351","1504"
"19227",246,405,159,"GACGTACGTAATGCTGTCAT","AAGTCAGGATTAGGCTTAAG","561307.5.peg.2351","1504"
"19228",61,446,385,"TAGATCATCAATATCATAGC","ATTCCCCACGTAACATATAT","561307.5.peg.2351","1504"
"19229",246,446,200,"GACGTACGTAATGCTGTCAT","ATTCCCCACGTAACATATAT","561307.5.peg.2351","1504"
"19230",138,446,308,"TGAGCAAGCTCTTCTTCGTT","ATTCCCCACGTAACATATAT","561307.5.peg.2351","1504"
"19231",398,163,235,"TTATCCAGTTTGGAATTTCT","TGTTAATAGAATTGAAGGGC","561307.5.peg.2352","1505"
"19232",408,163,245,"AATAGTGCACTTATCCAGTT","TGTTAATAGAATTGAAGGGC","561307.5.peg.2352","1505"
"19233",163,398,235,"TGTTAATAGAATTGAAGGGC","TTATCCAGTTTGGAATTTCT","561307.5.peg.2352","1505"
"19234",163,408,245,"TGTTAATAGAATTGAAGGGC","AATAGTGCACTTATCCAGTT","561307.5.peg.2352","1505"
"19235",268,39,229,"AATGCCTTGATTGAGTGCGT","ATTCATCCACATTTATGTC","561307.5.peg.2357","1510"
"19236",39,268,229,"ATTCATCCACATTTATGTC","AATGCCTTGATTGAGTGCGT","561307.5.peg.2357","1510"
"19237",268,6,262,"GCGTGTAGTTAAGTATCTAT","CATTTAATTAAGAGATGGGA","561307.5.peg.2360","1514"
"19238",213,6,207,"GTGACAAGATAATAAAGCA","CATTTAATTAAGAGATGGGA","561307.5.peg.2360","1514"
"19239",395,6,389,"AGCCATACCATTGACCTAAT","CATTTAATTAAGAGATGGGA","561307.5.peg.2360","1514"
"19240",213,10,203,"GTGACAAGATAATAAAGCA","GAGCATTTAATTAAGAGAT","561307.5.peg.2360","1514"
"19241",395,10,385,"AGCCATACCATTGACCTAAT","GAGCATTTAATTAAGAGAT","561307.5.peg.2360","1514"
"19242",268,10,258,"GCGTGTAGTTAAGTATCTAT","GAGCATTTAATTAAGAGAT","561307.5.peg.2360","1514"
"19243",6,213,207,"CATTTAATTAAGAGATGGGA","GTGACAAGATAATAAAGCA","561307.5.peg.2360","1514"
"19244",395,213,182,"AGCCATACCATTGACCTAAT","GTGACAAGATAATAAAGCA","561307.5.peg.2360","1514"
"19245",10,213,203,"GAGCATTTAATTAAGAGAT","GTGACAAGATAATAAAGCA","561307.5.peg.2360","1514"
"19246",6,268,262,"CATTTAATTAAGAGATGGGA","GCGTGTAGTTAAGTATCTAT","561307.5.peg.2360","1514"
"19247",395,268,127,"AGCCATACCATTGACCTAAT","GCGTGTAGTTAAGTATCTAT","561307.5.peg.2360","1514"
"19248",10,268,258,"GAGCATTTAATTAAGAGAT","GCGTGTAGTTAAGTATCTAT","561307.5.peg.2360","1514"
"19249",6,395,389,"CATTTAATTAAGAGATGGGA","AGCCATACCATTGACCTAAT","561307.5.peg.2360","1514"
"19250",10,395,385,"GAGCATTTAATTAAGAGAT","AGCCATACCATTGACCTAAT","561307.5.peg.2360","1514"
"19251",213,395,182,"GTGACAAGATAATAAAGCA","AGCCATACCATTGACCTAAT","561307.5.peg.2360","1514"
"19252",268,395,127,"GCGTGTAGTTAAGTATCTAT","AGCCATACCATTGACCTAAT","561307.5.peg.2360","1514"
"19253",567,444,123,"TCCTTTATTCGACTTTGTGA","AACCCTTGATTTACATCGCT","561307.5.peg.2361","1515"
"19254",792,444,348,"TTGTCCTTTGTTGGTTCTAC","AACCCTTGATTTACATCGCT","561307.5.peg.2361","1515"
"19255",867,444,423,"AGTTCCTTTGTCCCTTTGTT","AACCCTTGATTTACATCGCT","561307.5.peg.2361","1515"
"19256",801,444,357,"TTCTTGTCATTGTCCTTTGT","AACCCTTGATTTACATCGCT","561307.5.peg.2361","1515"
"19257",1005,444,561,"CAATAATGAGCTAACACTGA","AACCCTTGATTTACATCGCT","561307.5.peg.2361","1515"
"19258",444,567,123,"AACCCTTGATTTACATCGCT","TCCTTTATTCGACTTTGTGA","561307.5.peg.2361","1515"
"19259",801,567,234,"TTCTTGTCATTGTCCTTTGT","TCCTTTATTCGACTTTGTGA","561307.5.peg.2361","1515"
"19260",792,567,225,"TTGTCCTTTGTTGGTTCTAC","TCCTTTATTCGACTTTGTGA","561307.5.peg.2361","1515"
"19261",867,567,300,"AGTTCCTTTGTCCCTTTGTT","TCCTTTATTCGACTTTGTGA","561307.5.peg.2361","1515"
"19262",1005,567,438,"CAATAATGAGCTAACACTGA","TCCTTTATTCGACTTTGTGA","561307.5.peg.2361","1515"
"19263",1005,792,213,"CAATAATGAGCTAACACTGA","TTGTCCTTTGTTGGTTCTAC","561307.5.peg.2361","1515"
"19264",567,792,225,"TCCTTTATTCGACTTTGTGA","TTGTCCTTTGTTGGTTCTAC","561307.5.peg.2361","1515"
"19265",444,792,348,"AACCCTTGATTTACATCGCT","TTGTCCTTTGTTGGTTCTAC","561307.5.peg.2361","1515"
"19266",567,801,234,"TCCTTTATTCGACTTTGTGA","TTCTTGTCATTGTCCTTTGT","561307.5.peg.2361","1515"
"19267",444,801,357,"AACCCTTGATTTACATCGCT","TTCTTGTCATTGTCCTTTGT","561307.5.peg.2361","1515"
"19268",1005,801,204,"CAATAATGAGCTAACACTGA","TTCTTGTCATTGTCCTTTGT","561307.5.peg.2361","1515"
"19269",567,867,300,"TCCTTTATTCGACTTTGTGA","AGTTCCTTTGTCCCTTTGTT","561307.5.peg.2361","1515"
"19270",444,867,423,"AACCCTTGATTTACATCGCT","AGTTCCTTTGTCCCTTTGTT","561307.5.peg.2361","1515"
"19271",1005,867,138,"CAATAATGAGCTAACACTGA","AGTTCCTTTGTCCCTTTGTT","561307.5.peg.2361","1515"
"19272",567,1005,438,"TCCTTTATTCGACTTTGTGA","CAATAATGAGCTAACACTGA","561307.5.peg.2361","1515"
"19273",867,1005,138,"AGTTCCTTTGTCCCTTTGTT","CAATAATGAGCTAACACTGA","561307.5.peg.2361","1515"
"19274",444,1005,561,"AACCCTTGATTTACATCGCT","CAATAATGAGCTAACACTGA","561307.5.peg.2361","1515"
"19275",801,1005,204,"TTCTTGTCATTGTCCTTTGT","CAATAATGAGCTAACACTGA","561307.5.peg.2361","1515"
"19276",792,1005,213,"TTGTCCTTTGTTGGTTCTAC","CAATAATGAGCTAACACTGA","561307.5.peg.2361","1515"
"19277",315,13,302,"TGACTGCCTGTATGACATGT","AAAGAAGTGATACGGCAAGG","561307.5.peg.2363","1517"
"19278",315,15,300,"TGACTGCCTGTATGACATGT","TTAAAGAAGTGATACGGCAA","561307.5.peg.2363","1517"
"19279",13,315,302,"AAAGAAGTGATACGGCAAGG","TGACTGCCTGTATGACATGT","561307.5.peg.2363","1517"
"19280",15,315,300,"TTAAAGAAGTGATACGGCAA","TGACTGCCTGTATGACATGT","561307.5.peg.2363","1517"
"19281",275,72,203,"TCCCACCCCCTACAGTAAGA","CCATCTTTGACATCTAAACA","561307.5.peg.2364","1518"
"19282",378,72,306,"CTCGCTTGTTTAATGAGCTG","CCATCTTTGACATCTAAACA","561307.5.peg.2364","1518"
"19283",72,275,203,"CCATCTTTGACATCTAAACA","TCCCACCCCCTACAGTAAGA","561307.5.peg.2364","1518"
"19284",378,275,103,"CTCGCTTGTTTAATGAGCTG","TCCCACCCCCTACAGTAAGA","561307.5.peg.2364","1518"
"19285",72,378,306,"CCATCTTTGACATCTAAACA","CTCGCTTGTTTAATGAGCTG","561307.5.peg.2364","1518"
"19286",275,378,103,"TCCCACCCCCTACAGTAAGA","CTCGCTTGTTTAATGAGCTG","561307.5.peg.2364","1518"
"19287",337,9,328,"TATGCAATAATTAATCCCTG","TTGCGTCAGGCAATACAAGG","561307.5.peg.2365","1519"
"19288",337,66,271,"TATGCAATAATTAATCCCTG","GACCCAATCAAATCAATCGC","561307.5.peg.2365","1519"
"19289",9,337,328,"TTGCGTCAGGCAATACAAGG","TATGCAATAATTAATCCCTG","561307.5.peg.2365","1519"
"19290",66,337,271,"GACCCAATCAAATCAATCGC","TATGCAATAATTAATCCCTG","561307.5.peg.2365","1519"
"19291",236,120,116,"TGCCGATATCTTCAGTTACG","ACACCTGTATTAATATGCGA","561307.5.peg.2367","1521"
"19292",120,236,116,"ACACCTGTATTAATATGCGA","TGCCGATATCTTCAGTTACG","561307.5.peg.2367","1521"
"19293",438,264,174,"TGCTTGCCTGAAGGGTTATG","AGCGTTAATGCCGGACCTTC","561307.5.peg.2368","1522"
"19294",446,264,182,"TATCAAATTGCTTGCCTGAA","AGCGTTAATGCCGGACCTTC","561307.5.peg.2368","1522"
"19295",438,273,165,"TGCTTGCCTGAAGGGTTATG","TCAGGATTTAGCGTTAATGC","561307.5.peg.2368","1522"
"19296",446,273,173,"TATCAAATTGCTTGCCTGAA","TCAGGATTTAGCGTTAATGC","561307.5.peg.2368","1522"
"19297",264,438,174,"AGCGTTAATGCCGGACCTTC","TGCTTGCCTGAAGGGTTATG","561307.5.peg.2368","1522"
"19298",273,438,165,"TCAGGATTTAGCGTTAATGC","TGCTTGCCTGAAGGGTTATG","561307.5.peg.2368","1522"
"19299",264,446,182,"AGCGTTAATGCCGGACCTTC","TATCAAATTGCTTGCCTGAA","561307.5.peg.2368","1522"
"19300",273,446,173,"TCAGGATTTAGCGTTAATGC","TATCAAATTGCTTGCCTGAA","561307.5.peg.2368","1522"
"19301",378,13,365,"TAAATACCGACACTTTCTAG","GCAATTTATTCGCTCTTTGG","561307.5.peg.2369","1523"
"19302",498,13,485,"TGAGACACACCATTAGGTTG","GCAATTTATTCGCTCTTTGG","561307.5.peg.2369","1523"
"19303",374,13,361,"TACCGACACTTTCTAGTGGA","GCAATTTATTCGCTCTTTGG","561307.5.peg.2369","1523"
"19304",504,13,491,"ACTTCTTGAGACACACCATT","GCAATTTATTCGCTCTTTGG","561307.5.peg.2369","1523"
"19305",426,13,413,"GCTGTCATTAATACCGTTGA","GCAATTTATTCGCTCTTTGG","561307.5.peg.2369","1523"
"19306",117,13,104,"GACAAATATCGCGAATAAT","GCAATTTATTCGCTCTTTGG","561307.5.peg.2369","1523"
"19307",645,13,632,"TATGCAACAAATTGATTGCC","GCAATTTATTCGCTCTTTGG","561307.5.peg.2369","1523"
"19308",495,13,482,"GACACACCATTAGGTTGAGG","GCAATTTATTCGCTCTTTGG","561307.5.peg.2369","1523"
"19309",117,16,101,"GACAAATATCGCGAATAAT","AGAGCAATTTATTCGCTCTT","561307.5.peg.2369","1523"
"19310",426,16,410,"GCTGTCATTAATACCGTTGA","AGAGCAATTTATTCGCTCTT","561307.5.peg.2369","1523"
"19311",645,16,629,"TATGCAACAAATTGATTGCC","AGAGCAATTTATTCGCTCTT","561307.5.peg.2369","1523"
"19312",498,16,482,"TGAGACACACCATTAGGTTG","AGAGCAATTTATTCGCTCTT","561307.5.peg.2369","1523"
"19313",378,16,362,"TAAATACCGACACTTTCTAG","AGAGCAATTTATTCGCTCTT","561307.5.peg.2369","1523"
"19314",504,16,488,"ACTTCTTGAGACACACCATT","AGAGCAATTTATTCGCTCTT","561307.5.peg.2369","1523"
"19315",374,16,358,"TACCGACACTTTCTAGTGGA","AGAGCAATTTATTCGCTCTT","561307.5.peg.2369","1523"
"19316",495,16,479,"GACACACCATTAGGTTGAGG","AGAGCAATTTATTCGCTCTT","561307.5.peg.2369","1523"
"19317",498,48,450,"TGAGACACACCATTAGGTTG","ATTGTTGTGCATTAAGCAT","561307.5.peg.2369","1523"
"19318",378,48,330,"TAAATACCGACACTTTCTAG","ATTGTTGTGCATTAAGCAT","561307.5.peg.2369","1523"
"19319",495,48,447,"GACACACCATTAGGTTGAGG","ATTGTTGTGCATTAAGCAT","561307.5.peg.2369","1523"
"19320",504,48,456,"ACTTCTTGAGACACACCATT","ATTGTTGTGCATTAAGCAT","561307.5.peg.2369","1523"
"19321",645,48,597,"TATGCAACAAATTGATTGCC","ATTGTTGTGCATTAAGCAT","561307.5.peg.2369","1523"
"19322",426,48,378,"GCTGTCATTAATACCGTTGA","ATTGTTGTGCATTAAGCAT","561307.5.peg.2369","1523"
"19323",374,48,326,"TACCGACACTTTCTAGTGGA","ATTGTTGTGCATTAAGCAT","561307.5.peg.2369","1523"
"19324",498,96,402,"TGAGACACACCATTAGGTTG","GGATACAATGACTCATCTAA","561307.5.peg.2369","1523"
"19325",426,96,330,"GCTGTCATTAATACCGTTGA","GGATACAATGACTCATCTAA","561307.5.peg.2369","1523"
"19326",495,96,399,"GACACACCATTAGGTTGAGG","GGATACAATGACTCATCTAA","561307.5.peg.2369","1523"
"19327",645,96,549,"TATGCAACAAATTGATTGCC","GGATACAATGACTCATCTAA","561307.5.peg.2369","1523"
"19328",374,96,278,"TACCGACACTTTCTAGTGGA","GGATACAATGACTCATCTAA","561307.5.peg.2369","1523"
"19329",378,96,282,"TAAATACCGACACTTTCTAG","GGATACAATGACTCATCTAA","561307.5.peg.2369","1523"
"19330",504,96,408,"ACTTCTTGAGACACACCATT","GGATACAATGACTCATCTAA","561307.5.peg.2369","1523"
"19331",13,117,104,"GCAATTTATTCGCTCTTTGG","GACAAATATCGCGAATAAT","561307.5.peg.2369","1523"
"19332",378,117,261,"TAAATACCGACACTTTCTAG","GACAAATATCGCGAATAAT","561307.5.peg.2369","1523"
"19333",495,117,378,"GACACACCATTAGGTTGAGG","GACAAATATCGCGAATAAT","561307.5.peg.2369","1523"
"19334",374,117,257,"TACCGACACTTTCTAGTGGA","GACAAATATCGCGAATAAT","561307.5.peg.2369","1523"
"19335",16,117,101,"AGAGCAATTTATTCGCTCTT","GACAAATATCGCGAATAAT","561307.5.peg.2369","1523"
"19336",504,117,387,"ACTTCTTGAGACACACCATT","GACAAATATCGCGAATAAT","561307.5.peg.2369","1523"
"19337",645,117,528,"TATGCAACAAATTGATTGCC","GACAAATATCGCGAATAAT","561307.5.peg.2369","1523"
"19338",426,117,309,"GCTGTCATTAATACCGTTGA","GACAAATATCGCGAATAAT","561307.5.peg.2369","1523"
"19339",498,117,381,"TGAGACACACCATTAGGTTG","GACAAATATCGCGAATAAT","561307.5.peg.2369","1523"
"19340",117,374,257,"GACAAATATCGCGAATAAT","TACCGACACTTTCTAGTGGA","561307.5.peg.2369","1523"
"19341",16,374,358,"AGAGCAATTTATTCGCTCTT","TACCGACACTTTCTAGTGGA","561307.5.peg.2369","1523"
"19342",13,374,361,"GCAATTTATTCGCTCTTTGG","TACCGACACTTTCTAGTGGA","561307.5.peg.2369","1523"
"19343",498,374,124,"TGAGACACACCATTAGGTTG","TACCGACACTTTCTAGTGGA","561307.5.peg.2369","1523"
"19344",504,374,130,"ACTTCTTGAGACACACCATT","TACCGACACTTTCTAGTGGA","561307.5.peg.2369","1523"
"19345",48,374,326,"ATTGTTGTGCATTAAGCAT","TACCGACACTTTCTAGTGGA","561307.5.peg.2369","1523"
"19346",495,374,121,"GACACACCATTAGGTTGAGG","TACCGACACTTTCTAGTGGA","561307.5.peg.2369","1523"
"19347",645,374,271,"TATGCAACAAATTGATTGCC","TACCGACACTTTCTAGTGGA","561307.5.peg.2369","1523"
"19348",96,374,278,"GGATACAATGACTCATCTAA","TACCGACACTTTCTAGTGGA","561307.5.peg.2369","1523"
"19349",498,378,120,"TGAGACACACCATTAGGTTG","TAAATACCGACACTTTCTAG","561307.5.peg.2369","1523"
"19350",645,378,267,"TATGCAACAAATTGATTGCC","TAAATACCGACACTTTCTAG","561307.5.peg.2369","1523"
"19351",13,378,365,"GCAATTTATTCGCTCTTTGG","TAAATACCGACACTTTCTAG","561307.5.peg.2369","1523"
"19352",16,378,362,"AGAGCAATTTATTCGCTCTT","TAAATACCGACACTTTCTAG","561307.5.peg.2369","1523"
"19353",48,378,330,"ATTGTTGTGCATTAAGCAT","TAAATACCGACACTTTCTAG","561307.5.peg.2369","1523"
"19354",504,378,126,"ACTTCTTGAGACACACCATT","TAAATACCGACACTTTCTAG","561307.5.peg.2369","1523"
"19355",96,378,282,"GGATACAATGACTCATCTAA","TAAATACCGACACTTTCTAG","561307.5.peg.2369","1523"
"19356",495,378,117,"GACACACCATTAGGTTGAGG","TAAATACCGACACTTTCTAG","561307.5.peg.2369","1523"
"19357",117,378,261,"GACAAATATCGCGAATAAT","TAAATACCGACACTTTCTAG","561307.5.peg.2369","1523"
"19358",96,426,330,"GGATACAATGACTCATCTAA","GCTGTCATTAATACCGTTGA","561307.5.peg.2369","1523"
"19359",645,426,219,"TATGCAACAAATTGATTGCC","GCTGTCATTAATACCGTTGA","561307.5.peg.2369","1523"
"19360",117,426,309,"GACAAATATCGCGAATAAT","GCTGTCATTAATACCGTTGA","561307.5.peg.2369","1523"
"19361",16,426,410,"AGAGCAATTTATTCGCTCTT","GCTGTCATTAATACCGTTGA","561307.5.peg.2369","1523"
"19362",13,426,413,"GCAATTTATTCGCTCTTTGG","GCTGTCATTAATACCGTTGA","561307.5.peg.2369","1523"
"19363",48,426,378,"ATTGTTGTGCATTAAGCAT","GCTGTCATTAATACCGTTGA","561307.5.peg.2369","1523"
"19364",48,495,447,"ATTGTTGTGCATTAAGCAT","GACACACCATTAGGTTGAGG","561307.5.peg.2369","1523"
"19365",96,495,399,"GGATACAATGACTCATCTAA","GACACACCATTAGGTTGAGG","561307.5.peg.2369","1523"
"19366",645,495,150,"TATGCAACAAATTGATTGCC","GACACACCATTAGGTTGAGG","561307.5.peg.2369","1523"
"19367",117,495,378,"GACAAATATCGCGAATAAT","GACACACCATTAGGTTGAGG","561307.5.peg.2369","1523"
"19368",13,495,482,"GCAATTTATTCGCTCTTTGG","GACACACCATTAGGTTGAGG","561307.5.peg.2369","1523"
"19369",374,495,121,"TACCGACACTTTCTAGTGGA","GACACACCATTAGGTTGAGG","561307.5.peg.2369","1523"
"19370",16,495,479,"AGAGCAATTTATTCGCTCTT","GACACACCATTAGGTTGAGG","561307.5.peg.2369","1523"
"19371",378,495,117,"TAAATACCGACACTTTCTAG","GACACACCATTAGGTTGAGG","561307.5.peg.2369","1523"
"19372",13,498,485,"GCAATTTATTCGCTCTTTGG","TGAGACACACCATTAGGTTG","561307.5.peg.2369","1523"
"19373",374,498,124,"TACCGACACTTTCTAGTGGA","TGAGACACACCATTAGGTTG","561307.5.peg.2369","1523"
"19374",16,498,482,"AGAGCAATTTATTCGCTCTT","TGAGACACACCATTAGGTTG","561307.5.peg.2369","1523"
"19375",48,498,450,"ATTGTTGTGCATTAAGCAT","TGAGACACACCATTAGGTTG","561307.5.peg.2369","1523"
"19376",96,498,402,"GGATACAATGACTCATCTAA","TGAGACACACCATTAGGTTG","561307.5.peg.2369","1523"
"19377",117,498,381,"GACAAATATCGCGAATAAT","TGAGACACACCATTAGGTTG","561307.5.peg.2369","1523"
"19378",378,498,120,"TAAATACCGACACTTTCTAG","TGAGACACACCATTAGGTTG","561307.5.peg.2369","1523"
"19379",645,498,147,"TATGCAACAAATTGATTGCC","TGAGACACACCATTAGGTTG","561307.5.peg.2369","1523"
"19380",13,504,491,"GCAATTTATTCGCTCTTTGG","ACTTCTTGAGACACACCATT","561307.5.peg.2369","1523"
"19381",374,504,130,"TACCGACACTTTCTAGTGGA","ACTTCTTGAGACACACCATT","561307.5.peg.2369","1523"
"19382",378,504,126,"TAAATACCGACACTTTCTAG","ACTTCTTGAGACACACCATT","561307.5.peg.2369","1523"
"19383",96,504,408,"GGATACAATGACTCATCTAA","ACTTCTTGAGACACACCATT","561307.5.peg.2369","1523"
"19384",117,504,387,"GACAAATATCGCGAATAAT","ACTTCTTGAGACACACCATT","561307.5.peg.2369","1523"
"19385",645,504,141,"TATGCAACAAATTGATTGCC","ACTTCTTGAGACACACCATT","561307.5.peg.2369","1523"
"19386",48,504,456,"ATTGTTGTGCATTAAGCAT","ACTTCTTGAGACACACCATT","561307.5.peg.2369","1523"
"19387",16,504,488,"AGAGCAATTTATTCGCTCTT","ACTTCTTGAGACACACCATT","561307.5.peg.2369","1523"
"19388",48,645,597,"ATTGTTGTGCATTAAGCAT","TATGCAACAAATTGATTGCC","561307.5.peg.2369","1523"
"19389",16,645,629,"AGAGCAATTTATTCGCTCTT","TATGCAACAAATTGATTGCC","561307.5.peg.2369","1523"
"19390",498,645,147,"TGAGACACACCATTAGGTTG","TATGCAACAAATTGATTGCC","561307.5.peg.2369","1523"
"19391",426,645,219,"GCTGTCATTAATACCGTTGA","TATGCAACAAATTGATTGCC","561307.5.peg.2369","1523"
"19392",117,645,528,"GACAAATATCGCGAATAAT","TATGCAACAAATTGATTGCC","561307.5.peg.2369","1523"
"19393",13,645,632,"GCAATTTATTCGCTCTTTGG","TATGCAACAAATTGATTGCC","561307.5.peg.2369","1523"
"19394",504,645,141,"ACTTCTTGAGACACACCATT","TATGCAACAAATTGATTGCC","561307.5.peg.2369","1523"
"19395",378,645,267,"TAAATACCGACACTTTCTAG","TATGCAACAAATTGATTGCC","561307.5.peg.2369","1523"
"19396",374,645,271,"TACCGACACTTTCTAGTGGA","TATGCAACAAATTGATTGCC","561307.5.peg.2369","1523"
"19397",96,645,549,"GGATACAATGACTCATCTAA","TATGCAACAAATTGATTGCC","561307.5.peg.2369","1523"
"19398",495,645,150,"GACACACCATTAGGTTGAGG","TATGCAACAAATTGATTGCC","561307.5.peg.2369","1523"
"19399",492,111,381,"ATTGCCATATTGACTGCAGT","AATGCCCATTGCGCTGGTTG","561307.5.peg.237","1524"
"19400",444,111,333,"ATGACTGGTCCAACAACAAC","AATGCCCATTGCGCTGGTTG","561307.5.peg.237","1524"
"19401",273,111,162,"AAGCTAGATCCCAAGTATGC","AATGCCCATTGCGCTGGTTG","561307.5.peg.237","1524"
"19402",441,111,330,"ACTGGTCCAACAACAACTGG","AATGCCCATTGCGCTGGTTG","561307.5.peg.237","1524"
"19403",309,111,198,"GTACTTAATCCCGTGATAAT","AATGCCCATTGCGCTGGTTG","561307.5.peg.237","1524"
"19404",525,111,414,"TTGTAACCTTTCATATCTCC","AATGCCCATTGCGCTGGTTG","561307.5.peg.237","1524"
"19405",633,111,522,"ACGATAATACCTACAAGAAC","AATGCCCATTGCGCTGGTTG","561307.5.peg.237","1524"
"19406",577,111,466,"AACGACTATTGTTACAAGCA","AATGCCCATTGCGCTGGTTG","561307.5.peg.237","1524"
"19407",459,111,348,"AAACCAATTACCATGATGAC","AATGCCCATTGCGCTGGTTG","561307.5.peg.237","1524"
"19408",492,183,309,"ATTGCCATATTGACTGCAGT","ATTGGTAGTCCTGTTAAGAA","561307.5.peg.237","1524"
"19409",525,183,342,"TTGTAACCTTTCATATCTCC","ATTGGTAGTCCTGTTAAGAA","561307.5.peg.237","1524"
"19410",441,183,258,"ACTGGTCCAACAACAACTGG","ATTGGTAGTCCTGTTAAGAA","561307.5.peg.237","1524"
"19411",459,183,276,"AAACCAATTACCATGATGAC","ATTGGTAGTCCTGTTAAGAA","561307.5.peg.237","1524"
"19412",309,183,126,"GTACTTAATCCCGTGATAAT","ATTGGTAGTCCTGTTAAGAA","561307.5.peg.237","1524"
"19413",577,183,394,"AACGACTATTGTTACAAGCA","ATTGGTAGTCCTGTTAAGAA","561307.5.peg.237","1524"
"19414",633,183,450,"ACGATAATACCTACAAGAAC","ATTGGTAGTCCTGTTAAGAA","561307.5.peg.237","1524"
"19415",444,183,261,"ATGACTGGTCCAACAACAAC","ATTGGTAGTCCTGTTAAGAA","561307.5.peg.237","1524"
"19416",492,201,291,"ATTGCCATATTGACTGCAGT","GCTAGTAACGCTGCTGATAT","561307.5.peg.237","1524"
"19417",441,201,240,"ACTGGTCCAACAACAACTGG","GCTAGTAACGCTGCTGATAT","561307.5.peg.237","1524"
"19418",459,201,258,"AAACCAATTACCATGATGAC","GCTAGTAACGCTGCTGATAT","561307.5.peg.237","1524"
"19419",309,201,108,"GTACTTAATCCCGTGATAAT","GCTAGTAACGCTGCTGATAT","561307.5.peg.237","1524"
"19420",577,201,376,"AACGACTATTGTTACAAGCA","GCTAGTAACGCTGCTGATAT","561307.5.peg.237","1524"
"19421",525,201,324,"TTGTAACCTTTCATATCTCC","GCTAGTAACGCTGCTGATAT","561307.5.peg.237","1524"
"19422",444,201,243,"ATGACTGGTCCAACAACAAC","GCTAGTAACGCTGCTGATAT","561307.5.peg.237","1524"
"19423",633,201,432,"ACGATAATACCTACAAGAAC","GCTAGTAACGCTGCTGATAT","561307.5.peg.237","1524"
"19424",492,273,219,"ATTGCCATATTGACTGCAGT","AAGCTAGATCCCAAGTATGC","561307.5.peg.237","1524"
"19425",525,273,252,"TTGTAACCTTTCATATCTCC","AAGCTAGATCCCAAGTATGC","561307.5.peg.237","1524"
"19426",111,273,162,"AATGCCCATTGCGCTGGTTG","AAGCTAGATCCCAAGTATGC","561307.5.peg.237","1524"
"19427",441,273,168,"ACTGGTCCAACAACAACTGG","AAGCTAGATCCCAAGTATGC","561307.5.peg.237","1524"
"19428",577,273,304,"AACGACTATTGTTACAAGCA","AAGCTAGATCCCAAGTATGC","561307.5.peg.237","1524"
"19429",444,273,171,"ATGACTGGTCCAACAACAAC","AAGCTAGATCCCAAGTATGC","561307.5.peg.237","1524"
"19430",459,273,186,"AAACCAATTACCATGATGAC","AAGCTAGATCCCAAGTATGC","561307.5.peg.237","1524"
"19431",633,273,360,"ACGATAATACCTACAAGAAC","AAGCTAGATCCCAAGTATGC","561307.5.peg.237","1524"
"19432",111,309,198,"AATGCCCATTGCGCTGGTTG","GTACTTAATCCCGTGATAAT","561307.5.peg.237","1524"
"19433",441,309,132,"ACTGGTCCAACAACAACTGG","GTACTTAATCCCGTGATAAT","561307.5.peg.237","1524"
"19434",183,309,126,"ATTGGTAGTCCTGTTAAGAA","GTACTTAATCCCGTGATAAT","561307.5.peg.237","1524"
"19435",444,309,135,"ATGACTGGTCCAACAACAAC","GTACTTAATCCCGTGATAAT","561307.5.peg.237","1524"
"19436",633,309,324,"ACGATAATACCTACAAGAAC","GTACTTAATCCCGTGATAAT","561307.5.peg.237","1524"
"19437",577,309,268,"AACGACTATTGTTACAAGCA","GTACTTAATCCCGTGATAAT","561307.5.peg.237","1524"
"19438",201,309,108,"GCTAGTAACGCTGCTGATAT","GTACTTAATCCCGTGATAAT","561307.5.peg.237","1524"
"19439",492,309,183,"ATTGCCATATTGACTGCAGT","GTACTTAATCCCGTGATAAT","561307.5.peg.237","1524"
"19440",525,309,216,"TTGTAACCTTTCATATCTCC","GTACTTAATCCCGTGATAAT","561307.5.peg.237","1524"
"19441",459,309,150,"AAACCAATTACCATGATGAC","GTACTTAATCCCGTGATAAT","561307.5.peg.237","1524"
"19442",111,441,330,"AATGCCCATTGCGCTGGTTG","ACTGGTCCAACAACAACTGG","561307.5.peg.237","1524"
"19443",183,441,258,"ATTGGTAGTCCTGTTAAGAA","ACTGGTCCAACAACAACTGG","561307.5.peg.237","1524"
"19444",633,441,192,"ACGATAATACCTACAAGAAC","ACTGGTCCAACAACAACTGG","561307.5.peg.237","1524"
"19445",273,441,168,"AAGCTAGATCCCAAGTATGC","ACTGGTCCAACAACAACTGG","561307.5.peg.237","1524"
"19446",577,441,136,"AACGACTATTGTTACAAGCA","ACTGGTCCAACAACAACTGG","561307.5.peg.237","1524"
"19447",201,441,240,"GCTAGTAACGCTGCTGATAT","ACTGGTCCAACAACAACTGG","561307.5.peg.237","1524"
"19448",309,441,132,"GTACTTAATCCCGTGATAAT","ACTGGTCCAACAACAACTGG","561307.5.peg.237","1524"
"19449",201,444,243,"GCTAGTAACGCTGCTGATAT","ATGACTGGTCCAACAACAAC","561307.5.peg.237","1524"
"19450",111,444,333,"AATGCCCATTGCGCTGGTTG","ATGACTGGTCCAACAACAAC","561307.5.peg.237","1524"
"19451",273,444,171,"AAGCTAGATCCCAAGTATGC","ATGACTGGTCCAACAACAAC","561307.5.peg.237","1524"
"19452",183,444,261,"ATTGGTAGTCCTGTTAAGAA","ATGACTGGTCCAACAACAAC","561307.5.peg.237","1524"
"19453",309,444,135,"GTACTTAATCCCGTGATAAT","ATGACTGGTCCAACAACAAC","561307.5.peg.237","1524"
"19454",633,444,189,"ACGATAATACCTACAAGAAC","ATGACTGGTCCAACAACAAC","561307.5.peg.237","1524"
"19455",577,444,133,"AACGACTATTGTTACAAGCA","ATGACTGGTCCAACAACAAC","561307.5.peg.237","1524"
"19456",183,459,276,"ATTGGTAGTCCTGTTAAGAA","AAACCAATTACCATGATGAC","561307.5.peg.237","1524"
"19457",111,459,348,"AATGCCCATTGCGCTGGTTG","AAACCAATTACCATGATGAC","561307.5.peg.237","1524"
"19458",577,459,118,"AACGACTATTGTTACAAGCA","AAACCAATTACCATGATGAC","561307.5.peg.237","1524"
"19459",273,459,186,"AAGCTAGATCCCAAGTATGC","AAACCAATTACCATGATGAC","561307.5.peg.237","1524"
"19460",633,459,174,"ACGATAATACCTACAAGAAC","AAACCAATTACCATGATGAC","561307.5.peg.237","1524"
"19461",201,459,258,"GCTAGTAACGCTGCTGATAT","AAACCAATTACCATGATGAC","561307.5.peg.237","1524"
"19462",309,459,150,"GTACTTAATCCCGTGATAAT","AAACCAATTACCATGATGAC","561307.5.peg.237","1524"
"19463",633,492,141,"ACGATAATACCTACAAGAAC","ATTGCCATATTGACTGCAGT","561307.5.peg.237","1524"
"19464",183,492,309,"ATTGGTAGTCCTGTTAAGAA","ATTGCCATATTGACTGCAGT","561307.5.peg.237","1524"
"19465",111,492,381,"AATGCCCATTGCGCTGGTTG","ATTGCCATATTGACTGCAGT","561307.5.peg.237","1524"
"19466",309,492,183,"GTACTTAATCCCGTGATAAT","ATTGCCATATTGACTGCAGT","561307.5.peg.237","1524"
"19467",273,492,219,"AAGCTAGATCCCAAGTATGC","ATTGCCATATTGACTGCAGT","561307.5.peg.237","1524"
"19468",201,492,291,"GCTAGTAACGCTGCTGATAT","ATTGCCATATTGACTGCAGT","561307.5.peg.237","1524"
"19469",309,525,216,"GTACTTAATCCCGTGATAAT","TTGTAACCTTTCATATCTCC","561307.5.peg.237","1524"
"19470",183,525,342,"ATTGGTAGTCCTGTTAAGAA","TTGTAACCTTTCATATCTCC","561307.5.peg.237","1524"
"19471",201,525,324,"GCTAGTAACGCTGCTGATAT","TTGTAACCTTTCATATCTCC","561307.5.peg.237","1524"
"19472",633,525,108,"ACGATAATACCTACAAGAAC","TTGTAACCTTTCATATCTCC","561307.5.peg.237","1524"
"19473",111,525,414,"AATGCCCATTGCGCTGGTTG","TTGTAACCTTTCATATCTCC","561307.5.peg.237","1524"
"19474",273,525,252,"AAGCTAGATCCCAAGTATGC","TTGTAACCTTTCATATCTCC","561307.5.peg.237","1524"
"19475",273,577,304,"AAGCTAGATCCCAAGTATGC","AACGACTATTGTTACAAGCA","561307.5.peg.237","1524"
"19476",183,577,394,"ATTGGTAGTCCTGTTAAGAA","AACGACTATTGTTACAAGCA","561307.5.peg.237","1524"
"19477",444,577,133,"ATGACTGGTCCAACAACAAC","AACGACTATTGTTACAAGCA","561307.5.peg.237","1524"
"19478",309,577,268,"GTACTTAATCCCGTGATAAT","AACGACTATTGTTACAAGCA","561307.5.peg.237","1524"
"19479",111,577,466,"AATGCCCATTGCGCTGGTTG","AACGACTATTGTTACAAGCA","561307.5.peg.237","1524"
"19480",441,577,136,"ACTGGTCCAACAACAACTGG","AACGACTATTGTTACAAGCA","561307.5.peg.237","1524"
"19481",459,577,118,"AAACCAATTACCATGATGAC","AACGACTATTGTTACAAGCA","561307.5.peg.237","1524"
"19482",201,577,376,"GCTAGTAACGCTGCTGATAT","AACGACTATTGTTACAAGCA","561307.5.peg.237","1524"
"19483",492,633,141,"ATTGCCATATTGACTGCAGT","ACGATAATACCTACAAGAAC","561307.5.peg.237","1524"
"19484",111,633,522,"AATGCCCATTGCGCTGGTTG","ACGATAATACCTACAAGAAC","561307.5.peg.237","1524"
"19485",459,633,174,"AAACCAATTACCATGATGAC","ACGATAATACCTACAAGAAC","561307.5.peg.237","1524"
"19486",273,633,360,"AAGCTAGATCCCAAGTATGC","ACGATAATACCTACAAGAAC","561307.5.peg.237","1524"
"19487",444,633,189,"ATGACTGGTCCAACAACAAC","ACGATAATACCTACAAGAAC","561307.5.peg.237","1524"
"19488",183,633,450,"ATTGGTAGTCCTGTTAAGAA","ACGATAATACCTACAAGAAC","561307.5.peg.237","1524"
"19489",201,633,432,"GCTAGTAACGCTGCTGATAT","ACGATAATACCTACAAGAAC","561307.5.peg.237","1524"
"19490",441,633,192,"ACTGGTCCAACAACAACTGG","ACGATAATACCTACAAGAAC","561307.5.peg.237","1524"
"19491",309,633,324,"GTACTTAATCCCGTGATAAT","ACGATAATACCTACAAGAAC","561307.5.peg.237","1524"
"19492",525,633,108,"TTGTAACCTTTCATATCTCC","ACGATAATACCTACAAGAAC","561307.5.peg.237","1524"
"19493",179,5,174,"CCATCTGCTGCAAATCCTCA","ACAGTATTGAAAGTAAAGGG","561307.5.peg.2371","1526"
"19494",5,179,174,"ACAGTATTGAAAGTAAAGGG","CCATCTGCTGCAAATCCTCA","561307.5.peg.2371","1526"
"19495",375,153,222,"GATAAGTCGTATACATCATG","TATGCTTTGCATACTCATT","561307.5.peg.2372","1527"
"19496",281,153,128,"AATCATTGTTGCCCTTAGCT","TATGCTTTGCATACTCATT","561307.5.peg.2372","1527"
"19497",569,153,416,"TGTCATCAGAATAAGTAGCA","TATGCTTTGCATACTCATT","561307.5.peg.2372","1527"
"19498",447,153,294,"CATCAATTGAGATGATTAG","TATGCTTTGCATACTCATT","561307.5.peg.2372","1527"
"19499",153,281,128,"TATGCTTTGCATACTCATT","AATCATTGTTGCCCTTAGCT","561307.5.peg.2372","1527"
"19500",447,281,166,"CATCAATTGAGATGATTAG","AATCATTGTTGCCCTTAGCT","561307.5.peg.2372","1527"
"19501",569,281,288,"TGTCATCAGAATAAGTAGCA","AATCATTGTTGCCCTTAGCT","561307.5.peg.2372","1527"
"19502",153,375,222,"TATGCTTTGCATACTCATT","GATAAGTCGTATACATCATG","561307.5.peg.2372","1527"
"19503",569,375,194,"TGTCATCAGAATAAGTAGCA","GATAAGTCGTATACATCATG","561307.5.peg.2372","1527"
"19504",153,447,294,"TATGCTTTGCATACTCATT","CATCAATTGAGATGATTAG","561307.5.peg.2372","1527"
"19505",281,447,166,"AATCATTGTTGCCCTTAGCT","CATCAATTGAGATGATTAG","561307.5.peg.2372","1527"
"19506",569,447,122,"TGTCATCAGAATAAGTAGCA","CATCAATTGAGATGATTAG","561307.5.peg.2372","1527"
"19507",153,569,416,"TATGCTTTGCATACTCATT","TGTCATCAGAATAAGTAGCA","561307.5.peg.2372","1527"
"19508",375,569,194,"GATAAGTCGTATACATCATG","TGTCATCAGAATAAGTAGCA","561307.5.peg.2372","1527"
"19509",281,569,288,"AATCATTGTTGCCCTTAGCT","TGTCATCAGAATAAGTAGCA","561307.5.peg.2372","1527"
"19510",447,569,122,"CATCAATTGAGATGATTAG","TGTCATCAGAATAAGTAGCA","561307.5.peg.2372","1527"
"19511",295,27,268,"TTCAGGGTCAAATATGTACA","GGCGTCTCACCTTCCTATCA","561307.5.peg.2374","1529"
"19512",311,27,284,"AAATCTTCACACCATATTCA","GGCGTCTCACCTTCCTATCA","561307.5.peg.2374","1529"
"19513",295,80,215,"TTCAGGGTCAAATATGTACA","GATGAATACGACTATTTCCC","561307.5.peg.2374","1529"
"19514",311,80,231,"AAATCTTCACACCATATTCA","GATGAATACGACTATTTCCC","561307.5.peg.2374","1529"
"19515",27,295,268,"GGCGTCTCACCTTCCTATCA","TTCAGGGTCAAATATGTACA","561307.5.peg.2374","1529"
"19516",80,295,215,"GATGAATACGACTATTTCCC","TTCAGGGTCAAATATGTACA","561307.5.peg.2374","1529"
"19517",27,311,284,"GGCGTCTCACCTTCCTATCA","AAATCTTCACACCATATTCA","561307.5.peg.2374","1529"
"19518",80,311,231,"GATGAATACGACTATTTCCC","AAATCTTCACACCATATTCA","561307.5.peg.2374","1529"
"19519",280,60,220,"CTATCATGTAAACAACTAA","AGTCTTTGAACGAGATAAT","561307.5.peg.2375","1530"
"19520",473,60,413,"CTCCAGATAAATCTTGCGGT","AGTCTTTGAACGAGATAAT","561307.5.peg.2375","1530"
"19521",564,60,504,"GCAGGATCTAAATTGGCCAG","AGTCTTTGAACGAGATAAT","561307.5.peg.2375","1530"
"19522",477,60,417,"TGACCTCCAGATAAATCTTG","AGTCTTTGAACGAGATAAT","561307.5.peg.2375","1530"
"19523",582,60,522,"AGCGTTTCATGTCCTGTCGC","AGTCTTTGAACGAGATAAT","561307.5.peg.2375","1530"
"19524",571,60,511,"TCCTGTCGCAGGATCTAAAT","AGTCTTTGAACGAGATAAT","561307.5.peg.2375","1530"
"19525",60,280,220,"AGTCTTTGAACGAGATAAT","CTATCATGTAAACAACTAA","561307.5.peg.2375","1530"
"19526",473,280,193,"CTCCAGATAAATCTTGCGGT","CTATCATGTAAACAACTAA","561307.5.peg.2375","1530"
"19527",564,280,284,"GCAGGATCTAAATTGGCCAG","CTATCATGTAAACAACTAA","561307.5.peg.2375","1530"
"19528",477,280,197,"TGACCTCCAGATAAATCTTG","CTATCATGTAAACAACTAA","561307.5.peg.2375","1530"
"19529",582,280,302,"AGCGTTTCATGTCCTGTCGC","CTATCATGTAAACAACTAA","561307.5.peg.2375","1530"
"19530",571,280,291,"TCCTGTCGCAGGATCTAAAT","CTATCATGTAAACAACTAA","561307.5.peg.2375","1530"
"19531",60,473,413,"AGTCTTTGAACGAGATAAT","CTCCAGATAAATCTTGCGGT","561307.5.peg.2375","1530"
"19532",582,473,109,"AGCGTTTCATGTCCTGTCGC","CTCCAGATAAATCTTGCGGT","561307.5.peg.2375","1530"
"19533",280,473,193,"CTATCATGTAAACAACTAA","CTCCAGATAAATCTTGCGGT","561307.5.peg.2375","1530"
"19534",280,477,197,"CTATCATGTAAACAACTAA","TGACCTCCAGATAAATCTTG","561307.5.peg.2375","1530"
"19535",582,477,105,"AGCGTTTCATGTCCTGTCGC","TGACCTCCAGATAAATCTTG","561307.5.peg.2375","1530"
"19536",60,477,417,"AGTCTTTGAACGAGATAAT","TGACCTCCAGATAAATCTTG","561307.5.peg.2375","1530"
"19537",60,564,504,"AGTCTTTGAACGAGATAAT","GCAGGATCTAAATTGGCCAG","561307.5.peg.2375","1530"
"19538",280,564,284,"CTATCATGTAAACAACTAA","GCAGGATCTAAATTGGCCAG","561307.5.peg.2375","1530"
"19539",280,571,291,"CTATCATGTAAACAACTAA","TCCTGTCGCAGGATCTAAAT","561307.5.peg.2375","1530"
"19540",60,571,511,"AGTCTTTGAACGAGATAAT","TCCTGTCGCAGGATCTAAAT","561307.5.peg.2375","1530"
"19541",477,582,105,"TGACCTCCAGATAAATCTTG","AGCGTTTCATGTCCTGTCGC","561307.5.peg.2375","1530"
"19542",60,582,522,"AGTCTTTGAACGAGATAAT","AGCGTTTCATGTCCTGTCGC","561307.5.peg.2375","1530"
"19543",473,582,109,"CTCCAGATAAATCTTGCGGT","AGCGTTTCATGTCCTGTCGC","561307.5.peg.2375","1530"
"19544",280,582,302,"CTATCATGTAAACAACTAA","AGCGTTTCATGTCCTGTCGC","561307.5.peg.2375","1530"
"19545",330,174,156,"GACTTAAAGAACCATTATC","GCTACCCAAATGTCATACGG","561307.5.peg.2377","1532"
"19546",407,174,233,"TTTCTTCCGAATGAGGCAAT","GCTACCCAAATGTCATACGG","561307.5.peg.2377","1532"
"19547",414,174,240,"GTATGACTTTCTTCCGAATG","GCTACCCAAATGTCATACGG","561307.5.peg.2377","1532"
"19548",330,177,153,"GACTTAAAGAACCATTATC","GACGCTACCCAAATGTCATA","561307.5.peg.2377","1532"
"19549",407,177,230,"TTTCTTCCGAATGAGGCAAT","GACGCTACCCAAATGTCATA","561307.5.peg.2377","1532"
"19550",414,177,237,"GTATGACTTTCTTCCGAATG","GACGCTACCCAAATGTCATA","561307.5.peg.2377","1532"
"19551",407,263,144,"TTTCTTCCGAATGAGGCAAT","GCCTATCACTACCTACACCC","561307.5.peg.2377","1532"
"19552",414,263,151,"GTATGACTTTCTTCCGAATG","GCCTATCACTACCTACACCC","561307.5.peg.2377","1532"
"19553",174,330,156,"GCTACCCAAATGTCATACGG","GACTTAAAGAACCATTATC","561307.5.peg.2377","1532"
"19554",177,330,153,"GACGCTACCCAAATGTCATA","GACTTAAAGAACCATTATC","561307.5.peg.2377","1532"
"19555",174,407,233,"GCTACCCAAATGTCATACGG","TTTCTTCCGAATGAGGCAAT","561307.5.peg.2377","1532"
"19556",263,407,144,"GCCTATCACTACCTACACCC","TTTCTTCCGAATGAGGCAAT","561307.5.peg.2377","1532"
"19557",177,407,230,"GACGCTACCCAAATGTCATA","TTTCTTCCGAATGAGGCAAT","561307.5.peg.2377","1532"
"19558",174,414,240,"GCTACCCAAATGTCATACGG","GTATGACTTTCTTCCGAATG","561307.5.peg.2377","1532"
"19559",263,414,151,"GCCTATCACTACCTACACCC","GTATGACTTTCTTCCGAATG","561307.5.peg.2377","1532"
"19560",177,414,237,"GACGCTACCCAAATGTCATA","GTATGACTTTCTTCCGAATG","561307.5.peg.2377","1532"
"19561",264,97,167,"CGTTTGATTTCCTTCGTTTC","ATAATTGGAACAGCACTAT","561307.5.peg.2379","1534"
"19562",97,264,167,"ATAATTGGAACAGCACTAT","CGTTTGATTTCCTTCGTTTC","561307.5.peg.2379","1534"
"19563",363,98,265,"TATTGGCCAGTTGTGTGTCT","GATCCTGAGCAAACTGTTCA","561307.5.peg.2380","1536"
"19564",479,98,381,"TATTTGGACGAATTGCACCT","GATCCTGAGCAAACTGTTCA","561307.5.peg.2380","1536"
"19565",214,98,116,"CATATGTGCCATATATTGTT","GATCCTGAGCAAACTGTTCA","561307.5.peg.2380","1536"
"19566",98,214,116,"GATCCTGAGCAAACTGTTCA","CATATGTGCCATATATTGTT","561307.5.peg.2380","1536"
"19567",363,214,149,"TATTGGCCAGTTGTGTGTCT","CATATGTGCCATATATTGTT","561307.5.peg.2380","1536"
"19568",479,214,265,"TATTTGGACGAATTGCACCT","CATATGTGCCATATATTGTT","561307.5.peg.2380","1536"
"19569",98,363,265,"GATCCTGAGCAAACTGTTCA","TATTGGCCAGTTGTGTGTCT","561307.5.peg.2380","1536"
"19570",479,363,116,"TATTTGGACGAATTGCACCT","TATTGGCCAGTTGTGTGTCT","561307.5.peg.2380","1536"
"19571",214,363,149,"CATATGTGCCATATATTGTT","TATTGGCCAGTTGTGTGTCT","561307.5.peg.2380","1536"
"19572",98,479,381,"GATCCTGAGCAAACTGTTCA","TATTTGGACGAATTGCACCT","561307.5.peg.2380","1536"
"19573",214,479,265,"CATATGTGCCATATATTGTT","TATTTGGACGAATTGCACCT","561307.5.peg.2380","1536"
"19574",363,479,116,"TATTGGCCAGTTGTGTGTCT","TATTTGGACGAATTGCACCT","561307.5.peg.2380","1536"
"19575",271,102,169,"GGCGACACGTTCTGGGGTAA","TGAGTCACAGCTTCCCATGA","561307.5.peg.2381","1537"
"19576",277,102,175,"ATTAATGGCGACACGTTCTG","TGAGTCACAGCTTCCCATGA","561307.5.peg.2381","1537"
"19577",279,102,177,"ATATTAATGGCGACACGTTC","TGAGTCACAGCTTCCCATGA","561307.5.peg.2381","1537"
"19578",339,102,237,"AAGTGAATGGCTTGATCAAT","TGAGTCACAGCTTCCCATGA","561307.5.peg.2381","1537"
"19579",102,271,169,"TGAGTCACAGCTTCCCATGA","GGCGACACGTTCTGGGGTAA","561307.5.peg.2381","1537"
"19580",102,277,175,"TGAGTCACAGCTTCCCATGA","ATTAATGGCGACACGTTCTG","561307.5.peg.2381","1537"
"19581",102,279,177,"TGAGTCACAGCTTCCCATGA","ATATTAATGGCGACACGTTC","561307.5.peg.2381","1537"
"19582",102,339,237,"TGAGTCACAGCTTCCCATGA","AAGTGAATGGCTTGATCAAT","561307.5.peg.2381","1537"
"19583",213,7,206,"TGATCAGCCATTGACTTAAT","GATGATTAACTTGTTTGGAG","561307.5.peg.2382","1538"
"19584",243,7,236,"CCGGTAGTAAGACTTATCTC","GATGATTAACTTGTTTGGAG","561307.5.peg.2382","1538"
"19585",213,9,204,"TGATCAGCCATTGACTTAAT","GGGATGATTAACTTGTTTGG","561307.5.peg.2382","1538"
"19586",243,9,234,"CCGGTAGTAAGACTTATCTC","GGGATGATTAACTTGTTTGG","561307.5.peg.2382","1538"
"19587",7,213,206,"GATGATTAACTTGTTTGGAG","TGATCAGCCATTGACTTAAT","561307.5.peg.2382","1538"
"19588",9,213,204,"GGGATGATTAACTTGTTTGG","TGATCAGCCATTGACTTAAT","561307.5.peg.2382","1538"
"19589",7,243,236,"GATGATTAACTTGTTTGGAG","CCGGTAGTAAGACTTATCTC","561307.5.peg.2382","1538"
"19590",9,243,234,"GGGATGATTAACTTGTTTGG","CCGGTAGTAAGACTTATCTC","561307.5.peg.2382","1538"
"19591",726,104,622,"ACAATTAAGGAAACAAGTCC","AAGGTGTAAGTGCCCAAATA","561307.5.peg.2385","1541"
"19592",468,104,364,"CCAGCACGCGCGGTATTACT","AAGGTGTAAGTGCCCAAATA","561307.5.peg.2385","1541"
"19593",207,104,103,"GAGACGGCCCCAATTGGCAT","AAGGTGTAAGTGCCCAAATA","561307.5.peg.2385","1541"
"19594",478,104,374,"CATGATTCCACCAGCACGCG","AAGGTGTAAGTGCCCAAATA","561307.5.peg.2385","1541"
"19595",213,104,109,"ATTATAGAGACGGCCCCAAT","AAGGTGTAAGTGCCCAAATA","561307.5.peg.2385","1541"
"19596",596,104,492,"CCGCAGTAATTAAATTACCT","AAGGTGTAAGTGCCCAAATA","561307.5.peg.2385","1541"
"19597",543,104,439,"TTGCGTGCTGATCCGTCTTT","AAGGTGTAAGTGCCCAAATA","561307.5.peg.2385","1541"
"19598",459,104,355,"GCGGTATTACTTGGTGTAGC","AAGGTGTAAGTGCCCAAATA","561307.5.peg.2385","1541"
"19599",223,104,119,"GTAAATCCAATTATAGAGA","AAGGTGTAAGTGCCCAAATA","561307.5.peg.2385","1541"
"19600",468,132,336,"CCAGCACGCGCGGTATTACT","GCTGTTGGATCCACAGCATC","561307.5.peg.2385","1541"
"19601",726,132,594,"ACAATTAAGGAAACAAGTCC","GCTGTTGGATCCACAGCATC","561307.5.peg.2385","1541"
"19602",459,132,327,"GCGGTATTACTTGGTGTAGC","GCTGTTGGATCCACAGCATC","561307.5.peg.2385","1541"
"19603",478,132,346,"CATGATTCCACCAGCACGCG","GCTGTTGGATCCACAGCATC","561307.5.peg.2385","1541"
"19604",596,132,464,"CCGCAGTAATTAAATTACCT","GCTGTTGGATCCACAGCATC","561307.5.peg.2385","1541"
"19605",543,132,411,"TTGCGTGCTGATCCGTCTTT","GCTGTTGGATCCACAGCATC","561307.5.peg.2385","1541"
"19606",459,147,312,"GCGGTATTACTTGGTGTAGC","GCGAACATATACCATGCTGT","561307.5.peg.2385","1541"
"19607",543,147,396,"TTGCGTGCTGATCCGTCTTT","GCGAACATATACCATGCTGT","561307.5.peg.2385","1541"
"19608",478,147,331,"CATGATTCCACCAGCACGCG","GCGAACATATACCATGCTGT","561307.5.peg.2385","1541"
"19609",468,147,321,"CCAGCACGCGCGGTATTACT","GCGAACATATACCATGCTGT","561307.5.peg.2385","1541"
"19610",726,147,579,"ACAATTAAGGAAACAAGTCC","GCGAACATATACCATGCTGT","561307.5.peg.2385","1541"
"19611",596,147,449,"CCGCAGTAATTAAATTACCT","GCGAACATATACCATGCTGT","561307.5.peg.2385","1541"
"19612",104,207,103,"AAGGTGTAAGTGCCCAAATA","GAGACGGCCCCAATTGGCAT","561307.5.peg.2385","1541"
"19613",596,207,389,"CCGCAGTAATTAAATTACCT","GAGACGGCCCCAATTGGCAT","561307.5.peg.2385","1541"
"19614",468,207,261,"CCAGCACGCGCGGTATTACT","GAGACGGCCCCAATTGGCAT","561307.5.peg.2385","1541"
"19615",543,207,336,"TTGCGTGCTGATCCGTCTTT","GAGACGGCCCCAATTGGCAT","561307.5.peg.2385","1541"
"19616",478,207,271,"CATGATTCCACCAGCACGCG","GAGACGGCCCCAATTGGCAT","561307.5.peg.2385","1541"
"19617",459,207,252,"GCGGTATTACTTGGTGTAGC","GAGACGGCCCCAATTGGCAT","561307.5.peg.2385","1541"
"19618",726,207,519,"ACAATTAAGGAAACAAGTCC","GAGACGGCCCCAATTGGCAT","561307.5.peg.2385","1541"
"19619",596,213,383,"CCGCAGTAATTAAATTACCT","ATTATAGAGACGGCCCCAAT","561307.5.peg.2385","1541"
"19620",104,213,109,"AAGGTGTAAGTGCCCAAATA","ATTATAGAGACGGCCCCAAT","561307.5.peg.2385","1541"
"19621",726,213,513,"ACAATTAAGGAAACAAGTCC","ATTATAGAGACGGCCCCAAT","561307.5.peg.2385","1541"
"19622",459,213,246,"GCGGTATTACTTGGTGTAGC","ATTATAGAGACGGCCCCAAT","561307.5.peg.2385","1541"
"19623",543,213,330,"TTGCGTGCTGATCCGTCTTT","ATTATAGAGACGGCCCCAAT","561307.5.peg.2385","1541"
"19624",478,213,265,"CATGATTCCACCAGCACGCG","ATTATAGAGACGGCCCCAAT","561307.5.peg.2385","1541"
"19625",468,213,255,"CCAGCACGCGCGGTATTACT","ATTATAGAGACGGCCCCAAT","561307.5.peg.2385","1541"
"19626",596,223,373,"CCGCAGTAATTAAATTACCT","GTAAATCCAATTATAGAGA","561307.5.peg.2385","1541"
"19627",478,223,255,"CATGATTCCACCAGCACGCG","GTAAATCCAATTATAGAGA","561307.5.peg.2385","1541"
"19628",104,223,119,"AAGGTGTAAGTGCCCAAATA","GTAAATCCAATTATAGAGA","561307.5.peg.2385","1541"
"19629",543,223,320,"TTGCGTGCTGATCCGTCTTT","GTAAATCCAATTATAGAGA","561307.5.peg.2385","1541"
"19630",726,223,503,"ACAATTAAGGAAACAAGTCC","GTAAATCCAATTATAGAGA","561307.5.peg.2385","1541"
"19631",468,223,245,"CCAGCACGCGCGGTATTACT","GTAAATCCAATTATAGAGA","561307.5.peg.2385","1541"
"19632",459,223,236,"GCGGTATTACTTGGTGTAGC","GTAAATCCAATTATAGAGA","561307.5.peg.2385","1541"
"19633",104,459,355,"AAGGTGTAAGTGCCCAAATA","GCGGTATTACTTGGTGTAGC","561307.5.peg.2385","1541"
"19634",213,459,246,"ATTATAGAGACGGCCCCAAT","GCGGTATTACTTGGTGTAGC","561307.5.peg.2385","1541"
"19635",132,459,327,"GCTGTTGGATCCACAGCATC","GCGGTATTACTTGGTGTAGC","561307.5.peg.2385","1541"
"19636",147,459,312,"GCGAACATATACCATGCTGT","GCGGTATTACTTGGTGTAGC","561307.5.peg.2385","1541"
"19637",223,459,236,"GTAAATCCAATTATAGAGA","GCGGTATTACTTGGTGTAGC","561307.5.peg.2385","1541"
"19638",596,459,137,"CCGCAGTAATTAAATTACCT","GCGGTATTACTTGGTGTAGC","561307.5.peg.2385","1541"
"19639",207,459,252,"GAGACGGCCCCAATTGGCAT","GCGGTATTACTTGGTGTAGC","561307.5.peg.2385","1541"
"19640",726,459,267,"ACAATTAAGGAAACAAGTCC","GCGGTATTACTTGGTGTAGC","561307.5.peg.2385","1541"
"19641",132,468,336,"GCTGTTGGATCCACAGCATC","CCAGCACGCGCGGTATTACT","561307.5.peg.2385","1541"
"19642",213,468,255,"ATTATAGAGACGGCCCCAAT","CCAGCACGCGCGGTATTACT","561307.5.peg.2385","1541"
"19643",207,468,261,"GAGACGGCCCCAATTGGCAT","CCAGCACGCGCGGTATTACT","561307.5.peg.2385","1541"
"19644",147,468,321,"GCGAACATATACCATGCTGT","CCAGCACGCGCGGTATTACT","561307.5.peg.2385","1541"
"19645",726,468,258,"ACAATTAAGGAAACAAGTCC","CCAGCACGCGCGGTATTACT","561307.5.peg.2385","1541"
"19646",223,468,245,"GTAAATCCAATTATAGAGA","CCAGCACGCGCGGTATTACT","561307.5.peg.2385","1541"
"19647",104,468,364,"AAGGTGTAAGTGCCCAAATA","CCAGCACGCGCGGTATTACT","561307.5.peg.2385","1541"
"19648",596,468,128,"CCGCAGTAATTAAATTACCT","CCAGCACGCGCGGTATTACT","561307.5.peg.2385","1541"
"19649",213,478,265,"ATTATAGAGACGGCCCCAAT","CATGATTCCACCAGCACGCG","561307.5.peg.2385","1541"
"19650",147,478,331,"GCGAACATATACCATGCTGT","CATGATTCCACCAGCACGCG","561307.5.peg.2385","1541"
"19651",207,478,271,"GAGACGGCCCCAATTGGCAT","CATGATTCCACCAGCACGCG","561307.5.peg.2385","1541"
"19652",223,478,255,"GTAAATCCAATTATAGAGA","CATGATTCCACCAGCACGCG","561307.5.peg.2385","1541"
"19653",726,478,248,"ACAATTAAGGAAACAAGTCC","CATGATTCCACCAGCACGCG","561307.5.peg.2385","1541"
"19654",596,478,118,"CCGCAGTAATTAAATTACCT","CATGATTCCACCAGCACGCG","561307.5.peg.2385","1541"
"19655",132,478,346,"GCTGTTGGATCCACAGCATC","CATGATTCCACCAGCACGCG","561307.5.peg.2385","1541"
"19656",104,478,374,"AAGGTGTAAGTGCCCAAATA","CATGATTCCACCAGCACGCG","561307.5.peg.2385","1541"
"19657",726,543,183,"ACAATTAAGGAAACAAGTCC","TTGCGTGCTGATCCGTCTTT","561307.5.peg.2385","1541"
"19658",213,543,330,"ATTATAGAGACGGCCCCAAT","TTGCGTGCTGATCCGTCTTT","561307.5.peg.2385","1541"
"19659",132,543,411,"GCTGTTGGATCCACAGCATC","TTGCGTGCTGATCCGTCTTT","561307.5.peg.2385","1541"
"19660",104,543,439,"AAGGTGTAAGTGCCCAAATA","TTGCGTGCTGATCCGTCTTT","561307.5.peg.2385","1541"
"19661",147,543,396,"GCGAACATATACCATGCTGT","TTGCGTGCTGATCCGTCTTT","561307.5.peg.2385","1541"
"19662",207,543,336,"GAGACGGCCCCAATTGGCAT","TTGCGTGCTGATCCGTCTTT","561307.5.peg.2385","1541"
"19663",223,543,320,"GTAAATCCAATTATAGAGA","TTGCGTGCTGATCCGTCTTT","561307.5.peg.2385","1541"
"19664",104,596,492,"AAGGTGTAAGTGCCCAAATA","CCGCAGTAATTAAATTACCT","561307.5.peg.2385","1541"
"19665",459,596,137,"GCGGTATTACTTGGTGTAGC","CCGCAGTAATTAAATTACCT","561307.5.peg.2385","1541"
"19666",468,596,128,"CCAGCACGCGCGGTATTACT","CCGCAGTAATTAAATTACCT","561307.5.peg.2385","1541"
"19667",207,596,389,"GAGACGGCCCCAATTGGCAT","CCGCAGTAATTAAATTACCT","561307.5.peg.2385","1541"
"19668",478,596,118,"CATGATTCCACCAGCACGCG","CCGCAGTAATTAAATTACCT","561307.5.peg.2385","1541"
"19669",147,596,449,"GCGAACATATACCATGCTGT","CCGCAGTAATTAAATTACCT","561307.5.peg.2385","1541"
"19670",213,596,383,"ATTATAGAGACGGCCCCAAT","CCGCAGTAATTAAATTACCT","561307.5.peg.2385","1541"
"19671",726,596,130,"ACAATTAAGGAAACAAGTCC","CCGCAGTAATTAAATTACCT","561307.5.peg.2385","1541"
"19672",132,596,464,"GCTGTTGGATCCACAGCATC","CCGCAGTAATTAAATTACCT","561307.5.peg.2385","1541"
"19673",223,596,373,"GTAAATCCAATTATAGAGA","CCGCAGTAATTAAATTACCT","561307.5.peg.2385","1541"
"19674",213,726,513,"ATTATAGAGACGGCCCCAAT","ACAATTAAGGAAACAAGTCC","561307.5.peg.2385","1541"
"19675",104,726,622,"AAGGTGTAAGTGCCCAAATA","ACAATTAAGGAAACAAGTCC","561307.5.peg.2385","1541"
"19676",147,726,579,"GCGAACATATACCATGCTGT","ACAATTAAGGAAACAAGTCC","561307.5.peg.2385","1541"
"19677",132,726,594,"GCTGTTGGATCCACAGCATC","ACAATTAAGGAAACAAGTCC","561307.5.peg.2385","1541"
"19678",478,726,248,"CATGATTCCACCAGCACGCG","ACAATTAAGGAAACAAGTCC","561307.5.peg.2385","1541"
"19679",596,726,130,"CCGCAGTAATTAAATTACCT","ACAATTAAGGAAACAAGTCC","561307.5.peg.2385","1541"
"19680",459,726,267,"GCGGTATTACTTGGTGTAGC","ACAATTAAGGAAACAAGTCC","561307.5.peg.2385","1541"
"19681",543,726,183,"TTGCGTGCTGATCCGTCTTT","ACAATTAAGGAAACAAGTCC","561307.5.peg.2385","1541"
"19682",223,726,503,"GTAAATCCAATTATAGAGA","ACAATTAAGGAAACAAGTCC","561307.5.peg.2385","1541"
"19683",207,726,519,"GAGACGGCCCCAATTGGCAT","ACAATTAAGGAAACAAGTCC","561307.5.peg.2385","1541"
"19684",468,726,258,"CCAGCACGCGCGGTATTACT","ACAATTAAGGAAACAAGTCC","561307.5.peg.2385","1541"
"19685",270,117,153,"ACAATCGCTAATAGCTGAAT","TCAACGAACTGCCAATATAT","561307.5.peg.2386","1542"
"19686",117,270,153,"TCAACGAACTGCCAATATAT","ACAATCGCTAATAGCTGAAT","561307.5.peg.2386","1542"
"19687",288,11,277,"CTATCATTTGTTGACGTTT","AGACTACCATACAACATAA","561307.5.peg.2387","1543"
"19688",288,13,275,"CTATCATTTGTTGACGTTT","ATGTTGTATGGTAGTCTTTC","561307.5.peg.2387","1543"
"19689",288,75,213,"CTATCATTTGTTGACGTTT","GAATTTAGCGCGCGTGTTGC","561307.5.peg.2387","1543"
"19690",11,288,277,"AGACTACCATACAACATAA","CTATCATTTGTTGACGTTT","561307.5.peg.2387","1543"
"19691",13,288,275,"ATGTTGTATGGTAGTCTTTC","CTATCATTTGTTGACGTTT","561307.5.peg.2387","1543"
"19692",75,288,213,"GAATTTAGCGCGCGTGTTGC","CTATCATTTGTTGACGTTT","561307.5.peg.2387","1543"
"19693",417,315,102,"CCACCAATATCTTGGAAATG","AAATAGAAACCCACACCAGA","561307.5.peg.2388","1544"
"19694",425,315,110,"CAATCGTTCCACCAATATCT","AAATAGAAACCCACACCAGA","561307.5.peg.2388","1544"
"19695",315,417,102,"AAATAGAAACCCACACCAGA","CCACCAATATCTTGGAAATG","561307.5.peg.2388","1544"
"19696",315,425,110,"AAATAGAAACCCACACCAGA","CAATCGTTCCACCAATATCT","561307.5.peg.2388","1544"
"19697",286,168,118,"AATGATTCTTTGCGGAATT","GTTGTCTTACCTGATCCAGA","561307.5.peg.2391","1548"
"19698",293,168,125,"TGAAACCTAATGATTCTTTG","GTTGTCTTACCTGATCCAGA","561307.5.peg.2391","1548"
"19699",320,168,152,"TCGGCAGAATACTGTAATCT","GTTGTCTTACCTGATCCAGA","561307.5.peg.2391","1548"
"19700",320,218,102,"TCGGCAGAATACTGTAATCT","TCACGCTACCGCTAGAAATT","561307.5.peg.2391","1548"
"19701",168,286,118,"GTTGTCTTACCTGATCCAGA","AATGATTCTTTGCGGAATT","561307.5.peg.2391","1548"
"19702",168,293,125,"GTTGTCTTACCTGATCCAGA","TGAAACCTAATGATTCTTTG","561307.5.peg.2391","1548"
"19703",168,320,152,"GTTGTCTTACCTGATCCAGA","TCGGCAGAATACTGTAATCT","561307.5.peg.2391","1548"
"19704",218,320,102,"TCACGCTACCGCTAGAAATT","TCGGCAGAATACTGTAATCT","561307.5.peg.2391","1548"
"19705",202,9,193,"AAAGCACCTTTCTTAATGA","CATCTTCAATCAGTATTAGG","561307.5.peg.2392","1549"
"19706",160,9,151,"ACACCTTTAGTAAACTGTA","CATCTTCAATCAGTATTAGG","561307.5.peg.2392","1549"
"19707",916,9,907,"GCAATGATAGTTAAAGACA","CATCTTCAATCAGTATTAGG","561307.5.peg.2392","1549"
"19708",296,9,287,"ATAGCGCAAATTCACGTGTA","CATCTTCAATCAGTATTAGG","561307.5.peg.2392","1549"
"19709",9,160,151,"CATCTTCAATCAGTATTAGG","ACACCTTTAGTAAACTGTA","561307.5.peg.2392","1549"
"19710",296,160,136,"ATAGCGCAAATTCACGTGTA","ACACCTTTAGTAAACTGTA","561307.5.peg.2392","1549"
"19711",916,160,756,"GCAATGATAGTTAAAGACA","ACACCTTTAGTAAACTGTA","561307.5.peg.2392","1549"
"19712",9,202,193,"CATCTTCAATCAGTATTAGG","AAAGCACCTTTCTTAATGA","561307.5.peg.2392","1549"
"19713",916,202,714,"GCAATGATAGTTAAAGACA","AAAGCACCTTTCTTAATGA","561307.5.peg.2392","1549"
"19714",9,296,287,"CATCTTCAATCAGTATTAGG","ATAGCGCAAATTCACGTGTA","561307.5.peg.2392","1549"
"19715",160,296,136,"ACACCTTTAGTAAACTGTA","ATAGCGCAAATTCACGTGTA","561307.5.peg.2392","1549"
"19716",916,296,620,"GCAATGATAGTTAAAGACA","ATAGCGCAAATTCACGTGTA","561307.5.peg.2392","1549"
"19717",9,916,907,"CATCTTCAATCAGTATTAGG","GCAATGATAGTTAAAGACA","561307.5.peg.2392","1549"
"19718",202,916,714,"AAAGCACCTTTCTTAATGA","GCAATGATAGTTAAAGACA","561307.5.peg.2392","1549"
"19719",160,916,756,"ACACCTTTAGTAAACTGTA","GCAATGATAGTTAAAGACA","561307.5.peg.2392","1549"
"19720",296,916,620,"ATAGCGCAAATTCACGTGTA","GCAATGATAGTTAAAGACA","561307.5.peg.2392","1549"
"19721",244,10,234,"ATATCAGGTACAAATGGAA","TGATTGTACTAATTGACTGG","561307.5.peg.2399","1556"
"19722",258,10,248,"CTTCGTTGCGCTTTAATATC","TGATTGTACTAATTGACTGG","561307.5.peg.2399","1556"
"19723",10,244,234,"TGATTGTACTAATTGACTGG","ATATCAGGTACAAATGGAA","561307.5.peg.2399","1556"
"19724",10,258,248,"TGATTGTACTAATTGACTGG","CTTCGTTGCGCTTTAATATC","561307.5.peg.2399","1556"
"19725",308,165,143,"GTGATTGTATTGCTCTAAAT","TGTCTTGGTTGATAACGGTT","561307.5.peg.2402","1561"
"19726",339,165,174,"CGAATAATAACGTCTGCTTG","TGTCTTGGTTGATAACGGTT","561307.5.peg.2402","1561"
"19727",308,170,138,"GTGATTGTATTGCTCTAAAT","ACACCTGTCTTGGTTGATAA","561307.5.peg.2402","1561"
"19728",339,170,169,"CGAATAATAACGTCTGCTTG","ACACCTGTCTTGGTTGATAA","561307.5.peg.2402","1561"
"19729",308,180,128,"GTGATTGTATTGCTCTAAAT","TTTGGTTCAAACACCTGTCT","561307.5.peg.2402","1561"
"19730",339,180,159,"CGAATAATAACGTCTGCTTG","TTTGGTTCAAACACCTGTCT","561307.5.peg.2402","1561"
"19731",165,308,143,"TGTCTTGGTTGATAACGGTT","GTGATTGTATTGCTCTAAAT","561307.5.peg.2402","1561"
"19732",170,308,138,"ACACCTGTCTTGGTTGATAA","GTGATTGTATTGCTCTAAAT","561307.5.peg.2402","1561"
"19733",180,308,128,"TTTGGTTCAAACACCTGTCT","GTGATTGTATTGCTCTAAAT","561307.5.peg.2402","1561"
"19734",165,339,174,"TGTCTTGGTTGATAACGGTT","CGAATAATAACGTCTGCTTG","561307.5.peg.2402","1561"
"19735",170,339,169,"ACACCTGTCTTGGTTGATAA","CGAATAATAACGTCTGCTTG","561307.5.peg.2402","1561"
"19736",180,339,159,"TTTGGTTCAAACACCTGTCT","CGAATAATAACGTCTGCTTG","561307.5.peg.2402","1561"
"19737",380,11,369,"TTGTAATTCTGACGCTAAA","AGAACAAGGTAAACTCCAAA","561307.5.peg.2403","1562"
"19738",380,33,347,"TTGTAATTCTGACGCTAAA","GTCATTAGTCACTCACCCTT","561307.5.peg.2403","1562"
"19739",11,380,369,"AGAACAAGGTAAACTCCAAA","TTGTAATTCTGACGCTAAA","561307.5.peg.2403","1562"
"19740",33,380,347,"GTCATTAGTCACTCACCCTT","TTGTAATTCTGACGCTAAA","561307.5.peg.2403","1562"
"19741",188,5,183,"TAGCTGGTCCACCTACAGAT","TCTTACTAGCCTTCTTAAGA","561307.5.peg.2404","1563"
"19742",180,5,175,"CCACCTACAGATGGGTTACA","TCTTACTAGCCTTCTTAAGA","561307.5.peg.2404","1563"
"19743",762,5,757,"TTAGTATACGTTAGCCAACA","TCTTACTAGCCTTCTTAAGA","561307.5.peg.2404","1563"
"19744",861,5,856,"TCAATTGAAGGGCAATAACG","TCTTACTAGCCTTCTTAAGA","561307.5.peg.2404","1563"
"19745",936,5,931,"TCATTTGTATTACGACCTTC","TCTTACTAGCCTTCTTAAGA","561307.5.peg.2404","1563"
"19746",204,5,199,"CGAACAACGATACCTTTAGC","TCTTACTAGCCTTCTTAAGA","561307.5.peg.2404","1563"
"19747",312,5,307,"GCTCTTAGTGCTCTTACAGC","TCTTACTAGCCTTCTTAAGA","561307.5.peg.2404","1563"
"19748",856,5,851,"TGAAGGGCAATAACGTGGCC","TCTTACTAGCCTTCTTAAGA","561307.5.peg.2404","1563"
"19749",579,5,574,"TGTCTGATAATGTGATTGA","TCTTACTAGCCTTCTTAAGA","561307.5.peg.2404","1563"
"19750",5,180,175,"TCTTACTAGCCTTCTTAAGA","CCACCTACAGATGGGTTACA","561307.5.peg.2404","1563"
"19751",762,180,582,"TTAGTATACGTTAGCCAACA","CCACCTACAGATGGGTTACA","561307.5.peg.2404","1563"
"19752",936,180,756,"TCATTTGTATTACGACCTTC","CCACCTACAGATGGGTTACA","561307.5.peg.2404","1563"
"19753",312,180,132,"GCTCTTAGTGCTCTTACAGC","CCACCTACAGATGGGTTACA","561307.5.peg.2404","1563"
"19754",579,180,399,"TGTCTGATAATGTGATTGA","CCACCTACAGATGGGTTACA","561307.5.peg.2404","1563"
"19755",856,180,676,"TGAAGGGCAATAACGTGGCC","CCACCTACAGATGGGTTACA","561307.5.peg.2404","1563"
"19756",861,180,681,"TCAATTGAAGGGCAATAACG","CCACCTACAGATGGGTTACA","561307.5.peg.2404","1563"
"19757",762,188,574,"TTAGTATACGTTAGCCAACA","TAGCTGGTCCACCTACAGAT","561307.5.peg.2404","1563"
"19758",312,188,124,"GCTCTTAGTGCTCTTACAGC","TAGCTGGTCCACCTACAGAT","561307.5.peg.2404","1563"
"19759",856,188,668,"TGAAGGGCAATAACGTGGCC","TAGCTGGTCCACCTACAGAT","561307.5.peg.2404","1563"
"19760",936,188,748,"TCATTTGTATTACGACCTTC","TAGCTGGTCCACCTACAGAT","561307.5.peg.2404","1563"
"19761",861,188,673,"TCAATTGAAGGGCAATAACG","TAGCTGGTCCACCTACAGAT","561307.5.peg.2404","1563"
"19762",579,188,391,"TGTCTGATAATGTGATTGA","TAGCTGGTCCACCTACAGAT","561307.5.peg.2404","1563"
"19763",5,188,183,"TCTTACTAGCCTTCTTAAGA","TAGCTGGTCCACCTACAGAT","561307.5.peg.2404","1563"
"19764",936,204,732,"TCATTTGTATTACGACCTTC","CGAACAACGATACCTTTAGC","561307.5.peg.2404","1563"
"19765",856,204,652,"TGAAGGGCAATAACGTGGCC","CGAACAACGATACCTTTAGC","561307.5.peg.2404","1563"
"19766",312,204,108,"GCTCTTAGTGCTCTTACAGC","CGAACAACGATACCTTTAGC","561307.5.peg.2404","1563"
"19767",579,204,375,"TGTCTGATAATGTGATTGA","CGAACAACGATACCTTTAGC","561307.5.peg.2404","1563"
"19768",5,204,199,"TCTTACTAGCCTTCTTAAGA","CGAACAACGATACCTTTAGC","561307.5.peg.2404","1563"
"19769",861,204,657,"TCAATTGAAGGGCAATAACG","CGAACAACGATACCTTTAGC","561307.5.peg.2404","1563"
"19770",762,204,558,"TTAGTATACGTTAGCCAACA","CGAACAACGATACCTTTAGC","561307.5.peg.2404","1563"
"19771",5,312,307,"TCTTACTAGCCTTCTTAAGA","GCTCTTAGTGCTCTTACAGC","561307.5.peg.2404","1563"
"19772",180,312,132,"CCACCTACAGATGGGTTACA","GCTCTTAGTGCTCTTACAGC","561307.5.peg.2404","1563"
"19773",188,312,124,"TAGCTGGTCCACCTACAGAT","GCTCTTAGTGCTCTTACAGC","561307.5.peg.2404","1563"
"19774",204,312,108,"CGAACAACGATACCTTTAGC","GCTCTTAGTGCTCTTACAGC","561307.5.peg.2404","1563"
"19775",762,312,450,"TTAGTATACGTTAGCCAACA","GCTCTTAGTGCTCTTACAGC","561307.5.peg.2404","1563"
"19776",861,312,549,"TCAATTGAAGGGCAATAACG","GCTCTTAGTGCTCTTACAGC","561307.5.peg.2404","1563"
"19777",579,312,267,"TGTCTGATAATGTGATTGA","GCTCTTAGTGCTCTTACAGC","561307.5.peg.2404","1563"
"19778",936,312,624,"TCATTTGTATTACGACCTTC","GCTCTTAGTGCTCTTACAGC","561307.5.peg.2404","1563"
"19779",856,312,544,"TGAAGGGCAATAACGTGGCC","GCTCTTAGTGCTCTTACAGC","561307.5.peg.2404","1563"
"19780",936,579,357,"TCATTTGTATTACGACCTTC","TGTCTGATAATGTGATTGA","561307.5.peg.2404","1563"
"19781",861,579,282,"TCAATTGAAGGGCAATAACG","TGTCTGATAATGTGATTGA","561307.5.peg.2404","1563"
"19782",204,579,375,"CGAACAACGATACCTTTAGC","TGTCTGATAATGTGATTGA","561307.5.peg.2404","1563"
"19783",762,579,183,"TTAGTATACGTTAGCCAACA","TGTCTGATAATGTGATTGA","561307.5.peg.2404","1563"
"19784",5,579,574,"TCTTACTAGCCTTCTTAAGA","TGTCTGATAATGTGATTGA","561307.5.peg.2404","1563"
"19785",180,579,399,"CCACCTACAGATGGGTTACA","TGTCTGATAATGTGATTGA","561307.5.peg.2404","1563"
"19786",312,579,267,"GCTCTTAGTGCTCTTACAGC","TGTCTGATAATGTGATTGA","561307.5.peg.2404","1563"
"19787",188,579,391,"TAGCTGGTCCACCTACAGAT","TGTCTGATAATGTGATTGA","561307.5.peg.2404","1563"
"19788",856,579,277,"TGAAGGGCAATAACGTGGCC","TGTCTGATAATGTGATTGA","561307.5.peg.2404","1563"
"19789",579,762,183,"TGTCTGATAATGTGATTGA","TTAGTATACGTTAGCCAACA","561307.5.peg.2404","1563"
"19790",204,762,558,"CGAACAACGATACCTTTAGC","TTAGTATACGTTAGCCAACA","561307.5.peg.2404","1563"
"19791",5,762,757,"TCTTACTAGCCTTCTTAAGA","TTAGTATACGTTAGCCAACA","561307.5.peg.2404","1563"
"19792",312,762,450,"GCTCTTAGTGCTCTTACAGC","TTAGTATACGTTAGCCAACA","561307.5.peg.2404","1563"
"19793",188,762,574,"TAGCTGGTCCACCTACAGAT","TTAGTATACGTTAGCCAACA","561307.5.peg.2404","1563"
"19794",180,762,582,"CCACCTACAGATGGGTTACA","TTAGTATACGTTAGCCAACA","561307.5.peg.2404","1563"
"19795",936,762,174,"TCATTTGTATTACGACCTTC","TTAGTATACGTTAGCCAACA","561307.5.peg.2404","1563"
"19796",204,856,652,"CGAACAACGATACCTTTAGC","TGAAGGGCAATAACGTGGCC","561307.5.peg.2404","1563"
"19797",188,856,668,"TAGCTGGTCCACCTACAGAT","TGAAGGGCAATAACGTGGCC","561307.5.peg.2404","1563"
"19798",180,856,676,"CCACCTACAGATGGGTTACA","TGAAGGGCAATAACGTGGCC","561307.5.peg.2404","1563"
"19799",579,856,277,"TGTCTGATAATGTGATTGA","TGAAGGGCAATAACGTGGCC","561307.5.peg.2404","1563"
"19800",5,856,851,"TCTTACTAGCCTTCTTAAGA","TGAAGGGCAATAACGTGGCC","561307.5.peg.2404","1563"
"19801",312,856,544,"GCTCTTAGTGCTCTTACAGC","TGAAGGGCAATAACGTGGCC","561307.5.peg.2404","1563"
"19802",579,861,282,"TGTCTGATAATGTGATTGA","TCAATTGAAGGGCAATAACG","561307.5.peg.2404","1563"
"19803",312,861,549,"GCTCTTAGTGCTCTTACAGC","TCAATTGAAGGGCAATAACG","561307.5.peg.2404","1563"
"19804",188,861,673,"TAGCTGGTCCACCTACAGAT","TCAATTGAAGGGCAATAACG","561307.5.peg.2404","1563"
"19805",5,861,856,"TCTTACTAGCCTTCTTAAGA","TCAATTGAAGGGCAATAACG","561307.5.peg.2404","1563"
"19806",180,861,681,"CCACCTACAGATGGGTTACA","TCAATTGAAGGGCAATAACG","561307.5.peg.2404","1563"
"19807",204,861,657,"CGAACAACGATACCTTTAGC","TCAATTGAAGGGCAATAACG","561307.5.peg.2404","1563"
"19808",312,936,624,"GCTCTTAGTGCTCTTACAGC","TCATTTGTATTACGACCTTC","561307.5.peg.2404","1563"
"19809",5,936,931,"TCTTACTAGCCTTCTTAAGA","TCATTTGTATTACGACCTTC","561307.5.peg.2404","1563"
"19810",188,936,748,"TAGCTGGTCCACCTACAGAT","TCATTTGTATTACGACCTTC","561307.5.peg.2404","1563"
"19811",180,936,756,"CCACCTACAGATGGGTTACA","TCATTTGTATTACGACCTTC","561307.5.peg.2404","1563"
"19812",204,936,732,"CGAACAACGATACCTTTAGC","TCATTTGTATTACGACCTTC","561307.5.peg.2404","1563"
"19813",579,936,357,"TGTCTGATAATGTGATTGA","TCATTTGTATTACGACCTTC","561307.5.peg.2404","1563"
"19814",762,936,174,"TTAGTATACGTTAGCCAACA","TCATTTGTATTACGACCTTC","561307.5.peg.2404","1563"
"19815",126,12,114,"TCAGCAATTTCAACGGCTTG","TGTATTCACATCGTTGAAGG","561307.5.peg.2405","1564"
"19816",186,12,174,"CCGTAATTAATCGTATGTGA","TGTATTCACATCGTTGAAGG","561307.5.peg.2405","1564"
"19817",133,12,121,"AATTTGTCAGCAATTTCAA","TGTATTCACATCGTTGAAGG","561307.5.peg.2405","1564"
"19818",591,12,579,"TCTTCAACATCATCGTATTC","TGTATTCACATCGTTGAAGG","561307.5.peg.2405","1564"
"19819",133,15,118,"AATTTGTCAGCAATTTCAA","AATGTATTCACATCGTTGA","561307.5.peg.2405","1564"
"19820",186,15,171,"CCGTAATTAATCGTATGTGA","AATGTATTCACATCGTTGA","561307.5.peg.2405","1564"
"19821",126,15,111,"TCAGCAATTTCAACGGCTTG","AATGTATTCACATCGTTGA","561307.5.peg.2405","1564"
"19822",591,15,576,"TCTTCAACATCATCGTATTC","AATGTATTCACATCGTTGA","561307.5.peg.2405","1564"
"19823",591,84,507,"TCTTCAACATCATCGTATTC","CCAATTGCCCCTTCACCCAT","561307.5.peg.2405","1564"
"19824",186,84,102,"CCGTAATTAATCGTATGTGA","CCAATTGCCCCTTCACCCAT","561307.5.peg.2405","1564"
"19825",12,126,114,"TGTATTCACATCGTTGAAGG","TCAGCAATTTCAACGGCTTG","561307.5.peg.2405","1564"
"19826",15,126,111,"AATGTATTCACATCGTTGA","TCAGCAATTTCAACGGCTTG","561307.5.peg.2405","1564"
"19827",591,126,465,"TCTTCAACATCATCGTATTC","TCAGCAATTTCAACGGCTTG","561307.5.peg.2405","1564"
"19828",12,133,121,"TGTATTCACATCGTTGAAGG","AATTTGTCAGCAATTTCAA","561307.5.peg.2405","1564"
"19829",591,133,458,"TCTTCAACATCATCGTATTC","AATTTGTCAGCAATTTCAA","561307.5.peg.2405","1564"
"19830",15,133,118,"AATGTATTCACATCGTTGA","AATTTGTCAGCAATTTCAA","561307.5.peg.2405","1564"
"19831",15,186,171,"AATGTATTCACATCGTTGA","CCGTAATTAATCGTATGTGA","561307.5.peg.2405","1564"
"19832",12,186,174,"TGTATTCACATCGTTGAAGG","CCGTAATTAATCGTATGTGA","561307.5.peg.2405","1564"
"19833",591,186,405,"TCTTCAACATCATCGTATTC","CCGTAATTAATCGTATGTGA","561307.5.peg.2405","1564"
"19834",84,186,102,"CCAATTGCCCCTTCACCCAT","CCGTAATTAATCGTATGTGA","561307.5.peg.2405","1564"
"19835",12,591,579,"TGTATTCACATCGTTGAAGG","TCTTCAACATCATCGTATTC","561307.5.peg.2405","1564"
"19836",186,591,405,"CCGTAATTAATCGTATGTGA","TCTTCAACATCATCGTATTC","561307.5.peg.2405","1564"
"19837",15,591,576,"AATGTATTCACATCGTTGA","TCTTCAACATCATCGTATTC","561307.5.peg.2405","1564"
"19838",84,591,507,"CCAATTGCCCCTTCACCCAT","TCTTCAACATCATCGTATTC","561307.5.peg.2405","1564"
"19839",126,591,465,"TCAGCAATTTCAACGGCTTG","TCTTCAACATCATCGTATTC","561307.5.peg.2405","1564"
"19840",133,591,458,"AATTTGTCAGCAATTTCAA","TCTTCAACATCATCGTATTC","561307.5.peg.2405","1564"
"19841",483,348,135,"AATGGATTGTACGCTTTGGC","TCCTCAGTTGTTTCAGTAGA","561307.5.peg.2408","1567"
"19842",475,348,127,"GTACGCTTTGGCTGGTGCTT","TCCTCAGTTGTTTCAGTAGA","561307.5.peg.2408","1567"
"19843",450,348,102,"ACAGCTAAACTCGCTGCATG","TCCTCAGTTGTTTCAGTAGA","561307.5.peg.2408","1567"
"19844",582,348,234,"GTGTAAATCACTTTGGCATC","TCCTCAGTTGTTTCAGTAGA","561307.5.peg.2408","1567"
"19845",487,348,139,"AATAATGGATTGTACGCTT","TCCTCAGTTGTTTCAGTAGA","561307.5.peg.2408","1567"
"19846",589,348,241,"CTTGATGTGTAAATCACTT","TCCTCAGTTGTTTCAGTAGA","561307.5.peg.2408","1567"
"19847",582,435,147,"GTGTAAATCACTTTGGCATC","GCATGTGGAAAGCGGTTACC","561307.5.peg.2408","1567"
"19848",589,435,154,"CTTGATGTGTAAATCACTT","GCATGTGGAAAGCGGTTACC","561307.5.peg.2408","1567"
"19849",582,443,139,"GTGTAAATCACTTTGGCATC","AACTCGCTGCATGTGGAAAG","561307.5.peg.2408","1567"
"19850",589,443,146,"CTTGATGTGTAAATCACTT","AACTCGCTGCATGTGGAAAG","561307.5.peg.2408","1567"
"19851",348,450,102,"TCCTCAGTTGTTTCAGTAGA","ACAGCTAAACTCGCTGCATG","561307.5.peg.2408","1567"
"19852",589,450,139,"CTTGATGTGTAAATCACTT","ACAGCTAAACTCGCTGCATG","561307.5.peg.2408","1567"
"19853",582,450,132,"GTGTAAATCACTTTGGCATC","ACAGCTAAACTCGCTGCATG","561307.5.peg.2408","1567"
"19854",582,475,107,"GTGTAAATCACTTTGGCATC","GTACGCTTTGGCTGGTGCTT","561307.5.peg.2408","1567"
"19855",348,475,127,"TCCTCAGTTGTTTCAGTAGA","GTACGCTTTGGCTGGTGCTT","561307.5.peg.2408","1567"
"19856",589,475,114,"CTTGATGTGTAAATCACTT","GTACGCTTTGGCTGGTGCTT","561307.5.peg.2408","1567"
"19857",348,483,135,"TCCTCAGTTGTTTCAGTAGA","AATGGATTGTACGCTTTGGC","561307.5.peg.2408","1567"
"19858",589,483,106,"CTTGATGTGTAAATCACTT","AATGGATTGTACGCTTTGGC","561307.5.peg.2408","1567"
"19859",589,487,102,"CTTGATGTGTAAATCACTT","AATAATGGATTGTACGCTT","561307.5.peg.2408","1567"
"19860",348,487,139,"TCCTCAGTTGTTTCAGTAGA","AATAATGGATTGTACGCTT","561307.5.peg.2408","1567"
"19861",443,582,139,"AACTCGCTGCATGTGGAAAG","GTGTAAATCACTTTGGCATC","561307.5.peg.2408","1567"
"19862",348,582,234,"TCCTCAGTTGTTTCAGTAGA","GTGTAAATCACTTTGGCATC","561307.5.peg.2408","1567"
"19863",435,582,147,"GCATGTGGAAAGCGGTTACC","GTGTAAATCACTTTGGCATC","561307.5.peg.2408","1567"
"19864",450,582,132,"ACAGCTAAACTCGCTGCATG","GTGTAAATCACTTTGGCATC","561307.5.peg.2408","1567"
"19865",475,582,107,"GTACGCTTTGGCTGGTGCTT","GTGTAAATCACTTTGGCATC","561307.5.peg.2408","1567"
"19866",348,589,241,"TCCTCAGTTGTTTCAGTAGA","CTTGATGTGTAAATCACTT","561307.5.peg.2408","1567"
"19867",450,589,139,"ACAGCTAAACTCGCTGCATG","CTTGATGTGTAAATCACTT","561307.5.peg.2408","1567"
"19868",443,589,146,"AACTCGCTGCATGTGGAAAG","CTTGATGTGTAAATCACTT","561307.5.peg.2408","1567"
"19869",483,589,106,"AATGGATTGTACGCTTTGGC","CTTGATGTGTAAATCACTT","561307.5.peg.2408","1567"
"19870",435,589,154,"GCATGTGGAAAGCGGTTACC","CTTGATGTGTAAATCACTT","561307.5.peg.2408","1567"
"19871",475,589,114,"GTACGCTTTGGCTGGTGCTT","CTTGATGTGTAAATCACTT","561307.5.peg.2408","1567"
"19872",487,589,102,"AATAATGGATTGTACGCTT","CTTGATGTGTAAATCACTT","561307.5.peg.2408","1567"
"19873",514,359,155,"TACTGGGCGTGTTTCTGAGG","GACCTGATGTAATTAATGTC","561307.5.peg.2409","1568"
"19874",517,359,158,"TAGTACTGGGCGTGTTTCTG","GACCTGATGTAATTAATGTC","561307.5.peg.2409","1568"
"19875",530,359,171,"AGTTCACACCAGTTAGTACT","GACCTGATGTAATTAATGTC","561307.5.peg.2409","1568"
"19876",359,514,155,"GACCTGATGTAATTAATGTC","TACTGGGCGTGTTTCTGAGG","561307.5.peg.2409","1568"
"19877",359,517,158,"GACCTGATGTAATTAATGTC","TAGTACTGGGCGTGTTTCTG","561307.5.peg.2409","1568"
"19878",359,530,171,"GACCTGATGTAATTAATGTC","AGTTCACACCAGTTAGTACT","561307.5.peg.2409","1568"
"19879",380,31,349,"GCGCAAATAGAACCACATTG","GAATTACCTGAAGATGC","561307.5.peg.2411","1571"
"19880",432,31,401,"ATAAAGCGTCGTCTTATTTG","GAATTACCTGAAGATGC","561307.5.peg.2411","1571"
"19881",380,117,263,"GCGCAAATAGAACCACATTG","CCAATGAGGATATTCACGTC","561307.5.peg.2411","1571"
"19882",432,117,315,"ATAAAGCGTCGTCTTATTTG","CCAATGAGGATATTCACGTC","561307.5.peg.2411","1571"
"19883",31,380,349,"GAATTACCTGAAGATGC","GCGCAAATAGAACCACATTG","561307.5.peg.2411","1571"
"19884",117,380,263,"CCAATGAGGATATTCACGTC","GCGCAAATAGAACCACATTG","561307.5.peg.2411","1571"
"19885",31,432,401,"GAATTACCTGAAGATGC","ATAAAGCGTCGTCTTATTTG","561307.5.peg.2411","1571"
"19886",117,432,315,"CCAATGAGGATATTCACGTC","ATAAAGCGTCGTCTTATTTG","561307.5.peg.2411","1571"
"19887",727,144,583,"AATACCGCCCTCATAGTGAT","GTCGATCCTATATACATACC","561307.5.peg.2412","1572"
"19888",786,144,642,"AAATTGGCTCATCATGAAT","GTCGATCCTATATACATACC","561307.5.peg.2412","1572"
"19889",727,185,542,"AATACCGCCCTCATAGTGAT","CGACAATTTCCCACACTAAA","561307.5.peg.2412","1572"
"19890",786,185,601,"AAATTGGCTCATCATGAAT","CGACAATTTCCCACACTAAA","561307.5.peg.2412","1572"
"19891",144,727,583,"GTCGATCCTATATACATACC","AATACCGCCCTCATAGTGAT","561307.5.peg.2412","1572"
"19892",185,727,542,"CGACAATTTCCCACACTAAA","AATACCGCCCTCATAGTGAT","561307.5.peg.2412","1572"
"19893",144,786,642,"GTCGATCCTATATACATACC","AAATTGGCTCATCATGAAT","561307.5.peg.2412","1572"
"19894",185,786,601,"CGACAATTTCCCACACTAAA","AAATTGGCTCATCATGAAT","561307.5.peg.2412","1572"
"19895",600,94,506,"ATTCTGTTAAGTTATGTGG","AAATGATTCACGCATTTCAC","561307.5.peg.2413","1573"
"19896",843,94,749,"CGAGCCTTATTCACTTGGAA","AAATGATTCACGCATTTCAC","561307.5.peg.2413","1573"
"19897",848,94,754,"TCATACGAGCCTTATTCACT","AAATGATTCACGCATTTCAC","561307.5.peg.2413","1573"
"19898",531,94,437,"AATAAGTTAGGGAATCGAGC","AAATGATTCACGCATTTCAC","561307.5.peg.2413","1573"
"19899",542,94,448,"CACCATTGGCTAATAAGTTA","AAATGATTCACGCATTTCAC","561307.5.peg.2413","1573"
"19900",354,94,260,"TTACCTTGGCCATCAACAAG","AAATGATTCACGCATTTCAC","561307.5.peg.2413","1573"
"19901",653,94,559,"ACTCAGCAATTGAAATATCA","AAATGATTCACGCATTTCAC","561307.5.peg.2413","1573"
"19902",287,94,193,"AAATAGATGAGTCACCATGA","AAATGATTCACGCATTTCAC","561307.5.peg.2413","1573"
"19903",368,94,274,"CCATTGAACCAAAGTTACCT","AAATGATTCACGCATTTCAC","561307.5.peg.2413","1573"
"19904",696,94,602,"AGTCCAGCAGTTGGGAAATC","AAATGATTCACGCATTTCAC","561307.5.peg.2413","1573"
"19905",653,156,497,"ACTCAGCAATTGAAATATCA","TTTAAACCGTCACGAACATC","561307.5.peg.2413","1573"
"19906",848,156,692,"TCATACGAGCCTTATTCACT","TTTAAACCGTCACGAACATC","561307.5.peg.2413","1573"
"19907",287,156,131,"AAATAGATGAGTCACCATGA","TTTAAACCGTCACGAACATC","561307.5.peg.2413","1573"
"19908",368,156,212,"CCATTGAACCAAAGTTACCT","TTTAAACCGTCACGAACATC","561307.5.peg.2413","1573"
"19909",531,156,375,"AATAAGTTAGGGAATCGAGC","TTTAAACCGTCACGAACATC","561307.5.peg.2413","1573"
"19910",354,156,198,"TTACCTTGGCCATCAACAAG","TTTAAACCGTCACGAACATC","561307.5.peg.2413","1573"
"19911",600,156,444,"ATTCTGTTAAGTTATGTGG","TTTAAACCGTCACGAACATC","561307.5.peg.2413","1573"
"19912",696,156,540,"AGTCCAGCAGTTGGGAAATC","TTTAAACCGTCACGAACATC","561307.5.peg.2413","1573"
"19913",542,156,386,"CACCATTGGCTAATAAGTTA","TTTAAACCGTCACGAACATC","561307.5.peg.2413","1573"
"19914",843,156,687,"CGAGCCTTATTCACTTGGAA","TTTAAACCGTCACGAACATC","561307.5.peg.2413","1573"
"19915",368,180,188,"CCATTGAACCAAAGTTACCT","TATAGTATACGACGATGTAC","561307.5.peg.2413","1573"
"19916",542,180,362,"CACCATTGGCTAATAAGTTA","TATAGTATACGACGATGTAC","561307.5.peg.2413","1573"
"19917",653,180,473,"ACTCAGCAATTGAAATATCA","TATAGTATACGACGATGTAC","561307.5.peg.2413","1573"
"19918",531,180,351,"AATAAGTTAGGGAATCGAGC","TATAGTATACGACGATGTAC","561307.5.peg.2413","1573"
"19919",696,180,516,"AGTCCAGCAGTTGGGAAATC","TATAGTATACGACGATGTAC","561307.5.peg.2413","1573"
"19920",354,180,174,"TTACCTTGGCCATCAACAAG","TATAGTATACGACGATGTAC","561307.5.peg.2413","1573"
"19921",600,180,420,"ATTCTGTTAAGTTATGTGG","TATAGTATACGACGATGTAC","561307.5.peg.2413","1573"
"19922",843,180,663,"CGAGCCTTATTCACTTGGAA","TATAGTATACGACGATGTAC","561307.5.peg.2413","1573"
"19923",848,180,668,"TCATACGAGCCTTATTCACT","TATAGTATACGACGATGTAC","561307.5.peg.2413","1573"
"19924",287,180,107,"AAATAGATGAGTCACCATGA","TATAGTATACGACGATGTAC","561307.5.peg.2413","1573"
"19925",94,287,193,"AAATGATTCACGCATTTCAC","AAATAGATGAGTCACCATGA","561307.5.peg.2413","1573"
"19926",156,287,131,"TTTAAACCGTCACGAACATC","AAATAGATGAGTCACCATGA","561307.5.peg.2413","1573"
"19927",531,287,244,"AATAAGTTAGGGAATCGAGC","AAATAGATGAGTCACCATGA","561307.5.peg.2413","1573"
"19928",653,287,366,"ACTCAGCAATTGAAATATCA","AAATAGATGAGTCACCATGA","561307.5.peg.2413","1573"
"19929",848,287,561,"TCATACGAGCCTTATTCACT","AAATAGATGAGTCACCATGA","561307.5.peg.2413","1573"
"19930",843,287,556,"CGAGCCTTATTCACTTGGAA","AAATAGATGAGTCACCATGA","561307.5.peg.2413","1573"
"19931",600,287,313,"ATTCTGTTAAGTTATGTGG","AAATAGATGAGTCACCATGA","561307.5.peg.2413","1573"
"19932",696,287,409,"AGTCCAGCAGTTGGGAAATC","AAATAGATGAGTCACCATGA","561307.5.peg.2413","1573"
"19933",180,287,107,"TATAGTATACGACGATGTAC","AAATAGATGAGTCACCATGA","561307.5.peg.2413","1573"
"19934",542,287,255,"CACCATTGGCTAATAAGTTA","AAATAGATGAGTCACCATGA","561307.5.peg.2413","1573"
"19935",696,354,342,"AGTCCAGCAGTTGGGAAATC","TTACCTTGGCCATCAACAAG","561307.5.peg.2413","1573"
"19936",94,354,260,"AAATGATTCACGCATTTCAC","TTACCTTGGCCATCAACAAG","561307.5.peg.2413","1573"
"19937",848,354,494,"TCATACGAGCCTTATTCACT","TTACCTTGGCCATCAACAAG","561307.5.peg.2413","1573"
"19938",531,354,177,"AATAAGTTAGGGAATCGAGC","TTACCTTGGCCATCAACAAG","561307.5.peg.2413","1573"
"19939",653,354,299,"ACTCAGCAATTGAAATATCA","TTACCTTGGCCATCAACAAG","561307.5.peg.2413","1573"
"19940",542,354,188,"CACCATTGGCTAATAAGTTA","TTACCTTGGCCATCAACAAG","561307.5.peg.2413","1573"
"19941",180,354,174,"TATAGTATACGACGATGTAC","TTACCTTGGCCATCAACAAG","561307.5.peg.2413","1573"
"19942",843,354,489,"CGAGCCTTATTCACTTGGAA","TTACCTTGGCCATCAACAAG","561307.5.peg.2413","1573"
"19943",600,354,246,"ATTCTGTTAAGTTATGTGG","TTACCTTGGCCATCAACAAG","561307.5.peg.2413","1573"
"19944",156,354,198,"TTTAAACCGTCACGAACATC","TTACCTTGGCCATCAACAAG","561307.5.peg.2413","1573"
"19945",156,368,212,"TTTAAACCGTCACGAACATC","CCATTGAACCAAAGTTACCT","561307.5.peg.2413","1573"
"19946",653,368,285,"ACTCAGCAATTGAAATATCA","CCATTGAACCAAAGTTACCT","561307.5.peg.2413","1573"
"19947",600,368,232,"ATTCTGTTAAGTTATGTGG","CCATTGAACCAAAGTTACCT","561307.5.peg.2413","1573"
"19948",696,368,328,"AGTCCAGCAGTTGGGAAATC","CCATTGAACCAAAGTTACCT","561307.5.peg.2413","1573"
"19949",531,368,163,"AATAAGTTAGGGAATCGAGC","CCATTGAACCAAAGTTACCT","561307.5.peg.2413","1573"
"19950",542,368,174,"CACCATTGGCTAATAAGTTA","CCATTGAACCAAAGTTACCT","561307.5.peg.2413","1573"
"19951",180,368,188,"TATAGTATACGACGATGTAC","CCATTGAACCAAAGTTACCT","561307.5.peg.2413","1573"
"19952",94,368,274,"AAATGATTCACGCATTTCAC","CCATTGAACCAAAGTTACCT","561307.5.peg.2413","1573"
"19953",848,368,480,"TCATACGAGCCTTATTCACT","CCATTGAACCAAAGTTACCT","561307.5.peg.2413","1573"
"19954",843,368,475,"CGAGCCTTATTCACTTGGAA","CCATTGAACCAAAGTTACCT","561307.5.peg.2413","1573"
"19955",696,531,165,"AGTCCAGCAGTTGGGAAATC","AATAAGTTAGGGAATCGAGC","561307.5.peg.2413","1573"
"19956",354,531,177,"TTACCTTGGCCATCAACAAG","AATAAGTTAGGGAATCGAGC","561307.5.peg.2413","1573"
"19957",653,531,122,"ACTCAGCAATTGAAATATCA","AATAAGTTAGGGAATCGAGC","561307.5.peg.2413","1573"
"19958",843,531,312,"CGAGCCTTATTCACTTGGAA","AATAAGTTAGGGAATCGAGC","561307.5.peg.2413","1573"
"19959",156,531,375,"TTTAAACCGTCACGAACATC","AATAAGTTAGGGAATCGAGC","561307.5.peg.2413","1573"
"19960",287,531,244,"AAATAGATGAGTCACCATGA","AATAAGTTAGGGAATCGAGC","561307.5.peg.2413","1573"
"19961",368,531,163,"CCATTGAACCAAAGTTACCT","AATAAGTTAGGGAATCGAGC","561307.5.peg.2413","1573"
"19962",94,531,437,"AAATGATTCACGCATTTCAC","AATAAGTTAGGGAATCGAGC","561307.5.peg.2413","1573"
"19963",180,531,351,"TATAGTATACGACGATGTAC","AATAAGTTAGGGAATCGAGC","561307.5.peg.2413","1573"
"19964",848,531,317,"TCATACGAGCCTTATTCACT","AATAAGTTAGGGAATCGAGC","561307.5.peg.2413","1573"
"19965",287,542,255,"AAATAGATGAGTCACCATGA","CACCATTGGCTAATAAGTTA","561307.5.peg.2413","1573"
"19966",848,542,306,"TCATACGAGCCTTATTCACT","CACCATTGGCTAATAAGTTA","561307.5.peg.2413","1573"
"19967",354,542,188,"TTACCTTGGCCATCAACAAG","CACCATTGGCTAATAAGTTA","561307.5.peg.2413","1573"
"19968",180,542,362,"TATAGTATACGACGATGTAC","CACCATTGGCTAATAAGTTA","561307.5.peg.2413","1573"
"19969",368,542,174,"CCATTGAACCAAAGTTACCT","CACCATTGGCTAATAAGTTA","561307.5.peg.2413","1573"
"19970",696,542,154,"AGTCCAGCAGTTGGGAAATC","CACCATTGGCTAATAAGTTA","561307.5.peg.2413","1573"
"19971",843,542,301,"CGAGCCTTATTCACTTGGAA","CACCATTGGCTAATAAGTTA","561307.5.peg.2413","1573"
"19972",653,542,111,"ACTCAGCAATTGAAATATCA","CACCATTGGCTAATAAGTTA","561307.5.peg.2413","1573"
"19973",94,542,448,"AAATGATTCACGCATTTCAC","CACCATTGGCTAATAAGTTA","561307.5.peg.2413","1573"
"19974",156,542,386,"TTTAAACCGTCACGAACATC","CACCATTGGCTAATAAGTTA","561307.5.peg.2413","1573"
"19975",156,600,444,"TTTAAACCGTCACGAACATC","ATTCTGTTAAGTTATGTGG","561307.5.peg.2413","1573"
"19976",848,600,248,"TCATACGAGCCTTATTCACT","ATTCTGTTAAGTTATGTGG","561307.5.peg.2413","1573"
"19977",354,600,246,"TTACCTTGGCCATCAACAAG","ATTCTGTTAAGTTATGTGG","561307.5.peg.2413","1573"
"19978",368,600,232,"CCATTGAACCAAAGTTACCT","ATTCTGTTAAGTTATGTGG","561307.5.peg.2413","1573"
"19979",287,600,313,"AAATAGATGAGTCACCATGA","ATTCTGTTAAGTTATGTGG","561307.5.peg.2413","1573"
"19980",843,600,243,"CGAGCCTTATTCACTTGGAA","ATTCTGTTAAGTTATGTGG","561307.5.peg.2413","1573"
"19981",94,600,506,"AAATGATTCACGCATTTCAC","ATTCTGTTAAGTTATGTGG","561307.5.peg.2413","1573"
"19982",180,600,420,"TATAGTATACGACGATGTAC","ATTCTGTTAAGTTATGTGG","561307.5.peg.2413","1573"
"19983",542,653,111,"CACCATTGGCTAATAAGTTA","ACTCAGCAATTGAAATATCA","561307.5.peg.2413","1573"
"19984",94,653,559,"AAATGATTCACGCATTTCAC","ACTCAGCAATTGAAATATCA","561307.5.peg.2413","1573"
"19985",287,653,366,"AAATAGATGAGTCACCATGA","ACTCAGCAATTGAAATATCA","561307.5.peg.2413","1573"
"19986",156,653,497,"TTTAAACCGTCACGAACATC","ACTCAGCAATTGAAATATCA","561307.5.peg.2413","1573"
"19987",354,653,299,"TTACCTTGGCCATCAACAAG","ACTCAGCAATTGAAATATCA","561307.5.peg.2413","1573"
"19988",848,653,195,"TCATACGAGCCTTATTCACT","ACTCAGCAATTGAAATATCA","561307.5.peg.2413","1573"
"19989",180,653,473,"TATAGTATACGACGATGTAC","ACTCAGCAATTGAAATATCA","561307.5.peg.2413","1573"
"19990",368,653,285,"CCATTGAACCAAAGTTACCT","ACTCAGCAATTGAAATATCA","561307.5.peg.2413","1573"
"19991",843,653,190,"CGAGCCTTATTCACTTGGAA","ACTCAGCAATTGAAATATCA","561307.5.peg.2413","1573"
"19992",531,653,122,"AATAAGTTAGGGAATCGAGC","ACTCAGCAATTGAAATATCA","561307.5.peg.2413","1573"
"19993",542,696,154,"CACCATTGGCTAATAAGTTA","AGTCCAGCAGTTGGGAAATC","561307.5.peg.2413","1573"
"19994",843,696,147,"CGAGCCTTATTCACTTGGAA","AGTCCAGCAGTTGGGAAATC","561307.5.peg.2413","1573"
"19995",156,696,540,"TTTAAACCGTCACGAACATC","AGTCCAGCAGTTGGGAAATC","561307.5.peg.2413","1573"
"19996",94,696,602,"AAATGATTCACGCATTTCAC","AGTCCAGCAGTTGGGAAATC","561307.5.peg.2413","1573"
"19997",848,696,152,"TCATACGAGCCTTATTCACT","AGTCCAGCAGTTGGGAAATC","561307.5.peg.2413","1573"
"19998",354,696,342,"TTACCTTGGCCATCAACAAG","AGTCCAGCAGTTGGGAAATC","561307.5.peg.2413","1573"
"19999",368,696,328,"CCATTGAACCAAAGTTACCT","AGTCCAGCAGTTGGGAAATC","561307.5.peg.2413","1573"
"20000",287,696,409,"AAATAGATGAGTCACCATGA","AGTCCAGCAGTTGGGAAATC","561307.5.peg.2413","1573"
"20001",180,696,516,"TATAGTATACGACGATGTAC","AGTCCAGCAGTTGGGAAATC","561307.5.peg.2413","1573"
"20002",531,696,165,"AATAAGTTAGGGAATCGAGC","AGTCCAGCAGTTGGGAAATC","561307.5.peg.2413","1573"
"20003",354,843,489,"TTACCTTGGCCATCAACAAG","CGAGCCTTATTCACTTGGAA","561307.5.peg.2413","1573"
"20004",600,843,243,"ATTCTGTTAAGTTATGTGG","CGAGCCTTATTCACTTGGAA","561307.5.peg.2413","1573"
"20005",94,843,749,"AAATGATTCACGCATTTCAC","CGAGCCTTATTCACTTGGAA","561307.5.peg.2413","1573"
"20006",156,843,687,"TTTAAACCGTCACGAACATC","CGAGCCTTATTCACTTGGAA","561307.5.peg.2413","1573"
"20007",287,843,556,"AAATAGATGAGTCACCATGA","CGAGCCTTATTCACTTGGAA","561307.5.peg.2413","1573"
"20008",653,843,190,"ACTCAGCAATTGAAATATCA","CGAGCCTTATTCACTTGGAA","561307.5.peg.2413","1573"
"20009",368,843,475,"CCATTGAACCAAAGTTACCT","CGAGCCTTATTCACTTGGAA","561307.5.peg.2413","1573"
"20010",696,843,147,"AGTCCAGCAGTTGGGAAATC","CGAGCCTTATTCACTTGGAA","561307.5.peg.2413","1573"
"20011",542,843,301,"CACCATTGGCTAATAAGTTA","CGAGCCTTATTCACTTGGAA","561307.5.peg.2413","1573"
"20012",180,843,663,"TATAGTATACGACGATGTAC","CGAGCCTTATTCACTTGGAA","561307.5.peg.2413","1573"
"20013",531,843,312,"AATAAGTTAGGGAATCGAGC","CGAGCCTTATTCACTTGGAA","561307.5.peg.2413","1573"
"20014",94,848,754,"AAATGATTCACGCATTTCAC","TCATACGAGCCTTATTCACT","561307.5.peg.2413","1573"
"20015",542,848,306,"CACCATTGGCTAATAAGTTA","TCATACGAGCCTTATTCACT","561307.5.peg.2413","1573"
"20016",287,848,561,"AAATAGATGAGTCACCATGA","TCATACGAGCCTTATTCACT","561307.5.peg.2413","1573"
"20017",354,848,494,"TTACCTTGGCCATCAACAAG","TCATACGAGCCTTATTCACT","561307.5.peg.2413","1573"
"20018",531,848,317,"AATAAGTTAGGGAATCGAGC","TCATACGAGCCTTATTCACT","561307.5.peg.2413","1573"
"20019",156,848,692,"TTTAAACCGTCACGAACATC","TCATACGAGCCTTATTCACT","561307.5.peg.2413","1573"
"20020",653,848,195,"ACTCAGCAATTGAAATATCA","TCATACGAGCCTTATTCACT","561307.5.peg.2413","1573"
"20021",180,848,668,"TATAGTATACGACGATGTAC","TCATACGAGCCTTATTCACT","561307.5.peg.2413","1573"
"20022",696,848,152,"AGTCCAGCAGTTGGGAAATC","TCATACGAGCCTTATTCACT","561307.5.peg.2413","1573"
"20023",368,848,480,"CCATTGAACCAAAGTTACCT","TCATACGAGCCTTATTCACT","561307.5.peg.2413","1573"
"20024",600,848,248,"ATTCTGTTAAGTTATGTGG","TCATACGAGCCTTATTCACT","561307.5.peg.2413","1573"
"20025",254,78,176,"TATCAATAACCATCGCTTCT","TGTGAATCTTCTTTACGCTT","561307.5.peg.2414","1574"
"20026",336,78,258,"TTGAAATCAACGCCAAGACC","TGTGAATCTTCTTTACGCTT","561307.5.peg.2414","1574"
"20027",336,157,179,"TTGAAATCAACGCCAAGACC","TGCACGAGCCGCTAACATAA","561307.5.peg.2414","1574"
"20028",78,254,176,"TGTGAATCTTCTTTACGCTT","TATCAATAACCATCGCTTCT","561307.5.peg.2414","1574"
"20029",78,336,258,"TGTGAATCTTCTTTACGCTT","TTGAAATCAACGCCAAGACC","561307.5.peg.2414","1574"
"20030",157,336,179,"TGCACGAGCCGCTAACATAA","TTGAAATCAACGCCAAGACC","561307.5.peg.2414","1574"
"20031",254,31,223,"GTAATTCATTATATTGCGTC","TATACTTCAAGAAGGAT","561307.5.peg.2415","1575"
"20032",452,31,421,"CACCGAGAGAGCCTTGCTGT","TATACTTCAAGAAGGAT","561307.5.peg.2415","1575"
"20033",602,31,571,"CTAAACCTTCTTTAGCCTGA","TATACTTCAAGAAGGAT","561307.5.peg.2415","1575"
"20034",391,31,360,"TGTCTCACTAATTCTAAAG","TATACTTCAAGAAGGAT","561307.5.peg.2415","1575"
"20035",444,31,413,"GAGCCTTGCTGTGGGATTAT","TATACTTCAAGAAGGAT","561307.5.peg.2415","1575"
"20036",698,31,667,"ATGCAGCAATCCATTCAGAT","TATACTTCAAGAAGGAT","561307.5.peg.2415","1575"
"20037",594,31,563,"TCTTTAGCCTGAAGGTTCAA","TATACTTCAAGAAGGAT","561307.5.peg.2415","1575"
"20038",301,31,270,"AAATGGCTCACCTAGTCCAC","TATACTTCAAGAAGGAT","561307.5.peg.2415","1575"
"20039",31,254,223,"TATACTTCAAGAAGGAT","GTAATTCATTATATTGCGTC","561307.5.peg.2415","1575"
"20040",594,254,340,"TCTTTAGCCTGAAGGTTCAA","GTAATTCATTATATTGCGTC","561307.5.peg.2415","1575"
"20041",452,254,198,"CACCGAGAGAGCCTTGCTGT","GTAATTCATTATATTGCGTC","561307.5.peg.2415","1575"
"20042",602,254,348,"CTAAACCTTCTTTAGCCTGA","GTAATTCATTATATTGCGTC","561307.5.peg.2415","1575"
"20043",698,254,444,"ATGCAGCAATCCATTCAGAT","GTAATTCATTATATTGCGTC","561307.5.peg.2415","1575"
"20044",391,254,137,"TGTCTCACTAATTCTAAAG","GTAATTCATTATATTGCGTC","561307.5.peg.2415","1575"
"20045",444,254,190,"GAGCCTTGCTGTGGGATTAT","GTAATTCATTATATTGCGTC","561307.5.peg.2415","1575"
"20046",452,301,151,"CACCGAGAGAGCCTTGCTGT","AAATGGCTCACCTAGTCCAC","561307.5.peg.2415","1575"
"20047",444,301,143,"GAGCCTTGCTGTGGGATTAT","AAATGGCTCACCTAGTCCAC","561307.5.peg.2415","1575"
"20048",698,301,397,"ATGCAGCAATCCATTCAGAT","AAATGGCTCACCTAGTCCAC","561307.5.peg.2415","1575"
"20049",602,301,301,"CTAAACCTTCTTTAGCCTGA","AAATGGCTCACCTAGTCCAC","561307.5.peg.2415","1575"
"20050",594,301,293,"TCTTTAGCCTGAAGGTTCAA","AAATGGCTCACCTAGTCCAC","561307.5.peg.2415","1575"
"20051",31,301,270,"TATACTTCAAGAAGGAT","AAATGGCTCACCTAGTCCAC","561307.5.peg.2415","1575"
"20052",31,391,360,"TATACTTCAAGAAGGAT","TGTCTCACTAATTCTAAAG","561307.5.peg.2415","1575"
"20053",602,391,211,"CTAAACCTTCTTTAGCCTGA","TGTCTCACTAATTCTAAAG","561307.5.peg.2415","1575"
"20054",698,391,307,"ATGCAGCAATCCATTCAGAT","TGTCTCACTAATTCTAAAG","561307.5.peg.2415","1575"
"20055",594,391,203,"TCTTTAGCCTGAAGGTTCAA","TGTCTCACTAATTCTAAAG","561307.5.peg.2415","1575"
"20056",254,391,137,"GTAATTCATTATATTGCGTC","TGTCTCACTAATTCTAAAG","561307.5.peg.2415","1575"
"20057",31,444,413,"TATACTTCAAGAAGGAT","GAGCCTTGCTGTGGGATTAT","561307.5.peg.2415","1575"
"20058",301,444,143,"AAATGGCTCACCTAGTCCAC","GAGCCTTGCTGTGGGATTAT","561307.5.peg.2415","1575"
"20059",254,444,190,"GTAATTCATTATATTGCGTC","GAGCCTTGCTGTGGGATTAT","561307.5.peg.2415","1575"
"20060",602,444,158,"CTAAACCTTCTTTAGCCTGA","GAGCCTTGCTGTGGGATTAT","561307.5.peg.2415","1575"
"20061",594,444,150,"TCTTTAGCCTGAAGGTTCAA","GAGCCTTGCTGTGGGATTAT","561307.5.peg.2415","1575"
"20062",698,444,254,"ATGCAGCAATCCATTCAGAT","GAGCCTTGCTGTGGGATTAT","561307.5.peg.2415","1575"
"20063",698,452,246,"ATGCAGCAATCCATTCAGAT","CACCGAGAGAGCCTTGCTGT","561307.5.peg.2415","1575"
"20064",301,452,151,"AAATGGCTCACCTAGTCCAC","CACCGAGAGAGCCTTGCTGT","561307.5.peg.2415","1575"
"20065",594,452,142,"TCTTTAGCCTGAAGGTTCAA","CACCGAGAGAGCCTTGCTGT","561307.5.peg.2415","1575"
"20066",602,452,150,"CTAAACCTTCTTTAGCCTGA","CACCGAGAGAGCCTTGCTGT","561307.5.peg.2415","1575"
"20067",31,452,421,"TATACTTCAAGAAGGAT","CACCGAGAGAGCCTTGCTGT","561307.5.peg.2415","1575"
"20068",254,452,198,"GTAATTCATTATATTGCGTC","CACCGAGAGAGCCTTGCTGT","561307.5.peg.2415","1575"
"20069",31,594,563,"TATACTTCAAGAAGGAT","TCTTTAGCCTGAAGGTTCAA","561307.5.peg.2415","1575"
"20070",301,594,293,"AAATGGCTCACCTAGTCCAC","TCTTTAGCCTGAAGGTTCAA","561307.5.peg.2415","1575"
"20071",452,594,142,"CACCGAGAGAGCCTTGCTGT","TCTTTAGCCTGAAGGTTCAA","561307.5.peg.2415","1575"
"20072",254,594,340,"GTAATTCATTATATTGCGTC","TCTTTAGCCTGAAGGTTCAA","561307.5.peg.2415","1575"
"20073",444,594,150,"GAGCCTTGCTGTGGGATTAT","TCTTTAGCCTGAAGGTTCAA","561307.5.peg.2415","1575"
"20074",698,594,104,"ATGCAGCAATCCATTCAGAT","TCTTTAGCCTGAAGGTTCAA","561307.5.peg.2415","1575"
"20075",391,594,203,"TGTCTCACTAATTCTAAAG","TCTTTAGCCTGAAGGTTCAA","561307.5.peg.2415","1575"
"20076",301,602,301,"AAATGGCTCACCTAGTCCAC","CTAAACCTTCTTTAGCCTGA","561307.5.peg.2415","1575"
"20077",254,602,348,"GTAATTCATTATATTGCGTC","CTAAACCTTCTTTAGCCTGA","561307.5.peg.2415","1575"
"20078",452,602,150,"CACCGAGAGAGCCTTGCTGT","CTAAACCTTCTTTAGCCTGA","561307.5.peg.2415","1575"
"20079",31,602,571,"TATACTTCAAGAAGGAT","CTAAACCTTCTTTAGCCTGA","561307.5.peg.2415","1575"
"20080",391,602,211,"TGTCTCACTAATTCTAAAG","CTAAACCTTCTTTAGCCTGA","561307.5.peg.2415","1575"
"20081",444,602,158,"GAGCCTTGCTGTGGGATTAT","CTAAACCTTCTTTAGCCTGA","561307.5.peg.2415","1575"
"20082",301,698,397,"AAATGGCTCACCTAGTCCAC","ATGCAGCAATCCATTCAGAT","561307.5.peg.2415","1575"
"20083",594,698,104,"TCTTTAGCCTGAAGGTTCAA","ATGCAGCAATCCATTCAGAT","561307.5.peg.2415","1575"
"20084",391,698,307,"TGTCTCACTAATTCTAAAG","ATGCAGCAATCCATTCAGAT","561307.5.peg.2415","1575"
"20085",254,698,444,"GTAATTCATTATATTGCGTC","ATGCAGCAATCCATTCAGAT","561307.5.peg.2415","1575"
"20086",31,698,667,"TATACTTCAAGAAGGAT","ATGCAGCAATCCATTCAGAT","561307.5.peg.2415","1575"
"20087",452,698,246,"CACCGAGAGAGCCTTGCTGT","ATGCAGCAATCCATTCAGAT","561307.5.peg.2415","1575"
"20088",444,698,254,"GAGCCTTGCTGTGGGATTAT","ATGCAGCAATCCATTCAGAT","561307.5.peg.2415","1575"
"20089",459,4,455,"ACAATATCCCAATGTGCTTT","ATTATTTGGGAAAGGATGA","561307.5.peg.2416","1576"
"20090",639,4,635,"GTATCTGCGTTCACAAGCTG","ATTATTTGGGAAAGGATGA","561307.5.peg.2416","1576"
"20091",4,459,455,"ATTATTTGGGAAAGGATGA","ACAATATCCCAATGTGCTTT","561307.5.peg.2416","1576"
"20092",639,459,180,"GTATCTGCGTTCACAAGCTG","ACAATATCCCAATGTGCTTT","561307.5.peg.2416","1576"
"20093",4,639,635,"ATTATTTGGGAAAGGATGA","GTATCTGCGTTCACAAGCTG","561307.5.peg.2416","1576"
"20094",459,639,180,"ACAATATCCCAATGTGCTTT","GTATCTGCGTTCACAAGCTG","561307.5.peg.2416","1576"
"20095",115,9,106,"ACCAAATGAAATACCAACAC","AAATATAAAGTGGCAAAGG","561307.5.peg.2417","1577"
"20096",350,9,341,"CTAATGAACCTAATCCAACA","AAATATAAAGTGGCAAAGG","561307.5.peg.2417","1577"
"20097",321,9,312,"AACCCATATGTCTTGAAGTT","AAATATAAAGTGGCAAAGG","561307.5.peg.2417","1577"
"20098",249,9,240,"GTTAGTACAATCGCTGATAT","AAATATAAAGTGGCAAAGG","561307.5.peg.2417","1577"
"20099",202,9,193,"CATAATAAATTGCGCAGCAC","AAATATAAAGTGGCAAAGG","561307.5.peg.2417","1577"
"20100",9,115,106,"AAATATAAAGTGGCAAAGG","ACCAAATGAAATACCAACAC","561307.5.peg.2417","1577"
"20101",249,115,134,"GTTAGTACAATCGCTGATAT","ACCAAATGAAATACCAACAC","561307.5.peg.2417","1577"
"20102",321,115,206,"AACCCATATGTCTTGAAGTT","ACCAAATGAAATACCAACAC","561307.5.peg.2417","1577"
"20103",350,115,235,"CTAATGAACCTAATCCAACA","ACCAAATGAAATACCAACAC","561307.5.peg.2417","1577"
"20104",9,202,193,"AAATATAAAGTGGCAAAGG","CATAATAAATTGCGCAGCAC","561307.5.peg.2417","1577"
"20105",321,202,119,"AACCCATATGTCTTGAAGTT","CATAATAAATTGCGCAGCAC","561307.5.peg.2417","1577"
"20106",350,202,148,"CTAATGAACCTAATCCAACA","CATAATAAATTGCGCAGCAC","561307.5.peg.2417","1577"
"20107",9,249,240,"AAATATAAAGTGGCAAAGG","GTTAGTACAATCGCTGATAT","561307.5.peg.2417","1577"
"20108",115,249,134,"ACCAAATGAAATACCAACAC","GTTAGTACAATCGCTGATAT","561307.5.peg.2417","1577"
"20109",350,249,101,"CTAATGAACCTAATCCAACA","GTTAGTACAATCGCTGATAT","561307.5.peg.2417","1577"
"20110",115,321,206,"ACCAAATGAAATACCAACAC","AACCCATATGTCTTGAAGTT","561307.5.peg.2417","1577"
"20111",202,321,119,"CATAATAAATTGCGCAGCAC","AACCCATATGTCTTGAAGTT","561307.5.peg.2417","1577"
"20112",9,321,312,"AAATATAAAGTGGCAAAGG","AACCCATATGTCTTGAAGTT","561307.5.peg.2417","1577"
"20113",202,350,148,"CATAATAAATTGCGCAGCAC","CTAATGAACCTAATCCAACA","561307.5.peg.2417","1577"
"20114",115,350,235,"ACCAAATGAAATACCAACAC","CTAATGAACCTAATCCAACA","561307.5.peg.2417","1577"
"20115",249,350,101,"GTTAGTACAATCGCTGATAT","CTAATGAACCTAATCCAACA","561307.5.peg.2417","1577"
"20116",9,350,341,"AAATATAAAGTGGCAAAGG","CTAATGAACCTAATCCAACA","561307.5.peg.2417","1577"
"20117",153,5,148,"AGCCATCGAACCACGACATC","AGCAGCGTTAGGAGTGATGA","561307.5.peg.2418","1578"
"20118",5,153,148,"AGCAGCGTTAGGAGTGATGA","AGCCATCGAACCACGACATC","561307.5.peg.2418","1578"
"20119",502,225,277,"ACTTGTTGCAGCAAGGATAA","ATAATTTCTCGCCACCAACC","561307.5.peg.2419","1579"
"20120",509,225,284,"ATGTTCGACTTGTTGCAGCA","ATAATTTCTCGCCACCAACC","561307.5.peg.2419","1579"
"20121",502,309,193,"ACTTGTTGCAGCAAGGATAA","AAAGGTGAACTTGAACCGAA","561307.5.peg.2419","1579"
"20122",509,309,200,"ATGTTCGACTTGTTGCAGCA","AAAGGTGAACTTGAACCGAA","561307.5.peg.2419","1579"
"20123",225,502,277,"ATAATTTCTCGCCACCAACC","ACTTGTTGCAGCAAGGATAA","561307.5.peg.2419","1579"
"20124",309,502,193,"AAAGGTGAACTTGAACCGAA","ACTTGTTGCAGCAAGGATAA","561307.5.peg.2419","1579"
"20125",225,509,284,"ATAATTTCTCGCCACCAACC","ATGTTCGACTTGTTGCAGCA","561307.5.peg.2419","1579"
"20126",309,509,200,"AAAGGTGAACTTGAACCGAA","ATGTTCGACTTGTTGCAGCA","561307.5.peg.2419","1579"
"20127",1032,92,940,"TAGTCATCTTCCCCGTGACC","TTGGTAAACCACCTCGCATT","561307.5.peg.242","1580"
"20128",762,92,670,"ACGGTAATCGCAACATTTGA","TTGGTAAACCACCTCGCATT","561307.5.peg.242","1580"
"20129",1080,92,988,"TCATCGATTGGACTAATTAC","TTGGTAAACCACCTCGCATT","561307.5.peg.242","1580"
"20130",609,92,517,"GCTAATGAAGACTCACTTGA","TTGGTAAACCACCTCGCATT","561307.5.peg.242","1580"
"20131",1391,92,1299,"GAGAAATAACCCATTCGCCA","TTGGTAAACCACCTCGCATT","561307.5.peg.242","1580"
"20132",215,92,123,"AGTTACCATTCGCGTATGGT","TTGGTAAACCACCTCGCATT","561307.5.peg.242","1580"
"20133",1278,92,1186,"CTGATTGAGGCAAACCATTG","TTGGTAAACCACCTCGCATT","561307.5.peg.242","1580"
"20134",219,92,127,"TGTAAGTTACCATTCGCGTA","TTGGTAAACCACCTCGCATT","561307.5.peg.242","1580"
"20135",1257,92,1165,"GGTGTAGCACGGAAGATTAC","TTGGTAAACCACCTCGCATT","561307.5.peg.242","1580"
"20136",324,92,232,"AAACCATGTGTATCCCAACC","TTGGTAAACCACCTCGCATT","561307.5.peg.242","1580"
"20137",951,92,859,"AACGATTCTCTGTCTAAGAA","TTGGTAAACCACCTCGCATT","561307.5.peg.242","1580"
"20138",315,92,223,"GTATCCCAACCTGGTACGTA","TTGGTAAACCACCTCGCATT","561307.5.peg.242","1580"
"20139",1130,92,1038,"CATAGAACATCCCTTCAAAT","TTGGTAAACCACCTCGCATT","561307.5.peg.242","1580"
"20140",1268,92,1176,"CAAACCATTGTGGTGTAGCA","TTGGTAAACCACCTCGCATT","561307.5.peg.242","1580"
"20141",750,92,658,"ACATTTGATGGAATTGTCCA","TTGGTAAACCACCTCGCATT","561307.5.peg.242","1580"
"20142",594,92,502,"CTTGAAGGAGACCAATAAAC","TTGGTAAACCACCTCGCATT","561307.5.peg.242","1580"
"20143",847,92,755,"TTCTGCTACAGCGTCAGACA","TTGGTAAACCACCTCGCATT","561307.5.peg.242","1580"
"20144",609,111,498,"GCTAATGAAGACTCACTTGA","TGAATTTGCGGTTCCTTGTT","561307.5.peg.242","1580"
"20145",324,111,213,"AAACCATGTGTATCCCAACC","TGAATTTGCGGTTCCTTGTT","561307.5.peg.242","1580"
"20146",1278,111,1167,"CTGATTGAGGCAAACCATTG","TGAATTTGCGGTTCCTTGTT","561307.5.peg.242","1580"
"20147",750,111,639,"ACATTTGATGGAATTGTCCA","TGAATTTGCGGTTCCTTGTT","561307.5.peg.242","1580"
"20148",215,111,104,"AGTTACCATTCGCGTATGGT","TGAATTTGCGGTTCCTTGTT","561307.5.peg.242","1580"
"20149",1130,111,1019,"CATAGAACATCCCTTCAAAT","TGAATTTGCGGTTCCTTGTT","561307.5.peg.242","1580"
"20150",594,111,483,"CTTGAAGGAGACCAATAAAC","TGAATTTGCGGTTCCTTGTT","561307.5.peg.242","1580"
"20151",762,111,651,"ACGGTAATCGCAACATTTGA","TGAATTTGCGGTTCCTTGTT","561307.5.peg.242","1580"
"20152",1080,111,969,"TCATCGATTGGACTAATTAC","TGAATTTGCGGTTCCTTGTT","561307.5.peg.242","1580"
"20153",847,111,736,"TTCTGCTACAGCGTCAGACA","TGAATTTGCGGTTCCTTGTT","561307.5.peg.242","1580"
"20154",219,111,108,"TGTAAGTTACCATTCGCGTA","TGAATTTGCGGTTCCTTGTT","561307.5.peg.242","1580"
"20155",1391,111,1280,"GAGAAATAACCCATTCGCCA","TGAATTTGCGGTTCCTTGTT","561307.5.peg.242","1580"
"20156",1268,111,1157,"CAAACCATTGTGGTGTAGCA","TGAATTTGCGGTTCCTTGTT","561307.5.peg.242","1580"
"20157",951,111,840,"AACGATTCTCTGTCTAAGAA","TGAATTTGCGGTTCCTTGTT","561307.5.peg.242","1580"
"20158",1032,111,921,"TAGTCATCTTCCCCGTGACC","TGAATTTGCGGTTCCTTGTT","561307.5.peg.242","1580"
"20159",1257,111,1146,"GGTGTAGCACGGAAGATTAC","TGAATTTGCGGTTCCTTGTT","561307.5.peg.242","1580"
"20160",315,111,204,"GTATCCCAACCTGGTACGTA","TGAATTTGCGGTTCCTTGTT","561307.5.peg.242","1580"
"20161",92,215,123,"TTGGTAAACCACCTCGCATT","AGTTACCATTCGCGTATGGT","561307.5.peg.242","1580"
"20162",1130,215,915,"CATAGAACATCCCTTCAAAT","AGTTACCATTCGCGTATGGT","561307.5.peg.242","1580"
"20163",847,215,632,"TTCTGCTACAGCGTCAGACA","AGTTACCATTCGCGTATGGT","561307.5.peg.242","1580"
"20164",762,215,547,"ACGGTAATCGCAACATTTGA","AGTTACCATTCGCGTATGGT","561307.5.peg.242","1580"
"20165",111,215,104,"TGAATTTGCGGTTCCTTGTT","AGTTACCATTCGCGTATGGT","561307.5.peg.242","1580"
"20166",1257,215,1042,"GGTGTAGCACGGAAGATTAC","AGTTACCATTCGCGTATGGT","561307.5.peg.242","1580"
"20167",609,215,394,"GCTAATGAAGACTCACTTGA","AGTTACCATTCGCGTATGGT","561307.5.peg.242","1580"
"20168",951,215,736,"AACGATTCTCTGTCTAAGAA","AGTTACCATTCGCGTATGGT","561307.5.peg.242","1580"
"20169",324,215,109,"AAACCATGTGTATCCCAACC","AGTTACCATTCGCGTATGGT","561307.5.peg.242","1580"
"20170",315,215,100,"GTATCCCAACCTGGTACGTA","AGTTACCATTCGCGTATGGT","561307.5.peg.242","1580"
"20171",594,215,379,"CTTGAAGGAGACCAATAAAC","AGTTACCATTCGCGTATGGT","561307.5.peg.242","1580"
"20172",1278,215,1063,"CTGATTGAGGCAAACCATTG","AGTTACCATTCGCGTATGGT","561307.5.peg.242","1580"
"20173",1080,215,865,"TCATCGATTGGACTAATTAC","AGTTACCATTCGCGTATGGT","561307.5.peg.242","1580"
"20174",1391,215,1176,"GAGAAATAACCCATTCGCCA","AGTTACCATTCGCGTATGGT","561307.5.peg.242","1580"
"20175",750,215,535,"ACATTTGATGGAATTGTCCA","AGTTACCATTCGCGTATGGT","561307.5.peg.242","1580"
"20176",1032,215,817,"TAGTCATCTTCCCCGTGACC","AGTTACCATTCGCGTATGGT","561307.5.peg.242","1580"
"20177",1268,215,1053,"CAAACCATTGTGGTGTAGCA","AGTTACCATTCGCGTATGGT","561307.5.peg.242","1580"
"20178",1278,219,1059,"CTGATTGAGGCAAACCATTG","TGTAAGTTACCATTCGCGTA","561307.5.peg.242","1580"
"20179",951,219,732,"AACGATTCTCTGTCTAAGAA","TGTAAGTTACCATTCGCGTA","561307.5.peg.242","1580"
"20180",1391,219,1172,"GAGAAATAACCCATTCGCCA","TGTAAGTTACCATTCGCGTA","561307.5.peg.242","1580"
"20181",609,219,390,"GCTAATGAAGACTCACTTGA","TGTAAGTTACCATTCGCGTA","561307.5.peg.242","1580"
"20182",1032,219,813,"TAGTCATCTTCCCCGTGACC","TGTAAGTTACCATTCGCGTA","561307.5.peg.242","1580"
"20183",111,219,108,"TGAATTTGCGGTTCCTTGTT","TGTAAGTTACCATTCGCGTA","561307.5.peg.242","1580"
"20184",750,219,531,"ACATTTGATGGAATTGTCCA","TGTAAGTTACCATTCGCGTA","561307.5.peg.242","1580"
"20185",762,219,543,"ACGGTAATCGCAACATTTGA","TGTAAGTTACCATTCGCGTA","561307.5.peg.242","1580"
"20186",1268,219,1049,"CAAACCATTGTGGTGTAGCA","TGTAAGTTACCATTCGCGTA","561307.5.peg.242","1580"
"20187",594,219,375,"CTTGAAGGAGACCAATAAAC","TGTAAGTTACCATTCGCGTA","561307.5.peg.242","1580"
"20188",1257,219,1038,"GGTGTAGCACGGAAGATTAC","TGTAAGTTACCATTCGCGTA","561307.5.peg.242","1580"
"20189",92,219,127,"TTGGTAAACCACCTCGCATT","TGTAAGTTACCATTCGCGTA","561307.5.peg.242","1580"
"20190",1080,219,861,"TCATCGATTGGACTAATTAC","TGTAAGTTACCATTCGCGTA","561307.5.peg.242","1580"
"20191",847,219,628,"TTCTGCTACAGCGTCAGACA","TGTAAGTTACCATTCGCGTA","561307.5.peg.242","1580"
"20192",324,219,105,"AAACCATGTGTATCCCAACC","TGTAAGTTACCATTCGCGTA","561307.5.peg.242","1580"
"20193",1130,219,911,"CATAGAACATCCCTTCAAAT","TGTAAGTTACCATTCGCGTA","561307.5.peg.242","1580"
"20194",750,315,435,"ACATTTGATGGAATTGTCCA","GTATCCCAACCTGGTACGTA","561307.5.peg.242","1580"
"20195",92,315,223,"TTGGTAAACCACCTCGCATT","GTATCCCAACCTGGTACGTA","561307.5.peg.242","1580"
"20196",1080,315,765,"TCATCGATTGGACTAATTAC","GTATCCCAACCTGGTACGTA","561307.5.peg.242","1580"
"20197",951,315,636,"AACGATTCTCTGTCTAAGAA","GTATCCCAACCTGGTACGTA","561307.5.peg.242","1580"
"20198",1278,315,963,"CTGATTGAGGCAAACCATTG","GTATCCCAACCTGGTACGTA","561307.5.peg.242","1580"
"20199",609,315,294,"GCTAATGAAGACTCACTTGA","GTATCCCAACCTGGTACGTA","561307.5.peg.242","1580"
"20200",1268,315,953,"CAAACCATTGTGGTGTAGCA","GTATCCCAACCTGGTACGTA","561307.5.peg.242","1580"
"20201",762,315,447,"ACGGTAATCGCAACATTTGA","GTATCCCAACCTGGTACGTA","561307.5.peg.242","1580"
"20202",1391,315,1076,"GAGAAATAACCCATTCGCCA","GTATCCCAACCTGGTACGTA","561307.5.peg.242","1580"
"20203",594,315,279,"CTTGAAGGAGACCAATAAAC","GTATCCCAACCTGGTACGTA","561307.5.peg.242","1580"
"20204",215,315,100,"AGTTACCATTCGCGTATGGT","GTATCCCAACCTGGTACGTA","561307.5.peg.242","1580"
"20205",1032,315,717,"TAGTCATCTTCCCCGTGACC","GTATCCCAACCTGGTACGTA","561307.5.peg.242","1580"
"20206",111,315,204,"TGAATTTGCGGTTCCTTGTT","GTATCCCAACCTGGTACGTA","561307.5.peg.242","1580"
"20207",847,315,532,"TTCTGCTACAGCGTCAGACA","GTATCCCAACCTGGTACGTA","561307.5.peg.242","1580"
"20208",1130,315,815,"CATAGAACATCCCTTCAAAT","GTATCCCAACCTGGTACGTA","561307.5.peg.242","1580"
"20209",1257,315,942,"GGTGTAGCACGGAAGATTAC","GTATCCCAACCTGGTACGTA","561307.5.peg.242","1580"
"20210",1130,324,806,"CATAGAACATCCCTTCAAAT","AAACCATGTGTATCCCAACC","561307.5.peg.242","1580"
"20211",1257,324,933,"GGTGTAGCACGGAAGATTAC","AAACCATGTGTATCCCAACC","561307.5.peg.242","1580"
"20212",609,324,285,"GCTAATGAAGACTCACTTGA","AAACCATGTGTATCCCAACC","561307.5.peg.242","1580"
"20213",1032,324,708,"TAGTCATCTTCCCCGTGACC","AAACCATGTGTATCCCAACC","561307.5.peg.242","1580"
"20214",1278,324,954,"CTGATTGAGGCAAACCATTG","AAACCATGTGTATCCCAACC","561307.5.peg.242","1580"
"20215",951,324,627,"AACGATTCTCTGTCTAAGAA","AAACCATGTGTATCCCAACC","561307.5.peg.242","1580"
"20216",847,324,523,"TTCTGCTACAGCGTCAGACA","AAACCATGTGTATCCCAACC","561307.5.peg.242","1580"
"20217",92,324,232,"TTGGTAAACCACCTCGCATT","AAACCATGTGTATCCCAACC","561307.5.peg.242","1580"
"20218",1080,324,756,"TCATCGATTGGACTAATTAC","AAACCATGTGTATCCCAACC","561307.5.peg.242","1580"
"20219",1268,324,944,"CAAACCATTGTGGTGTAGCA","AAACCATGTGTATCCCAACC","561307.5.peg.242","1580"
"20220",1391,324,1067,"GAGAAATAACCCATTCGCCA","AAACCATGTGTATCCCAACC","561307.5.peg.242","1580"
"20221",215,324,109,"AGTTACCATTCGCGTATGGT","AAACCATGTGTATCCCAACC","561307.5.peg.242","1580"
"20222",219,324,105,"TGTAAGTTACCATTCGCGTA","AAACCATGTGTATCCCAACC","561307.5.peg.242","1580"
"20223",762,324,438,"ACGGTAATCGCAACATTTGA","AAACCATGTGTATCCCAACC","561307.5.peg.242","1580"
"20224",111,324,213,"TGAATTTGCGGTTCCTTGTT","AAACCATGTGTATCCCAACC","561307.5.peg.242","1580"
"20225",594,324,270,"CTTGAAGGAGACCAATAAAC","AAACCATGTGTATCCCAACC","561307.5.peg.242","1580"
"20226",750,324,426,"ACATTTGATGGAATTGTCCA","AAACCATGTGTATCCCAACC","561307.5.peg.242","1580"
"20227",951,594,357,"AACGATTCTCTGTCTAAGAA","CTTGAAGGAGACCAATAAAC","561307.5.peg.242","1580"
"20228",324,594,270,"AAACCATGTGTATCCCAACC","CTTGAAGGAGACCAATAAAC","561307.5.peg.242","1580"
"20229",1268,594,674,"CAAACCATTGTGGTGTAGCA","CTTGAAGGAGACCAATAAAC","561307.5.peg.242","1580"
"20230",750,594,156,"ACATTTGATGGAATTGTCCA","CTTGAAGGAGACCAATAAAC","561307.5.peg.242","1580"
"20231",1080,594,486,"TCATCGATTGGACTAATTAC","CTTGAAGGAGACCAATAAAC","561307.5.peg.242","1580"
"20232",1257,594,663,"GGTGTAGCACGGAAGATTAC","CTTGAAGGAGACCAATAAAC","561307.5.peg.242","1580"
"20233",92,594,502,"TTGGTAAACCACCTCGCATT","CTTGAAGGAGACCAATAAAC","561307.5.peg.242","1580"
"20234",111,594,483,"TGAATTTGCGGTTCCTTGTT","CTTGAAGGAGACCAATAAAC","561307.5.peg.242","1580"
"20235",1278,594,684,"CTGATTGAGGCAAACCATTG","CTTGAAGGAGACCAATAAAC","561307.5.peg.242","1580"
"20236",219,594,375,"TGTAAGTTACCATTCGCGTA","CTTGAAGGAGACCAATAAAC","561307.5.peg.242","1580"
"20237",215,594,379,"AGTTACCATTCGCGTATGGT","CTTGAAGGAGACCAATAAAC","561307.5.peg.242","1580"
"20238",1391,594,797,"GAGAAATAACCCATTCGCCA","CTTGAAGGAGACCAATAAAC","561307.5.peg.242","1580"
"20239",1032,594,438,"TAGTCATCTTCCCCGTGACC","CTTGAAGGAGACCAATAAAC","561307.5.peg.242","1580"
"20240",847,594,253,"TTCTGCTACAGCGTCAGACA","CTTGAAGGAGACCAATAAAC","561307.5.peg.242","1580"
"20241",762,594,168,"ACGGTAATCGCAACATTTGA","CTTGAAGGAGACCAATAAAC","561307.5.peg.242","1580"
"20242",1130,594,536,"CATAGAACATCCCTTCAAAT","CTTGAAGGAGACCAATAAAC","561307.5.peg.242","1580"
"20243",315,594,279,"GTATCCCAACCTGGTACGTA","CTTGAAGGAGACCAATAAAC","561307.5.peg.242","1580"
"20244",324,609,285,"AAACCATGTGTATCCCAACC","GCTAATGAAGACTCACTTGA","561307.5.peg.242","1580"
"20245",1130,609,521,"CATAGAACATCCCTTCAAAT","GCTAATGAAGACTCACTTGA","561307.5.peg.242","1580"
"20246",215,609,394,"AGTTACCATTCGCGTATGGT","GCTAATGAAGACTCACTTGA","561307.5.peg.242","1580"
"20247",1391,609,782,"GAGAAATAACCCATTCGCCA","GCTAATGAAGACTCACTTGA","561307.5.peg.242","1580"
"20248",219,609,390,"TGTAAGTTACCATTCGCGTA","GCTAATGAAGACTCACTTGA","561307.5.peg.242","1580"
"20249",92,609,517,"TTGGTAAACCACCTCGCATT","GCTAATGAAGACTCACTTGA","561307.5.peg.242","1580"
"20250",951,609,342,"AACGATTCTCTGTCTAAGAA","GCTAATGAAGACTCACTTGA","561307.5.peg.242","1580"
"20251",315,609,294,"GTATCCCAACCTGGTACGTA","GCTAATGAAGACTCACTTGA","561307.5.peg.242","1580"
"20252",1080,609,471,"TCATCGATTGGACTAATTAC","GCTAATGAAGACTCACTTGA","561307.5.peg.242","1580"
"20253",762,609,153,"ACGGTAATCGCAACATTTGA","GCTAATGAAGACTCACTTGA","561307.5.peg.242","1580"
"20254",1278,609,669,"CTGATTGAGGCAAACCATTG","GCTAATGAAGACTCACTTGA","561307.5.peg.242","1580"
"20255",1032,609,423,"TAGTCATCTTCCCCGTGACC","GCTAATGAAGACTCACTTGA","561307.5.peg.242","1580"
"20256",750,609,141,"ACATTTGATGGAATTGTCCA","GCTAATGAAGACTCACTTGA","561307.5.peg.242","1580"
"20257",1268,609,659,"CAAACCATTGTGGTGTAGCA","GCTAATGAAGACTCACTTGA","561307.5.peg.242","1580"
"20258",111,609,498,"TGAATTTGCGGTTCCTTGTT","GCTAATGAAGACTCACTTGA","561307.5.peg.242","1580"
"20259",847,609,238,"TTCTGCTACAGCGTCAGACA","GCTAATGAAGACTCACTTGA","561307.5.peg.242","1580"
"20260",1257,609,648,"GGTGTAGCACGGAAGATTAC","GCTAATGAAGACTCACTTGA","561307.5.peg.242","1580"
"20261",315,750,435,"GTATCCCAACCTGGTACGTA","ACATTTGATGGAATTGTCCA","561307.5.peg.242","1580"
"20262",609,750,141,"GCTAATGAAGACTCACTTGA","ACATTTGATGGAATTGTCCA","561307.5.peg.242","1580"
"20263",1278,750,528,"CTGATTGAGGCAAACCATTG","ACATTTGATGGAATTGTCCA","561307.5.peg.242","1580"
"20264",219,750,531,"TGTAAGTTACCATTCGCGTA","ACATTTGATGGAATTGTCCA","561307.5.peg.242","1580"
"20265",951,750,201,"AACGATTCTCTGTCTAAGAA","ACATTTGATGGAATTGTCCA","561307.5.peg.242","1580"
"20266",1257,750,507,"GGTGTAGCACGGAAGATTAC","ACATTTGATGGAATTGTCCA","561307.5.peg.242","1580"
"20267",324,750,426,"AAACCATGTGTATCCCAACC","ACATTTGATGGAATTGTCCA","561307.5.peg.242","1580"
"20268",1080,750,330,"TCATCGATTGGACTAATTAC","ACATTTGATGGAATTGTCCA","561307.5.peg.242","1580"
"20269",111,750,639,"TGAATTTGCGGTTCCTTGTT","ACATTTGATGGAATTGTCCA","561307.5.peg.242","1580"
"20270",1032,750,282,"TAGTCATCTTCCCCGTGACC","ACATTTGATGGAATTGTCCA","561307.5.peg.242","1580"
"20271",594,750,156,"CTTGAAGGAGACCAATAAAC","ACATTTGATGGAATTGTCCA","561307.5.peg.242","1580"
"20272",1268,750,518,"CAAACCATTGTGGTGTAGCA","ACATTTGATGGAATTGTCCA","561307.5.peg.242","1580"
"20273",92,750,658,"TTGGTAAACCACCTCGCATT","ACATTTGATGGAATTGTCCA","561307.5.peg.242","1580"
"20274",215,750,535,"AGTTACCATTCGCGTATGGT","ACATTTGATGGAATTGTCCA","561307.5.peg.242","1580"
"20275",1130,750,380,"CATAGAACATCCCTTCAAAT","ACATTTGATGGAATTGTCCA","561307.5.peg.242","1580"
"20276",1391,750,641,"GAGAAATAACCCATTCGCCA","ACATTTGATGGAATTGTCCA","561307.5.peg.242","1580"
"20277",219,762,543,"TGTAAGTTACCATTCGCGTA","ACGGTAATCGCAACATTTGA","561307.5.peg.242","1580"
"20278",1130,762,368,"CATAGAACATCCCTTCAAAT","ACGGTAATCGCAACATTTGA","561307.5.peg.242","1580"
"20279",315,762,447,"GTATCCCAACCTGGTACGTA","ACGGTAATCGCAACATTTGA","561307.5.peg.242","1580"
"20280",1391,762,629,"GAGAAATAACCCATTCGCCA","ACGGTAATCGCAACATTTGA","561307.5.peg.242","1580"
"20281",609,762,153,"GCTAATGAAGACTCACTTGA","ACGGTAATCGCAACATTTGA","561307.5.peg.242","1580"
"20282",215,762,547,"AGTTACCATTCGCGTATGGT","ACGGTAATCGCAACATTTGA","561307.5.peg.242","1580"
"20283",594,762,168,"CTTGAAGGAGACCAATAAAC","ACGGTAATCGCAACATTTGA","561307.5.peg.242","1580"
"20284",1278,762,516,"CTGATTGAGGCAAACCATTG","ACGGTAATCGCAACATTTGA","561307.5.peg.242","1580"
"20285",1032,762,270,"TAGTCATCTTCCCCGTGACC","ACGGTAATCGCAACATTTGA","561307.5.peg.242","1580"
"20286",951,762,189,"AACGATTCTCTGTCTAAGAA","ACGGTAATCGCAACATTTGA","561307.5.peg.242","1580"
"20287",1268,762,506,"CAAACCATTGTGGTGTAGCA","ACGGTAATCGCAACATTTGA","561307.5.peg.242","1580"
"20288",324,762,438,"AAACCATGTGTATCCCAACC","ACGGTAATCGCAACATTTGA","561307.5.peg.242","1580"
"20289",111,762,651,"TGAATTTGCGGTTCCTTGTT","ACGGTAATCGCAACATTTGA","561307.5.peg.242","1580"
"20290",1257,762,495,"GGTGTAGCACGGAAGATTAC","ACGGTAATCGCAACATTTGA","561307.5.peg.242","1580"
"20291",1080,762,318,"TCATCGATTGGACTAATTAC","ACGGTAATCGCAACATTTGA","561307.5.peg.242","1580"
"20292",92,762,670,"TTGGTAAACCACCTCGCATT","ACGGTAATCGCAACATTTGA","561307.5.peg.242","1580"
"20293",215,847,632,"AGTTACCATTCGCGTATGGT","TTCTGCTACAGCGTCAGACA","561307.5.peg.242","1580"
"20294",1391,847,544,"GAGAAATAACCCATTCGCCA","TTCTGCTACAGCGTCAGACA","561307.5.peg.242","1580"
"20295",1032,847,185,"TAGTCATCTTCCCCGTGACC","TTCTGCTACAGCGTCAGACA","561307.5.peg.242","1580"
"20296",1268,847,421,"CAAACCATTGTGGTGTAGCA","TTCTGCTACAGCGTCAGACA","561307.5.peg.242","1580"
"20297",951,847,104,"AACGATTCTCTGTCTAAGAA","TTCTGCTACAGCGTCAGACA","561307.5.peg.242","1580"
"20298",1080,847,233,"TCATCGATTGGACTAATTAC","TTCTGCTACAGCGTCAGACA","561307.5.peg.242","1580"
"20299",111,847,736,"TGAATTTGCGGTTCCTTGTT","TTCTGCTACAGCGTCAGACA","561307.5.peg.242","1580"
"20300",324,847,523,"AAACCATGTGTATCCCAACC","TTCTGCTACAGCGTCAGACA","561307.5.peg.242","1580"
"20301",1257,847,410,"GGTGTAGCACGGAAGATTAC","TTCTGCTACAGCGTCAGACA","561307.5.peg.242","1580"
"20302",1130,847,283,"CATAGAACATCCCTTCAAAT","TTCTGCTACAGCGTCAGACA","561307.5.peg.242","1580"
"20303",609,847,238,"GCTAATGAAGACTCACTTGA","TTCTGCTACAGCGTCAGACA","561307.5.peg.242","1580"
"20304",315,847,532,"GTATCCCAACCTGGTACGTA","TTCTGCTACAGCGTCAGACA","561307.5.peg.242","1580"
"20305",219,847,628,"TGTAAGTTACCATTCGCGTA","TTCTGCTACAGCGTCAGACA","561307.5.peg.242","1580"
"20306",594,847,253,"CTTGAAGGAGACCAATAAAC","TTCTGCTACAGCGTCAGACA","561307.5.peg.242","1580"
"20307",92,847,755,"TTGGTAAACCACCTCGCATT","TTCTGCTACAGCGTCAGACA","561307.5.peg.242","1580"
"20308",1278,847,431,"CTGATTGAGGCAAACCATTG","TTCTGCTACAGCGTCAGACA","561307.5.peg.242","1580"
"20309",762,951,189,"ACGGTAATCGCAACATTTGA","AACGATTCTCTGTCTAAGAA","561307.5.peg.242","1580"
"20310",215,951,736,"AGTTACCATTCGCGTATGGT","AACGATTCTCTGTCTAAGAA","561307.5.peg.242","1580"
"20311",111,951,840,"TGAATTTGCGGTTCCTTGTT","AACGATTCTCTGTCTAAGAA","561307.5.peg.242","1580"
"20312",324,951,627,"AAACCATGTGTATCCCAACC","AACGATTCTCTGTCTAAGAA","561307.5.peg.242","1580"
"20313",1268,951,317,"CAAACCATTGTGGTGTAGCA","AACGATTCTCTGTCTAAGAA","561307.5.peg.242","1580"
"20314",609,951,342,"GCTAATGAAGACTCACTTGA","AACGATTCTCTGTCTAAGAA","561307.5.peg.242","1580"
"20315",219,951,732,"TGTAAGTTACCATTCGCGTA","AACGATTCTCTGTCTAAGAA","561307.5.peg.242","1580"
"20316",1278,951,327,"CTGATTGAGGCAAACCATTG","AACGATTCTCTGTCTAAGAA","561307.5.peg.242","1580"
"20317",594,951,357,"CTTGAAGGAGACCAATAAAC","AACGATTCTCTGTCTAAGAA","561307.5.peg.242","1580"
"20318",315,951,636,"GTATCCCAACCTGGTACGTA","AACGATTCTCTGTCTAAGAA","561307.5.peg.242","1580"
"20319",1130,951,179,"CATAGAACATCCCTTCAAAT","AACGATTCTCTGTCTAAGAA","561307.5.peg.242","1580"
"20320",92,951,859,"TTGGTAAACCACCTCGCATT","AACGATTCTCTGTCTAAGAA","561307.5.peg.242","1580"
"20321",1391,951,440,"GAGAAATAACCCATTCGCCA","AACGATTCTCTGTCTAAGAA","561307.5.peg.242","1580"
"20322",847,951,104,"TTCTGCTACAGCGTCAGACA","AACGATTCTCTGTCTAAGAA","561307.5.peg.242","1580"
"20323",1257,951,306,"GGTGTAGCACGGAAGATTAC","AACGATTCTCTGTCTAAGAA","561307.5.peg.242","1580"
"20324",1080,951,129,"TCATCGATTGGACTAATTAC","AACGATTCTCTGTCTAAGAA","561307.5.peg.242","1580"
"20325",750,951,201,"ACATTTGATGGAATTGTCCA","AACGATTCTCTGTCTAAGAA","561307.5.peg.242","1580"
"20326",594,1032,438,"CTTGAAGGAGACCAATAAAC","TAGTCATCTTCCCCGTGACC","561307.5.peg.242","1580"
"20327",847,1032,185,"TTCTGCTACAGCGTCAGACA","TAGTCATCTTCCCCGTGACC","561307.5.peg.242","1580"
"20328",609,1032,423,"GCTAATGAAGACTCACTTGA","TAGTCATCTTCCCCGTGACC","561307.5.peg.242","1580"
"20329",762,1032,270,"ACGGTAATCGCAACATTTGA","TAGTCATCTTCCCCGTGACC","561307.5.peg.242","1580"
"20330",92,1032,940,"TTGGTAAACCACCTCGCATT","TAGTCATCTTCCCCGTGACC","561307.5.peg.242","1580"
"20331",315,1032,717,"GTATCCCAACCTGGTACGTA","TAGTCATCTTCCCCGTGACC","561307.5.peg.242","1580"
"20332",1278,1032,246,"CTGATTGAGGCAAACCATTG","TAGTCATCTTCCCCGTGACC","561307.5.peg.242","1580"
"20333",219,1032,813,"TGTAAGTTACCATTCGCGTA","TAGTCATCTTCCCCGTGACC","561307.5.peg.242","1580"
"20334",324,1032,708,"AAACCATGTGTATCCCAACC","TAGTCATCTTCCCCGTGACC","561307.5.peg.242","1580"
"20335",215,1032,817,"AGTTACCATTCGCGTATGGT","TAGTCATCTTCCCCGTGACC","561307.5.peg.242","1580"
"20336",1257,1032,225,"GGTGTAGCACGGAAGATTAC","TAGTCATCTTCCCCGTGACC","561307.5.peg.242","1580"
"20337",1268,1032,236,"CAAACCATTGTGGTGTAGCA","TAGTCATCTTCCCCGTGACC","561307.5.peg.242","1580"
"20338",1391,1032,359,"GAGAAATAACCCATTCGCCA","TAGTCATCTTCCCCGTGACC","561307.5.peg.242","1580"
"20339",750,1032,282,"ACATTTGATGGAATTGTCCA","TAGTCATCTTCCCCGTGACC","561307.5.peg.242","1580"
"20340",111,1032,921,"TGAATTTGCGGTTCCTTGTT","TAGTCATCTTCCCCGTGACC","561307.5.peg.242","1580"
"20341",324,1080,756,"AAACCATGTGTATCCCAACC","TCATCGATTGGACTAATTAC","561307.5.peg.242","1580"
"20342",111,1080,969,"TGAATTTGCGGTTCCTTGTT","TCATCGATTGGACTAATTAC","561307.5.peg.242","1580"
"20343",219,1080,861,"TGTAAGTTACCATTCGCGTA","TCATCGATTGGACTAATTAC","561307.5.peg.242","1580"
"20344",1257,1080,177,"GGTGTAGCACGGAAGATTAC","TCATCGATTGGACTAATTAC","561307.5.peg.242","1580"
"20345",847,1080,233,"TTCTGCTACAGCGTCAGACA","TCATCGATTGGACTAATTAC","561307.5.peg.242","1580"
"20346",762,1080,318,"ACGGTAATCGCAACATTTGA","TCATCGATTGGACTAATTAC","561307.5.peg.242","1580"
"20347",1278,1080,198,"CTGATTGAGGCAAACCATTG","TCATCGATTGGACTAATTAC","561307.5.peg.242","1580"
"20348",609,1080,471,"GCTAATGAAGACTCACTTGA","TCATCGATTGGACTAATTAC","561307.5.peg.242","1580"
"20349",315,1080,765,"GTATCCCAACCTGGTACGTA","TCATCGATTGGACTAATTAC","561307.5.peg.242","1580"
"20350",750,1080,330,"ACATTTGATGGAATTGTCCA","TCATCGATTGGACTAATTAC","561307.5.peg.242","1580"
"20351",951,1080,129,"AACGATTCTCTGTCTAAGAA","TCATCGATTGGACTAATTAC","561307.5.peg.242","1580"
"20352",1391,1080,311,"GAGAAATAACCCATTCGCCA","TCATCGATTGGACTAATTAC","561307.5.peg.242","1580"
"20353",92,1080,988,"TTGGTAAACCACCTCGCATT","TCATCGATTGGACTAATTAC","561307.5.peg.242","1580"
"20354",1268,1080,188,"CAAACCATTGTGGTGTAGCA","TCATCGATTGGACTAATTAC","561307.5.peg.242","1580"
"20355",594,1080,486,"CTTGAAGGAGACCAATAAAC","TCATCGATTGGACTAATTAC","561307.5.peg.242","1580"
"20356",215,1080,865,"AGTTACCATTCGCGTATGGT","TCATCGATTGGACTAATTAC","561307.5.peg.242","1580"
"20357",750,1130,380,"ACATTTGATGGAATTGTCCA","CATAGAACATCCCTTCAAAT","561307.5.peg.242","1580"
"20358",219,1130,911,"TGTAAGTTACCATTCGCGTA","CATAGAACATCCCTTCAAAT","561307.5.peg.242","1580"
"20359",594,1130,536,"CTTGAAGGAGACCAATAAAC","CATAGAACATCCCTTCAAAT","561307.5.peg.242","1580"
"20360",215,1130,915,"AGTTACCATTCGCGTATGGT","CATAGAACATCCCTTCAAAT","561307.5.peg.242","1580"
"20361",1391,1130,261,"GAGAAATAACCCATTCGCCA","CATAGAACATCCCTTCAAAT","561307.5.peg.242","1580"
"20362",324,1130,806,"AAACCATGTGTATCCCAACC","CATAGAACATCCCTTCAAAT","561307.5.peg.242","1580"
"20363",92,1130,1038,"TTGGTAAACCACCTCGCATT","CATAGAACATCCCTTCAAAT","561307.5.peg.242","1580"
"20364",609,1130,521,"GCTAATGAAGACTCACTTGA","CATAGAACATCCCTTCAAAT","561307.5.peg.242","1580"
"20365",847,1130,283,"TTCTGCTACAGCGTCAGACA","CATAGAACATCCCTTCAAAT","561307.5.peg.242","1580"
"20366",111,1130,1019,"TGAATTTGCGGTTCCTTGTT","CATAGAACATCCCTTCAAAT","561307.5.peg.242","1580"
"20367",315,1130,815,"GTATCCCAACCTGGTACGTA","CATAGAACATCCCTTCAAAT","561307.5.peg.242","1580"
"20368",1278,1130,148,"CTGATTGAGGCAAACCATTG","CATAGAACATCCCTTCAAAT","561307.5.peg.242","1580"
"20369",1268,1130,138,"CAAACCATTGTGGTGTAGCA","CATAGAACATCCCTTCAAAT","561307.5.peg.242","1580"
"20370",1257,1130,127,"GGTGTAGCACGGAAGATTAC","CATAGAACATCCCTTCAAAT","561307.5.peg.242","1580"
"20371",762,1130,368,"ACGGTAATCGCAACATTTGA","CATAGAACATCCCTTCAAAT","561307.5.peg.242","1580"
"20372",951,1130,179,"AACGATTCTCTGTCTAAGAA","CATAGAACATCCCTTCAAAT","561307.5.peg.242","1580"
"20373",594,1257,663,"CTTGAAGGAGACCAATAAAC","GGTGTAGCACGGAAGATTAC","561307.5.peg.242","1580"
"20374",315,1257,942,"GTATCCCAACCTGGTACGTA","GGTGTAGCACGGAAGATTAC","561307.5.peg.242","1580"
"20375",1080,1257,177,"TCATCGATTGGACTAATTAC","GGTGTAGCACGGAAGATTAC","561307.5.peg.242","1580"
"20376",219,1257,1038,"TGTAAGTTACCATTCGCGTA","GGTGTAGCACGGAAGATTAC","561307.5.peg.242","1580"
"20377",324,1257,933,"AAACCATGTGTATCCCAACC","GGTGTAGCACGGAAGATTAC","561307.5.peg.242","1580"
"20378",1391,1257,134,"GAGAAATAACCCATTCGCCA","GGTGTAGCACGGAAGATTAC","561307.5.peg.242","1580"
"20379",762,1257,495,"ACGGTAATCGCAACATTTGA","GGTGTAGCACGGAAGATTAC","561307.5.peg.242","1580"
"20380",609,1257,648,"GCTAATGAAGACTCACTTGA","GGTGTAGCACGGAAGATTAC","561307.5.peg.242","1580"
"20381",847,1257,410,"TTCTGCTACAGCGTCAGACA","GGTGTAGCACGGAAGATTAC","561307.5.peg.242","1580"
"20382",750,1257,507,"ACATTTGATGGAATTGTCCA","GGTGTAGCACGGAAGATTAC","561307.5.peg.242","1580"
"20383",1032,1257,225,"TAGTCATCTTCCCCGTGACC","GGTGTAGCACGGAAGATTAC","561307.5.peg.242","1580"
"20384",1130,1257,127,"CATAGAACATCCCTTCAAAT","GGTGTAGCACGGAAGATTAC","561307.5.peg.242","1580"
"20385",215,1257,1042,"AGTTACCATTCGCGTATGGT","GGTGTAGCACGGAAGATTAC","561307.5.peg.242","1580"
"20386",951,1257,306,"AACGATTCTCTGTCTAAGAA","GGTGTAGCACGGAAGATTAC","561307.5.peg.242","1580"
"20387",111,1257,1146,"TGAATTTGCGGTTCCTTGTT","GGTGTAGCACGGAAGATTAC","561307.5.peg.242","1580"
"20388",92,1257,1165,"TTGGTAAACCACCTCGCATT","GGTGTAGCACGGAAGATTAC","561307.5.peg.242","1580"
"20389",762,1268,506,"ACGGTAATCGCAACATTTGA","CAAACCATTGTGGTGTAGCA","561307.5.peg.242","1580"
"20390",315,1268,953,"GTATCCCAACCTGGTACGTA","CAAACCATTGTGGTGTAGCA","561307.5.peg.242","1580"
"20391",1032,1268,236,"TAGTCATCTTCCCCGTGACC","CAAACCATTGTGGTGTAGCA","561307.5.peg.242","1580"
"20392",951,1268,317,"AACGATTCTCTGTCTAAGAA","CAAACCATTGTGGTGTAGCA","561307.5.peg.242","1580"
"20393",215,1268,1053,"AGTTACCATTCGCGTATGGT","CAAACCATTGTGGTGTAGCA","561307.5.peg.242","1580"
"20394",847,1268,421,"TTCTGCTACAGCGTCAGACA","CAAACCATTGTGGTGTAGCA","561307.5.peg.242","1580"
"20395",594,1268,674,"CTTGAAGGAGACCAATAAAC","CAAACCATTGTGGTGTAGCA","561307.5.peg.242","1580"
"20396",219,1268,1049,"TGTAAGTTACCATTCGCGTA","CAAACCATTGTGGTGTAGCA","561307.5.peg.242","1580"
"20397",609,1268,659,"GCTAATGAAGACTCACTTGA","CAAACCATTGTGGTGTAGCA","561307.5.peg.242","1580"
"20398",92,1268,1176,"TTGGTAAACCACCTCGCATT","CAAACCATTGTGGTGTAGCA","561307.5.peg.242","1580"
"20399",324,1268,944,"AAACCATGTGTATCCCAACC","CAAACCATTGTGGTGTAGCA","561307.5.peg.242","1580"
"20400",111,1268,1157,"TGAATTTGCGGTTCCTTGTT","CAAACCATTGTGGTGTAGCA","561307.5.peg.242","1580"
"20401",1080,1268,188,"TCATCGATTGGACTAATTAC","CAAACCATTGTGGTGTAGCA","561307.5.peg.242","1580"
"20402",1391,1268,123,"GAGAAATAACCCATTCGCCA","CAAACCATTGTGGTGTAGCA","561307.5.peg.242","1580"
"20403",750,1268,518,"ACATTTGATGGAATTGTCCA","CAAACCATTGTGGTGTAGCA","561307.5.peg.242","1580"
"20404",1130,1268,138,"CATAGAACATCCCTTCAAAT","CAAACCATTGTGGTGTAGCA","561307.5.peg.242","1580"
"20405",1080,1278,198,"TCATCGATTGGACTAATTAC","CTGATTGAGGCAAACCATTG","561307.5.peg.242","1580"
"20406",92,1278,1186,"TTGGTAAACCACCTCGCATT","CTGATTGAGGCAAACCATTG","561307.5.peg.242","1580"
"20407",951,1278,327,"AACGATTCTCTGTCTAAGAA","CTGATTGAGGCAAACCATTG","561307.5.peg.242","1580"
"20408",762,1278,516,"ACGGTAATCGCAACATTTGA","CTGATTGAGGCAAACCATTG","561307.5.peg.242","1580"
"20409",111,1278,1167,"TGAATTTGCGGTTCCTTGTT","CTGATTGAGGCAAACCATTG","561307.5.peg.242","1580"
"20410",215,1278,1063,"AGTTACCATTCGCGTATGGT","CTGATTGAGGCAAACCATTG","561307.5.peg.242","1580"
"20411",1032,1278,246,"TAGTCATCTTCCCCGTGACC","CTGATTGAGGCAAACCATTG","561307.5.peg.242","1580"
"20412",594,1278,684,"CTTGAAGGAGACCAATAAAC","CTGATTGAGGCAAACCATTG","561307.5.peg.242","1580"
"20413",847,1278,431,"TTCTGCTACAGCGTCAGACA","CTGATTGAGGCAAACCATTG","561307.5.peg.242","1580"
"20414",1391,1278,113,"GAGAAATAACCCATTCGCCA","CTGATTGAGGCAAACCATTG","561307.5.peg.242","1580"
"20415",609,1278,669,"GCTAATGAAGACTCACTTGA","CTGATTGAGGCAAACCATTG","561307.5.peg.242","1580"
"20416",1130,1278,148,"CATAGAACATCCCTTCAAAT","CTGATTGAGGCAAACCATTG","561307.5.peg.242","1580"
"20417",324,1278,954,"AAACCATGTGTATCCCAACC","CTGATTGAGGCAAACCATTG","561307.5.peg.242","1580"
"20418",219,1278,1059,"TGTAAGTTACCATTCGCGTA","CTGATTGAGGCAAACCATTG","561307.5.peg.242","1580"
"20419",750,1278,528,"ACATTTGATGGAATTGTCCA","CTGATTGAGGCAAACCATTG","561307.5.peg.242","1580"
"20420",315,1278,963,"GTATCCCAACCTGGTACGTA","CTGATTGAGGCAAACCATTG","561307.5.peg.242","1580"
"20421",750,1391,641,"ACATTTGATGGAATTGTCCA","GAGAAATAACCCATTCGCCA","561307.5.peg.242","1580"
"20422",219,1391,1172,"TGTAAGTTACCATTCGCGTA","GAGAAATAACCCATTCGCCA","561307.5.peg.242","1580"
"20423",111,1391,1280,"TGAATTTGCGGTTCCTTGTT","GAGAAATAACCCATTCGCCA","561307.5.peg.242","1580"
"20424",324,1391,1067,"AAACCATGTGTATCCCAACC","GAGAAATAACCCATTCGCCA","561307.5.peg.242","1580"
"20425",215,1391,1176,"AGTTACCATTCGCGTATGGT","GAGAAATAACCCATTCGCCA","561307.5.peg.242","1580"
"20426",1130,1391,261,"CATAGAACATCCCTTCAAAT","GAGAAATAACCCATTCGCCA","561307.5.peg.242","1580"
"20427",1278,1391,113,"CTGATTGAGGCAAACCATTG","GAGAAATAACCCATTCGCCA","561307.5.peg.242","1580"
"20428",1268,1391,123,"CAAACCATTGTGGTGTAGCA","GAGAAATAACCCATTCGCCA","561307.5.peg.242","1580"
"20429",92,1391,1299,"TTGGTAAACCACCTCGCATT","GAGAAATAACCCATTCGCCA","561307.5.peg.242","1580"
"20430",1032,1391,359,"TAGTCATCTTCCCCGTGACC","GAGAAATAACCCATTCGCCA","561307.5.peg.242","1580"
"20431",315,1391,1076,"GTATCCCAACCTGGTACGTA","GAGAAATAACCCATTCGCCA","561307.5.peg.242","1580"
"20432",762,1391,629,"ACGGTAATCGCAACATTTGA","GAGAAATAACCCATTCGCCA","561307.5.peg.242","1580"
"20433",1257,1391,134,"GGTGTAGCACGGAAGATTAC","GAGAAATAACCCATTCGCCA","561307.5.peg.242","1580"
"20434",1080,1391,311,"TCATCGATTGGACTAATTAC","GAGAAATAACCCATTCGCCA","561307.5.peg.242","1580"
"20435",951,1391,440,"AACGATTCTCTGTCTAAGAA","GAGAAATAACCCATTCGCCA","561307.5.peg.242","1580"
"20436",594,1391,797,"CTTGAAGGAGACCAATAAAC","GAGAAATAACCCATTCGCCA","561307.5.peg.242","1580"
"20437",847,1391,544,"TTCTGCTACAGCGTCAGACA","GAGAAATAACCCATTCGCCA","561307.5.peg.242","1580"
"20438",609,1391,782,"GCTAATGAAGACTCACTTGA","GAGAAATAACCCATTCGCCA","561307.5.peg.242","1580"
"20439",715,87,628,"TAAATAGGCTACGAATTGAT","GTGATGATCATGATGACAAA","561307.5.peg.2421","1582"
"20440",896,87,809,"CGCGTCCTAATGCTAAGTCT","GTGATGATCATGATGACAAA","561307.5.peg.2421","1582"
"20441",983,87,896,"CACGAGTACGTTTCTCCATC","GTGATGATCATGATGACAAA","561307.5.peg.2421","1582"
"20442",896,715,181,"CGCGTCCTAATGCTAAGTCT","TAAATAGGCTACGAATTGAT","561307.5.peg.2421","1582"
"20443",87,715,628,"GTGATGATCATGATGACAAA","TAAATAGGCTACGAATTGAT","561307.5.peg.2421","1582"
"20444",983,715,268,"CACGAGTACGTTTCTCCATC","TAAATAGGCTACGAATTGAT","561307.5.peg.2421","1582"
"20445",87,896,809,"GTGATGATCATGATGACAAA","CGCGTCCTAATGCTAAGTCT","561307.5.peg.2421","1582"
"20446",715,896,181,"TAAATAGGCTACGAATTGAT","CGCGTCCTAATGCTAAGTCT","561307.5.peg.2421","1582"
"20447",715,983,268,"TAAATAGGCTACGAATTGAT","CACGAGTACGTTTCTCCATC","561307.5.peg.2421","1582"
"20448",87,983,896,"GTGATGATCATGATGACAAA","CACGAGTACGTTTCTCCATC","561307.5.peg.2421","1582"
"20449",600,26,574,"CGATATCCTGTAGGTATACC","CACAGTTGAACAATAAAGT","561307.5.peg.2423","1584"
"20450",339,26,313,"TACTGAACATTTCGCGTCGT","CACAGTTGAACAATAAAGT","561307.5.peg.2423","1584"
"20451",206,26,180,"CATTTAAGTGCATCATTGCA","CACAGTTGAACAATAAAGT","561307.5.peg.2423","1584"
"20452",632,26,606,"GGTTGAACCCTGCTGTCATT","CACAGTTGAACAATAAAGT","561307.5.peg.2423","1584"
"20453",671,26,645,"CTACAGATGGACGCGCTGCA","CACAGTTGAACAATAAAGT","561307.5.peg.2423","1584"
"20454",684,26,658,"AACGCAGTCTTACCTACAGA","CACAGTTGAACAATAAAGT","561307.5.peg.2423","1584"
"20455",609,26,583,"TCTAAATCTCGATATCCTGT","CACAGTTGAACAATAAAGT","561307.5.peg.2423","1584"
"20456",339,45,294,"TACTGAACATTTCGCGTCGT","CATACATTCTATCCATGAA","561307.5.peg.2423","1584"
"20457",600,45,555,"CGATATCCTGTAGGTATACC","CATACATTCTATCCATGAA","561307.5.peg.2423","1584"
"20458",671,45,626,"CTACAGATGGACGCGCTGCA","CATACATTCTATCCATGAA","561307.5.peg.2423","1584"
"20459",684,45,639,"AACGCAGTCTTACCTACAGA","CATACATTCTATCCATGAA","561307.5.peg.2423","1584"
"20460",206,45,161,"CATTTAAGTGCATCATTGCA","CATACATTCTATCCATGAA","561307.5.peg.2423","1584"
"20461",609,45,564,"TCTAAATCTCGATATCCTGT","CATACATTCTATCCATGAA","561307.5.peg.2423","1584"
"20462",632,45,587,"GGTTGAACCCTGCTGTCATT","CATACATTCTATCCATGAA","561307.5.peg.2423","1584"
"20463",339,81,258,"TACTGAACATTTCGCGTCGT","TGTTCAGCTTCATTGTTATG","561307.5.peg.2423","1584"
"20464",684,81,603,"AACGCAGTCTTACCTACAGA","TGTTCAGCTTCATTGTTATG","561307.5.peg.2423","1584"
"20465",600,81,519,"CGATATCCTGTAGGTATACC","TGTTCAGCTTCATTGTTATG","561307.5.peg.2423","1584"
"20466",609,81,528,"TCTAAATCTCGATATCCTGT","TGTTCAGCTTCATTGTTATG","561307.5.peg.2423","1584"
"20467",632,81,551,"GGTTGAACCCTGCTGTCATT","TGTTCAGCTTCATTGTTATG","561307.5.peg.2423","1584"
"20468",206,81,125,"CATTTAAGTGCATCATTGCA","TGTTCAGCTTCATTGTTATG","561307.5.peg.2423","1584"
"20469",671,81,590,"CTACAGATGGACGCGCTGCA","TGTTCAGCTTCATTGTTATG","561307.5.peg.2423","1584"
"20470",671,206,465,"CTACAGATGGACGCGCTGCA","CATTTAAGTGCATCATTGCA","561307.5.peg.2423","1584"
"20471",81,206,125,"TGTTCAGCTTCATTGTTATG","CATTTAAGTGCATCATTGCA","561307.5.peg.2423","1584"
"20472",26,206,180,"CACAGTTGAACAATAAAGT","CATTTAAGTGCATCATTGCA","561307.5.peg.2423","1584"
"20473",45,206,161,"CATACATTCTATCCATGAA","CATTTAAGTGCATCATTGCA","561307.5.peg.2423","1584"
"20474",632,206,426,"GGTTGAACCCTGCTGTCATT","CATTTAAGTGCATCATTGCA","561307.5.peg.2423","1584"
"20475",600,206,394,"CGATATCCTGTAGGTATACC","CATTTAAGTGCATCATTGCA","561307.5.peg.2423","1584"
"20476",609,206,403,"TCTAAATCTCGATATCCTGT","CATTTAAGTGCATCATTGCA","561307.5.peg.2423","1584"
"20477",684,206,478,"AACGCAGTCTTACCTACAGA","CATTTAAGTGCATCATTGCA","561307.5.peg.2423","1584"
"20478",339,206,133,"TACTGAACATTTCGCGTCGT","CATTTAAGTGCATCATTGCA","561307.5.peg.2423","1584"
"20479",81,339,258,"TGTTCAGCTTCATTGTTATG","TACTGAACATTTCGCGTCGT","561307.5.peg.2423","1584"
"20480",600,339,261,"CGATATCCTGTAGGTATACC","TACTGAACATTTCGCGTCGT","561307.5.peg.2423","1584"
"20481",671,339,332,"CTACAGATGGACGCGCTGCA","TACTGAACATTTCGCGTCGT","561307.5.peg.2423","1584"
"20482",206,339,133,"CATTTAAGTGCATCATTGCA","TACTGAACATTTCGCGTCGT","561307.5.peg.2423","1584"
"20483",26,339,313,"CACAGTTGAACAATAAAGT","TACTGAACATTTCGCGTCGT","561307.5.peg.2423","1584"
"20484",632,339,293,"GGTTGAACCCTGCTGTCATT","TACTGAACATTTCGCGTCGT","561307.5.peg.2423","1584"
"20485",684,339,345,"AACGCAGTCTTACCTACAGA","TACTGAACATTTCGCGTCGT","561307.5.peg.2423","1584"
"20486",609,339,270,"TCTAAATCTCGATATCCTGT","TACTGAACATTTCGCGTCGT","561307.5.peg.2423","1584"
"20487",45,339,294,"CATACATTCTATCCATGAA","TACTGAACATTTCGCGTCGT","561307.5.peg.2423","1584"
"20488",26,600,574,"CACAGTTGAACAATAAAGT","CGATATCCTGTAGGTATACC","561307.5.peg.2423","1584"
"20489",339,600,261,"TACTGAACATTTCGCGTCGT","CGATATCCTGTAGGTATACC","561307.5.peg.2423","1584"
"20490",81,600,519,"TGTTCAGCTTCATTGTTATG","CGATATCCTGTAGGTATACC","561307.5.peg.2423","1584"
"20491",206,600,394,"CATTTAAGTGCATCATTGCA","CGATATCCTGTAGGTATACC","561307.5.peg.2423","1584"
"20492",45,600,555,"CATACATTCTATCCATGAA","CGATATCCTGTAGGTATACC","561307.5.peg.2423","1584"
"20493",206,609,403,"CATTTAAGTGCATCATTGCA","TCTAAATCTCGATATCCTGT","561307.5.peg.2423","1584"
"20494",45,609,564,"CATACATTCTATCCATGAA","TCTAAATCTCGATATCCTGT","561307.5.peg.2423","1584"
"20495",81,609,528,"TGTTCAGCTTCATTGTTATG","TCTAAATCTCGATATCCTGT","561307.5.peg.2423","1584"
"20496",339,609,270,"TACTGAACATTTCGCGTCGT","TCTAAATCTCGATATCCTGT","561307.5.peg.2423","1584"
"20497",26,609,583,"CACAGTTGAACAATAAAGT","TCTAAATCTCGATATCCTGT","561307.5.peg.2423","1584"
"20498",206,632,426,"CATTTAAGTGCATCATTGCA","GGTTGAACCCTGCTGTCATT","561307.5.peg.2423","1584"
"20499",45,632,587,"CATACATTCTATCCATGAA","GGTTGAACCCTGCTGTCATT","561307.5.peg.2423","1584"
"20500",81,632,551,"TGTTCAGCTTCATTGTTATG","GGTTGAACCCTGCTGTCATT","561307.5.peg.2423","1584"
"20501",26,632,606,"CACAGTTGAACAATAAAGT","GGTTGAACCCTGCTGTCATT","561307.5.peg.2423","1584"
"20502",339,632,293,"TACTGAACATTTCGCGTCGT","GGTTGAACCCTGCTGTCATT","561307.5.peg.2423","1584"
"20503",26,671,645,"CACAGTTGAACAATAAAGT","CTACAGATGGACGCGCTGCA","561307.5.peg.2423","1584"
"20504",339,671,332,"TACTGAACATTTCGCGTCGT","CTACAGATGGACGCGCTGCA","561307.5.peg.2423","1584"
"20505",81,671,590,"TGTTCAGCTTCATTGTTATG","CTACAGATGGACGCGCTGCA","561307.5.peg.2423","1584"
"20506",206,671,465,"CATTTAAGTGCATCATTGCA","CTACAGATGGACGCGCTGCA","561307.5.peg.2423","1584"
"20507",45,671,626,"CATACATTCTATCCATGAA","CTACAGATGGACGCGCTGCA","561307.5.peg.2423","1584"
"20508",339,684,345,"TACTGAACATTTCGCGTCGT","AACGCAGTCTTACCTACAGA","561307.5.peg.2423","1584"
"20509",81,684,603,"TGTTCAGCTTCATTGTTATG","AACGCAGTCTTACCTACAGA","561307.5.peg.2423","1584"
"20510",206,684,478,"CATTTAAGTGCATCATTGCA","AACGCAGTCTTACCTACAGA","561307.5.peg.2423","1584"
"20511",45,684,639,"CATACATTCTATCCATGAA","AACGCAGTCTTACCTACAGA","561307.5.peg.2423","1584"
"20512",26,684,658,"CACAGTTGAACAATAAAGT","AACGCAGTCTTACCTACAGA","561307.5.peg.2423","1584"
"20513",276,170,106,"ATTCTTTCAATAGTGCAAC","CTCCGCCAAATTGAATGGTA","561307.5.peg.2424","1585"
"20514",369,170,199,"TCATCTTGTGCTAAGTGATA","CTCCGCCAAATTGAATGGTA","561307.5.peg.2424","1585"
"20515",450,170,280,"TGAACTTTGTCTACATATGC","CTCCGCCAAATTGAATGGTA","561307.5.peg.2424","1585"
"20516",170,276,106,"CTCCGCCAAATTGAATGGTA","ATTCTTTCAATAGTGCAAC","561307.5.peg.2424","1585"
"20517",450,276,174,"TGAACTTTGTCTACATATGC","ATTCTTTCAATAGTGCAAC","561307.5.peg.2424","1585"
"20518",170,369,199,"CTCCGCCAAATTGAATGGTA","TCATCTTGTGCTAAGTGATA","561307.5.peg.2424","1585"
"20519",170,450,280,"CTCCGCCAAATTGAATGGTA","TGAACTTTGTCTACATATGC","561307.5.peg.2424","1585"
"20520",276,450,174,"ATTCTTTCAATAGTGCAAC","TGAACTTTGTCTACATATGC","561307.5.peg.2424","1585"
"20521",363,225,138,"ATTAATTCACGCGTACTAAA","ACTTCCATACCATCACGACC","561307.5.peg.2425","1586"
"20522",225,363,138,"ACTTCCATACCATCACGACC","ATTAATTCACGCGTACTAAA","561307.5.peg.2425","1586"
"20523",600,226,374,"TGGTTACGCATATCGGTGAT","TTCTCCAATTTCTTGACGGT","561307.5.peg.2426","1587"
"20524",566,226,340,"TTCGCGCTATAAAGAATCCT","TTCTCCAATTTCTTGACGGT","561307.5.peg.2426","1587"
"20525",815,226,589,"CGATACGAATACGTCCACGG","TTCTCCAATTTCTTGACGGT","561307.5.peg.2426","1587"
"20526",607,226,381,"GACCGTCTGGTTACGCATAT","TTCTCCAATTTCTTGACGGT","561307.5.peg.2426","1587"
"20527",410,226,184,"GGATATTATATACCCAGACA","TTCTCCAATTTCTTGACGGT","561307.5.peg.2426","1587"
"20528",595,226,369,"ACGCATATCGGTGATTGGTT","TTCTCCAATTTCTTGACGGT","561307.5.peg.2426","1587"
"20529",620,226,394,"CTCTGGACATTTCGACCGTC","TTCTCCAATTTCTTGACGGT","561307.5.peg.2426","1587"
"20530",784,226,558,"ATAATACCATCACTCATAT","TTCTCCAATTTCTTGACGGT","561307.5.peg.2426","1587"
"20531",818,226,592,"TGACGATACGAATACGTCCA","TTCTCCAATTTCTTGACGGT","561307.5.peg.2426","1587"
"20532",637,226,411,"ACGTTGCGTATAGTTACCTC","TTCTCCAATTTCTTGACGGT","561307.5.peg.2426","1587"
"20533",595,410,185,"ACGCATATCGGTGATTGGTT","GGATATTATATACCCAGACA","561307.5.peg.2426","1587"
"20534",566,410,156,"TTCGCGCTATAAAGAATCCT","GGATATTATATACCCAGACA","561307.5.peg.2426","1587"
"20535",600,410,190,"TGGTTACGCATATCGGTGAT","GGATATTATATACCCAGACA","561307.5.peg.2426","1587"
"20536",226,410,184,"TTCTCCAATTTCTTGACGGT","GGATATTATATACCCAGACA","561307.5.peg.2426","1587"
"20537",607,410,197,"GACCGTCTGGTTACGCATAT","GGATATTATATACCCAGACA","561307.5.peg.2426","1587"
"20538",815,410,405,"CGATACGAATACGTCCACGG","GGATATTATATACCCAGACA","561307.5.peg.2426","1587"
"20539",784,410,374,"ATAATACCATCACTCATAT","GGATATTATATACCCAGACA","561307.5.peg.2426","1587"
"20540",620,410,210,"CTCTGGACATTTCGACCGTC","GGATATTATATACCCAGACA","561307.5.peg.2426","1587"
"20541",637,410,227,"ACGTTGCGTATAGTTACCTC","GGATATTATATACCCAGACA","561307.5.peg.2426","1587"
"20542",818,410,408,"TGACGATACGAATACGTCCA","GGATATTATATACCCAGACA","561307.5.peg.2426","1587"
"20543",784,566,218,"ATAATACCATCACTCATAT","TTCGCGCTATAAAGAATCCT","561307.5.peg.2426","1587"
"20544",410,566,156,"GGATATTATATACCCAGACA","TTCGCGCTATAAAGAATCCT","561307.5.peg.2426","1587"
"20545",818,566,252,"TGACGATACGAATACGTCCA","TTCGCGCTATAAAGAATCCT","561307.5.peg.2426","1587"
"20546",815,566,249,"CGATACGAATACGTCCACGG","TTCGCGCTATAAAGAATCCT","561307.5.peg.2426","1587"
"20547",226,566,340,"TTCTCCAATTTCTTGACGGT","TTCGCGCTATAAAGAATCCT","561307.5.peg.2426","1587"
"20548",815,595,220,"CGATACGAATACGTCCACGG","ACGCATATCGGTGATTGGTT","561307.5.peg.2426","1587"
"20549",784,595,189,"ATAATACCATCACTCATAT","ACGCATATCGGTGATTGGTT","561307.5.peg.2426","1587"
"20550",226,595,369,"TTCTCCAATTTCTTGACGGT","ACGCATATCGGTGATTGGTT","561307.5.peg.2426","1587"
"20551",818,595,223,"TGACGATACGAATACGTCCA","ACGCATATCGGTGATTGGTT","561307.5.peg.2426","1587"
"20552",410,595,185,"GGATATTATATACCCAGACA","ACGCATATCGGTGATTGGTT","561307.5.peg.2426","1587"
"20553",784,600,184,"ATAATACCATCACTCATAT","TGGTTACGCATATCGGTGAT","561307.5.peg.2426","1587"
"20554",815,600,215,"CGATACGAATACGTCCACGG","TGGTTACGCATATCGGTGAT","561307.5.peg.2426","1587"
"20555",410,600,190,"GGATATTATATACCCAGACA","TGGTTACGCATATCGGTGAT","561307.5.peg.2426","1587"
"20556",818,600,218,"TGACGATACGAATACGTCCA","TGGTTACGCATATCGGTGAT","561307.5.peg.2426","1587"
"20557",226,600,374,"TTCTCCAATTTCTTGACGGT","TGGTTACGCATATCGGTGAT","561307.5.peg.2426","1587"
"20558",410,607,197,"GGATATTATATACCCAGACA","GACCGTCTGGTTACGCATAT","561307.5.peg.2426","1587"
"20559",226,607,381,"TTCTCCAATTTCTTGACGGT","GACCGTCTGGTTACGCATAT","561307.5.peg.2426","1587"
"20560",815,607,208,"CGATACGAATACGTCCACGG","GACCGTCTGGTTACGCATAT","561307.5.peg.2426","1587"
"20561",818,607,211,"TGACGATACGAATACGTCCA","GACCGTCTGGTTACGCATAT","561307.5.peg.2426","1587"
"20562",784,607,177,"ATAATACCATCACTCATAT","GACCGTCTGGTTACGCATAT","561307.5.peg.2426","1587"
"20563",226,620,394,"TTCTCCAATTTCTTGACGGT","CTCTGGACATTTCGACCGTC","561307.5.peg.2426","1587"
"20564",784,620,164,"ATAATACCATCACTCATAT","CTCTGGACATTTCGACCGTC","561307.5.peg.2426","1587"
"20565",818,620,198,"TGACGATACGAATACGTCCA","CTCTGGACATTTCGACCGTC","561307.5.peg.2426","1587"
"20566",410,620,210,"GGATATTATATACCCAGACA","CTCTGGACATTTCGACCGTC","561307.5.peg.2426","1587"
"20567",815,620,195,"CGATACGAATACGTCCACGG","CTCTGGACATTTCGACCGTC","561307.5.peg.2426","1587"
"20568",226,637,411,"TTCTCCAATTTCTTGACGGT","ACGTTGCGTATAGTTACCTC","561307.5.peg.2426","1587"
"20569",784,637,147,"ATAATACCATCACTCATAT","ACGTTGCGTATAGTTACCTC","561307.5.peg.2426","1587"
"20570",818,637,181,"TGACGATACGAATACGTCCA","ACGTTGCGTATAGTTACCTC","561307.5.peg.2426","1587"
"20571",815,637,178,"CGATACGAATACGTCCACGG","ACGTTGCGTATAGTTACCTC","561307.5.peg.2426","1587"
"20572",410,637,227,"GGATATTATATACCCAGACA","ACGTTGCGTATAGTTACCTC","561307.5.peg.2426","1587"
"20573",410,784,374,"GGATATTATATACCCAGACA","ATAATACCATCACTCATAT","561307.5.peg.2426","1587"
"20574",226,784,558,"TTCTCCAATTTCTTGACGGT","ATAATACCATCACTCATAT","561307.5.peg.2426","1587"
"20575",566,784,218,"TTCGCGCTATAAAGAATCCT","ATAATACCATCACTCATAT","561307.5.peg.2426","1587"
"20576",607,784,177,"GACCGTCTGGTTACGCATAT","ATAATACCATCACTCATAT","561307.5.peg.2426","1587"
"20577",637,784,147,"ACGTTGCGTATAGTTACCTC","ATAATACCATCACTCATAT","561307.5.peg.2426","1587"
"20578",595,784,189,"ACGCATATCGGTGATTGGTT","ATAATACCATCACTCATAT","561307.5.peg.2426","1587"
"20579",600,784,184,"TGGTTACGCATATCGGTGAT","ATAATACCATCACTCATAT","561307.5.peg.2426","1587"
"20580",620,784,164,"CTCTGGACATTTCGACCGTC","ATAATACCATCACTCATAT","561307.5.peg.2426","1587"
"20581",620,815,195,"CTCTGGACATTTCGACCGTC","CGATACGAATACGTCCACGG","561307.5.peg.2426","1587"
"20582",410,815,405,"GGATATTATATACCCAGACA","CGATACGAATACGTCCACGG","561307.5.peg.2426","1587"
"20583",226,815,589,"TTCTCCAATTTCTTGACGGT","CGATACGAATACGTCCACGG","561307.5.peg.2426","1587"
"20584",607,815,208,"GACCGTCTGGTTACGCATAT","CGATACGAATACGTCCACGG","561307.5.peg.2426","1587"
"20585",566,815,249,"TTCGCGCTATAAAGAATCCT","CGATACGAATACGTCCACGG","561307.5.peg.2426","1587"
"20586",637,815,178,"ACGTTGCGTATAGTTACCTC","CGATACGAATACGTCCACGG","561307.5.peg.2426","1587"
"20587",595,815,220,"ACGCATATCGGTGATTGGTT","CGATACGAATACGTCCACGG","561307.5.peg.2426","1587"
"20588",600,815,215,"TGGTTACGCATATCGGTGAT","CGATACGAATACGTCCACGG","561307.5.peg.2426","1587"
"20589",566,818,252,"TTCGCGCTATAAAGAATCCT","TGACGATACGAATACGTCCA","561307.5.peg.2426","1587"
"20590",226,818,592,"TTCTCCAATTTCTTGACGGT","TGACGATACGAATACGTCCA","561307.5.peg.2426","1587"
"20591",595,818,223,"ACGCATATCGGTGATTGGTT","TGACGATACGAATACGTCCA","561307.5.peg.2426","1587"
"20592",607,818,211,"GACCGTCTGGTTACGCATAT","TGACGATACGAATACGTCCA","561307.5.peg.2426","1587"
"20593",620,818,198,"CTCTGGACATTTCGACCGTC","TGACGATACGAATACGTCCA","561307.5.peg.2426","1587"
"20594",600,818,218,"TGGTTACGCATATCGGTGAT","TGACGATACGAATACGTCCA","561307.5.peg.2426","1587"
"20595",637,818,181,"ACGTTGCGTATAGTTACCTC","TGACGATACGAATACGTCCA","561307.5.peg.2426","1587"
"20596",410,818,408,"GGATATTATATACCCAGACA","TGACGATACGAATACGTCCA","561307.5.peg.2426","1587"
"20597",343,1,342,"ATCACGACGAACATGTTCCA","AGTCATTGAAGACGGTGATT","561307.5.peg.2427","1588"
"20598",270,1,269,"ACCGTCGCAATCGTTCCTTC","AGTCATTGAAGACGGTGATT","561307.5.peg.2427","1588"
"20599",642,1,641,"TTGTGATGATATCTGTGTA","AGTCATTGAAGACGGTGATT","561307.5.peg.2427","1588"
"20600",429,1,428,"TGACCAAGATATGTTGATAA","AGTCATTGAAGACGGTGATT","561307.5.peg.2427","1588"
"20601",1,270,269,"AGTCATTGAAGACGGTGATT","ACCGTCGCAATCGTTCCTTC","561307.5.peg.2427","1588"
"20602",429,270,159,"TGACCAAGATATGTTGATAA","ACCGTCGCAATCGTTCCTTC","561307.5.peg.2427","1588"
"20603",642,270,372,"TTGTGATGATATCTGTGTA","ACCGTCGCAATCGTTCCTTC","561307.5.peg.2427","1588"
"20604",1,343,342,"AGTCATTGAAGACGGTGATT","ATCACGACGAACATGTTCCA","561307.5.peg.2427","1588"
"20605",642,343,299,"TTGTGATGATATCTGTGTA","ATCACGACGAACATGTTCCA","561307.5.peg.2427","1588"
"20606",1,429,428,"AGTCATTGAAGACGGTGATT","TGACCAAGATATGTTGATAA","561307.5.peg.2427","1588"
"20607",270,429,159,"ACCGTCGCAATCGTTCCTTC","TGACCAAGATATGTTGATAA","561307.5.peg.2427","1588"
"20608",642,429,213,"TTGTGATGATATCTGTGTA","TGACCAAGATATGTTGATAA","561307.5.peg.2427","1588"
"20609",1,642,641,"AGTCATTGAAGACGGTGATT","TTGTGATGATATCTGTGTA","561307.5.peg.2427","1588"
"20610",343,642,299,"ATCACGACGAACATGTTCCA","TTGTGATGATATCTGTGTA","561307.5.peg.2427","1588"
"20611",270,642,372,"ACCGTCGCAATCGTTCCTTC","TTGTGATGATATCTGTGTA","561307.5.peg.2427","1588"
"20612",429,642,213,"TGACCAAGATATGTTGATAA","TTGTGATGATATCTGTGTA","561307.5.peg.2427","1588"
"20613",323,38,285,"AATGAATTTCTGATCCATA","ATACACTCATGCGTATCAAG","561307.5.peg.2429","1590"
"20614",38,323,285,"ATACACTCATGCGTATCAAG","AATGAATTTCTGATCCATA","561307.5.peg.2429","1590"
"20615",1023,7,1016,"CGCCATGTTTCTTGTGTTGA","GGTGTATGACAGTTAATGGA","561307.5.peg.2430","1592"
"20616",253,7,246,"CTGCGCTGATGCTGATACGT","GGTGTATGACAGTTAATGGA","561307.5.peg.2430","1592"
"20617",625,7,618,"TGAAAGTGGTAAACCTTGGA","GGTGTATGACAGTTAATGGA","561307.5.peg.2430","1592"
"20618",521,7,514,"TTTCTTCGGCTAGTCGGCCA","GGTGTATGACAGTTAATGGA","561307.5.peg.2430","1592"
"20619",402,7,395,"TTGAACGTTGCTGTGTGAGT","GGTGTATGACAGTTAATGGA","561307.5.peg.2430","1592"
"20620",906,7,899,"TCAACGCCTTTAATGCCTTC","GGTGTATGACAGTTAATGGA","561307.5.peg.2430","1592"
"20621",147,7,140,"GTTACTGCATGTGCTTTCAT","GGTGTATGACAGTTAATGGA","561307.5.peg.2430","1592"
"20622",650,7,643,"CCATTTCTTCACCTTTAGAC","GGTGTATGACAGTTAATGGA","561307.5.peg.2430","1592"
"20623",776,7,769,"AAACGTTAGTACTTAGCATC","GGTGTATGACAGTTAATGGA","561307.5.peg.2430","1592"
"20624",629,7,622,"GGTTTGAAAGTGGTAAACCT","GGTGTATGACAGTTAATGGA","561307.5.peg.2430","1592"
"20625",719,7,712,"CGTATCCAAAGTCAAATTCA","GGTGTATGACAGTTAATGGA","561307.5.peg.2430","1592"
"20626",310,7,303,"TGGTTTGTTAGATGGTGCGT","GGTGTATGACAGTTAATGGA","561307.5.peg.2430","1592"
"20627",210,7,203,"TGATGAGCCGCTTCCTTTGT","GGTGTATGACAGTTAATGGA","561307.5.peg.2430","1592"
"20628",939,7,932,"TCCGCTGTCACACTTTGTAA","GGTGTATGACAGTTAATGGA","561307.5.peg.2430","1592"
"20629",639,7,632,"CCTTTAGACTGGTTTGAAAG","GGTGTATGACAGTTAATGGA","561307.5.peg.2430","1592"
"20630",456,7,449,"GCATTAGCAGCAAACATTCG","GGTGTATGACAGTTAATGGA","561307.5.peg.2430","1592"
"20631",207,7,200,"TGAGCCGCTTCCTTTGTTGG","GGTGTATGACAGTTAATGGA","561307.5.peg.2430","1592"
"20632",521,11,510,"TTTCTTCGGCTAGTCGGCCA","ATTGGTGTATGACAGTTAA","561307.5.peg.2430","1592"
"20633",719,11,708,"CGTATCCAAAGTCAAATTCA","ATTGGTGTATGACAGTTAA","561307.5.peg.2430","1592"
"20634",456,11,445,"GCATTAGCAGCAAACATTCG","ATTGGTGTATGACAGTTAA","561307.5.peg.2430","1592"
"20635",310,11,299,"TGGTTTGTTAGATGGTGCGT","ATTGGTGTATGACAGTTAA","561307.5.peg.2430","1592"
"20636",207,11,196,"TGAGCCGCTTCCTTTGTTGG","ATTGGTGTATGACAGTTAA","561307.5.peg.2430","1592"
"20637",939,11,928,"TCCGCTGTCACACTTTGTAA","ATTGGTGTATGACAGTTAA","561307.5.peg.2430","1592"
"20638",629,11,618,"GGTTTGAAAGTGGTAAACCT","ATTGGTGTATGACAGTTAA","561307.5.peg.2430","1592"
"20639",776,11,765,"AAACGTTAGTACTTAGCATC","ATTGGTGTATGACAGTTAA","561307.5.peg.2430","1592"
"20640",906,11,895,"TCAACGCCTTTAATGCCTTC","ATTGGTGTATGACAGTTAA","561307.5.peg.2430","1592"
"20641",210,11,199,"TGATGAGCCGCTTCCTTTGT","ATTGGTGTATGACAGTTAA","561307.5.peg.2430","1592"
"20642",639,11,628,"CCTTTAGACTGGTTTGAAAG","ATTGGTGTATGACAGTTAA","561307.5.peg.2430","1592"
"20643",1023,11,1012,"CGCCATGTTTCTTGTGTTGA","ATTGGTGTATGACAGTTAA","561307.5.peg.2430","1592"
"20644",625,11,614,"TGAAAGTGGTAAACCTTGGA","ATTGGTGTATGACAGTTAA","561307.5.peg.2430","1592"
"20645",253,11,242,"CTGCGCTGATGCTGATACGT","ATTGGTGTATGACAGTTAA","561307.5.peg.2430","1592"
"20646",147,11,136,"GTTACTGCATGTGCTTTCAT","ATTGGTGTATGACAGTTAA","561307.5.peg.2430","1592"
"20647",402,11,391,"TTGAACGTTGCTGTGTGAGT","ATTGGTGTATGACAGTTAA","561307.5.peg.2430","1592"
"20648",650,11,639,"CCATTTCTTCACCTTTAGAC","ATTGGTGTATGACAGTTAA","561307.5.peg.2430","1592"
"20649",456,147,309,"GCATTAGCAGCAAACATTCG","GTTACTGCATGTGCTTTCAT","561307.5.peg.2430","1592"
"20650",906,147,759,"TCAACGCCTTTAATGCCTTC","GTTACTGCATGTGCTTTCAT","561307.5.peg.2430","1592"
"20651",639,147,492,"CCTTTAGACTGGTTTGAAAG","GTTACTGCATGTGCTTTCAT","561307.5.peg.2430","1592"
"20652",629,147,482,"GGTTTGAAAGTGGTAAACCT","GTTACTGCATGTGCTTTCAT","561307.5.peg.2430","1592"
"20653",776,147,629,"AAACGTTAGTACTTAGCATC","GTTACTGCATGTGCTTTCAT","561307.5.peg.2430","1592"
"20654",310,147,163,"TGGTTTGTTAGATGGTGCGT","GTTACTGCATGTGCTTTCAT","561307.5.peg.2430","1592"
"20655",625,147,478,"TGAAAGTGGTAAACCTTGGA","GTTACTGCATGTGCTTTCAT","561307.5.peg.2430","1592"
"20656",402,147,255,"TTGAACGTTGCTGTGTGAGT","GTTACTGCATGTGCTTTCAT","561307.5.peg.2430","1592"
"20657",7,147,140,"GGTGTATGACAGTTAATGGA","GTTACTGCATGTGCTTTCAT","561307.5.peg.2430","1592"
"20658",650,147,503,"CCATTTCTTCACCTTTAGAC","GTTACTGCATGTGCTTTCAT","561307.5.peg.2430","1592"
"20659",253,147,106,"CTGCGCTGATGCTGATACGT","GTTACTGCATGTGCTTTCAT","561307.5.peg.2430","1592"
"20660",11,147,136,"ATTGGTGTATGACAGTTAA","GTTACTGCATGTGCTTTCAT","561307.5.peg.2430","1592"
"20661",939,147,792,"TCCGCTGTCACACTTTGTAA","GTTACTGCATGTGCTTTCAT","561307.5.peg.2430","1592"
"20662",719,147,572,"CGTATCCAAAGTCAAATTCA","GTTACTGCATGTGCTTTCAT","561307.5.peg.2430","1592"
"20663",1023,147,876,"CGCCATGTTTCTTGTGTTGA","GTTACTGCATGTGCTTTCAT","561307.5.peg.2430","1592"
"20664",521,147,374,"TTTCTTCGGCTAGTCGGCCA","GTTACTGCATGTGCTTTCAT","561307.5.peg.2430","1592"
"20665",402,207,195,"TTGAACGTTGCTGTGTGAGT","TGAGCCGCTTCCTTTGTTGG","561307.5.peg.2430","1592"
"20666",7,207,200,"GGTGTATGACAGTTAATGGA","TGAGCCGCTTCCTTTGTTGG","561307.5.peg.2430","1592"
"20667",521,207,314,"TTTCTTCGGCTAGTCGGCCA","TGAGCCGCTTCCTTTGTTGG","561307.5.peg.2430","1592"
"20668",456,207,249,"GCATTAGCAGCAAACATTCG","TGAGCCGCTTCCTTTGTTGG","561307.5.peg.2430","1592"
"20669",625,207,418,"TGAAAGTGGTAAACCTTGGA","TGAGCCGCTTCCTTTGTTGG","561307.5.peg.2430","1592"
"20670",310,207,103,"TGGTTTGTTAGATGGTGCGT","TGAGCCGCTTCCTTTGTTGG","561307.5.peg.2430","1592"
"20671",629,207,422,"GGTTTGAAAGTGGTAAACCT","TGAGCCGCTTCCTTTGTTGG","561307.5.peg.2430","1592"
"20672",639,207,432,"CCTTTAGACTGGTTTGAAAG","TGAGCCGCTTCCTTTGTTGG","561307.5.peg.2430","1592"
"20673",906,207,699,"TCAACGCCTTTAATGCCTTC","TGAGCCGCTTCCTTTGTTGG","561307.5.peg.2430","1592"
"20674",776,207,569,"AAACGTTAGTACTTAGCATC","TGAGCCGCTTCCTTTGTTGG","561307.5.peg.2430","1592"
"20675",650,207,443,"CCATTTCTTCACCTTTAGAC","TGAGCCGCTTCCTTTGTTGG","561307.5.peg.2430","1592"
"20676",11,207,196,"ATTGGTGTATGACAGTTAA","TGAGCCGCTTCCTTTGTTGG","561307.5.peg.2430","1592"
"20677",1023,207,816,"CGCCATGTTTCTTGTGTTGA","TGAGCCGCTTCCTTTGTTGG","561307.5.peg.2430","1592"
"20678",939,207,732,"TCCGCTGTCACACTTTGTAA","TGAGCCGCTTCCTTTGTTGG","561307.5.peg.2430","1592"
"20679",719,207,512,"CGTATCCAAAGTCAAATTCA","TGAGCCGCTTCCTTTGTTGG","561307.5.peg.2430","1592"
"20680",402,210,192,"TTGAACGTTGCTGTGTGAGT","TGATGAGCCGCTTCCTTTGT","561307.5.peg.2430","1592"
"20681",310,210,100,"TGGTTTGTTAGATGGTGCGT","TGATGAGCCGCTTCCTTTGT","561307.5.peg.2430","1592"
"20682",7,210,203,"GGTGTATGACAGTTAATGGA","TGATGAGCCGCTTCCTTTGT","561307.5.peg.2430","1592"
"20683",939,210,729,"TCCGCTGTCACACTTTGTAA","TGATGAGCCGCTTCCTTTGT","561307.5.peg.2430","1592"
"20684",11,210,199,"ATTGGTGTATGACAGTTAA","TGATGAGCCGCTTCCTTTGT","561307.5.peg.2430","1592"
"20685",776,210,566,"AAACGTTAGTACTTAGCATC","TGATGAGCCGCTTCCTTTGT","561307.5.peg.2430","1592"
"20686",639,210,429,"CCTTTAGACTGGTTTGAAAG","TGATGAGCCGCTTCCTTTGT","561307.5.peg.2430","1592"
"20687",906,210,696,"TCAACGCCTTTAATGCCTTC","TGATGAGCCGCTTCCTTTGT","561307.5.peg.2430","1592"
"20688",1023,210,813,"CGCCATGTTTCTTGTGTTGA","TGATGAGCCGCTTCCTTTGT","561307.5.peg.2430","1592"
"20689",650,210,440,"CCATTTCTTCACCTTTAGAC","TGATGAGCCGCTTCCTTTGT","561307.5.peg.2430","1592"
"20690",625,210,415,"TGAAAGTGGTAAACCTTGGA","TGATGAGCCGCTTCCTTTGT","561307.5.peg.2430","1592"
"20691",456,210,246,"GCATTAGCAGCAAACATTCG","TGATGAGCCGCTTCCTTTGT","561307.5.peg.2430","1592"
"20692",719,210,509,"CGTATCCAAAGTCAAATTCA","TGATGAGCCGCTTCCTTTGT","561307.5.peg.2430","1592"
"20693",521,210,311,"TTTCTTCGGCTAGTCGGCCA","TGATGAGCCGCTTCCTTTGT","561307.5.peg.2430","1592"
"20694",629,210,419,"GGTTTGAAAGTGGTAAACCT","TGATGAGCCGCTTCCTTTGT","561307.5.peg.2430","1592"
"20695",402,253,149,"TTGAACGTTGCTGTGTGAGT","CTGCGCTGATGCTGATACGT","561307.5.peg.2430","1592"
"20696",11,253,242,"ATTGGTGTATGACAGTTAA","CTGCGCTGATGCTGATACGT","561307.5.peg.2430","1592"
"20697",719,253,466,"CGTATCCAAAGTCAAATTCA","CTGCGCTGATGCTGATACGT","561307.5.peg.2430","1592"
"20698",639,253,386,"CCTTTAGACTGGTTTGAAAG","CTGCGCTGATGCTGATACGT","561307.5.peg.2430","1592"
"20699",7,253,246,"GGTGTATGACAGTTAATGGA","CTGCGCTGATGCTGATACGT","561307.5.peg.2430","1592"
"20700",939,253,686,"TCCGCTGTCACACTTTGTAA","CTGCGCTGATGCTGATACGT","561307.5.peg.2430","1592"
"20701",650,253,397,"CCATTTCTTCACCTTTAGAC","CTGCGCTGATGCTGATACGT","561307.5.peg.2430","1592"
"20702",776,253,523,"AAACGTTAGTACTTAGCATC","CTGCGCTGATGCTGATACGT","561307.5.peg.2430","1592"
"20703",906,253,653,"TCAACGCCTTTAATGCCTTC","CTGCGCTGATGCTGATACGT","561307.5.peg.2430","1592"
"20704",629,253,376,"GGTTTGAAAGTGGTAAACCT","CTGCGCTGATGCTGATACGT","561307.5.peg.2430","1592"
"20705",147,253,106,"GTTACTGCATGTGCTTTCAT","CTGCGCTGATGCTGATACGT","561307.5.peg.2430","1592"
"20706",456,253,203,"GCATTAGCAGCAAACATTCG","CTGCGCTGATGCTGATACGT","561307.5.peg.2430","1592"
"20707",521,253,268,"TTTCTTCGGCTAGTCGGCCA","CTGCGCTGATGCTGATACGT","561307.5.peg.2430","1592"
"20708",1023,253,770,"CGCCATGTTTCTTGTGTTGA","CTGCGCTGATGCTGATACGT","561307.5.peg.2430","1592"
"20709",625,253,372,"TGAAAGTGGTAAACCTTGGA","CTGCGCTGATGCTGATACGT","561307.5.peg.2430","1592"
"20710",625,310,315,"TGAAAGTGGTAAACCTTGGA","TGGTTTGTTAGATGGTGCGT","561307.5.peg.2430","1592"
"20711",1023,310,713,"CGCCATGTTTCTTGTGTTGA","TGGTTTGTTAGATGGTGCGT","561307.5.peg.2430","1592"
"20712",7,310,303,"GGTGTATGACAGTTAATGGA","TGGTTTGTTAGATGGTGCGT","561307.5.peg.2430","1592"
"20713",939,310,629,"TCCGCTGTCACACTTTGTAA","TGGTTTGTTAGATGGTGCGT","561307.5.peg.2430","1592"
"20714",906,310,596,"TCAACGCCTTTAATGCCTTC","TGGTTTGTTAGATGGTGCGT","561307.5.peg.2430","1592"
"20715",719,310,409,"CGTATCCAAAGTCAAATTCA","TGGTTTGTTAGATGGTGCGT","561307.5.peg.2430","1592"
"20716",11,310,299,"ATTGGTGTATGACAGTTAA","TGGTTTGTTAGATGGTGCGT","561307.5.peg.2430","1592"
"20717",639,310,329,"CCTTTAGACTGGTTTGAAAG","TGGTTTGTTAGATGGTGCGT","561307.5.peg.2430","1592"
"20718",456,310,146,"GCATTAGCAGCAAACATTCG","TGGTTTGTTAGATGGTGCGT","561307.5.peg.2430","1592"
"20719",147,310,163,"GTTACTGCATGTGCTTTCAT","TGGTTTGTTAGATGGTGCGT","561307.5.peg.2430","1592"
"20720",650,310,340,"CCATTTCTTCACCTTTAGAC","TGGTTTGTTAGATGGTGCGT","561307.5.peg.2430","1592"
"20721",207,310,103,"TGAGCCGCTTCCTTTGTTGG","TGGTTTGTTAGATGGTGCGT","561307.5.peg.2430","1592"
"20722",210,310,100,"TGATGAGCCGCTTCCTTTGT","TGGTTTGTTAGATGGTGCGT","561307.5.peg.2430","1592"
"20723",629,310,319,"GGTTTGAAAGTGGTAAACCT","TGGTTTGTTAGATGGTGCGT","561307.5.peg.2430","1592"
"20724",776,310,466,"AAACGTTAGTACTTAGCATC","TGGTTTGTTAGATGGTGCGT","561307.5.peg.2430","1592"
"20725",521,310,211,"TTTCTTCGGCTAGTCGGCCA","TGGTTTGTTAGATGGTGCGT","561307.5.peg.2430","1592"
"20726",521,402,119,"TTTCTTCGGCTAGTCGGCCA","TTGAACGTTGCTGTGTGAGT","561307.5.peg.2430","1592"
"20727",7,402,395,"GGTGTATGACAGTTAATGGA","TTGAACGTTGCTGTGTGAGT","561307.5.peg.2430","1592"
"20728",629,402,227,"GGTTTGAAAGTGGTAAACCT","TTGAACGTTGCTGTGTGAGT","561307.5.peg.2430","1592"
"20729",639,402,237,"CCTTTAGACTGGTTTGAAAG","TTGAACGTTGCTGTGTGAGT","561307.5.peg.2430","1592"
"20730",906,402,504,"TCAACGCCTTTAATGCCTTC","TTGAACGTTGCTGTGTGAGT","561307.5.peg.2430","1592"
"20731",650,402,248,"CCATTTCTTCACCTTTAGAC","TTGAACGTTGCTGTGTGAGT","561307.5.peg.2430","1592"
"20732",625,402,223,"TGAAAGTGGTAAACCTTGGA","TTGAACGTTGCTGTGTGAGT","561307.5.peg.2430","1592"
"20733",939,402,537,"TCCGCTGTCACACTTTGTAA","TTGAACGTTGCTGTGTGAGT","561307.5.peg.2430","1592"
"20734",207,402,195,"TGAGCCGCTTCCTTTGTTGG","TTGAACGTTGCTGTGTGAGT","561307.5.peg.2430","1592"
"20735",776,402,374,"AAACGTTAGTACTTAGCATC","TTGAACGTTGCTGTGTGAGT","561307.5.peg.2430","1592"
"20736",1023,402,621,"CGCCATGTTTCTTGTGTTGA","TTGAACGTTGCTGTGTGAGT","561307.5.peg.2430","1592"
"20737",147,402,255,"GTTACTGCATGTGCTTTCAT","TTGAACGTTGCTGTGTGAGT","561307.5.peg.2430","1592"
"20738",11,402,391,"ATTGGTGTATGACAGTTAA","TTGAACGTTGCTGTGTGAGT","561307.5.peg.2430","1592"
"20739",210,402,192,"TGATGAGCCGCTTCCTTTGT","TTGAACGTTGCTGTGTGAGT","561307.5.peg.2430","1592"
"20740",253,402,149,"CTGCGCTGATGCTGATACGT","TTGAACGTTGCTGTGTGAGT","561307.5.peg.2430","1592"
"20741",719,402,317,"CGTATCCAAAGTCAAATTCA","TTGAACGTTGCTGTGTGAGT","561307.5.peg.2430","1592"
"20742",639,456,183,"CCTTTAGACTGGTTTGAAAG","GCATTAGCAGCAAACATTCG","561307.5.peg.2430","1592"
"20743",906,456,450,"TCAACGCCTTTAATGCCTTC","GCATTAGCAGCAAACATTCG","561307.5.peg.2430","1592"
"20744",939,456,483,"TCCGCTGTCACACTTTGTAA","GCATTAGCAGCAAACATTCG","561307.5.peg.2430","1592"
"20745",253,456,203,"CTGCGCTGATGCTGATACGT","GCATTAGCAGCAAACATTCG","561307.5.peg.2430","1592"
"20746",776,456,320,"AAACGTTAGTACTTAGCATC","GCATTAGCAGCAAACATTCG","561307.5.peg.2430","1592"
"20747",1023,456,567,"CGCCATGTTTCTTGTGTTGA","GCATTAGCAGCAAACATTCG","561307.5.peg.2430","1592"
"20748",7,456,449,"GGTGTATGACAGTTAATGGA","GCATTAGCAGCAAACATTCG","561307.5.peg.2430","1592"
"20749",629,456,173,"GGTTTGAAAGTGGTAAACCT","GCATTAGCAGCAAACATTCG","561307.5.peg.2430","1592"
"20750",650,456,194,"CCATTTCTTCACCTTTAGAC","GCATTAGCAGCAAACATTCG","561307.5.peg.2430","1592"
"20751",147,456,309,"GTTACTGCATGTGCTTTCAT","GCATTAGCAGCAAACATTCG","561307.5.peg.2430","1592"
"20752",310,456,146,"TGGTTTGTTAGATGGTGCGT","GCATTAGCAGCAAACATTCG","561307.5.peg.2430","1592"
"20753",11,456,445,"ATTGGTGTATGACAGTTAA","GCATTAGCAGCAAACATTCG","561307.5.peg.2430","1592"
"20754",719,456,263,"CGTATCCAAAGTCAAATTCA","GCATTAGCAGCAAACATTCG","561307.5.peg.2430","1592"
"20755",207,456,249,"TGAGCCGCTTCCTTTGTTGG","GCATTAGCAGCAAACATTCG","561307.5.peg.2430","1592"
"20756",625,456,169,"TGAAAGTGGTAAACCTTGGA","GCATTAGCAGCAAACATTCG","561307.5.peg.2430","1592"
"20757",210,456,246,"TGATGAGCCGCTTCCTTTGT","GCATTAGCAGCAAACATTCG","561307.5.peg.2430","1592"
"20758",310,521,211,"TGGTTTGTTAGATGGTGCGT","TTTCTTCGGCTAGTCGGCCA","561307.5.peg.2430","1592"
"20759",776,521,255,"AAACGTTAGTACTTAGCATC","TTTCTTCGGCTAGTCGGCCA","561307.5.peg.2430","1592"
"20760",253,521,268,"CTGCGCTGATGCTGATACGT","TTTCTTCGGCTAGTCGGCCA","561307.5.peg.2430","1592"
"20761",210,521,311,"TGATGAGCCGCTTCCTTTGT","TTTCTTCGGCTAGTCGGCCA","561307.5.peg.2430","1592"
"20762",650,521,129,"CCATTTCTTCACCTTTAGAC","TTTCTTCGGCTAGTCGGCCA","561307.5.peg.2430","1592"
"20763",7,521,514,"GGTGTATGACAGTTAATGGA","TTTCTTCGGCTAGTCGGCCA","561307.5.peg.2430","1592"
"20764",906,521,385,"TCAACGCCTTTAATGCCTTC","TTTCTTCGGCTAGTCGGCCA","561307.5.peg.2430","1592"
"20765",629,521,108,"GGTTTGAAAGTGGTAAACCT","TTTCTTCGGCTAGTCGGCCA","561307.5.peg.2430","1592"
"20766",207,521,314,"TGAGCCGCTTCCTTTGTTGG","TTTCTTCGGCTAGTCGGCCA","561307.5.peg.2430","1592"
"20767",939,521,418,"TCCGCTGTCACACTTTGTAA","TTTCTTCGGCTAGTCGGCCA","561307.5.peg.2430","1592"
"20768",1023,521,502,"CGCCATGTTTCTTGTGTTGA","TTTCTTCGGCTAGTCGGCCA","561307.5.peg.2430","1592"
"20769",402,521,119,"TTGAACGTTGCTGTGTGAGT","TTTCTTCGGCTAGTCGGCCA","561307.5.peg.2430","1592"
"20770",147,521,374,"GTTACTGCATGTGCTTTCAT","TTTCTTCGGCTAGTCGGCCA","561307.5.peg.2430","1592"
"20771",719,521,198,"CGTATCCAAAGTCAAATTCA","TTTCTTCGGCTAGTCGGCCA","561307.5.peg.2430","1592"
"20772",11,521,510,"ATTGGTGTATGACAGTTAA","TTTCTTCGGCTAGTCGGCCA","561307.5.peg.2430","1592"
"20773",639,521,118,"CCTTTAGACTGGTTTGAAAG","TTTCTTCGGCTAGTCGGCCA","561307.5.peg.2430","1592"
"20774",625,521,104,"TGAAAGTGGTAAACCTTGGA","TTTCTTCGGCTAGTCGGCCA","561307.5.peg.2430","1592"
"20775",147,625,478,"GTTACTGCATGTGCTTTCAT","TGAAAGTGGTAAACCTTGGA","561307.5.peg.2430","1592"
"20776",521,625,104,"TTTCTTCGGCTAGTCGGCCA","TGAAAGTGGTAAACCTTGGA","561307.5.peg.2430","1592"
"20777",906,625,281,"TCAACGCCTTTAATGCCTTC","TGAAAGTGGTAAACCTTGGA","561307.5.peg.2430","1592"
"20778",776,625,151,"AAACGTTAGTACTTAGCATC","TGAAAGTGGTAAACCTTGGA","561307.5.peg.2430","1592"
"20779",939,625,314,"TCCGCTGTCACACTTTGTAA","TGAAAGTGGTAAACCTTGGA","561307.5.peg.2430","1592"
"20780",310,625,315,"TGGTTTGTTAGATGGTGCGT","TGAAAGTGGTAAACCTTGGA","561307.5.peg.2430","1592"
"20781",7,625,618,"GGTGTATGACAGTTAATGGA","TGAAAGTGGTAAACCTTGGA","561307.5.peg.2430","1592"
"20782",402,625,223,"TTGAACGTTGCTGTGTGAGT","TGAAAGTGGTAAACCTTGGA","561307.5.peg.2430","1592"
"20783",456,625,169,"GCATTAGCAGCAAACATTCG","TGAAAGTGGTAAACCTTGGA","561307.5.peg.2430","1592"
"20784",11,625,614,"ATTGGTGTATGACAGTTAA","TGAAAGTGGTAAACCTTGGA","561307.5.peg.2430","1592"
"20785",1023,625,398,"CGCCATGTTTCTTGTGTTGA","TGAAAGTGGTAAACCTTGGA","561307.5.peg.2430","1592"
"20786",207,625,418,"TGAGCCGCTTCCTTTGTTGG","TGAAAGTGGTAAACCTTGGA","561307.5.peg.2430","1592"
"20787",253,625,372,"CTGCGCTGATGCTGATACGT","TGAAAGTGGTAAACCTTGGA","561307.5.peg.2430","1592"
"20788",210,625,415,"TGATGAGCCGCTTCCTTTGT","TGAAAGTGGTAAACCTTGGA","561307.5.peg.2430","1592"
"20789",147,629,482,"GTTACTGCATGTGCTTTCAT","GGTTTGAAAGTGGTAAACCT","561307.5.peg.2430","1592"
"20790",253,629,376,"CTGCGCTGATGCTGATACGT","GGTTTGAAAGTGGTAAACCT","561307.5.peg.2430","1592"
"20791",1023,629,394,"CGCCATGTTTCTTGTGTTGA","GGTTTGAAAGTGGTAAACCT","561307.5.peg.2430","1592"
"20792",310,629,319,"TGGTTTGTTAGATGGTGCGT","GGTTTGAAAGTGGTAAACCT","561307.5.peg.2430","1592"
"20793",521,629,108,"TTTCTTCGGCTAGTCGGCCA","GGTTTGAAAGTGGTAAACCT","561307.5.peg.2430","1592"
"20794",7,629,622,"GGTGTATGACAGTTAATGGA","GGTTTGAAAGTGGTAAACCT","561307.5.peg.2430","1592"
"20795",210,629,419,"TGATGAGCCGCTTCCTTTGT","GGTTTGAAAGTGGTAAACCT","561307.5.peg.2430","1592"
"20796",456,629,173,"GCATTAGCAGCAAACATTCG","GGTTTGAAAGTGGTAAACCT","561307.5.peg.2430","1592"
"20797",11,629,618,"ATTGGTGTATGACAGTTAA","GGTTTGAAAGTGGTAAACCT","561307.5.peg.2430","1592"
"20798",776,629,147,"AAACGTTAGTACTTAGCATC","GGTTTGAAAGTGGTAAACCT","561307.5.peg.2430","1592"
"20799",939,629,310,"TCCGCTGTCACACTTTGTAA","GGTTTGAAAGTGGTAAACCT","561307.5.peg.2430","1592"
"20800",906,629,277,"TCAACGCCTTTAATGCCTTC","GGTTTGAAAGTGGTAAACCT","561307.5.peg.2430","1592"
"20801",402,629,227,"TTGAACGTTGCTGTGTGAGT","GGTTTGAAAGTGGTAAACCT","561307.5.peg.2430","1592"
"20802",207,629,422,"TGAGCCGCTTCCTTTGTTGG","GGTTTGAAAGTGGTAAACCT","561307.5.peg.2430","1592"
"20803",207,639,432,"TGAGCCGCTTCCTTTGTTGG","CCTTTAGACTGGTTTGAAAG","561307.5.peg.2430","1592"
"20804",7,639,632,"GGTGTATGACAGTTAATGGA","CCTTTAGACTGGTTTGAAAG","561307.5.peg.2430","1592"
"20805",776,639,137,"AAACGTTAGTACTTAGCATC","CCTTTAGACTGGTTTGAAAG","561307.5.peg.2430","1592"
"20806",210,639,429,"TGATGAGCCGCTTCCTTTGT","CCTTTAGACTGGTTTGAAAG","561307.5.peg.2430","1592"
"20807",939,639,300,"TCCGCTGTCACACTTTGTAA","CCTTTAGACTGGTTTGAAAG","561307.5.peg.2430","1592"
"20808",310,639,329,"TGGTTTGTTAGATGGTGCGT","CCTTTAGACTGGTTTGAAAG","561307.5.peg.2430","1592"
"20809",11,639,628,"ATTGGTGTATGACAGTTAA","CCTTTAGACTGGTTTGAAAG","561307.5.peg.2430","1592"
"20810",253,639,386,"CTGCGCTGATGCTGATACGT","CCTTTAGACTGGTTTGAAAG","561307.5.peg.2430","1592"
"20811",1023,639,384,"CGCCATGTTTCTTGTGTTGA","CCTTTAGACTGGTTTGAAAG","561307.5.peg.2430","1592"
"20812",521,639,118,"TTTCTTCGGCTAGTCGGCCA","CCTTTAGACTGGTTTGAAAG","561307.5.peg.2430","1592"
"20813",147,639,492,"GTTACTGCATGTGCTTTCAT","CCTTTAGACTGGTTTGAAAG","561307.5.peg.2430","1592"
"20814",456,639,183,"GCATTAGCAGCAAACATTCG","CCTTTAGACTGGTTTGAAAG","561307.5.peg.2430","1592"
"20815",402,639,237,"TTGAACGTTGCTGTGTGAGT","CCTTTAGACTGGTTTGAAAG","561307.5.peg.2430","1592"
"20816",906,639,267,"TCAACGCCTTTAATGCCTTC","CCTTTAGACTGGTTTGAAAG","561307.5.peg.2430","1592"
"20817",207,650,443,"TGAGCCGCTTCCTTTGTTGG","CCATTTCTTCACCTTTAGAC","561307.5.peg.2430","1592"
"20818",11,650,639,"ATTGGTGTATGACAGTTAA","CCATTTCTTCACCTTTAGAC","561307.5.peg.2430","1592"
"20819",253,650,397,"CTGCGCTGATGCTGATACGT","CCATTTCTTCACCTTTAGAC","561307.5.peg.2430","1592"
"20820",310,650,340,"TGGTTTGTTAGATGGTGCGT","CCATTTCTTCACCTTTAGAC","561307.5.peg.2430","1592"
"20821",1023,650,373,"CGCCATGTTTCTTGTGTTGA","CCATTTCTTCACCTTTAGAC","561307.5.peg.2430","1592"
"20822",776,650,126,"AAACGTTAGTACTTAGCATC","CCATTTCTTCACCTTTAGAC","561307.5.peg.2430","1592"
"20823",906,650,256,"TCAACGCCTTTAATGCCTTC","CCATTTCTTCACCTTTAGAC","561307.5.peg.2430","1592"
"20824",210,650,440,"TGATGAGCCGCTTCCTTTGT","CCATTTCTTCACCTTTAGAC","561307.5.peg.2430","1592"
"20825",402,650,248,"TTGAACGTTGCTGTGTGAGT","CCATTTCTTCACCTTTAGAC","561307.5.peg.2430","1592"
"20826",521,650,129,"TTTCTTCGGCTAGTCGGCCA","CCATTTCTTCACCTTTAGAC","561307.5.peg.2430","1592"
"20827",939,650,289,"TCCGCTGTCACACTTTGTAA","CCATTTCTTCACCTTTAGAC","561307.5.peg.2430","1592"
"20828",456,650,194,"GCATTAGCAGCAAACATTCG","CCATTTCTTCACCTTTAGAC","561307.5.peg.2430","1592"
"20829",147,650,503,"GTTACTGCATGTGCTTTCAT","CCATTTCTTCACCTTTAGAC","561307.5.peg.2430","1592"
"20830",7,650,643,"GGTGTATGACAGTTAATGGA","CCATTTCTTCACCTTTAGAC","561307.5.peg.2430","1592"
"20831",7,719,712,"GGTGTATGACAGTTAATGGA","CGTATCCAAAGTCAAATTCA","561307.5.peg.2430","1592"
"20832",210,719,509,"TGATGAGCCGCTTCCTTTGT","CGTATCCAAAGTCAAATTCA","561307.5.peg.2430","1592"
"20833",456,719,263,"GCATTAGCAGCAAACATTCG","CGTATCCAAAGTCAAATTCA","561307.5.peg.2430","1592"
"20834",906,719,187,"TCAACGCCTTTAATGCCTTC","CGTATCCAAAGTCAAATTCA","561307.5.peg.2430","1592"
"20835",11,719,708,"ATTGGTGTATGACAGTTAA","CGTATCCAAAGTCAAATTCA","561307.5.peg.2430","1592"
"20836",147,719,572,"GTTACTGCATGTGCTTTCAT","CGTATCCAAAGTCAAATTCA","561307.5.peg.2430","1592"
"20837",207,719,512,"TGAGCCGCTTCCTTTGTTGG","CGTATCCAAAGTCAAATTCA","561307.5.peg.2430","1592"
"20838",253,719,466,"CTGCGCTGATGCTGATACGT","CGTATCCAAAGTCAAATTCA","561307.5.peg.2430","1592"
"20839",521,719,198,"TTTCTTCGGCTAGTCGGCCA","CGTATCCAAAGTCAAATTCA","561307.5.peg.2430","1592"
"20840",402,719,317,"TTGAACGTTGCTGTGTGAGT","CGTATCCAAAGTCAAATTCA","561307.5.peg.2430","1592"
"20841",1023,719,304,"CGCCATGTTTCTTGTGTTGA","CGTATCCAAAGTCAAATTCA","561307.5.peg.2430","1592"
"20842",310,719,409,"TGGTTTGTTAGATGGTGCGT","CGTATCCAAAGTCAAATTCA","561307.5.peg.2430","1592"
"20843",939,719,220,"TCCGCTGTCACACTTTGTAA","CGTATCCAAAGTCAAATTCA","561307.5.peg.2430","1592"
"20844",629,776,147,"GGTTTGAAAGTGGTAAACCT","AAACGTTAGTACTTAGCATC","561307.5.peg.2430","1592"
"20845",253,776,523,"CTGCGCTGATGCTGATACGT","AAACGTTAGTACTTAGCATC","561307.5.peg.2430","1592"
"20846",639,776,137,"CCTTTAGACTGGTTTGAAAG","AAACGTTAGTACTTAGCATC","561307.5.peg.2430","1592"
"20847",402,776,374,"TTGAACGTTGCTGTGTGAGT","AAACGTTAGTACTTAGCATC","561307.5.peg.2430","1592"
"20848",906,776,130,"TCAACGCCTTTAATGCCTTC","AAACGTTAGTACTTAGCATC","561307.5.peg.2430","1592"
"20849",310,776,466,"TGGTTTGTTAGATGGTGCGT","AAACGTTAGTACTTAGCATC","561307.5.peg.2430","1592"
"20850",210,776,566,"TGATGAGCCGCTTCCTTTGT","AAACGTTAGTACTTAGCATC","561307.5.peg.2430","1592"
"20851",521,776,255,"TTTCTTCGGCTAGTCGGCCA","AAACGTTAGTACTTAGCATC","561307.5.peg.2430","1592"
"20852",939,776,163,"TCCGCTGTCACACTTTGTAA","AAACGTTAGTACTTAGCATC","561307.5.peg.2430","1592"
"20853",456,776,320,"GCATTAGCAGCAAACATTCG","AAACGTTAGTACTTAGCATC","561307.5.peg.2430","1592"
"20854",7,776,769,"GGTGTATGACAGTTAATGGA","AAACGTTAGTACTTAGCATC","561307.5.peg.2430","1592"
"20855",11,776,765,"ATTGGTGTATGACAGTTAA","AAACGTTAGTACTTAGCATC","561307.5.peg.2430","1592"
"20856",147,776,629,"GTTACTGCATGTGCTTTCAT","AAACGTTAGTACTTAGCATC","561307.5.peg.2430","1592"
"20857",650,776,126,"CCATTTCTTCACCTTTAGAC","AAACGTTAGTACTTAGCATC","561307.5.peg.2430","1592"
"20858",207,776,569,"TGAGCCGCTTCCTTTGTTGG","AAACGTTAGTACTTAGCATC","561307.5.peg.2430","1592"
"20859",625,776,151,"TGAAAGTGGTAAACCTTGGA","AAACGTTAGTACTTAGCATC","561307.5.peg.2430","1592"
"20860",1023,776,247,"CGCCATGTTTCTTGTGTTGA","AAACGTTAGTACTTAGCATC","561307.5.peg.2430","1592"
"20861",402,906,504,"TTGAACGTTGCTGTGTGAGT","TCAACGCCTTTAATGCCTTC","561307.5.peg.2430","1592"
"20862",310,906,596,"TGGTTTGTTAGATGGTGCGT","TCAACGCCTTTAATGCCTTC","561307.5.peg.2430","1592"
"20863",719,906,187,"CGTATCCAAAGTCAAATTCA","TCAACGCCTTTAATGCCTTC","561307.5.peg.2430","1592"
"20864",11,906,895,"ATTGGTGTATGACAGTTAA","TCAACGCCTTTAATGCCTTC","561307.5.peg.2430","1592"
"20865",147,906,759,"GTTACTGCATGTGCTTTCAT","TCAACGCCTTTAATGCCTTC","561307.5.peg.2430","1592"
"20866",639,906,267,"CCTTTAGACTGGTTTGAAAG","TCAACGCCTTTAATGCCTTC","561307.5.peg.2430","1592"
"20867",210,906,696,"TGATGAGCCGCTTCCTTTGT","TCAACGCCTTTAATGCCTTC","561307.5.peg.2430","1592"
"20868",629,906,277,"GGTTTGAAAGTGGTAAACCT","TCAACGCCTTTAATGCCTTC","561307.5.peg.2430","1592"
"20869",650,906,256,"CCATTTCTTCACCTTTAGAC","TCAACGCCTTTAATGCCTTC","561307.5.peg.2430","1592"
"20870",253,906,653,"CTGCGCTGATGCTGATACGT","TCAACGCCTTTAATGCCTTC","561307.5.peg.2430","1592"
"20871",776,906,130,"AAACGTTAGTACTTAGCATC","TCAACGCCTTTAATGCCTTC","561307.5.peg.2430","1592"
"20872",456,906,450,"GCATTAGCAGCAAACATTCG","TCAACGCCTTTAATGCCTTC","561307.5.peg.2430","1592"
"20873",625,906,281,"TGAAAGTGGTAAACCTTGGA","TCAACGCCTTTAATGCCTTC","561307.5.peg.2430","1592"
"20874",521,906,385,"TTTCTTCGGCTAGTCGGCCA","TCAACGCCTTTAATGCCTTC","561307.5.peg.2430","1592"
"20875",7,906,899,"GGTGTATGACAGTTAATGGA","TCAACGCCTTTAATGCCTTC","561307.5.peg.2430","1592"
"20876",207,906,699,"TGAGCCGCTTCCTTTGTTGG","TCAACGCCTTTAATGCCTTC","561307.5.peg.2430","1592"
"20877",1023,906,117,"CGCCATGTTTCTTGTGTTGA","TCAACGCCTTTAATGCCTTC","561307.5.peg.2430","1592"
"20878",207,939,732,"TGAGCCGCTTCCTTTGTTGG","TCCGCTGTCACACTTTGTAA","561307.5.peg.2430","1592"
"20879",310,939,629,"TGGTTTGTTAGATGGTGCGT","TCCGCTGTCACACTTTGTAA","561307.5.peg.2430","1592"
"20880",629,939,310,"GGTTTGAAAGTGGTAAACCT","TCCGCTGTCACACTTTGTAA","561307.5.peg.2430","1592"
"20881",625,939,314,"TGAAAGTGGTAAACCTTGGA","TCCGCTGTCACACTTTGTAA","561307.5.peg.2430","1592"
"20882",210,939,729,"TGATGAGCCGCTTCCTTTGT","TCCGCTGTCACACTTTGTAA","561307.5.peg.2430","1592"
"20883",776,939,163,"AAACGTTAGTACTTAGCATC","TCCGCTGTCACACTTTGTAA","561307.5.peg.2430","1592"
"20884",650,939,289,"CCATTTCTTCACCTTTAGAC","TCCGCTGTCACACTTTGTAA","561307.5.peg.2430","1592"
"20885",719,939,220,"CGTATCCAAAGTCAAATTCA","TCCGCTGTCACACTTTGTAA","561307.5.peg.2430","1592"
"20886",521,939,418,"TTTCTTCGGCTAGTCGGCCA","TCCGCTGTCACACTTTGTAA","561307.5.peg.2430","1592"
"20887",147,939,792,"GTTACTGCATGTGCTTTCAT","TCCGCTGTCACACTTTGTAA","561307.5.peg.2430","1592"
"20888",11,939,928,"ATTGGTGTATGACAGTTAA","TCCGCTGTCACACTTTGTAA","561307.5.peg.2430","1592"
"20889",456,939,483,"GCATTAGCAGCAAACATTCG","TCCGCTGTCACACTTTGTAA","561307.5.peg.2430","1592"
"20890",402,939,537,"TTGAACGTTGCTGTGTGAGT","TCCGCTGTCACACTTTGTAA","561307.5.peg.2430","1592"
"20891",639,939,300,"CCTTTAGACTGGTTTGAAAG","TCCGCTGTCACACTTTGTAA","561307.5.peg.2430","1592"
"20892",253,939,686,"CTGCGCTGATGCTGATACGT","TCCGCTGTCACACTTTGTAA","561307.5.peg.2430","1592"
"20893",7,939,932,"GGTGTATGACAGTTAATGGA","TCCGCTGTCACACTTTGTAA","561307.5.peg.2430","1592"
"20894",629,1023,394,"GGTTTGAAAGTGGTAAACCT","CGCCATGTTTCTTGTGTTGA","561307.5.peg.2430","1592"
"20895",11,1023,1012,"ATTGGTGTATGACAGTTAA","CGCCATGTTTCTTGTGTTGA","561307.5.peg.2430","1592"
"20896",625,1023,398,"TGAAAGTGGTAAACCTTGGA","CGCCATGTTTCTTGTGTTGA","561307.5.peg.2430","1592"
"20897",147,1023,876,"GTTACTGCATGTGCTTTCAT","CGCCATGTTTCTTGTGTTGA","561307.5.peg.2430","1592"
"20898",456,1023,567,"GCATTAGCAGCAAACATTCG","CGCCATGTTTCTTGTGTTGA","561307.5.peg.2430","1592"
"20899",7,1023,1016,"GGTGTATGACAGTTAATGGA","CGCCATGTTTCTTGTGTTGA","561307.5.peg.2430","1592"
"20900",210,1023,813,"TGATGAGCCGCTTCCTTTGT","CGCCATGTTTCTTGTGTTGA","561307.5.peg.2430","1592"
"20901",776,1023,247,"AAACGTTAGTACTTAGCATC","CGCCATGTTTCTTGTGTTGA","561307.5.peg.2430","1592"
"20902",639,1023,384,"CCTTTAGACTGGTTTGAAAG","CGCCATGTTTCTTGTGTTGA","561307.5.peg.2430","1592"
"20903",207,1023,816,"TGAGCCGCTTCCTTTGTTGG","CGCCATGTTTCTTGTGTTGA","561307.5.peg.2430","1592"
"20904",719,1023,304,"CGTATCCAAAGTCAAATTCA","CGCCATGTTTCTTGTGTTGA","561307.5.peg.2430","1592"
"20905",650,1023,373,"CCATTTCTTCACCTTTAGAC","CGCCATGTTTCTTGTGTTGA","561307.5.peg.2430","1592"
"20906",521,1023,502,"TTTCTTCGGCTAGTCGGCCA","CGCCATGTTTCTTGTGTTGA","561307.5.peg.2430","1592"
"20907",906,1023,117,"TCAACGCCTTTAATGCCTTC","CGCCATGTTTCTTGTGTTGA","561307.5.peg.2430","1592"
"20908",402,1023,621,"TTGAACGTTGCTGTGTGAGT","CGCCATGTTTCTTGTGTTGA","561307.5.peg.2430","1592"
"20909",253,1023,770,"CTGCGCTGATGCTGATACGT","CGCCATGTTTCTTGTGTTGA","561307.5.peg.2430","1592"
"20910",310,1023,713,"TGGTTTGTTAGATGGTGCGT","CGCCATGTTTCTTGTGTTGA","561307.5.peg.2430","1592"
"20911",255,134,121,"AATGTAATGACTGTGGATTG","TGATGTCTATCTTGGTGTAT","561307.5.peg.2432","1594"
"20912",255,142,113,"AATGTAATGACTGTGGATTG","ACTTCTATGATGTCTATCT","561307.5.peg.2432","1594"
"20913",134,255,121,"TGATGTCTATCTTGGTGTAT","AATGTAATGACTGTGGATTG","561307.5.peg.2432","1594"
"20914",142,255,113,"ACTTCTATGATGTCTATCT","AATGTAATGACTGTGGATTG","561307.5.peg.2432","1594"
"20915",575,266,309,"GAGGATTCTGTGGATGTCCT","TGTCATCTTCTTCAGTATCT","561307.5.peg.2433","1595"
"20916",648,266,382,"ATGAATTGCTGCTTTCTATT","TGTCATCTTCTTCAGTATCT","561307.5.peg.2433","1595"
"20917",266,575,309,"TGTCATCTTCTTCAGTATCT","GAGGATTCTGTGGATGTCCT","561307.5.peg.2433","1595"
"20918",266,648,382,"TGTCATCTTCTTCAGTATCT","ATGAATTGCTGCTTTCTATT","561307.5.peg.2433","1595"
"20919",488,112,376,"CTGTGACTTTGACTTCAATT","GTCAATTAATTGCCCTTGCT","561307.5.peg.2437","1599"
"20920",512,112,400,"TAATGTCACTAGGGAATCCA","GTCAATTAATTGCCCTTGCT","561307.5.peg.2437","1599"
"20921",488,178,310,"CTGTGACTTTGACTTCAATT","CTCATCAACAGGATGAAGTA","561307.5.peg.2437","1599"
"20922",512,178,334,"TAATGTCACTAGGGAATCCA","CTCATCAACAGGATGAAGTA","561307.5.peg.2437","1599"
"20923",488,189,299,"CTGTGACTTTGACTTCAATT","AATGACTCAATCTCATCAAC","561307.5.peg.2437","1599"
"20924",512,189,323,"TAATGTCACTAGGGAATCCA","AATGACTCAATCTCATCAAC","561307.5.peg.2437","1599"
"20925",112,488,376,"GTCAATTAATTGCCCTTGCT","CTGTGACTTTGACTTCAATT","561307.5.peg.2437","1599"
"20926",178,488,310,"CTCATCAACAGGATGAAGTA","CTGTGACTTTGACTTCAATT","561307.5.peg.2437","1599"
"20927",189,488,299,"AATGACTCAATCTCATCAAC","CTGTGACTTTGACTTCAATT","561307.5.peg.2437","1599"
"20928",112,512,400,"GTCAATTAATTGCCCTTGCT","TAATGTCACTAGGGAATCCA","561307.5.peg.2437","1599"
"20929",178,512,334,"CTCATCAACAGGATGAAGTA","TAATGTCACTAGGGAATCCA","561307.5.peg.2437","1599"
"20930",189,512,323,"AATGACTCAATCTCATCAAC","TAATGTCACTAGGGAATCCA","561307.5.peg.2437","1599"
"20931",399,140,259,"ATACTTTCAGGCGTGTGTCC","ATTTCGATAAATCACGAACA","561307.5.peg.2438","1600"
"20932",462,140,322,"TCACCACTAAATAATCCCAT","ATTTCGATAAATCACGAACA","561307.5.peg.2438","1600"
"20933",670,140,530,"CCTATTGTAGATATAGGTA","ATTTCGATAAATCACGAACA","561307.5.peg.2438","1600"
"20934",647,140,507,"CACCTAATGCTTTACCACAA","ATTTCGATAAATCACGAACA","561307.5.peg.2438","1600"
"20935",627,140,487,"GGGCTTCCAGCACCATGACC","ATTTCGATAAATCACGAACA","561307.5.peg.2438","1600"
"20936",140,399,259,"ATTTCGATAAATCACGAACA","ATACTTTCAGGCGTGTGTCC","561307.5.peg.2438","1600"
"20937",647,399,248,"CACCTAATGCTTTACCACAA","ATACTTTCAGGCGTGTGTCC","561307.5.peg.2438","1600"
"20938",627,399,228,"GGGCTTCCAGCACCATGACC","ATACTTTCAGGCGTGTGTCC","561307.5.peg.2438","1600"
"20939",670,399,271,"CCTATTGTAGATATAGGTA","ATACTTTCAGGCGTGTGTCC","561307.5.peg.2438","1600"
"20940",627,462,165,"GGGCTTCCAGCACCATGACC","TCACCACTAAATAATCCCAT","561307.5.peg.2438","1600"
"20941",140,462,322,"ATTTCGATAAATCACGAACA","TCACCACTAAATAATCCCAT","561307.5.peg.2438","1600"
"20942",647,462,185,"CACCTAATGCTTTACCACAA","TCACCACTAAATAATCCCAT","561307.5.peg.2438","1600"
"20943",670,462,208,"CCTATTGTAGATATAGGTA","TCACCACTAAATAATCCCAT","561307.5.peg.2438","1600"
"20944",462,627,165,"TCACCACTAAATAATCCCAT","GGGCTTCCAGCACCATGACC","561307.5.peg.2438","1600"
"20945",399,627,228,"ATACTTTCAGGCGTGTGTCC","GGGCTTCCAGCACCATGACC","561307.5.peg.2438","1600"
"20946",140,627,487,"ATTTCGATAAATCACGAACA","GGGCTTCCAGCACCATGACC","561307.5.peg.2438","1600"
"20947",140,647,507,"ATTTCGATAAATCACGAACA","CACCTAATGCTTTACCACAA","561307.5.peg.2438","1600"
"20948",462,647,185,"TCACCACTAAATAATCCCAT","CACCTAATGCTTTACCACAA","561307.5.peg.2438","1600"
"20949",399,647,248,"ATACTTTCAGGCGTGTGTCC","CACCTAATGCTTTACCACAA","561307.5.peg.2438","1600"
"20950",399,670,271,"ATACTTTCAGGCGTGTGTCC","CCTATTGTAGATATAGGTA","561307.5.peg.2438","1600"
"20951",140,670,530,"ATTTCGATAAATCACGAACA","CCTATTGTAGATATAGGTA","561307.5.peg.2438","1600"
"20952",462,670,208,"TCACCACTAAATAATCCCAT","CCTATTGTAGATATAGGTA","561307.5.peg.2438","1600"
"20953",453,103,350,"CAAGTTTCGTTAACATAGTC","TCTTAATAGTCTTGATGCTA","561307.5.peg.2439","1601"
"20954",522,103,419,"CCACACTTTATAGGAGTGTT","TCTTAATAGTCTTGATGCTA","561307.5.peg.2439","1601"
"20955",531,103,428,"GGCGCACCTCCACACTTTAT","TCTTAATAGTCTTGATGCTA","561307.5.peg.2439","1601"
"20956",261,103,158,"TTTATCCAGTTAGCACCTTC","TCTTAATAGTCTTGATGCTA","561307.5.peg.2439","1601"
"20957",602,103,499,"ATATCACATTAGCGTTAGAA","TCTTAATAGTCTTGATGCTA","561307.5.peg.2439","1601"
"20958",453,165,288,"CAAGTTTCGTTAACATAGTC","TGATAGTAATGATGGTCTGC","561307.5.peg.2439","1601"
"20959",531,165,366,"GGCGCACCTCCACACTTTAT","TGATAGTAATGATGGTCTGC","561307.5.peg.2439","1601"
"20960",522,165,357,"CCACACTTTATAGGAGTGTT","TGATAGTAATGATGGTCTGC","561307.5.peg.2439","1601"
"20961",602,165,437,"ATATCACATTAGCGTTAGAA","TGATAGTAATGATGGTCTGC","561307.5.peg.2439","1601"
"20962",103,261,158,"TCTTAATAGTCTTGATGCTA","TTTATCCAGTTAGCACCTTC","561307.5.peg.2439","1601"
"20963",531,261,270,"GGCGCACCTCCACACTTTAT","TTTATCCAGTTAGCACCTTC","561307.5.peg.2439","1601"
"20964",522,261,261,"CCACACTTTATAGGAGTGTT","TTTATCCAGTTAGCACCTTC","561307.5.peg.2439","1601"
"20965",453,261,192,"CAAGTTTCGTTAACATAGTC","TTTATCCAGTTAGCACCTTC","561307.5.peg.2439","1601"
"20966",602,261,341,"ATATCACATTAGCGTTAGAA","TTTATCCAGTTAGCACCTTC","561307.5.peg.2439","1601"
"20967",103,453,350,"TCTTAATAGTCTTGATGCTA","CAAGTTTCGTTAACATAGTC","561307.5.peg.2439","1601"
"20968",165,453,288,"TGATAGTAATGATGGTCTGC","CAAGTTTCGTTAACATAGTC","561307.5.peg.2439","1601"
"20969",261,453,192,"TTTATCCAGTTAGCACCTTC","CAAGTTTCGTTAACATAGTC","561307.5.peg.2439","1601"
"20970",602,453,149,"ATATCACATTAGCGTTAGAA","CAAGTTTCGTTAACATAGTC","561307.5.peg.2439","1601"
"20971",103,522,419,"TCTTAATAGTCTTGATGCTA","CCACACTTTATAGGAGTGTT","561307.5.peg.2439","1601"
"20972",165,522,357,"TGATAGTAATGATGGTCTGC","CCACACTTTATAGGAGTGTT","561307.5.peg.2439","1601"
"20973",261,522,261,"TTTATCCAGTTAGCACCTTC","CCACACTTTATAGGAGTGTT","561307.5.peg.2439","1601"
"20974",103,531,428,"TCTTAATAGTCTTGATGCTA","GGCGCACCTCCACACTTTAT","561307.5.peg.2439","1601"
"20975",165,531,366,"TGATAGTAATGATGGTCTGC","GGCGCACCTCCACACTTTAT","561307.5.peg.2439","1601"
"20976",261,531,270,"TTTATCCAGTTAGCACCTTC","GGCGCACCTCCACACTTTAT","561307.5.peg.2439","1601"
"20977",165,602,437,"TGATAGTAATGATGGTCTGC","ATATCACATTAGCGTTAGAA","561307.5.peg.2439","1601"
"20978",261,602,341,"TTTATCCAGTTAGCACCTTC","ATATCACATTAGCGTTAGAA","561307.5.peg.2439","1601"
"20979",103,602,499,"TCTTAATAGTCTTGATGCTA","ATATCACATTAGCGTTAGAA","561307.5.peg.2439","1601"
"20980",453,602,149,"CAAGTTTCGTTAACATAGTC","ATATCACATTAGCGTTAGAA","561307.5.peg.2439","1601"
"20981",306,201,105,"CTTTAGGTTCATAATAGTT","TCCAATATATATTGCCCTCT","561307.5.peg.244","1602"
"20982",321,201,120,"ATTCAAAGTCGCTTTCTTT","TCCAATATATATTGCCCTCT","561307.5.peg.244","1602"
"20983",201,306,105,"TCCAATATATATTGCCCTCT","CTTTAGGTTCATAATAGTT","561307.5.peg.244","1602"
"20984",201,321,120,"TCCAATATATATTGCCCTCT","ATTCAAAGTCGCTTTCTTT","561307.5.peg.244","1602"
"20985",291,102,189,"CTCGTTTCACGGAACTGTTC","ATATCTGTAACGTCTTCCAT","561307.5.peg.2440","1603"
"20986",302,102,200,"CTAATTGAATACTCGTTTCA","ATATCTGTAACGTCTTCCAT","561307.5.peg.2440","1603"
"20987",417,102,315,"ATAATTTCGGCAGCAACGTC","ATATCTGTAACGTCTTCCAT","561307.5.peg.2440","1603"
"20988",485,102,383,"CATCGATTTCATAGTAGCCA","ATATCTGTAACGTCTTCCAT","561307.5.peg.2440","1603"
"20989",400,102,298,"GTCAGGTCTTAAGATTAAGC","ATATCTGTAACGTCTTCCAT","561307.5.peg.2440","1603"
"20990",203,102,101,"CACTATGTATGCCTTCAGGG","ATATCTGTAACGTCTTCCAT","561307.5.peg.2440","1603"
"20991",102,203,101,"ATATCTGTAACGTCTTCCAT","CACTATGTATGCCTTCAGGG","561307.5.peg.2440","1603"
"20992",417,203,214,"ATAATTTCGGCAGCAACGTC","CACTATGTATGCCTTCAGGG","561307.5.peg.2440","1603"
"20993",400,203,197,"GTCAGGTCTTAAGATTAAGC","CACTATGTATGCCTTCAGGG","561307.5.peg.2440","1603"
"20994",485,203,282,"CATCGATTTCATAGTAGCCA","CACTATGTATGCCTTCAGGG","561307.5.peg.2440","1603"
"20995",400,291,109,"GTCAGGTCTTAAGATTAAGC","CTCGTTTCACGGAACTGTTC","561307.5.peg.2440","1603"
"20996",102,291,189,"ATATCTGTAACGTCTTCCAT","CTCGTTTCACGGAACTGTTC","561307.5.peg.2440","1603"
"20997",485,291,194,"CATCGATTTCATAGTAGCCA","CTCGTTTCACGGAACTGTTC","561307.5.peg.2440","1603"
"20998",417,291,126,"ATAATTTCGGCAGCAACGTC","CTCGTTTCACGGAACTGTTC","561307.5.peg.2440","1603"
"20999",102,302,200,"ATATCTGTAACGTCTTCCAT","CTAATTGAATACTCGTTTCA","561307.5.peg.2440","1603"
"21000",485,302,183,"CATCGATTTCATAGTAGCCA","CTAATTGAATACTCGTTTCA","561307.5.peg.2440","1603"
"21001",417,302,115,"ATAATTTCGGCAGCAACGTC","CTAATTGAATACTCGTTTCA","561307.5.peg.2440","1603"
"21002",102,400,298,"ATATCTGTAACGTCTTCCAT","GTCAGGTCTTAAGATTAAGC","561307.5.peg.2440","1603"
"21003",203,400,197,"CACTATGTATGCCTTCAGGG","GTCAGGTCTTAAGATTAAGC","561307.5.peg.2440","1603"
"21004",291,400,109,"CTCGTTTCACGGAACTGTTC","GTCAGGTCTTAAGATTAAGC","561307.5.peg.2440","1603"
"21005",203,417,214,"CACTATGTATGCCTTCAGGG","ATAATTTCGGCAGCAACGTC","561307.5.peg.2440","1603"
"21006",102,417,315,"ATATCTGTAACGTCTTCCAT","ATAATTTCGGCAGCAACGTC","561307.5.peg.2440","1603"
"21007",291,417,126,"CTCGTTTCACGGAACTGTTC","ATAATTTCGGCAGCAACGTC","561307.5.peg.2440","1603"
"21008",302,417,115,"CTAATTGAATACTCGTTTCA","ATAATTTCGGCAGCAACGTC","561307.5.peg.2440","1603"
"21009",203,485,282,"CACTATGTATGCCTTCAGGG","CATCGATTTCATAGTAGCCA","561307.5.peg.2440","1603"
"21010",291,485,194,"CTCGTTTCACGGAACTGTTC","CATCGATTTCATAGTAGCCA","561307.5.peg.2440","1603"
"21011",102,485,383,"ATATCTGTAACGTCTTCCAT","CATCGATTTCATAGTAGCCA","561307.5.peg.2440","1603"
"21012",302,485,183,"CTAATTGAATACTCGTTTCA","CATCGATTTCATAGTAGCCA","561307.5.peg.2440","1603"
"21013",624,214,410,"GATTCTTCCTCTGAATGAGT","TATAGGAGAAGCTAAGAAAC","561307.5.peg.2442","1605"
"21014",624,231,393,"GATTCTTCCTCTGAATGAGT","TCGGCTAGTCCACCTATTAT","561307.5.peg.2442","1605"
"21015",214,624,410,"TATAGGAGAAGCTAAGAAAC","GATTCTTCCTCTGAATGAGT","561307.5.peg.2442","1605"
"21016",231,624,393,"TCGGCTAGTCCACCTATTAT","GATTCTTCCTCTGAATGAGT","561307.5.peg.2442","1605"
"21017",684,6,678,"AAGCTGTTAAATTCCGGCTG","AAACAAATAGGGAACAAGGT","561307.5.peg.2448","1611"
"21018",690,6,684,"ATGAAGAAGCTGTTAAATTC","AAACAAATAGGGAACAAGGT","561307.5.peg.2448","1611"
"21019",357,6,351,"CCATAACAGTGTGTCCCATT","AAACAAATAGGGAACAAGGT","561307.5.peg.2448","1611"
"21020",914,6,908,"TTCATTACCACTCGTAATT","AAACAAATAGGGAACAAGGT","561307.5.peg.2448","1611"
"21021",1123,6,1117,"TGCGACTACCATCTTATATT","AAACAAATAGGGAACAAGGT","561307.5.peg.2448","1611"
"21022",864,6,858,"AATCTAAACTCAGTCTGTGA","AAACAAATAGGGAACAAGGT","561307.5.peg.2448","1611"
"21023",849,6,843,"TGTGATGGCCATCGTCCATC","AAACAAATAGGGAACAAGGT","561307.5.peg.2448","1611"
"21024",837,6,831,"CGTCCATCAGGCAAACGTGA","AAACAAATAGGGAACAAGGT","561307.5.peg.2448","1611"
"21025",684,357,327,"AAGCTGTTAAATTCCGGCTG","CCATAACAGTGTGTCCCATT","561307.5.peg.2448","1611"
"21026",6,357,351,"AAACAAATAGGGAACAAGGT","CCATAACAGTGTGTCCCATT","561307.5.peg.2448","1611"
"21027",837,357,480,"CGTCCATCAGGCAAACGTGA","CCATAACAGTGTGTCCCATT","561307.5.peg.2448","1611"
"21028",914,357,557,"TTCATTACCACTCGTAATT","CCATAACAGTGTGTCCCATT","561307.5.peg.2448","1611"
"21029",1123,357,766,"TGCGACTACCATCTTATATT","CCATAACAGTGTGTCCCATT","561307.5.peg.2448","1611"
"21030",849,357,492,"TGTGATGGCCATCGTCCATC","CCATAACAGTGTGTCCCATT","561307.5.peg.2448","1611"
"21031",864,357,507,"AATCTAAACTCAGTCTGTGA","CCATAACAGTGTGTCCCATT","561307.5.peg.2448","1611"
"21032",690,357,333,"ATGAAGAAGCTGTTAAATTC","CCATAACAGTGTGTCCCATT","561307.5.peg.2448","1611"
"21033",1123,684,439,"TGCGACTACCATCTTATATT","AAGCTGTTAAATTCCGGCTG","561307.5.peg.2448","1611"
"21034",914,684,230,"TTCATTACCACTCGTAATT","AAGCTGTTAAATTCCGGCTG","561307.5.peg.2448","1611"
"21035",6,684,678,"AAACAAATAGGGAACAAGGT","AAGCTGTTAAATTCCGGCTG","561307.5.peg.2448","1611"
"21036",864,684,180,"AATCTAAACTCAGTCTGTGA","AAGCTGTTAAATTCCGGCTG","561307.5.peg.2448","1611"
"21037",357,684,327,"CCATAACAGTGTGTCCCATT","AAGCTGTTAAATTCCGGCTG","561307.5.peg.2448","1611"
"21038",849,684,165,"TGTGATGGCCATCGTCCATC","AAGCTGTTAAATTCCGGCTG","561307.5.peg.2448","1611"
"21039",837,684,153,"CGTCCATCAGGCAAACGTGA","AAGCTGTTAAATTCCGGCTG","561307.5.peg.2448","1611"
"21040",849,690,159,"TGTGATGGCCATCGTCCATC","ATGAAGAAGCTGTTAAATTC","561307.5.peg.2448","1611"
"21041",6,690,684,"AAACAAATAGGGAACAAGGT","ATGAAGAAGCTGTTAAATTC","561307.5.peg.2448","1611"
"21042",914,690,224,"TTCATTACCACTCGTAATT","ATGAAGAAGCTGTTAAATTC","561307.5.peg.2448","1611"
"21043",864,690,174,"AATCTAAACTCAGTCTGTGA","ATGAAGAAGCTGTTAAATTC","561307.5.peg.2448","1611"
"21044",1123,690,433,"TGCGACTACCATCTTATATT","ATGAAGAAGCTGTTAAATTC","561307.5.peg.2448","1611"
"21045",357,690,333,"CCATAACAGTGTGTCCCATT","ATGAAGAAGCTGTTAAATTC","561307.5.peg.2448","1611"
"21046",837,690,147,"CGTCCATCAGGCAAACGTGA","ATGAAGAAGCTGTTAAATTC","561307.5.peg.2448","1611"
"21047",1123,837,286,"TGCGACTACCATCTTATATT","CGTCCATCAGGCAAACGTGA","561307.5.peg.2448","1611"
"21048",690,837,147,"ATGAAGAAGCTGTTAAATTC","CGTCCATCAGGCAAACGTGA","561307.5.peg.2448","1611"
"21049",6,837,831,"AAACAAATAGGGAACAAGGT","CGTCCATCAGGCAAACGTGA","561307.5.peg.2448","1611"
"21050",684,837,153,"AAGCTGTTAAATTCCGGCTG","CGTCCATCAGGCAAACGTGA","561307.5.peg.2448","1611"
"21051",357,837,480,"CCATAACAGTGTGTCCCATT","CGTCCATCAGGCAAACGTGA","561307.5.peg.2448","1611"
"21052",690,849,159,"ATGAAGAAGCTGTTAAATTC","TGTGATGGCCATCGTCCATC","561307.5.peg.2448","1611"
"21053",357,849,492,"CCATAACAGTGTGTCCCATT","TGTGATGGCCATCGTCCATC","561307.5.peg.2448","1611"
"21054",684,849,165,"AAGCTGTTAAATTCCGGCTG","TGTGATGGCCATCGTCCATC","561307.5.peg.2448","1611"
"21055",6,849,843,"AAACAAATAGGGAACAAGGT","TGTGATGGCCATCGTCCATC","561307.5.peg.2448","1611"
"21056",1123,849,274,"TGCGACTACCATCTTATATT","TGTGATGGCCATCGTCCATC","561307.5.peg.2448","1611"
"21057",6,864,858,"AAACAAATAGGGAACAAGGT","AATCTAAACTCAGTCTGTGA","561307.5.peg.2448","1611"
"21058",357,864,507,"CCATAACAGTGTGTCCCATT","AATCTAAACTCAGTCTGTGA","561307.5.peg.2448","1611"
"21059",690,864,174,"ATGAAGAAGCTGTTAAATTC","AATCTAAACTCAGTCTGTGA","561307.5.peg.2448","1611"
"21060",1123,864,259,"TGCGACTACCATCTTATATT","AATCTAAACTCAGTCTGTGA","561307.5.peg.2448","1611"
"21061",684,864,180,"AAGCTGTTAAATTCCGGCTG","AATCTAAACTCAGTCTGTGA","561307.5.peg.2448","1611"
"21062",6,914,908,"AAACAAATAGGGAACAAGGT","TTCATTACCACTCGTAATT","561307.5.peg.2448","1611"
"21063",690,914,224,"ATGAAGAAGCTGTTAAATTC","TTCATTACCACTCGTAATT","561307.5.peg.2448","1611"
"21064",1123,914,209,"TGCGACTACCATCTTATATT","TTCATTACCACTCGTAATT","561307.5.peg.2448","1611"
"21065",684,914,230,"AAGCTGTTAAATTCCGGCTG","TTCATTACCACTCGTAATT","561307.5.peg.2448","1611"
"21066",357,914,557,"CCATAACAGTGTGTCCCATT","TTCATTACCACTCGTAATT","561307.5.peg.2448","1611"
"21067",684,1123,439,"AAGCTGTTAAATTCCGGCTG","TGCGACTACCATCTTATATT","561307.5.peg.2448","1611"
"21068",864,1123,259,"AATCTAAACTCAGTCTGTGA","TGCGACTACCATCTTATATT","561307.5.peg.2448","1611"
"21069",357,1123,766,"CCATAACAGTGTGTCCCATT","TGCGACTACCATCTTATATT","561307.5.peg.2448","1611"
"21070",849,1123,274,"TGTGATGGCCATCGTCCATC","TGCGACTACCATCTTATATT","561307.5.peg.2448","1611"
"21071",837,1123,286,"CGTCCATCAGGCAAACGTGA","TGCGACTACCATCTTATATT","561307.5.peg.2448","1611"
"21072",914,1123,209,"TTCATTACCACTCGTAATT","TGCGACTACCATCTTATATT","561307.5.peg.2448","1611"
"21073",6,1123,1117,"AAACAAATAGGGAACAAGGT","TGCGACTACCATCTTATATT","561307.5.peg.2448","1611"
"21074",690,1123,433,"ATGAAGAAGCTGTTAAATTC","TGCGACTACCATCTTATATT","561307.5.peg.2448","1611"
"21075",966,209,757,"TGATTTAGTTGGTGATTGGT","GAAATCGATACAAGTCGCGG","561307.5.peg.2455","1619"
"21076",839,209,630,"AATCATGTTGTGCCGATTGC","GAAATCGATACAAGTCGCGG","561307.5.peg.2455","1619"
"21077",398,209,189,"TTTAGACAACTCATTATGT","GAAATCGATACAAGTCGCGG","561307.5.peg.2455","1619"
"21078",798,209,589,"CGATCACCTCGATATTGTTT","GAAATCGATACAAGTCGCGG","561307.5.peg.2455","1619"
"21079",473,209,264,"GGTTCGAATGATATGTACGC","GAAATCGATACAAGTCGCGG","561307.5.peg.2455","1619"
"21080",958,209,749,"TTGGTGATTGGTTGGTTGAA","GAAATCGATACAAGTCGCGG","561307.5.peg.2455","1619"
"21081",1137,209,928,"ATTTCTGCATCATACGTGAA","GAAATCGATACAAGTCGCGG","561307.5.peg.2455","1619"
"21082",966,212,754,"TGATTTAGTTGGTGATTGGT","GTTGAAATCGATACAAGTCG","561307.5.peg.2455","1619"
"21083",798,212,586,"CGATCACCTCGATATTGTTT","GTTGAAATCGATACAAGTCG","561307.5.peg.2455","1619"
"21084",839,212,627,"AATCATGTTGTGCCGATTGC","GTTGAAATCGATACAAGTCG","561307.5.peg.2455","1619"
"21085",398,212,186,"TTTAGACAACTCATTATGT","GTTGAAATCGATACAAGTCG","561307.5.peg.2455","1619"
"21086",1137,212,925,"ATTTCTGCATCATACGTGAA","GTTGAAATCGATACAAGTCG","561307.5.peg.2455","1619"
"21087",473,212,261,"GGTTCGAATGATATGTACGC","GTTGAAATCGATACAAGTCG","561307.5.peg.2455","1619"
"21088",958,212,746,"TTGGTGATTGGTTGGTTGAA","GTTGAAATCGATACAAGTCG","561307.5.peg.2455","1619"
"21089",958,398,560,"TTGGTGATTGGTTGGTTGAA","TTTAGACAACTCATTATGT","561307.5.peg.2455","1619"
"21090",839,398,441,"AATCATGTTGTGCCGATTGC","TTTAGACAACTCATTATGT","561307.5.peg.2455","1619"
"21091",212,398,186,"GTTGAAATCGATACAAGTCG","TTTAGACAACTCATTATGT","561307.5.peg.2455","1619"
"21092",798,398,400,"CGATCACCTCGATATTGTTT","TTTAGACAACTCATTATGT","561307.5.peg.2455","1619"
"21093",209,398,189,"GAAATCGATACAAGTCGCGG","TTTAGACAACTCATTATGT","561307.5.peg.2455","1619"
"21094",1137,398,739,"ATTTCTGCATCATACGTGAA","TTTAGACAACTCATTATGT","561307.5.peg.2455","1619"
"21095",966,398,568,"TGATTTAGTTGGTGATTGGT","TTTAGACAACTCATTATGT","561307.5.peg.2455","1619"
"21096",1137,473,664,"ATTTCTGCATCATACGTGAA","GGTTCGAATGATATGTACGC","561307.5.peg.2455","1619"
"21097",958,473,485,"TTGGTGATTGGTTGGTTGAA","GGTTCGAATGATATGTACGC","561307.5.peg.2455","1619"
"21098",212,473,261,"GTTGAAATCGATACAAGTCG","GGTTCGAATGATATGTACGC","561307.5.peg.2455","1619"
"21099",798,473,325,"CGATCACCTCGATATTGTTT","GGTTCGAATGATATGTACGC","561307.5.peg.2455","1619"
"21100",839,473,366,"AATCATGTTGTGCCGATTGC","GGTTCGAATGATATGTACGC","561307.5.peg.2455","1619"
"21101",209,473,264,"GAAATCGATACAAGTCGCGG","GGTTCGAATGATATGTACGC","561307.5.peg.2455","1619"
"21102",966,473,493,"TGATTTAGTTGGTGATTGGT","GGTTCGAATGATATGTACGC","561307.5.peg.2455","1619"
"21103",209,798,589,"GAAATCGATACAAGTCGCGG","CGATCACCTCGATATTGTTT","561307.5.peg.2455","1619"
"21104",398,798,400,"TTTAGACAACTCATTATGT","CGATCACCTCGATATTGTTT","561307.5.peg.2455","1619"
"21105",966,798,168,"TGATTTAGTTGGTGATTGGT","CGATCACCTCGATATTGTTT","561307.5.peg.2455","1619"
"21106",958,798,160,"TTGGTGATTGGTTGGTTGAA","CGATCACCTCGATATTGTTT","561307.5.peg.2455","1619"
"21107",212,798,586,"GTTGAAATCGATACAAGTCG","CGATCACCTCGATATTGTTT","561307.5.peg.2455","1619"
"21108",473,798,325,"GGTTCGAATGATATGTACGC","CGATCACCTCGATATTGTTT","561307.5.peg.2455","1619"
"21109",1137,798,339,"ATTTCTGCATCATACGTGAA","CGATCACCTCGATATTGTTT","561307.5.peg.2455","1619"
"21110",209,839,630,"GAAATCGATACAAGTCGCGG","AATCATGTTGTGCCGATTGC","561307.5.peg.2455","1619"
"21111",212,839,627,"GTTGAAATCGATACAAGTCG","AATCATGTTGTGCCGATTGC","561307.5.peg.2455","1619"
"21112",398,839,441,"TTTAGACAACTCATTATGT","AATCATGTTGTGCCGATTGC","561307.5.peg.2455","1619"
"21113",1137,839,298,"ATTTCTGCATCATACGTGAA","AATCATGTTGTGCCGATTGC","561307.5.peg.2455","1619"
"21114",966,839,127,"TGATTTAGTTGGTGATTGGT","AATCATGTTGTGCCGATTGC","561307.5.peg.2455","1619"
"21115",473,839,366,"GGTTCGAATGATATGTACGC","AATCATGTTGTGCCGATTGC","561307.5.peg.2455","1619"
"21116",958,839,119,"TTGGTGATTGGTTGGTTGAA","AATCATGTTGTGCCGATTGC","561307.5.peg.2455","1619"
"21117",473,958,485,"GGTTCGAATGATATGTACGC","TTGGTGATTGGTTGGTTGAA","561307.5.peg.2455","1619"
"21118",398,958,560,"TTTAGACAACTCATTATGT","TTGGTGATTGGTTGGTTGAA","561307.5.peg.2455","1619"
"21119",1137,958,179,"ATTTCTGCATCATACGTGAA","TTGGTGATTGGTTGGTTGAA","561307.5.peg.2455","1619"
"21120",839,958,119,"AATCATGTTGTGCCGATTGC","TTGGTGATTGGTTGGTTGAA","561307.5.peg.2455","1619"
"21121",212,958,746,"GTTGAAATCGATACAAGTCG","TTGGTGATTGGTTGGTTGAA","561307.5.peg.2455","1619"
"21122",798,958,160,"CGATCACCTCGATATTGTTT","TTGGTGATTGGTTGGTTGAA","561307.5.peg.2455","1619"
"21123",209,958,749,"GAAATCGATACAAGTCGCGG","TTGGTGATTGGTTGGTTGAA","561307.5.peg.2455","1619"
"21124",398,966,568,"TTTAGACAACTCATTATGT","TGATTTAGTTGGTGATTGGT","561307.5.peg.2455","1619"
"21125",839,966,127,"AATCATGTTGTGCCGATTGC","TGATTTAGTTGGTGATTGGT","561307.5.peg.2455","1619"
"21126",209,966,757,"GAAATCGATACAAGTCGCGG","TGATTTAGTTGGTGATTGGT","561307.5.peg.2455","1619"
"21127",798,966,168,"CGATCACCTCGATATTGTTT","TGATTTAGTTGGTGATTGGT","561307.5.peg.2455","1619"
"21128",212,966,754,"GTTGAAATCGATACAAGTCG","TGATTTAGTTGGTGATTGGT","561307.5.peg.2455","1619"
"21129",473,966,493,"GGTTCGAATGATATGTACGC","TGATTTAGTTGGTGATTGGT","561307.5.peg.2455","1619"
"21130",1137,966,171,"ATTTCTGCATCATACGTGAA","TGATTTAGTTGGTGATTGGT","561307.5.peg.2455","1619"
"21131",398,1137,739,"TTTAGACAACTCATTATGT","ATTTCTGCATCATACGTGAA","561307.5.peg.2455","1619"
"21132",798,1137,339,"CGATCACCTCGATATTGTTT","ATTTCTGCATCATACGTGAA","561307.5.peg.2455","1619"
"21133",212,1137,925,"GTTGAAATCGATACAAGTCG","ATTTCTGCATCATACGTGAA","561307.5.peg.2455","1619"
"21134",839,1137,298,"AATCATGTTGTGCCGATTGC","ATTTCTGCATCATACGTGAA","561307.5.peg.2455","1619"
"21135",966,1137,171,"TGATTTAGTTGGTGATTGGT","ATTTCTGCATCATACGTGAA","561307.5.peg.2455","1619"
"21136",209,1137,928,"GAAATCGATACAAGTCGCGG","ATTTCTGCATCATACGTGAA","561307.5.peg.2455","1619"
"21137",958,1137,179,"TTGGTGATTGGTTGGTTGAA","ATTTCTGCATCATACGTGAA","561307.5.peg.2455","1619"
"21138",473,1137,664,"GGTTCGAATGATATGTACGC","ATTTCTGCATCATACGTGAA","561307.5.peg.2455","1619"
"21139",219,3,216,"ATCGTTACTTTAATTCCACG","TGATGTAACTAAGGAGATGA","561307.5.peg.2456","1620"
"21140",275,3,272,"GTAATGCGTCAAAGTCTGCA","TGATGTAACTAAGGAGATGA","561307.5.peg.2456","1620"
"21141",3,219,216,"TGATGTAACTAAGGAGATGA","ATCGTTACTTTAATTCCACG","561307.5.peg.2456","1620"
"21142",3,275,272,"TGATGTAACTAAGGAGATGA","GTAATGCGTCAAAGTCTGCA","561307.5.peg.2456","1620"
"21143",458,310,148,"AACCGAAACCGAATAGTATG","AGCACCCATTATCACTCCAA","561307.5.peg.2458","1622"
"21144",724,310,414,"AGCTAAGATAGCTGTAATCG","AGCACCCATTATCACTCCAA","561307.5.peg.2458","1622"
"21145",695,310,385,"TGTTATCGCCTAGTAACACA","AGCACCCATTATCACTCCAA","561307.5.peg.2458","1622"
"21146",576,310,266,"CCGACAATGACAGCGAGTAT","AGCACCCATTATCACTCCAA","561307.5.peg.2458","1622"
"21147",310,458,148,"AGCACCCATTATCACTCCAA","AACCGAAACCGAATAGTATG","561307.5.peg.2458","1622"
"21148",695,458,237,"TGTTATCGCCTAGTAACACA","AACCGAAACCGAATAGTATG","561307.5.peg.2458","1622"
"21149",576,458,118,"CCGACAATGACAGCGAGTAT","AACCGAAACCGAATAGTATG","561307.5.peg.2458","1622"
"21150",724,458,266,"AGCTAAGATAGCTGTAATCG","AACCGAAACCGAATAGTATG","561307.5.peg.2458","1622"
"21151",310,576,266,"AGCACCCATTATCACTCCAA","CCGACAATGACAGCGAGTAT","561307.5.peg.2458","1622"
"21152",695,576,119,"TGTTATCGCCTAGTAACACA","CCGACAATGACAGCGAGTAT","561307.5.peg.2458","1622"
"21153",458,576,118,"AACCGAAACCGAATAGTATG","CCGACAATGACAGCGAGTAT","561307.5.peg.2458","1622"
"21154",724,576,148,"AGCTAAGATAGCTGTAATCG","CCGACAATGACAGCGAGTAT","561307.5.peg.2458","1622"
"21155",310,695,385,"AGCACCCATTATCACTCCAA","TGTTATCGCCTAGTAACACA","561307.5.peg.2458","1622"
"21156",576,695,119,"CCGACAATGACAGCGAGTAT","TGTTATCGCCTAGTAACACA","561307.5.peg.2458","1622"
"21157",458,695,237,"AACCGAAACCGAATAGTATG","TGTTATCGCCTAGTAACACA","561307.5.peg.2458","1622"
"21158",576,724,148,"CCGACAATGACAGCGAGTAT","AGCTAAGATAGCTGTAATCG","561307.5.peg.2458","1622"
"21159",310,724,414,"AGCACCCATTATCACTCCAA","AGCTAAGATAGCTGTAATCG","561307.5.peg.2458","1622"
"21160",458,724,266,"AACCGAAACCGAATAGTATG","AGCTAAGATAGCTGTAATCG","561307.5.peg.2458","1622"
"21161",404,3,401,"CACGACAGCGAGAATAGTTA","TCTAATACGAAAGGACTTGG","561307.5.peg.2459","1623"
"21162",621,3,618,"ATTTCCATTGCAGAATGCCA","TCTAATACGAAAGGACTTGG","561307.5.peg.2459","1623"
"21163",225,3,222,"TCAAGACTACCACCTGCTTT","TCTAATACGAAAGGACTTGG","561307.5.peg.2459","1623"
"21164",281,3,278,"TCTCCATTTCACGACCACCG","TCTAATACGAAAGGACTTGG","561307.5.peg.2459","1623"
"21165",121,3,118,"ACCAGATCCGATTAAGTAAG","TCTAATACGAAAGGACTTGG","561307.5.peg.2459","1623"
"21166",621,6,615,"ATTTCCATTGCAGAATGCCA","ATTCTAATACGAAAGGACT","561307.5.peg.2459","1623"
"21167",281,6,275,"TCTCCATTTCACGACCACCG","ATTCTAATACGAAAGGACT","561307.5.peg.2459","1623"
"21168",404,6,398,"CACGACAGCGAGAATAGTTA","ATTCTAATACGAAAGGACT","561307.5.peg.2459","1623"
"21169",225,6,219,"TCAAGACTACCACCTGCTTT","ATTCTAATACGAAAGGACT","561307.5.peg.2459","1623"
"21170",121,6,115,"ACCAGATCCGATTAAGTAAG","ATTCTAATACGAAAGGACT","561307.5.peg.2459","1623"
"21171",621,121,500,"ATTTCCATTGCAGAATGCCA","ACCAGATCCGATTAAGTAAG","561307.5.peg.2459","1623"
"21172",6,121,115,"ATTCTAATACGAAAGGACT","ACCAGATCCGATTAAGTAAG","561307.5.peg.2459","1623"
"21173",281,121,160,"TCTCCATTTCACGACCACCG","ACCAGATCCGATTAAGTAAG","561307.5.peg.2459","1623"
"21174",404,121,283,"CACGACAGCGAGAATAGTTA","ACCAGATCCGATTAAGTAAG","561307.5.peg.2459","1623"
"21175",225,121,104,"TCAAGACTACCACCTGCTTT","ACCAGATCCGATTAAGTAAG","561307.5.peg.2459","1623"
"21176",3,121,118,"TCTAATACGAAAGGACTTGG","ACCAGATCCGATTAAGTAAG","561307.5.peg.2459","1623"
"21177",3,225,222,"TCTAATACGAAAGGACTTGG","TCAAGACTACCACCTGCTTT","561307.5.peg.2459","1623"
"21178",121,225,104,"ACCAGATCCGATTAAGTAAG","TCAAGACTACCACCTGCTTT","561307.5.peg.2459","1623"
"21179",621,225,396,"ATTTCCATTGCAGAATGCCA","TCAAGACTACCACCTGCTTT","561307.5.peg.2459","1623"
"21180",404,225,179,"CACGACAGCGAGAATAGTTA","TCAAGACTACCACCTGCTTT","561307.5.peg.2459","1623"
"21181",6,225,219,"ATTCTAATACGAAAGGACT","TCAAGACTACCACCTGCTTT","561307.5.peg.2459","1623"
"21182",621,281,340,"ATTTCCATTGCAGAATGCCA","TCTCCATTTCACGACCACCG","561307.5.peg.2459","1623"
"21183",404,281,123,"CACGACAGCGAGAATAGTTA","TCTCCATTTCACGACCACCG","561307.5.peg.2459","1623"
"21184",6,281,275,"ATTCTAATACGAAAGGACT","TCTCCATTTCACGACCACCG","561307.5.peg.2459","1623"
"21185",121,281,160,"ACCAGATCCGATTAAGTAAG","TCTCCATTTCACGACCACCG","561307.5.peg.2459","1623"
"21186",3,281,278,"TCTAATACGAAAGGACTTGG","TCTCCATTTCACGACCACCG","561307.5.peg.2459","1623"
"21187",3,404,401,"TCTAATACGAAAGGACTTGG","CACGACAGCGAGAATAGTTA","561307.5.peg.2459","1623"
"21188",6,404,398,"ATTCTAATACGAAAGGACT","CACGACAGCGAGAATAGTTA","561307.5.peg.2459","1623"
"21189",281,404,123,"TCTCCATTTCACGACCACCG","CACGACAGCGAGAATAGTTA","561307.5.peg.2459","1623"
"21190",225,404,179,"TCAAGACTACCACCTGCTTT","CACGACAGCGAGAATAGTTA","561307.5.peg.2459","1623"
"21191",121,404,283,"ACCAGATCCGATTAAGTAAG","CACGACAGCGAGAATAGTTA","561307.5.peg.2459","1623"
"21192",621,404,217,"ATTTCCATTGCAGAATGCCA","CACGACAGCGAGAATAGTTA","561307.5.peg.2459","1623"
"21193",404,621,217,"CACGACAGCGAGAATAGTTA","ATTTCCATTGCAGAATGCCA","561307.5.peg.2459","1623"
"21194",121,621,500,"ACCAGATCCGATTAAGTAAG","ATTTCCATTGCAGAATGCCA","561307.5.peg.2459","1623"
"21195",6,621,615,"ATTCTAATACGAAAGGACT","ATTTCCATTGCAGAATGCCA","561307.5.peg.2459","1623"
"21196",225,621,396,"TCAAGACTACCACCTGCTTT","ATTTCCATTGCAGAATGCCA","561307.5.peg.2459","1623"
"21197",281,621,340,"TCTCCATTTCACGACCACCG","ATTTCCATTGCAGAATGCCA","561307.5.peg.2459","1623"
"21198",3,621,618,"TCTAATACGAAAGGACTTGG","ATTTCCATTGCAGAATGCCA","561307.5.peg.2459","1623"
"21199",307,129,178,"ATACTGACTTCTTTGTTGAG","ATCGCCAACTGCCTATGTGA","561307.5.peg.2461","1626"
"21200",448,129,319,"GATAAGTCTTCAATATGAC","ATCGCCAACTGCCTATGTGA","561307.5.peg.2461","1626"
"21201",129,307,178,"ATCGCCAACTGCCTATGTGA","ATACTGACTTCTTTGTTGAG","561307.5.peg.2461","1626"
"21202",448,307,141,"GATAAGTCTTCAATATGAC","ATACTGACTTCTTTGTTGAG","561307.5.peg.2461","1626"
"21203",129,448,319,"ATCGCCAACTGCCTATGTGA","GATAAGTCTTCAATATGAC","561307.5.peg.2461","1626"
"21204",307,448,141,"ATACTGACTTCTTTGTTGAG","GATAAGTCTTCAATATGAC","561307.5.peg.2461","1626"
"21205",225,72,153,"GCACCTGCTGATACACGCGC","GATAATCCGACATTATCGAA","561307.5.peg.2463","1628"
"21206",813,72,741,"ACCACCATTGTTGCTAGTGA","GATAATCCGACATTATCGAA","561307.5.peg.2463","1628"
"21207",792,72,720,"GGAATAATGTCTGCTAGTTC","GATAATCCGACATTATCGAA","561307.5.peg.2463","1628"
"21208",456,72,384,"AATACTGCACAAATCGCAAT","GATAATCCGACATTATCGAA","561307.5.peg.2463","1628"
"21209",72,225,153,"GATAATCCGACATTATCGAA","GCACCTGCTGATACACGCGC","561307.5.peg.2463","1628"
"21210",792,225,567,"GGAATAATGTCTGCTAGTTC","GCACCTGCTGATACACGCGC","561307.5.peg.2463","1628"
"21211",456,225,231,"AATACTGCACAAATCGCAAT","GCACCTGCTGATACACGCGC","561307.5.peg.2463","1628"
"21212",813,225,588,"ACCACCATTGTTGCTAGTGA","GCACCTGCTGATACACGCGC","561307.5.peg.2463","1628"
"21213",72,456,384,"GATAATCCGACATTATCGAA","AATACTGCACAAATCGCAAT","561307.5.peg.2463","1628"
"21214",792,456,336,"GGAATAATGTCTGCTAGTTC","AATACTGCACAAATCGCAAT","561307.5.peg.2463","1628"
"21215",225,456,231,"GCACCTGCTGATACACGCGC","AATACTGCACAAATCGCAAT","561307.5.peg.2463","1628"
"21216",813,456,357,"ACCACCATTGTTGCTAGTGA","AATACTGCACAAATCGCAAT","561307.5.peg.2463","1628"
"21217",72,792,720,"GATAATCCGACATTATCGAA","GGAATAATGTCTGCTAGTTC","561307.5.peg.2463","1628"
"21218",456,792,336,"AATACTGCACAAATCGCAAT","GGAATAATGTCTGCTAGTTC","561307.5.peg.2463","1628"
"21219",225,792,567,"GCACCTGCTGATACACGCGC","GGAATAATGTCTGCTAGTTC","561307.5.peg.2463","1628"
"21220",456,813,357,"AATACTGCACAAATCGCAAT","ACCACCATTGTTGCTAGTGA","561307.5.peg.2463","1628"
"21221",72,813,741,"GATAATCCGACATTATCGAA","ACCACCATTGTTGCTAGTGA","561307.5.peg.2463","1628"
"21222",225,813,588,"GCACCTGCTGATACACGCGC","ACCACCATTGTTGCTAGTGA","561307.5.peg.2463","1628"
"21223",252,9,243,"AAATGGATCACCGCATCTGA","TTGGTCAACAGTAAACAAGG","561307.5.peg.247","1630"
"21224",358,9,349,"GCACGTTTGTTAATTTCTT","TTGGTCAACAGTAAACAAGG","561307.5.peg.247","1630"
"21225",252,12,240,"AAATGGATCACCGCATCTGA","TCATTGGTCAACAGTAAACA","561307.5.peg.247","1630"
"21226",358,12,346,"GCACGTTTGTTAATTTCTT","TCATTGGTCAACAGTAAACA","561307.5.peg.247","1630"
"21227",358,28,330,"GCACGTTTGTTAATTTCTT","GGACGCATGTTAGCATTCAT","561307.5.peg.247","1630"
"21228",252,28,224,"AAATGGATCACCGCATCTGA","GGACGCATGTTAGCATTCAT","561307.5.peg.247","1630"
"21229",9,252,243,"TTGGTCAACAGTAAACAAGG","AAATGGATCACCGCATCTGA","561307.5.peg.247","1630"
"21230",358,252,106,"GCACGTTTGTTAATTTCTT","AAATGGATCACCGCATCTGA","561307.5.peg.247","1630"
"21231",12,252,240,"TCATTGGTCAACAGTAAACA","AAATGGATCACCGCATCTGA","561307.5.peg.247","1630"
"21232",28,252,224,"GGACGCATGTTAGCATTCAT","AAATGGATCACCGCATCTGA","561307.5.peg.247","1630"
"21233",12,358,346,"TCATTGGTCAACAGTAAACA","GCACGTTTGTTAATTTCTT","561307.5.peg.247","1630"
"21234",9,358,349,"TTGGTCAACAGTAAACAAGG","GCACGTTTGTTAATTTCTT","561307.5.peg.247","1630"
"21235",252,358,106,"AAATGGATCACCGCATCTGA","GCACGTTTGTTAATTTCTT","561307.5.peg.247","1630"
"21236",28,358,330,"GGACGCATGTTAGCATTCAT","GCACGTTTGTTAATTTCTT","561307.5.peg.247","1630"
"21237",329,127,202,"CAAATACCATGTCTGCACCT","GTGGTCAATCATTCGGTTTA","561307.5.peg.249","1632"
"21238",551,127,424,"GTCAACGATATCTAATAAA","GTGGTCAATCATTCGGTTTA","561307.5.peg.249","1632"
"21239",329,134,195,"CAAATACCATGTCTGCACCT","TCATTCCGTGGTCAATCATT","561307.5.peg.249","1632"
"21240",551,134,417,"GTCAACGATATCTAATAAA","TCATTCCGTGGTCAATCATT","561307.5.peg.249","1632"
"21241",551,146,405,"GTCAACGATATCTAATAAA","TTCAACATTATTCATTCCG","561307.5.peg.249","1632"
"21242",329,146,183,"CAAATACCATGTCTGCACCT","TTCAACATTATTCATTCCG","561307.5.peg.249","1632"
"21243",127,329,202,"GTGGTCAATCATTCGGTTTA","CAAATACCATGTCTGCACCT","561307.5.peg.249","1632"
"21244",551,329,222,"GTCAACGATATCTAATAAA","CAAATACCATGTCTGCACCT","561307.5.peg.249","1632"
"21245",134,329,195,"TCATTCCGTGGTCAATCATT","CAAATACCATGTCTGCACCT","561307.5.peg.249","1632"
"21246",146,329,183,"TTCAACATTATTCATTCCG","CAAATACCATGTCTGCACCT","561307.5.peg.249","1632"
"21247",134,551,417,"TCATTCCGTGGTCAATCATT","GTCAACGATATCTAATAAA","561307.5.peg.249","1632"
"21248",127,551,424,"GTGGTCAATCATTCGGTTTA","GTCAACGATATCTAATAAA","561307.5.peg.249","1632"
"21249",329,551,222,"CAAATACCATGTCTGCACCT","GTCAACGATATCTAATAAA","561307.5.peg.249","1632"
"21250",146,551,405,"TTCAACATTATTCATTCCG","GTCAACGATATCTAATAAA","561307.5.peg.249","1632"
"21251",275,44,231,"TCCAATGATAGGTAATTTC","GTAATGTTCTTCCATAGAT","561307.5.peg.250","1634"
"21252",285,44,241,"TAAACTTCCGTTCCAATGAT","GTAATGTTCTTCCATAGAT","561307.5.peg.250","1634"
"21253",44,275,231,"GTAATGTTCTTCCATAGAT","TCCAATGATAGGTAATTTC","561307.5.peg.250","1634"
"21254",44,285,241,"GTAATGTTCTTCCATAGAT","TAAACTTCCGTTCCAATGAT","561307.5.peg.250","1634"
"21255",417,11,406,"TGTTCTTTAGGAGCTGATTG","AATAAGATGGTAAATGGGCA","561307.5.peg.251","1635"
"21256",11,417,406,"AATAAGATGGTAAATGGGCA","TGTTCTTTAGGAGCTGATTG","561307.5.peg.251","1635"
"21257",285,12,273,"GATACTGTATAAGGTATTCC","GGTTTAATCGGTTTATGGAT","561307.5.peg.252","1636"
"21258",384,12,372,"GTACCCGTTACAGCTATGAT","GGTTTAATCGGTTTATGGAT","561307.5.peg.252","1636"
"21259",478,12,466,"TGCAACATAACCAATATTGC","GGTTTAATCGGTTTATGGAT","561307.5.peg.252","1636"
"21260",478,17,461,"TGCAACATAACCAATATTGC","TTCAGGTTTAATCGGTTTA","561307.5.peg.252","1636"
"21261",384,17,367,"GTACCCGTTACAGCTATGAT","TTCAGGTTTAATCGGTTTA","561307.5.peg.252","1636"
"21262",285,17,268,"GATACTGTATAAGGTATTCC","TTCAGGTTTAATCGGTTTA","561307.5.peg.252","1636"
"21263",285,24,261,"GATACTGTATAAGGTATTCC","GGTCTGATTTCAGGTTTAAT","561307.5.peg.252","1636"
"21264",478,24,454,"TGCAACATAACCAATATTGC","GGTCTGATTTCAGGTTTAAT","561307.5.peg.252","1636"
"21265",384,24,360,"GTACCCGTTACAGCTATGAT","GGTCTGATTTCAGGTTTAAT","561307.5.peg.252","1636"
"21266",12,285,273,"GGTTTAATCGGTTTATGGAT","GATACTGTATAAGGTATTCC","561307.5.peg.252","1636"
"21267",24,285,261,"GGTCTGATTTCAGGTTTAAT","GATACTGTATAAGGTATTCC","561307.5.peg.252","1636"
"21268",17,285,268,"TTCAGGTTTAATCGGTTTA","GATACTGTATAAGGTATTCC","561307.5.peg.252","1636"
"21269",478,285,193,"TGCAACATAACCAATATTGC","GATACTGTATAAGGTATTCC","561307.5.peg.252","1636"
"21270",12,384,372,"GGTTTAATCGGTTTATGGAT","GTACCCGTTACAGCTATGAT","561307.5.peg.252","1636"
"21271",17,384,367,"TTCAGGTTTAATCGGTTTA","GTACCCGTTACAGCTATGAT","561307.5.peg.252","1636"
"21272",24,384,360,"GGTCTGATTTCAGGTTTAAT","GTACCCGTTACAGCTATGAT","561307.5.peg.252","1636"
"21273",17,478,461,"TTCAGGTTTAATCGGTTTA","TGCAACATAACCAATATTGC","561307.5.peg.252","1636"
"21274",12,478,466,"GGTTTAATCGGTTTATGGAT","TGCAACATAACCAATATTGC","561307.5.peg.252","1636"
"21275",24,478,454,"GGTCTGATTTCAGGTTTAAT","TGCAACATAACCAATATTGC","561307.5.peg.252","1636"
"21276",285,478,193,"GATACTGTATAAGGTATTCC","TGCAACATAACCAATATTGC","561307.5.peg.252","1636"
"21277",491,162,329,"AACATATGCAAATGATAGT","GTCTTCTTCATATGGCTTTG","561307.5.peg.253","1637"
"21278",359,162,197,"CTGTTTACTTGTTAAACCT","GTCTTCTTCATATGGCTTTG","561307.5.peg.253","1637"
"21279",471,162,309,"GGGATTGCTACATTCGTAAA","GTCTTCTTCATATGGCTTTG","561307.5.peg.253","1637"
"21280",359,170,189,"CTGTTTACTTGTTAAACCT","GTGTACCAGTCTTCTTCATA","561307.5.peg.253","1637"
"21281",471,170,301,"GGGATTGCTACATTCGTAAA","GTGTACCAGTCTTCTTCATA","561307.5.peg.253","1637"
"21282",491,170,321,"AACATATGCAAATGATAGT","GTGTACCAGTCTTCTTCATA","561307.5.peg.253","1637"
"21283",359,192,167,"CTGTTTACTTGTTAAACCT","AATGTTAGTCCACCCATCGT","561307.5.peg.253","1637"
"21284",471,192,279,"GGGATTGCTACATTCGTAAA","AATGTTAGTCCACCCATCGT","561307.5.peg.253","1637"
"21285",491,192,299,"AACATATGCAAATGATAGT","AATGTTAGTCCACCCATCGT","561307.5.peg.253","1637"
"21286",192,359,167,"AATGTTAGTCCACCCATCGT","CTGTTTACTTGTTAAACCT","561307.5.peg.253","1637"
"21287",170,359,189,"GTGTACCAGTCTTCTTCATA","CTGTTTACTTGTTAAACCT","561307.5.peg.253","1637"
"21288",162,359,197,"GTCTTCTTCATATGGCTTTG","CTGTTTACTTGTTAAACCT","561307.5.peg.253","1637"
"21289",471,359,112,"GGGATTGCTACATTCGTAAA","CTGTTTACTTGTTAAACCT","561307.5.peg.253","1637"
"21290",491,359,132,"AACATATGCAAATGATAGT","CTGTTTACTTGTTAAACCT","561307.5.peg.253","1637"
"21291",162,471,309,"GTCTTCTTCATATGGCTTTG","GGGATTGCTACATTCGTAAA","561307.5.peg.253","1637"
"21292",192,471,279,"AATGTTAGTCCACCCATCGT","GGGATTGCTACATTCGTAAA","561307.5.peg.253","1637"
"21293",170,471,301,"GTGTACCAGTCTTCTTCATA","GGGATTGCTACATTCGTAAA","561307.5.peg.253","1637"
"21294",359,471,112,"CTGTTTACTTGTTAAACCT","GGGATTGCTACATTCGTAAA","561307.5.peg.253","1637"
"21295",162,491,329,"GTCTTCTTCATATGGCTTTG","AACATATGCAAATGATAGT","561307.5.peg.253","1637"
"21296",170,491,321,"GTGTACCAGTCTTCTTCATA","AACATATGCAAATGATAGT","561307.5.peg.253","1637"
"21297",359,491,132,"CTGTTTACTTGTTAAACCT","AACATATGCAAATGATAGT","561307.5.peg.253","1637"
"21298",192,491,299,"AATGTTAGTCCACCCATCGT","AACATATGCAAATGATAGT","561307.5.peg.253","1637"
"21299",839,13,826,"CCGCAAATAAATCTTTCGGC","CCTTGAGAACGATAATGTAA","561307.5.peg.254","1638"
"21300",237,13,224,"TCATATATCTTTCCTCGTTC","CCTTGAGAACGATAATGTAA","561307.5.peg.254","1638"
"21301",1127,13,1114,"AAGTAAATCCGAGTGACATT","CCTTGAGAACGATAATGTAA","561307.5.peg.254","1638"
"21302",612,13,599,"CCTTTAAGTTCACCAGTATC","CCTTGAGAACGATAATGTAA","561307.5.peg.254","1638"
"21303",909,13,896,"CCAGTTTCAGGATTAAATGT","CCTTGAGAACGATAATGTAA","561307.5.peg.254","1638"
"21304",452,13,439,"CTTTGCGTCCAAATTCAATT","CCTTGAGAACGATAATGTAA","561307.5.peg.254","1638"
"21305",750,13,737,"TGGACATCATCACCACGTTT","CCTTGAGAACGATAATGTAA","561307.5.peg.254","1638"
"21306",843,13,830,"ACAACCGCAAATAAATCTTT","CCTTGAGAACGATAATGTAA","561307.5.peg.254","1638"
"21307",921,13,908,"CCAAAGTCTTTACCAGTTTC","CCTTGAGAACGATAATGTAA","561307.5.peg.254","1638"
"21308",839,16,823,"CCGCAAATAAATCTTTCGGC","CCTTTACATTATCGTTCTCA","561307.5.peg.254","1638"
"21309",612,16,596,"CCTTTAAGTTCACCAGTATC","CCTTTACATTATCGTTCTCA","561307.5.peg.254","1638"
"21310",452,16,436,"CTTTGCGTCCAAATTCAATT","CCTTTACATTATCGTTCTCA","561307.5.peg.254","1638"
"21311",909,16,893,"CCAGTTTCAGGATTAAATGT","CCTTTACATTATCGTTCTCA","561307.5.peg.254","1638"
"21312",1127,16,1111,"AAGTAAATCCGAGTGACATT","CCTTTACATTATCGTTCTCA","561307.5.peg.254","1638"
"21313",237,16,221,"TCATATATCTTTCCTCGTTC","CCTTTACATTATCGTTCTCA","561307.5.peg.254","1638"
"21314",843,16,827,"ACAACCGCAAATAAATCTTT","CCTTTACATTATCGTTCTCA","561307.5.peg.254","1638"
"21315",750,16,734,"TGGACATCATCACCACGTTT","CCTTTACATTATCGTTCTCA","561307.5.peg.254","1638"
"21316",921,16,905,"CCAAAGTCTTTACCAGTTTC","CCTTTACATTATCGTTCTCA","561307.5.peg.254","1638"
"21317",909,98,811,"CCAGTTTCAGGATTAAATGT","GTCCGAATAAACCAACAAGT","561307.5.peg.254","1638"
"21318",612,98,514,"CCTTTAAGTTCACCAGTATC","GTCCGAATAAACCAACAAGT","561307.5.peg.254","1638"
"21319",921,98,823,"CCAAAGTCTTTACCAGTTTC","GTCCGAATAAACCAACAAGT","561307.5.peg.254","1638"
"21320",237,98,139,"TCATATATCTTTCCTCGTTC","GTCCGAATAAACCAACAAGT","561307.5.peg.254","1638"
"21321",750,98,652,"TGGACATCATCACCACGTTT","GTCCGAATAAACCAACAAGT","561307.5.peg.254","1638"
"21322",1127,98,1029,"AAGTAAATCCGAGTGACATT","GTCCGAATAAACCAACAAGT","561307.5.peg.254","1638"
"21323",452,98,354,"CTTTGCGTCCAAATTCAATT","GTCCGAATAAACCAACAAGT","561307.5.peg.254","1638"
"21324",843,98,745,"ACAACCGCAAATAAATCTTT","GTCCGAATAAACCAACAAGT","561307.5.peg.254","1638"
"21325",839,98,741,"CCGCAAATAAATCTTTCGGC","GTCCGAATAAACCAACAAGT","561307.5.peg.254","1638"
"21326",16,237,221,"CCTTTACATTATCGTTCTCA","TCATATATCTTTCCTCGTTC","561307.5.peg.254","1638"
"21327",909,237,672,"CCAGTTTCAGGATTAAATGT","TCATATATCTTTCCTCGTTC","561307.5.peg.254","1638"
"21328",750,237,513,"TGGACATCATCACCACGTTT","TCATATATCTTTCCTCGTTC","561307.5.peg.254","1638"
"21329",921,237,684,"CCAAAGTCTTTACCAGTTTC","TCATATATCTTTCCTCGTTC","561307.5.peg.254","1638"
"21330",98,237,139,"GTCCGAATAAACCAACAAGT","TCATATATCTTTCCTCGTTC","561307.5.peg.254","1638"
"21331",452,237,215,"CTTTGCGTCCAAATTCAATT","TCATATATCTTTCCTCGTTC","561307.5.peg.254","1638"
"21332",839,237,602,"CCGCAAATAAATCTTTCGGC","TCATATATCTTTCCTCGTTC","561307.5.peg.254","1638"
"21333",843,237,606,"ACAACCGCAAATAAATCTTT","TCATATATCTTTCCTCGTTC","561307.5.peg.254","1638"
"21334",1127,237,890,"AAGTAAATCCGAGTGACATT","TCATATATCTTTCCTCGTTC","561307.5.peg.254","1638"
"21335",13,237,224,"CCTTGAGAACGATAATGTAA","TCATATATCTTTCCTCGTTC","561307.5.peg.254","1638"
"21336",612,237,375,"CCTTTAAGTTCACCAGTATC","TCATATATCTTTCCTCGTTC","561307.5.peg.254","1638"
"21337",98,452,354,"GTCCGAATAAACCAACAAGT","CTTTGCGTCCAAATTCAATT","561307.5.peg.254","1638"
"21338",612,452,160,"CCTTTAAGTTCACCAGTATC","CTTTGCGTCCAAATTCAATT","561307.5.peg.254","1638"
"21339",750,452,298,"TGGACATCATCACCACGTTT","CTTTGCGTCCAAATTCAATT","561307.5.peg.254","1638"
"21340",921,452,469,"CCAAAGTCTTTACCAGTTTC","CTTTGCGTCCAAATTCAATT","561307.5.peg.254","1638"
"21341",13,452,439,"CCTTGAGAACGATAATGTAA","CTTTGCGTCCAAATTCAATT","561307.5.peg.254","1638"
"21342",839,452,387,"CCGCAAATAAATCTTTCGGC","CTTTGCGTCCAAATTCAATT","561307.5.peg.254","1638"
"21343",16,452,436,"CCTTTACATTATCGTTCTCA","CTTTGCGTCCAAATTCAATT","561307.5.peg.254","1638"
"21344",909,452,457,"CCAGTTTCAGGATTAAATGT","CTTTGCGTCCAAATTCAATT","561307.5.peg.254","1638"
"21345",843,452,391,"ACAACCGCAAATAAATCTTT","CTTTGCGTCCAAATTCAATT","561307.5.peg.254","1638"
"21346",1127,452,675,"AAGTAAATCCGAGTGACATT","CTTTGCGTCCAAATTCAATT","561307.5.peg.254","1638"
"21347",237,452,215,"TCATATATCTTTCCTCGTTC","CTTTGCGTCCAAATTCAATT","561307.5.peg.254","1638"
"21348",13,612,599,"CCTTGAGAACGATAATGTAA","CCTTTAAGTTCACCAGTATC","561307.5.peg.254","1638"
"21349",909,612,297,"CCAGTTTCAGGATTAAATGT","CCTTTAAGTTCACCAGTATC","561307.5.peg.254","1638"
"21350",16,612,596,"CCTTTACATTATCGTTCTCA","CCTTTAAGTTCACCAGTATC","561307.5.peg.254","1638"
"21351",843,612,231,"ACAACCGCAAATAAATCTTT","CCTTTAAGTTCACCAGTATC","561307.5.peg.254","1638"
"21352",839,612,227,"CCGCAAATAAATCTTTCGGC","CCTTTAAGTTCACCAGTATC","561307.5.peg.254","1638"
"21353",921,612,309,"CCAAAGTCTTTACCAGTTTC","CCTTTAAGTTCACCAGTATC","561307.5.peg.254","1638"
"21354",98,612,514,"GTCCGAATAAACCAACAAGT","CCTTTAAGTTCACCAGTATC","561307.5.peg.254","1638"
"21355",750,612,138,"TGGACATCATCACCACGTTT","CCTTTAAGTTCACCAGTATC","561307.5.peg.254","1638"
"21356",1127,612,515,"AAGTAAATCCGAGTGACATT","CCTTTAAGTTCACCAGTATC","561307.5.peg.254","1638"
"21357",237,612,375,"TCATATATCTTTCCTCGTTC","CCTTTAAGTTCACCAGTATC","561307.5.peg.254","1638"
"21358",452,612,160,"CTTTGCGTCCAAATTCAATT","CCTTTAAGTTCACCAGTATC","561307.5.peg.254","1638"
"21359",237,750,513,"TCATATATCTTTCCTCGTTC","TGGACATCATCACCACGTTT","561307.5.peg.254","1638"
"21360",612,750,138,"CCTTTAAGTTCACCAGTATC","TGGACATCATCACCACGTTT","561307.5.peg.254","1638"
"21361",98,750,652,"GTCCGAATAAACCAACAAGT","TGGACATCATCACCACGTTT","561307.5.peg.254","1638"
"21362",452,750,298,"CTTTGCGTCCAAATTCAATT","TGGACATCATCACCACGTTT","561307.5.peg.254","1638"
"21363",921,750,171,"CCAAAGTCTTTACCAGTTTC","TGGACATCATCACCACGTTT","561307.5.peg.254","1638"
"21364",1127,750,377,"AAGTAAATCCGAGTGACATT","TGGACATCATCACCACGTTT","561307.5.peg.254","1638"
"21365",16,750,734,"CCTTTACATTATCGTTCTCA","TGGACATCATCACCACGTTT","561307.5.peg.254","1638"
"21366",13,750,737,"CCTTGAGAACGATAATGTAA","TGGACATCATCACCACGTTT","561307.5.peg.254","1638"
"21367",909,750,159,"CCAGTTTCAGGATTAAATGT","TGGACATCATCACCACGTTT","561307.5.peg.254","1638"
"21368",16,839,823,"CCTTTACATTATCGTTCTCA","CCGCAAATAAATCTTTCGGC","561307.5.peg.254","1638"
"21369",452,839,387,"CTTTGCGTCCAAATTCAATT","CCGCAAATAAATCTTTCGGC","561307.5.peg.254","1638"
"21370",13,839,826,"CCTTGAGAACGATAATGTAA","CCGCAAATAAATCTTTCGGC","561307.5.peg.254","1638"
"21371",237,839,602,"TCATATATCTTTCCTCGTTC","CCGCAAATAAATCTTTCGGC","561307.5.peg.254","1638"
"21372",98,839,741,"GTCCGAATAAACCAACAAGT","CCGCAAATAAATCTTTCGGC","561307.5.peg.254","1638"
"21373",1127,839,288,"AAGTAAATCCGAGTGACATT","CCGCAAATAAATCTTTCGGC","561307.5.peg.254","1638"
"21374",612,839,227,"CCTTTAAGTTCACCAGTATC","CCGCAAATAAATCTTTCGGC","561307.5.peg.254","1638"
"21375",612,843,231,"CCTTTAAGTTCACCAGTATC","ACAACCGCAAATAAATCTTT","561307.5.peg.254","1638"
"21376",13,843,830,"CCTTGAGAACGATAATGTAA","ACAACCGCAAATAAATCTTT","561307.5.peg.254","1638"
"21377",98,843,745,"GTCCGAATAAACCAACAAGT","ACAACCGCAAATAAATCTTT","561307.5.peg.254","1638"
"21378",452,843,391,"CTTTGCGTCCAAATTCAATT","ACAACCGCAAATAAATCTTT","561307.5.peg.254","1638"
"21379",237,843,606,"TCATATATCTTTCCTCGTTC","ACAACCGCAAATAAATCTTT","561307.5.peg.254","1638"
"21380",16,843,827,"CCTTTACATTATCGTTCTCA","ACAACCGCAAATAAATCTTT","561307.5.peg.254","1638"
"21381",1127,843,284,"AAGTAAATCCGAGTGACATT","ACAACCGCAAATAAATCTTT","561307.5.peg.254","1638"
"21382",13,909,896,"CCTTGAGAACGATAATGTAA","CCAGTTTCAGGATTAAATGT","561307.5.peg.254","1638"
"21383",237,909,672,"TCATATATCTTTCCTCGTTC","CCAGTTTCAGGATTAAATGT","561307.5.peg.254","1638"
"21384",16,909,893,"CCTTTACATTATCGTTCTCA","CCAGTTTCAGGATTAAATGT","561307.5.peg.254","1638"
"21385",1127,909,218,"AAGTAAATCCGAGTGACATT","CCAGTTTCAGGATTAAATGT","561307.5.peg.254","1638"
"21386",98,909,811,"GTCCGAATAAACCAACAAGT","CCAGTTTCAGGATTAAATGT","561307.5.peg.254","1638"
"21387",750,909,159,"TGGACATCATCACCACGTTT","CCAGTTTCAGGATTAAATGT","561307.5.peg.254","1638"
"21388",612,909,297,"CCTTTAAGTTCACCAGTATC","CCAGTTTCAGGATTAAATGT","561307.5.peg.254","1638"
"21389",452,909,457,"CTTTGCGTCCAAATTCAATT","CCAGTTTCAGGATTAAATGT","561307.5.peg.254","1638"
"21390",98,921,823,"GTCCGAATAAACCAACAAGT","CCAAAGTCTTTACCAGTTTC","561307.5.peg.254","1638"
"21391",452,921,469,"CTTTGCGTCCAAATTCAATT","CCAAAGTCTTTACCAGTTTC","561307.5.peg.254","1638"
"21392",612,921,309,"CCTTTAAGTTCACCAGTATC","CCAAAGTCTTTACCAGTTTC","561307.5.peg.254","1638"
"21393",237,921,684,"TCATATATCTTTCCTCGTTC","CCAAAGTCTTTACCAGTTTC","561307.5.peg.254","1638"
"21394",16,921,905,"CCTTTACATTATCGTTCTCA","CCAAAGTCTTTACCAGTTTC","561307.5.peg.254","1638"
"21395",750,921,171,"TGGACATCATCACCACGTTT","CCAAAGTCTTTACCAGTTTC","561307.5.peg.254","1638"
"21396",1127,921,206,"AAGTAAATCCGAGTGACATT","CCAAAGTCTTTACCAGTTTC","561307.5.peg.254","1638"
"21397",13,921,908,"CCTTGAGAACGATAATGTAA","CCAAAGTCTTTACCAGTTTC","561307.5.peg.254","1638"
"21398",839,1127,288,"CCGCAAATAAATCTTTCGGC","AAGTAAATCCGAGTGACATT","561307.5.peg.254","1638"
"21399",98,1127,1029,"GTCCGAATAAACCAACAAGT","AAGTAAATCCGAGTGACATT","561307.5.peg.254","1638"
"21400",237,1127,890,"TCATATATCTTTCCTCGTTC","AAGTAAATCCGAGTGACATT","561307.5.peg.254","1638"
"21401",909,1127,218,"CCAGTTTCAGGATTAAATGT","AAGTAAATCCGAGTGACATT","561307.5.peg.254","1638"
"21402",612,1127,515,"CCTTTAAGTTCACCAGTATC","AAGTAAATCCGAGTGACATT","561307.5.peg.254","1638"
"21403",452,1127,675,"CTTTGCGTCCAAATTCAATT","AAGTAAATCCGAGTGACATT","561307.5.peg.254","1638"
"21404",750,1127,377,"TGGACATCATCACCACGTTT","AAGTAAATCCGAGTGACATT","561307.5.peg.254","1638"
"21405",16,1127,1111,"CCTTTACATTATCGTTCTCA","AAGTAAATCCGAGTGACATT","561307.5.peg.254","1638"
"21406",843,1127,284,"ACAACCGCAAATAAATCTTT","AAGTAAATCCGAGTGACATT","561307.5.peg.254","1638"
"21407",13,1127,1114,"CCTTGAGAACGATAATGTAA","AAGTAAATCCGAGTGACATT","561307.5.peg.254","1638"
"21408",921,1127,206,"CCAAAGTCTTTACCAGTTTC","AAGTAAATCCGAGTGACATT","561307.5.peg.254","1638"
"21409",365,212,153,"GTTCTGGAATGTCGAGTTGT","AGCATTATCAATTGCAGTT","561307.5.peg.256","1640"
"21410",381,212,169,"TGATAACTGAATCCTCGTTC","AGCATTATCAATTGCAGTT","561307.5.peg.256","1640"
"21411",404,212,192,"GCATGTCTAATGTTGCGTCA","AGCATTATCAATTGCAGTT","561307.5.peg.256","1640"
"21412",434,212,222,"ATGCTGTTAGTTCTTGTGTT","AGCATTATCAATTGCAGTT","561307.5.peg.256","1640"
"21413",212,365,153,"AGCATTATCAATTGCAGTT","GTTCTGGAATGTCGAGTTGT","561307.5.peg.256","1640"
"21414",212,381,169,"AGCATTATCAATTGCAGTT","TGATAACTGAATCCTCGTTC","561307.5.peg.256","1640"
"21415",212,404,192,"AGCATTATCAATTGCAGTT","GCATGTCTAATGTTGCGTCA","561307.5.peg.256","1640"
"21416",212,434,222,"AGCATTATCAATTGCAGTT","ATGCTGTTAGTTCTTGTGTT","561307.5.peg.256","1640"
"21417",650,10,640,"CTGGTTCACCAATGAGCACA","TGACCAACTCTACAAATTAG","561307.5.peg.26","1644"
"21418",922,10,912,"TAGCATGTTGCCTGCATCCA","TGACCAACTCTACAAATTAG","561307.5.peg.26","1644"
"21419",887,10,877,"TACCAGCACCTACAAGCATA","TGACCAACTCTACAAATTAG","561307.5.peg.26","1644"
"21420",1232,10,1222,"TACGAATTGTTGCACATGCT","TGACCAACTCTACAAATTAG","561307.5.peg.26","1644"
"21421",1153,10,1143,"CAATTCAGCGGCAGCAACTA","TGACCAACTCTACAAATTAG","561307.5.peg.26","1644"
"21422",1272,10,1262,"TAACTTGATCCAATTCAGT","TGACCAACTCTACAAATTAG","561307.5.peg.26","1644"
"21423",308,10,298,"TATCAATTGGTTTGCTTGT","TGACCAACTCTACAAATTAG","561307.5.peg.26","1644"
"21424",542,10,532,"TAACTTCTTCTACTAAGTCG","TGACCAACTCTACAAATTAG","561307.5.peg.26","1644"
"21425",1165,10,1155,"GTAACGATCAGACAATTCAG","TGACCAACTCTACAAATTAG","561307.5.peg.26","1644"
"21426",507,10,497,"ATGCTTCGTAATTAACTTC","TGACCAACTCTACAAATTAG","561307.5.peg.26","1644"
"21427",320,10,310,"TTCAGCCTTAGTTATCAAT","TGACCAACTCTACAAATTAG","561307.5.peg.26","1644"
"21428",948,10,938,"AACTCTCCTCGTGCTAACAT","TGACCAACTCTACAAATTAG","561307.5.peg.26","1644"
"21429",10,308,298,"TGACCAACTCTACAAATTAG","TATCAATTGGTTTGCTTGT","561307.5.peg.26","1644"
"21430",542,308,234,"TAACTTCTTCTACTAAGTCG","TATCAATTGGTTTGCTTGT","561307.5.peg.26","1644"
"21431",1153,308,845,"CAATTCAGCGGCAGCAACTA","TATCAATTGGTTTGCTTGT","561307.5.peg.26","1644"
"21432",948,308,640,"AACTCTCCTCGTGCTAACAT","TATCAATTGGTTTGCTTGT","561307.5.peg.26","1644"
"21433",887,308,579,"TACCAGCACCTACAAGCATA","TATCAATTGGTTTGCTTGT","561307.5.peg.26","1644"
"21434",922,308,614,"TAGCATGTTGCCTGCATCCA","TATCAATTGGTTTGCTTGT","561307.5.peg.26","1644"
"21435",1232,308,924,"TACGAATTGTTGCACATGCT","TATCAATTGGTTTGCTTGT","561307.5.peg.26","1644"
"21436",1165,308,857,"GTAACGATCAGACAATTCAG","TATCAATTGGTTTGCTTGT","561307.5.peg.26","1644"
"21437",1272,308,964,"TAACTTGATCCAATTCAGT","TATCAATTGGTTTGCTTGT","561307.5.peg.26","1644"
"21438",650,308,342,"CTGGTTCACCAATGAGCACA","TATCAATTGGTTTGCTTGT","561307.5.peg.26","1644"
"21439",507,308,199,"ATGCTTCGTAATTAACTTC","TATCAATTGGTTTGCTTGT","561307.5.peg.26","1644"
"21440",922,320,602,"TAGCATGTTGCCTGCATCCA","TTCAGCCTTAGTTATCAAT","561307.5.peg.26","1644"
"21441",1232,320,912,"TACGAATTGTTGCACATGCT","TTCAGCCTTAGTTATCAAT","561307.5.peg.26","1644"
"21442",542,320,222,"TAACTTCTTCTACTAAGTCG","TTCAGCCTTAGTTATCAAT","561307.5.peg.26","1644"
"21443",948,320,628,"AACTCTCCTCGTGCTAACAT","TTCAGCCTTAGTTATCAAT","561307.5.peg.26","1644"
"21444",507,320,187,"ATGCTTCGTAATTAACTTC","TTCAGCCTTAGTTATCAAT","561307.5.peg.26","1644"
"21445",1153,320,833,"CAATTCAGCGGCAGCAACTA","TTCAGCCTTAGTTATCAAT","561307.5.peg.26","1644"
"21446",1165,320,845,"GTAACGATCAGACAATTCAG","TTCAGCCTTAGTTATCAAT","561307.5.peg.26","1644"
"21447",1272,320,952,"TAACTTGATCCAATTCAGT","TTCAGCCTTAGTTATCAAT","561307.5.peg.26","1644"
"21448",887,320,567,"TACCAGCACCTACAAGCATA","TTCAGCCTTAGTTATCAAT","561307.5.peg.26","1644"
"21449",10,320,310,"TGACCAACTCTACAAATTAG","TTCAGCCTTAGTTATCAAT","561307.5.peg.26","1644"
"21450",650,320,330,"CTGGTTCACCAATGAGCACA","TTCAGCCTTAGTTATCAAT","561307.5.peg.26","1644"
"21451",1232,507,725,"TACGAATTGTTGCACATGCT","ATGCTTCGTAATTAACTTC","561307.5.peg.26","1644"
"21452",948,507,441,"AACTCTCCTCGTGCTAACAT","ATGCTTCGTAATTAACTTC","561307.5.peg.26","1644"
"21453",1272,507,765,"TAACTTGATCCAATTCAGT","ATGCTTCGTAATTAACTTC","561307.5.peg.26","1644"
"21454",320,507,187,"TTCAGCCTTAGTTATCAAT","ATGCTTCGTAATTAACTTC","561307.5.peg.26","1644"
"21455",1153,507,646,"CAATTCAGCGGCAGCAACTA","ATGCTTCGTAATTAACTTC","561307.5.peg.26","1644"
"21456",922,507,415,"TAGCATGTTGCCTGCATCCA","ATGCTTCGTAATTAACTTC","561307.5.peg.26","1644"
"21457",887,507,380,"TACCAGCACCTACAAGCATA","ATGCTTCGTAATTAACTTC","561307.5.peg.26","1644"
"21458",308,507,199,"TATCAATTGGTTTGCTTGT","ATGCTTCGTAATTAACTTC","561307.5.peg.26","1644"
"21459",10,507,497,"TGACCAACTCTACAAATTAG","ATGCTTCGTAATTAACTTC","561307.5.peg.26","1644"
"21460",1165,507,658,"GTAACGATCAGACAATTCAG","ATGCTTCGTAATTAACTTC","561307.5.peg.26","1644"
"21461",650,507,143,"CTGGTTCACCAATGAGCACA","ATGCTTCGTAATTAACTTC","561307.5.peg.26","1644"
"21462",10,542,532,"TGACCAACTCTACAAATTAG","TAACTTCTTCTACTAAGTCG","561307.5.peg.26","1644"
"21463",308,542,234,"TATCAATTGGTTTGCTTGT","TAACTTCTTCTACTAAGTCG","561307.5.peg.26","1644"
"21464",1232,542,690,"TACGAATTGTTGCACATGCT","TAACTTCTTCTACTAAGTCG","561307.5.peg.26","1644"
"21465",650,542,108,"CTGGTTCACCAATGAGCACA","TAACTTCTTCTACTAAGTCG","561307.5.peg.26","1644"
"21466",1272,542,730,"TAACTTGATCCAATTCAGT","TAACTTCTTCTACTAAGTCG","561307.5.peg.26","1644"
"21467",922,542,380,"TAGCATGTTGCCTGCATCCA","TAACTTCTTCTACTAAGTCG","561307.5.peg.26","1644"
"21468",1165,542,623,"GTAACGATCAGACAATTCAG","TAACTTCTTCTACTAAGTCG","561307.5.peg.26","1644"
"21469",320,542,222,"TTCAGCCTTAGTTATCAAT","TAACTTCTTCTACTAAGTCG","561307.5.peg.26","1644"
"21470",948,542,406,"AACTCTCCTCGTGCTAACAT","TAACTTCTTCTACTAAGTCG","561307.5.peg.26","1644"
"21471",887,542,345,"TACCAGCACCTACAAGCATA","TAACTTCTTCTACTAAGTCG","561307.5.peg.26","1644"
"21472",1153,542,611,"CAATTCAGCGGCAGCAACTA","TAACTTCTTCTACTAAGTCG","561307.5.peg.26","1644"
"21473",507,650,143,"ATGCTTCGTAATTAACTTC","CTGGTTCACCAATGAGCACA","561307.5.peg.26","1644"
"21474",1153,650,503,"CAATTCAGCGGCAGCAACTA","CTGGTTCACCAATGAGCACA","561307.5.peg.26","1644"
"21475",320,650,330,"TTCAGCCTTAGTTATCAAT","CTGGTTCACCAATGAGCACA","561307.5.peg.26","1644"
"21476",948,650,298,"AACTCTCCTCGTGCTAACAT","CTGGTTCACCAATGAGCACA","561307.5.peg.26","1644"
"21477",887,650,237,"TACCAGCACCTACAAGCATA","CTGGTTCACCAATGAGCACA","561307.5.peg.26","1644"
"21478",542,650,108,"TAACTTCTTCTACTAAGTCG","CTGGTTCACCAATGAGCACA","561307.5.peg.26","1644"
"21479",1232,650,582,"TACGAATTGTTGCACATGCT","CTGGTTCACCAATGAGCACA","561307.5.peg.26","1644"
"21480",922,650,272,"TAGCATGTTGCCTGCATCCA","CTGGTTCACCAATGAGCACA","561307.5.peg.26","1644"
"21481",1165,650,515,"GTAACGATCAGACAATTCAG","CTGGTTCACCAATGAGCACA","561307.5.peg.26","1644"
"21482",10,650,640,"TGACCAACTCTACAAATTAG","CTGGTTCACCAATGAGCACA","561307.5.peg.26","1644"
"21483",308,650,342,"TATCAATTGGTTTGCTTGT","CTGGTTCACCAATGAGCACA","561307.5.peg.26","1644"
"21484",1272,650,622,"TAACTTGATCCAATTCAGT","CTGGTTCACCAATGAGCACA","561307.5.peg.26","1644"
"21485",542,887,345,"TAACTTCTTCTACTAAGTCG","TACCAGCACCTACAAGCATA","561307.5.peg.26","1644"
"21486",1232,887,345,"TACGAATTGTTGCACATGCT","TACCAGCACCTACAAGCATA","561307.5.peg.26","1644"
"21487",320,887,567,"TTCAGCCTTAGTTATCAAT","TACCAGCACCTACAAGCATA","561307.5.peg.26","1644"
"21488",10,887,877,"TGACCAACTCTACAAATTAG","TACCAGCACCTACAAGCATA","561307.5.peg.26","1644"
"21489",650,887,237,"CTGGTTCACCAATGAGCACA","TACCAGCACCTACAAGCATA","561307.5.peg.26","1644"
"21490",1272,887,385,"TAACTTGATCCAATTCAGT","TACCAGCACCTACAAGCATA","561307.5.peg.26","1644"
"21491",1153,887,266,"CAATTCAGCGGCAGCAACTA","TACCAGCACCTACAAGCATA","561307.5.peg.26","1644"
"21492",1165,887,278,"GTAACGATCAGACAATTCAG","TACCAGCACCTACAAGCATA","561307.5.peg.26","1644"
"21493",308,887,579,"TATCAATTGGTTTGCTTGT","TACCAGCACCTACAAGCATA","561307.5.peg.26","1644"
"21494",507,887,380,"ATGCTTCGTAATTAACTTC","TACCAGCACCTACAAGCATA","561307.5.peg.26","1644"
"21495",308,922,614,"TATCAATTGGTTTGCTTGT","TAGCATGTTGCCTGCATCCA","561307.5.peg.26","1644"
"21496",542,922,380,"TAACTTCTTCTACTAAGTCG","TAGCATGTTGCCTGCATCCA","561307.5.peg.26","1644"
"21497",320,922,602,"TTCAGCCTTAGTTATCAAT","TAGCATGTTGCCTGCATCCA","561307.5.peg.26","1644"
"21498",650,922,272,"CTGGTTCACCAATGAGCACA","TAGCATGTTGCCTGCATCCA","561307.5.peg.26","1644"
"21499",507,922,415,"ATGCTTCGTAATTAACTTC","TAGCATGTTGCCTGCATCCA","561307.5.peg.26","1644"
"21500",1232,922,310,"TACGAATTGTTGCACATGCT","TAGCATGTTGCCTGCATCCA","561307.5.peg.26","1644"
"21501",10,922,912,"TGACCAACTCTACAAATTAG","TAGCATGTTGCCTGCATCCA","561307.5.peg.26","1644"
"21502",1272,922,350,"TAACTTGATCCAATTCAGT","TAGCATGTTGCCTGCATCCA","561307.5.peg.26","1644"
"21503",1153,922,231,"CAATTCAGCGGCAGCAACTA","TAGCATGTTGCCTGCATCCA","561307.5.peg.26","1644"
"21504",1165,922,243,"GTAACGATCAGACAATTCAG","TAGCATGTTGCCTGCATCCA","561307.5.peg.26","1644"
"21505",320,948,628,"TTCAGCCTTAGTTATCAAT","AACTCTCCTCGTGCTAACAT","561307.5.peg.26","1644"
"21506",10,948,938,"TGACCAACTCTACAAATTAG","AACTCTCCTCGTGCTAACAT","561307.5.peg.26","1644"
"21507",650,948,298,"CTGGTTCACCAATGAGCACA","AACTCTCCTCGTGCTAACAT","561307.5.peg.26","1644"
"21508",1272,948,324,"TAACTTGATCCAATTCAGT","AACTCTCCTCGTGCTAACAT","561307.5.peg.26","1644"
"21509",1232,948,284,"TACGAATTGTTGCACATGCT","AACTCTCCTCGTGCTAACAT","561307.5.peg.26","1644"
"21510",507,948,441,"ATGCTTCGTAATTAACTTC","AACTCTCCTCGTGCTAACAT","561307.5.peg.26","1644"
"21511",1153,948,205,"CAATTCAGCGGCAGCAACTA","AACTCTCCTCGTGCTAACAT","561307.5.peg.26","1644"
"21512",308,948,640,"TATCAATTGGTTTGCTTGT","AACTCTCCTCGTGCTAACAT","561307.5.peg.26","1644"
"21513",1165,948,217,"GTAACGATCAGACAATTCAG","AACTCTCCTCGTGCTAACAT","561307.5.peg.26","1644"
"21514",542,948,406,"TAACTTCTTCTACTAAGTCG","AACTCTCCTCGTGCTAACAT","561307.5.peg.26","1644"
"21515",1272,1153,119,"TAACTTGATCCAATTCAGT","CAATTCAGCGGCAGCAACTA","561307.5.peg.26","1644"
"21516",650,1153,503,"CTGGTTCACCAATGAGCACA","CAATTCAGCGGCAGCAACTA","561307.5.peg.26","1644"
"21517",922,1153,231,"TAGCATGTTGCCTGCATCCA","CAATTCAGCGGCAGCAACTA","561307.5.peg.26","1644"
"21518",948,1153,205,"AACTCTCCTCGTGCTAACAT","CAATTCAGCGGCAGCAACTA","561307.5.peg.26","1644"
"21519",320,1153,833,"TTCAGCCTTAGTTATCAAT","CAATTCAGCGGCAGCAACTA","561307.5.peg.26","1644"
"21520",887,1153,266,"TACCAGCACCTACAAGCATA","CAATTCAGCGGCAGCAACTA","561307.5.peg.26","1644"
"21521",308,1153,845,"TATCAATTGGTTTGCTTGT","CAATTCAGCGGCAGCAACTA","561307.5.peg.26","1644"
"21522",507,1153,646,"ATGCTTCGTAATTAACTTC","CAATTCAGCGGCAGCAACTA","561307.5.peg.26","1644"
"21523",542,1153,611,"TAACTTCTTCTACTAAGTCG","CAATTCAGCGGCAGCAACTA","561307.5.peg.26","1644"
"21524",10,1153,1143,"TGACCAACTCTACAAATTAG","CAATTCAGCGGCAGCAACTA","561307.5.peg.26","1644"
"21525",10,1165,1155,"TGACCAACTCTACAAATTAG","GTAACGATCAGACAATTCAG","561307.5.peg.26","1644"
"21526",542,1165,623,"TAACTTCTTCTACTAAGTCG","GTAACGATCAGACAATTCAG","561307.5.peg.26","1644"
"21527",1272,1165,107,"TAACTTGATCCAATTCAGT","GTAACGATCAGACAATTCAG","561307.5.peg.26","1644"
"21528",308,1165,857,"TATCAATTGGTTTGCTTGT","GTAACGATCAGACAATTCAG","561307.5.peg.26","1644"
"21529",948,1165,217,"AACTCTCCTCGTGCTAACAT","GTAACGATCAGACAATTCAG","561307.5.peg.26","1644"
"21530",650,1165,515,"CTGGTTCACCAATGAGCACA","GTAACGATCAGACAATTCAG","561307.5.peg.26","1644"
"21531",887,1165,278,"TACCAGCACCTACAAGCATA","GTAACGATCAGACAATTCAG","561307.5.peg.26","1644"
"21532",507,1165,658,"ATGCTTCGTAATTAACTTC","GTAACGATCAGACAATTCAG","561307.5.peg.26","1644"
"21533",922,1165,243,"TAGCATGTTGCCTGCATCCA","GTAACGATCAGACAATTCAG","561307.5.peg.26","1644"
"21534",320,1165,845,"TTCAGCCTTAGTTATCAAT","GTAACGATCAGACAATTCAG","561307.5.peg.26","1644"
"21535",922,1232,310,"TAGCATGTTGCCTGCATCCA","TACGAATTGTTGCACATGCT","561307.5.peg.26","1644"
"21536",308,1232,924,"TATCAATTGGTTTGCTTGT","TACGAATTGTTGCACATGCT","561307.5.peg.26","1644"
"21537",887,1232,345,"TACCAGCACCTACAAGCATA","TACGAATTGTTGCACATGCT","561307.5.peg.26","1644"
"21538",542,1232,690,"TAACTTCTTCTACTAAGTCG","TACGAATTGTTGCACATGCT","561307.5.peg.26","1644"
"21539",507,1232,725,"ATGCTTCGTAATTAACTTC","TACGAATTGTTGCACATGCT","561307.5.peg.26","1644"
"21540",650,1232,582,"CTGGTTCACCAATGAGCACA","TACGAATTGTTGCACATGCT","561307.5.peg.26","1644"
"21541",320,1232,912,"TTCAGCCTTAGTTATCAAT","TACGAATTGTTGCACATGCT","561307.5.peg.26","1644"
"21542",10,1232,1222,"TGACCAACTCTACAAATTAG","TACGAATTGTTGCACATGCT","561307.5.peg.26","1644"
"21543",948,1232,284,"AACTCTCCTCGTGCTAACAT","TACGAATTGTTGCACATGCT","561307.5.peg.26","1644"
"21544",650,1272,622,"CTGGTTCACCAATGAGCACA","TAACTTGATCCAATTCAGT","561307.5.peg.26","1644"
"21545",320,1272,952,"TTCAGCCTTAGTTATCAAT","TAACTTGATCCAATTCAGT","561307.5.peg.26","1644"
"21546",922,1272,350,"TAGCATGTTGCCTGCATCCA","TAACTTGATCCAATTCAGT","561307.5.peg.26","1644"
"21547",308,1272,964,"TATCAATTGGTTTGCTTGT","TAACTTGATCCAATTCAGT","561307.5.peg.26","1644"
"21548",10,1272,1262,"TGACCAACTCTACAAATTAG","TAACTTGATCCAATTCAGT","561307.5.peg.26","1644"
"21549",542,1272,730,"TAACTTCTTCTACTAAGTCG","TAACTTGATCCAATTCAGT","561307.5.peg.26","1644"
"21550",1165,1272,107,"GTAACGATCAGACAATTCAG","TAACTTGATCCAATTCAGT","561307.5.peg.26","1644"
"21551",887,1272,385,"TACCAGCACCTACAAGCATA","TAACTTGATCCAATTCAGT","561307.5.peg.26","1644"
"21552",1153,1272,119,"CAATTCAGCGGCAGCAACTA","TAACTTGATCCAATTCAGT","561307.5.peg.26","1644"
"21553",507,1272,765,"ATGCTTCGTAATTAACTTC","TAACTTGATCCAATTCAGT","561307.5.peg.26","1644"
"21554",948,1272,324,"AACTCTCCTCGTGCTAACAT","TAACTTGATCCAATTCAGT","561307.5.peg.26","1644"
"21555",327,155,172,"GGGTTACCCGGTTGAGGTTT","TAAATAGTTTATCGACGACT","561307.5.peg.261","1646"
"21556",290,155,135,"ATTCTAAAGCACCGAATCCA","TAAATAGTTTATCGACGACT","561307.5.peg.261","1646"
"21557",333,155,178,"GGTTGAGGGTTACCCGGTTG","TAAATAGTTTATCGACGACT","561307.5.peg.261","1646"
"21558",347,155,192,"ATCTAAACATGCGTGGTTGA","TAAATAGTTTATCGACGACT","561307.5.peg.261","1646"
"21559",501,155,346,"TCTTGATAACGCGCTTCATA","TAAATAGTTTATCGACGACT","561307.5.peg.261","1646"
"21560",339,155,184,"ATGCGTGGTTGAGGGTTACC","TAAATAGTTTATCGACGACT","561307.5.peg.261","1646"
"21561",385,155,230,"GAAGCCCATTCGATTTATCA","TAAATAGTTTATCGACGACT","561307.5.peg.261","1646"
"21562",354,155,199,"CTAATAATCTAAACATGCG","TAAATAGTTTATCGACGACT","561307.5.peg.261","1646"
"21563",465,155,310,"ACACCAACATTGATACCAAC","TAAATAGTTTATCGACGACT","561307.5.peg.261","1646"
"21564",327,189,138,"GGGTTACCCGGTTGAGGTTT","TGTATCGTTTGTGATAACGT","561307.5.peg.261","1646"
"21565",339,189,150,"ATGCGTGGTTGAGGGTTACC","TGTATCGTTTGTGATAACGT","561307.5.peg.261","1646"
"21566",501,189,312,"TCTTGATAACGCGCTTCATA","TGTATCGTTTGTGATAACGT","561307.5.peg.261","1646"
"21567",290,189,101,"ATTCTAAAGCACCGAATCCA","TGTATCGTTTGTGATAACGT","561307.5.peg.261","1646"
"21568",347,189,158,"ATCTAAACATGCGTGGTTGA","TGTATCGTTTGTGATAACGT","561307.5.peg.261","1646"
"21569",354,189,165,"CTAATAATCTAAACATGCG","TGTATCGTTTGTGATAACGT","561307.5.peg.261","1646"
"21570",385,189,196,"GAAGCCCATTCGATTTATCA","TGTATCGTTTGTGATAACGT","561307.5.peg.261","1646"
"21571",333,189,144,"GGTTGAGGGTTACCCGGTTG","TGTATCGTTTGTGATAACGT","561307.5.peg.261","1646"
"21572",465,189,276,"ACACCAACATTGATACCAAC","TGTATCGTTTGTGATAACGT","561307.5.peg.261","1646"
"21573",339,231,108,"ATGCGTGGTTGAGGGTTACC","AAACCAGCTGCTAAGCCAAT","561307.5.peg.261","1646"
"21574",354,231,123,"CTAATAATCTAAACATGCG","AAACCAGCTGCTAAGCCAAT","561307.5.peg.261","1646"
"21575",333,231,102,"GGTTGAGGGTTACCCGGTTG","AAACCAGCTGCTAAGCCAAT","561307.5.peg.261","1646"
"21576",501,231,270,"TCTTGATAACGCGCTTCATA","AAACCAGCTGCTAAGCCAAT","561307.5.peg.261","1646"
"21577",385,231,154,"GAAGCCCATTCGATTTATCA","AAACCAGCTGCTAAGCCAAT","561307.5.peg.261","1646"
"21578",347,231,116,"ATCTAAACATGCGTGGTTGA","AAACCAGCTGCTAAGCCAAT","561307.5.peg.261","1646"
"21579",465,231,234,"ACACCAACATTGATACCAAC","AAACCAGCTGCTAAGCCAAT","561307.5.peg.261","1646"
"21580",155,290,135,"TAAATAGTTTATCGACGACT","ATTCTAAAGCACCGAATCCA","561307.5.peg.261","1646"
"21581",501,290,211,"TCTTGATAACGCGCTTCATA","ATTCTAAAGCACCGAATCCA","561307.5.peg.261","1646"
"21582",465,290,175,"ACACCAACATTGATACCAAC","ATTCTAAAGCACCGAATCCA","561307.5.peg.261","1646"
"21583",189,290,101,"TGTATCGTTTGTGATAACGT","ATTCTAAAGCACCGAATCCA","561307.5.peg.261","1646"
"21584",189,327,138,"TGTATCGTTTGTGATAACGT","GGGTTACCCGGTTGAGGTTT","561307.5.peg.261","1646"
"21585",501,327,174,"TCTTGATAACGCGCTTCATA","GGGTTACCCGGTTGAGGTTT","561307.5.peg.261","1646"
"21586",155,327,172,"TAAATAGTTTATCGACGACT","GGGTTACCCGGTTGAGGTTT","561307.5.peg.261","1646"
"21587",465,327,138,"ACACCAACATTGATACCAAC","GGGTTACCCGGTTGAGGTTT","561307.5.peg.261","1646"
"21588",155,333,178,"TAAATAGTTTATCGACGACT","GGTTGAGGGTTACCCGGTTG","561307.5.peg.261","1646"
"21589",231,333,102,"AAACCAGCTGCTAAGCCAAT","GGTTGAGGGTTACCCGGTTG","561307.5.peg.261","1646"
"21590",465,333,132,"ACACCAACATTGATACCAAC","GGTTGAGGGTTACCCGGTTG","561307.5.peg.261","1646"
"21591",501,333,168,"TCTTGATAACGCGCTTCATA","GGTTGAGGGTTACCCGGTTG","561307.5.peg.261","1646"
"21592",189,333,144,"TGTATCGTTTGTGATAACGT","GGTTGAGGGTTACCCGGTTG","561307.5.peg.261","1646"
"21593",155,339,184,"TAAATAGTTTATCGACGACT","ATGCGTGGTTGAGGGTTACC","561307.5.peg.261","1646"
"21594",231,339,108,"AAACCAGCTGCTAAGCCAAT","ATGCGTGGTTGAGGGTTACC","561307.5.peg.261","1646"
"21595",189,339,150,"TGTATCGTTTGTGATAACGT","ATGCGTGGTTGAGGGTTACC","561307.5.peg.261","1646"
"21596",501,339,162,"TCTTGATAACGCGCTTCATA","ATGCGTGGTTGAGGGTTACC","561307.5.peg.261","1646"
"21597",465,339,126,"ACACCAACATTGATACCAAC","ATGCGTGGTTGAGGGTTACC","561307.5.peg.261","1646"
"21598",189,347,158,"TGTATCGTTTGTGATAACGT","ATCTAAACATGCGTGGTTGA","561307.5.peg.261","1646"
"21599",231,347,116,"AAACCAGCTGCTAAGCCAAT","ATCTAAACATGCGTGGTTGA","561307.5.peg.261","1646"
"21600",501,347,154,"TCTTGATAACGCGCTTCATA","ATCTAAACATGCGTGGTTGA","561307.5.peg.261","1646"
"21601",155,347,192,"TAAATAGTTTATCGACGACT","ATCTAAACATGCGTGGTTGA","561307.5.peg.261","1646"
"21602",465,347,118,"ACACCAACATTGATACCAAC","ATCTAAACATGCGTGGTTGA","561307.5.peg.261","1646"
"21603",501,354,147,"TCTTGATAACGCGCTTCATA","CTAATAATCTAAACATGCG","561307.5.peg.261","1646"
"21604",155,354,199,"TAAATAGTTTATCGACGACT","CTAATAATCTAAACATGCG","561307.5.peg.261","1646"
"21605",231,354,123,"AAACCAGCTGCTAAGCCAAT","CTAATAATCTAAACATGCG","561307.5.peg.261","1646"
"21606",189,354,165,"TGTATCGTTTGTGATAACGT","CTAATAATCTAAACATGCG","561307.5.peg.261","1646"
"21607",465,354,111,"ACACCAACATTGATACCAAC","CTAATAATCTAAACATGCG","561307.5.peg.261","1646"
"21608",231,385,154,"AAACCAGCTGCTAAGCCAAT","GAAGCCCATTCGATTTATCA","561307.5.peg.261","1646"
"21609",501,385,116,"TCTTGATAACGCGCTTCATA","GAAGCCCATTCGATTTATCA","561307.5.peg.261","1646"
"21610",155,385,230,"TAAATAGTTTATCGACGACT","GAAGCCCATTCGATTTATCA","561307.5.peg.261","1646"
"21611",189,385,196,"TGTATCGTTTGTGATAACGT","GAAGCCCATTCGATTTATCA","561307.5.peg.261","1646"
"21612",189,465,276,"TGTATCGTTTGTGATAACGT","ACACCAACATTGATACCAAC","561307.5.peg.261","1646"
"21613",155,465,310,"TAAATAGTTTATCGACGACT","ACACCAACATTGATACCAAC","561307.5.peg.261","1646"
"21614",354,465,111,"CTAATAATCTAAACATGCG","ACACCAACATTGATACCAAC","561307.5.peg.261","1646"
"21615",231,465,234,"AAACCAGCTGCTAAGCCAAT","ACACCAACATTGATACCAAC","561307.5.peg.261","1646"
"21616",327,465,138,"GGGTTACCCGGTTGAGGTTT","ACACCAACATTGATACCAAC","561307.5.peg.261","1646"
"21617",290,465,175,"ATTCTAAAGCACCGAATCCA","ACACCAACATTGATACCAAC","561307.5.peg.261","1646"
"21618",333,465,132,"GGTTGAGGGTTACCCGGTTG","ACACCAACATTGATACCAAC","561307.5.peg.261","1646"
"21619",347,465,118,"ATCTAAACATGCGTGGTTGA","ACACCAACATTGATACCAAC","561307.5.peg.261","1646"
"21620",339,465,126,"ATGCGTGGTTGAGGGTTACC","ACACCAACATTGATACCAAC","561307.5.peg.261","1646"
"21621",347,501,154,"ATCTAAACATGCGTGGTTGA","TCTTGATAACGCGCTTCATA","561307.5.peg.261","1646"
"21622",155,501,346,"TAAATAGTTTATCGACGACT","TCTTGATAACGCGCTTCATA","561307.5.peg.261","1646"
"21623",385,501,116,"GAAGCCCATTCGATTTATCA","TCTTGATAACGCGCTTCATA","561307.5.peg.261","1646"
"21624",231,501,270,"AAACCAGCTGCTAAGCCAAT","TCTTGATAACGCGCTTCATA","561307.5.peg.261","1646"
"21625",327,501,174,"GGGTTACCCGGTTGAGGTTT","TCTTGATAACGCGCTTCATA","561307.5.peg.261","1646"
"21626",354,501,147,"CTAATAATCTAAACATGCG","TCTTGATAACGCGCTTCATA","561307.5.peg.261","1646"
"21627",189,501,312,"TGTATCGTTTGTGATAACGT","TCTTGATAACGCGCTTCATA","561307.5.peg.261","1646"
"21628",333,501,168,"GGTTGAGGGTTACCCGGTTG","TCTTGATAACGCGCTTCATA","561307.5.peg.261","1646"
"21629",290,501,211,"ATTCTAAAGCACCGAATCCA","TCTTGATAACGCGCTTCATA","561307.5.peg.261","1646"
"21630",339,501,162,"ATGCGTGGTTGAGGGTTACC","TCTTGATAACGCGCTTCATA","561307.5.peg.261","1646"
"21631",255,105,150,"TCGCCACTTGCAATTACTCT","TTTACATCACCACCACTCAC","561307.5.peg.262","1647"
"21632",341,105,236,"GAGCTACGAGTTGCCCTAAT","TTTACATCACCACCACTCAC","561307.5.peg.262","1647"
"21633",341,176,165,"GAGCTACGAGTTGCCCTAAT","ATGATTCTTTACGTCCACGT","561307.5.peg.262","1647"
"21634",105,255,150,"TTTACATCACCACCACTCAC","TCGCCACTTGCAATTACTCT","561307.5.peg.262","1647"
"21635",105,341,236,"TTTACATCACCACCACTCAC","GAGCTACGAGTTGCCCTAAT","561307.5.peg.262","1647"
"21636",176,341,165,"ATGATTCTTTACGTCCACGT","GAGCTACGAGTTGCCCTAAT","561307.5.peg.262","1647"
"21637",196,10,186,"AAATGATGGCGTGATCGTAC","ACTTGAAATAGATCATTGA","561307.5.peg.266","1651"
"21638",340,10,330,"GATATTCAGCTCGTAATGGT","ACTTGAAATAGATCATTGA","561307.5.peg.266","1651"
"21639",186,10,176,"GTGATCGTACGGGTCGATTT","ACTTGAAATAGATCATTGA","561307.5.peg.266","1651"
"21640",259,10,249,"AAATGCTGGTGAAGTATCCA","ACTTGAAATAGATCATTGA","561307.5.peg.266","1651"
"21641",344,10,334,"CAAAGATATTCAGCTCGTAA","ACTTGAAATAGATCATTGA","561307.5.peg.266","1651"
"21642",304,10,294,"ATATTCAGCATATGTTTCTC","ACTTGAAATAGATCATTGA","561307.5.peg.266","1651"
"21643",304,82,222,"ATATTCAGCATATGTTTCTC","CATACCTATACCTGCAGCAC","561307.5.peg.266","1651"
"21644",196,82,114,"AAATGATGGCGTGATCGTAC","CATACCTATACCTGCAGCAC","561307.5.peg.266","1651"
"21645",259,82,177,"AAATGCTGGTGAAGTATCCA","CATACCTATACCTGCAGCAC","561307.5.peg.266","1651"
"21646",340,82,258,"GATATTCAGCTCGTAATGGT","CATACCTATACCTGCAGCAC","561307.5.peg.266","1651"
"21647",344,82,262,"CAAAGATATTCAGCTCGTAA","CATACCTATACCTGCAGCAC","561307.5.peg.266","1651"
"21648",186,82,104,"GTGATCGTACGGGTCGATTT","CATACCTATACCTGCAGCAC","561307.5.peg.266","1651"
"21649",10,186,176,"ACTTGAAATAGATCATTGA","GTGATCGTACGGGTCGATTT","561307.5.peg.266","1651"
"21650",304,186,118,"ATATTCAGCATATGTTTCTC","GTGATCGTACGGGTCGATTT","561307.5.peg.266","1651"
"21651",344,186,158,"CAAAGATATTCAGCTCGTAA","GTGATCGTACGGGTCGATTT","561307.5.peg.266","1651"
"21652",340,186,154,"GATATTCAGCTCGTAATGGT","GTGATCGTACGGGTCGATTT","561307.5.peg.266","1651"
"21653",82,186,104,"CATACCTATACCTGCAGCAC","GTGATCGTACGGGTCGATTT","561307.5.peg.266","1651"
"21654",344,196,148,"CAAAGATATTCAGCTCGTAA","AAATGATGGCGTGATCGTAC","561307.5.peg.266","1651"
"21655",10,196,186,"ACTTGAAATAGATCATTGA","AAATGATGGCGTGATCGTAC","561307.5.peg.266","1651"
"21656",82,196,114,"CATACCTATACCTGCAGCAC","AAATGATGGCGTGATCGTAC","561307.5.peg.266","1651"
"21657",304,196,108,"ATATTCAGCATATGTTTCTC","AAATGATGGCGTGATCGTAC","561307.5.peg.266","1651"
"21658",340,196,144,"GATATTCAGCTCGTAATGGT","AAATGATGGCGTGATCGTAC","561307.5.peg.266","1651"
"21659",82,259,177,"CATACCTATACCTGCAGCAC","AAATGCTGGTGAAGTATCCA","561307.5.peg.266","1651"
"21660",10,259,249,"ACTTGAAATAGATCATTGA","AAATGCTGGTGAAGTATCCA","561307.5.peg.266","1651"
"21661",82,304,222,"CATACCTATACCTGCAGCAC","ATATTCAGCATATGTTTCTC","561307.5.peg.266","1651"
"21662",186,304,118,"GTGATCGTACGGGTCGATTT","ATATTCAGCATATGTTTCTC","561307.5.peg.266","1651"
"21663",196,304,108,"AAATGATGGCGTGATCGTAC","ATATTCAGCATATGTTTCTC","561307.5.peg.266","1651"
"21664",10,304,294,"ACTTGAAATAGATCATTGA","ATATTCAGCATATGTTTCTC","561307.5.peg.266","1651"
"21665",10,340,330,"ACTTGAAATAGATCATTGA","GATATTCAGCTCGTAATGGT","561307.5.peg.266","1651"
"21666",82,340,258,"CATACCTATACCTGCAGCAC","GATATTCAGCTCGTAATGGT","561307.5.peg.266","1651"
"21667",186,340,154,"GTGATCGTACGGGTCGATTT","GATATTCAGCTCGTAATGGT","561307.5.peg.266","1651"
"21668",196,340,144,"AAATGATGGCGTGATCGTAC","GATATTCAGCTCGTAATGGT","561307.5.peg.266","1651"
"21669",10,344,334,"ACTTGAAATAGATCATTGA","CAAAGATATTCAGCTCGTAA","561307.5.peg.266","1651"
"21670",82,344,262,"CATACCTATACCTGCAGCAC","CAAAGATATTCAGCTCGTAA","561307.5.peg.266","1651"
"21671",196,344,148,"AAATGATGGCGTGATCGTAC","CAAAGATATTCAGCTCGTAA","561307.5.peg.266","1651"
"21672",186,344,158,"GTGATCGTACGGGTCGATTT","CAAAGATATTCAGCTCGTAA","561307.5.peg.266","1651"
"21673",228,93,135,"ATCACATGTTCACTCGCTAT","TAATGAGGTTCATTAGGTAT","561307.5.peg.267","1652"
"21674",351,93,258,"AATTGATAAGCGATACCGAT","TAATGAGGTTCATTAGGTAT","561307.5.peg.267","1652"
"21675",228,99,129,"ATCACATGTTCACTCGCTAT","CCAAATAATGAGGTTCATT","561307.5.peg.267","1652"
"21676",351,99,252,"AATTGATAAGCGATACCGAT","CCAAATAATGAGGTTCATT","561307.5.peg.267","1652"
"21677",93,228,135,"TAATGAGGTTCATTAGGTAT","ATCACATGTTCACTCGCTAT","561307.5.peg.267","1652"
"21678",351,228,123,"AATTGATAAGCGATACCGAT","ATCACATGTTCACTCGCTAT","561307.5.peg.267","1652"
"21679",99,228,129,"CCAAATAATGAGGTTCATT","ATCACATGTTCACTCGCTAT","561307.5.peg.267","1652"
"21680",99,351,252,"CCAAATAATGAGGTTCATT","AATTGATAAGCGATACCGAT","561307.5.peg.267","1652"
"21681",93,351,258,"TAATGAGGTTCATTAGGTAT","AATTGATAAGCGATACCGAT","561307.5.peg.267","1652"
"21682",228,351,123,"ATCACATGTTCACTCGCTAT","AATTGATAAGCGATACCGAT","561307.5.peg.267","1652"
"21683",339,144,195,"CAAGCATCTAAGACAGAGAC","AATTCATTCATGATGACTGC","561307.5.peg.269","1654"
"21684",449,144,305,"ATAAGCCTTGGATGTCTTTA","AATTCATTCATGATGACTGC","561307.5.peg.269","1654"
"21685",339,210,129,"CAAGCATCTAAGACAGAGAC","CCCTCTGTCAGTTCACTTAA","561307.5.peg.269","1654"
"21686",449,210,239,"ATAAGCCTTGGATGTCTTTA","CCCTCTGTCAGTTCACTTAA","561307.5.peg.269","1654"
"21687",144,339,195,"AATTCATTCATGATGACTGC","CAAGCATCTAAGACAGAGAC","561307.5.peg.269","1654"
"21688",449,339,110,"ATAAGCCTTGGATGTCTTTA","CAAGCATCTAAGACAGAGAC","561307.5.peg.269","1654"
"21689",210,339,129,"CCCTCTGTCAGTTCACTTAA","CAAGCATCTAAGACAGAGAC","561307.5.peg.269","1654"
"21690",210,449,239,"CCCTCTGTCAGTTCACTTAA","ATAAGCCTTGGATGTCTTTA","561307.5.peg.269","1654"
"21691",144,449,305,"AATTCATTCATGATGACTGC","ATAAGCCTTGGATGTCTTTA","561307.5.peg.269","1654"
"21692",339,449,110,"CAAGCATCTAAGACAGAGAC","ATAAGCCTTGGATGTCTTTA","561307.5.peg.269","1654"
"21693",915,99,816,"ATCTTCGCTATCCATGTAGA","GCCCTCAAACCATCGAGCCC","561307.5.peg.27","1655"
"21694",915,149,766,"ATCTTCGCTATCCATGTAGA","CAACCATTGCTTATTTAAG","561307.5.peg.27","1655"
"21695",99,915,816,"GCCCTCAAACCATCGAGCCC","ATCTTCGCTATCCATGTAGA","561307.5.peg.27","1655"
"21696",149,915,766,"CAACCATTGCTTATTTAAG","ATCTTCGCTATCCATGTAGA","561307.5.peg.27","1655"
"21697",253,10,243,"ATCACTGTCAGGGTTTGAAG","CCTAACAATTAACAAATGG","561307.5.peg.270","1656"
"21698",245,10,235,"CAGGGTTTGAAGCGGAATCA","CCTAACAATTAACAAATGG","561307.5.peg.270","1656"
"21699",126,10,116,"TCTCCGGTACCGTTTGCACC","CCTAACAATTAACAAATGG","561307.5.peg.270","1656"
"21700",240,10,230,"TTTGAAGCGGAATCAGGGAG","CCTAACAATTAACAAATGG","561307.5.peg.270","1656"
"21701",199,10,189,"TCCATAATCACGACGATCAA","CCTAACAATTAACAAATGG","561307.5.peg.270","1656"
"21702",263,10,253,"TGACACGATAATCACTGTCA","CCTAACAATTAACAAATGG","561307.5.peg.270","1656"
"21703",307,10,297,"ACTTAATGACTTTGCAAGTT","CCTAACAATTAACAAATGG","561307.5.peg.270","1656"
"21704",199,89,110,"TCCATAATCACGACGATCAA","CGGGTCCTTGTCCGACTTGG","561307.5.peg.270","1656"
"21705",263,89,174,"TGACACGATAATCACTGTCA","CGGGTCCTTGTCCGACTTGG","561307.5.peg.270","1656"
"21706",307,89,218,"ACTTAATGACTTTGCAAGTT","CGGGTCCTTGTCCGACTTGG","561307.5.peg.270","1656"
"21707",240,89,151,"TTTGAAGCGGAATCAGGGAG","CGGGTCCTTGTCCGACTTGG","561307.5.peg.270","1656"
"21708",253,89,164,"ATCACTGTCAGGGTTTGAAG","CGGGTCCTTGTCCGACTTGG","561307.5.peg.270","1656"
"21709",245,89,156,"CAGGGTTTGAAGCGGAATCA","CGGGTCCTTGTCCGACTTGG","561307.5.peg.270","1656"
"21710",307,92,215,"ACTTAATGACTTTGCAAGTT","GCACGGGTCCTTGTCCGACT","561307.5.peg.270","1656"
"21711",263,92,171,"TGACACGATAATCACTGTCA","GCACGGGTCCTTGTCCGACT","561307.5.peg.270","1656"
"21712",245,92,153,"CAGGGTTTGAAGCGGAATCA","GCACGGGTCCTTGTCCGACT","561307.5.peg.270","1656"
"21713",240,92,148,"TTTGAAGCGGAATCAGGGAG","GCACGGGTCCTTGTCCGACT","561307.5.peg.270","1656"
"21714",199,92,107,"TCCATAATCACGACGATCAA","GCACGGGTCCTTGTCCGACT","561307.5.peg.270","1656"
"21715",253,92,161,"ATCACTGTCAGGGTTTGAAG","GCACGGGTCCTTGTCCGACT","561307.5.peg.270","1656"
"21716",240,108,132,"TTTGAAGCGGAATCAGGGAG","CCAGGAATAAAGATGAGCAC","561307.5.peg.270","1656"
"21717",263,108,155,"TGACACGATAATCACTGTCA","CCAGGAATAAAGATGAGCAC","561307.5.peg.270","1656"
"21718",253,108,145,"ATCACTGTCAGGGTTTGAAG","CCAGGAATAAAGATGAGCAC","561307.5.peg.270","1656"
"21719",245,108,137,"CAGGGTTTGAAGCGGAATCA","CCAGGAATAAAGATGAGCAC","561307.5.peg.270","1656"
"21720",307,108,199,"ACTTAATGACTTTGCAAGTT","CCAGGAATAAAGATGAGCAC","561307.5.peg.270","1656"
"21721",253,126,127,"ATCACTGTCAGGGTTTGAAG","TCTCCGGTACCGTTTGCACC","561307.5.peg.270","1656"
"21722",10,126,116,"CCTAACAATTAACAAATGG","TCTCCGGTACCGTTTGCACC","561307.5.peg.270","1656"
"21723",245,126,119,"CAGGGTTTGAAGCGGAATCA","TCTCCGGTACCGTTTGCACC","561307.5.peg.270","1656"
"21724",307,126,181,"ACTTAATGACTTTGCAAGTT","TCTCCGGTACCGTTTGCACC","561307.5.peg.270","1656"
"21725",240,126,114,"TTTGAAGCGGAATCAGGGAG","TCTCCGGTACCGTTTGCACC","561307.5.peg.270","1656"
"21726",263,126,137,"TGACACGATAATCACTGTCA","TCTCCGGTACCGTTTGCACC","561307.5.peg.270","1656"
"21727",10,199,189,"CCTAACAATTAACAAATGG","TCCATAATCACGACGATCAA","561307.5.peg.270","1656"
"21728",89,199,110,"CGGGTCCTTGTCCGACTTGG","TCCATAATCACGACGATCAA","561307.5.peg.270","1656"
"21729",92,199,107,"GCACGGGTCCTTGTCCGACT","TCCATAATCACGACGATCAA","561307.5.peg.270","1656"
"21730",307,199,108,"ACTTAATGACTTTGCAAGTT","TCCATAATCACGACGATCAA","561307.5.peg.270","1656"
"21731",10,240,230,"CCTAACAATTAACAAATGG","TTTGAAGCGGAATCAGGGAG","561307.5.peg.270","1656"
"21732",108,240,132,"CCAGGAATAAAGATGAGCAC","TTTGAAGCGGAATCAGGGAG","561307.5.peg.270","1656"
"21733",89,240,151,"CGGGTCCTTGTCCGACTTGG","TTTGAAGCGGAATCAGGGAG","561307.5.peg.270","1656"
"21734",126,240,114,"TCTCCGGTACCGTTTGCACC","TTTGAAGCGGAATCAGGGAG","561307.5.peg.270","1656"
"21735",92,240,148,"GCACGGGTCCTTGTCCGACT","TTTGAAGCGGAATCAGGGAG","561307.5.peg.270","1656"
"21736",89,245,156,"CGGGTCCTTGTCCGACTTGG","CAGGGTTTGAAGCGGAATCA","561307.5.peg.270","1656"
"21737",92,245,153,"GCACGGGTCCTTGTCCGACT","CAGGGTTTGAAGCGGAATCA","561307.5.peg.270","1656"
"21738",108,245,137,"CCAGGAATAAAGATGAGCAC","CAGGGTTTGAAGCGGAATCA","561307.5.peg.270","1656"
"21739",10,245,235,"CCTAACAATTAACAAATGG","CAGGGTTTGAAGCGGAATCA","561307.5.peg.270","1656"
"21740",126,245,119,"TCTCCGGTACCGTTTGCACC","CAGGGTTTGAAGCGGAATCA","561307.5.peg.270","1656"
"21741",10,253,243,"CCTAACAATTAACAAATGG","ATCACTGTCAGGGTTTGAAG","561307.5.peg.270","1656"
"21742",89,253,164,"CGGGTCCTTGTCCGACTTGG","ATCACTGTCAGGGTTTGAAG","561307.5.peg.270","1656"
"21743",92,253,161,"GCACGGGTCCTTGTCCGACT","ATCACTGTCAGGGTTTGAAG","561307.5.peg.270","1656"
"21744",126,253,127,"TCTCCGGTACCGTTTGCACC","ATCACTGTCAGGGTTTGAAG","561307.5.peg.270","1656"
"21745",108,253,145,"CCAGGAATAAAGATGAGCAC","ATCACTGTCAGGGTTTGAAG","561307.5.peg.270","1656"
"21746",10,263,253,"CCTAACAATTAACAAATGG","TGACACGATAATCACTGTCA","561307.5.peg.270","1656"
"21747",89,263,174,"CGGGTCCTTGTCCGACTTGG","TGACACGATAATCACTGTCA","561307.5.peg.270","1656"
"21748",126,263,137,"TCTCCGGTACCGTTTGCACC","TGACACGATAATCACTGTCA","561307.5.peg.270","1656"
"21749",92,263,171,"GCACGGGTCCTTGTCCGACT","TGACACGATAATCACTGTCA","561307.5.peg.270","1656"
"21750",108,263,155,"CCAGGAATAAAGATGAGCAC","TGACACGATAATCACTGTCA","561307.5.peg.270","1656"
"21751",92,307,215,"GCACGGGTCCTTGTCCGACT","ACTTAATGACTTTGCAAGTT","561307.5.peg.270","1656"
"21752",89,307,218,"CGGGTCCTTGTCCGACTTGG","ACTTAATGACTTTGCAAGTT","561307.5.peg.270","1656"
"21753",10,307,297,"CCTAACAATTAACAAATGG","ACTTAATGACTTTGCAAGTT","561307.5.peg.270","1656"
"21754",126,307,181,"TCTCCGGTACCGTTTGCACC","ACTTAATGACTTTGCAAGTT","561307.5.peg.270","1656"
"21755",199,307,108,"TCCATAATCACGACGATCAA","ACTTAATGACTTTGCAAGTT","561307.5.peg.270","1656"
"21756",108,307,199,"CCAGGAATAAAGATGAGCAC","ACTTAATGACTTTGCAAGTT","561307.5.peg.270","1656"
"21757",405,129,276,"AATTCTCGCGCTGCGGCTTC","ACTTTCATCGGTACACCTTT","561307.5.peg.271","1657"
"21758",282,129,153,"TTCTGACCAACCAAATTTGA","ACTTTCATCGGTACACCTTT","561307.5.peg.271","1657"
"21759",412,129,283,"ACGTTCGAATTCTCGCGCTG","ACTTTCATCGGTACACCTTT","561307.5.peg.271","1657"
"21760",363,129,234,"GCAAAGCCTACAAAGCGATT","ACTTTCATCGGTACACCTTT","561307.5.peg.271","1657"
"21761",393,129,264,"GCGGCTTCAGGCTCATTGAT","ACTTTCATCGGTACACCTTT","561307.5.peg.271","1657"
"21762",412,141,271,"ACGTTCGAATTCTCGCGCTG","CCTTCTAACATTACTTTCAT","561307.5.peg.271","1657"
"21763",393,141,252,"GCGGCTTCAGGCTCATTGAT","CCTTCTAACATTACTTTCAT","561307.5.peg.271","1657"
"21764",282,141,141,"TTCTGACCAACCAAATTTGA","CCTTCTAACATTACTTTCAT","561307.5.peg.271","1657"
"21765",405,141,264,"AATTCTCGCGCTGCGGCTTC","CCTTCTAACATTACTTTCAT","561307.5.peg.271","1657"
"21766",363,141,222,"GCAAAGCCTACAAAGCGATT","CCTTCTAACATTACTTTCAT","561307.5.peg.271","1657"
"21767",363,193,170,"GCAAAGCCTACAAAGCGATT","ATCATGATGTGATAATTCGT","561307.5.peg.271","1657"
"21768",393,193,200,"GCGGCTTCAGGCTCATTGAT","ATCATGATGTGATAATTCGT","561307.5.peg.271","1657"
"21769",405,193,212,"AATTCTCGCGCTGCGGCTTC","ATCATGATGTGATAATTCGT","561307.5.peg.271","1657"
"21770",412,193,219,"ACGTTCGAATTCTCGCGCTG","ATCATGATGTGATAATTCGT","561307.5.peg.271","1657"
"21771",393,282,111,"GCGGCTTCAGGCTCATTGAT","TTCTGACCAACCAAATTTGA","561307.5.peg.271","1657"
"21772",129,282,153,"ACTTTCATCGGTACACCTTT","TTCTGACCAACCAAATTTGA","561307.5.peg.271","1657"
"21773",412,282,130,"ACGTTCGAATTCTCGCGCTG","TTCTGACCAACCAAATTTGA","561307.5.peg.271","1657"
"21774",141,282,141,"CCTTCTAACATTACTTTCAT","TTCTGACCAACCAAATTTGA","561307.5.peg.271","1657"
"21775",405,282,123,"AATTCTCGCGCTGCGGCTTC","TTCTGACCAACCAAATTTGA","561307.5.peg.271","1657"
"21776",129,363,234,"ACTTTCATCGGTACACCTTT","GCAAAGCCTACAAAGCGATT","561307.5.peg.271","1657"
"21777",193,363,170,"ATCATGATGTGATAATTCGT","GCAAAGCCTACAAAGCGATT","561307.5.peg.271","1657"
"21778",141,363,222,"CCTTCTAACATTACTTTCAT","GCAAAGCCTACAAAGCGATT","561307.5.peg.271","1657"
"21779",282,393,111,"TTCTGACCAACCAAATTTGA","GCGGCTTCAGGCTCATTGAT","561307.5.peg.271","1657"
"21780",141,393,252,"CCTTCTAACATTACTTTCAT","GCGGCTTCAGGCTCATTGAT","561307.5.peg.271","1657"
"21781",129,393,264,"ACTTTCATCGGTACACCTTT","GCGGCTTCAGGCTCATTGAT","561307.5.peg.271","1657"
"21782",193,393,200,"ATCATGATGTGATAATTCGT","GCGGCTTCAGGCTCATTGAT","561307.5.peg.271","1657"
"21783",141,405,264,"CCTTCTAACATTACTTTCAT","AATTCTCGCGCTGCGGCTTC","561307.5.peg.271","1657"
"21784",129,405,276,"ACTTTCATCGGTACACCTTT","AATTCTCGCGCTGCGGCTTC","561307.5.peg.271","1657"
"21785",193,405,212,"ATCATGATGTGATAATTCGT","AATTCTCGCGCTGCGGCTTC","561307.5.peg.271","1657"
"21786",282,405,123,"TTCTGACCAACCAAATTTGA","AATTCTCGCGCTGCGGCTTC","561307.5.peg.271","1657"
"21787",129,412,283,"ACTTTCATCGGTACACCTTT","ACGTTCGAATTCTCGCGCTG","561307.5.peg.271","1657"
"21788",193,412,219,"ATCATGATGTGATAATTCGT","ACGTTCGAATTCTCGCGCTG","561307.5.peg.271","1657"
"21789",282,412,130,"TTCTGACCAACCAAATTTGA","ACGTTCGAATTCTCGCGCTG","561307.5.peg.271","1657"
"21790",141,412,271,"CCTTCTAACATTACTTTCAT","ACGTTCGAATTCTCGCGCTG","561307.5.peg.271","1657"
"21791",245,93,152,"CAGATAATGTGTAGTCTAGG","TGTTTGGTTCTAACGATTCT","561307.5.peg.279","1665"
"21792",248,93,155,"TACAGATAATGTGTAGTCT","TGTTTGGTTCTAACGATTCT","561307.5.peg.279","1665"
"21793",93,245,152,"TGTTTGGTTCTAACGATTCT","CAGATAATGTGTAGTCTAGG","561307.5.peg.279","1665"
"21794",93,248,155,"TGTTTGGTTCTAACGATTCT","TACAGATAATGTGTAGTCT","561307.5.peg.279","1665"
"21795",104,1,103,"CGATATCAATTCCTAATTCA","TGACATTAAAGAGGTGATA","561307.5.peg.28","1666"
"21796",1,104,103,"TGACATTAAAGAGGTGATA","CGATATCAATTCCTAATTCA","561307.5.peg.28","1666"
"21797",262,112,150,"TGGCGATAGGTCAAATTTCA","TAAACCCGCAACAATACCTA","561307.5.peg.281","1668"
"21798",237,112,125,"ACCAATGCACCAATCAAAGC","TAAACCCGCAACAATACCTA","561307.5.peg.281","1668"
"21799",541,112,429,"ACCATTAACCATATTACCGA","TAAACCCGCAACAATACCTA","561307.5.peg.281","1668"
"21800",275,112,163,"CAGCAATTGCTAATGGCGAT","TAAACCCGCAACAATACCTA","561307.5.peg.281","1668"
"21801",112,237,125,"TAAACCCGCAACAATACCTA","ACCAATGCACCAATCAAAGC","561307.5.peg.281","1668"
"21802",541,237,304,"ACCATTAACCATATTACCGA","ACCAATGCACCAATCAAAGC","561307.5.peg.281","1668"
"21803",112,262,150,"TAAACCCGCAACAATACCTA","TGGCGATAGGTCAAATTTCA","561307.5.peg.281","1668"
"21804",541,262,279,"ACCATTAACCATATTACCGA","TGGCGATAGGTCAAATTTCA","561307.5.peg.281","1668"
"21805",112,275,163,"TAAACCCGCAACAATACCTA","CAGCAATTGCTAATGGCGAT","561307.5.peg.281","1668"
"21806",541,275,266,"ACCATTAACCATATTACCGA","CAGCAATTGCTAATGGCGAT","561307.5.peg.281","1668"
"21807",112,541,429,"TAAACCCGCAACAATACCTA","ACCATTAACCATATTACCGA","561307.5.peg.281","1668"
"21808",237,541,304,"ACCAATGCACCAATCAAAGC","ACCATTAACCATATTACCGA","561307.5.peg.281","1668"
"21809",262,541,279,"TGGCGATAGGTCAAATTTCA","ACCATTAACCATATTACCGA","561307.5.peg.281","1668"
"21810",275,541,266,"CAGCAATTGCTAATGGCGAT","ACCATTAACCATATTACCGA","561307.5.peg.281","1668"
"21811",371,210,161,"CTGATTGTACATTTGAACCT","TCATATGCACCATCTTTGAT","561307.5.peg.282","1669"
"21812",210,371,161,"TCATATGCACCATCTTTGAT","CTGATTGTACATTTGAACCT","561307.5.peg.282","1669"
"21813",464,91,373,"TGAGTGGTTCAATAGCAAAT","TAATCCAGGTAAGTATCGCG","561307.5.peg.284","1671"
"21814",570,91,479,"GCGTTTGAATAATATTTCT","TAATCCAGGTAAGTATCGCG","561307.5.peg.284","1671"
"21815",533,91,442,"ATAAGAACGTGATAACCAAT","TAATCCAGGTAAGTATCGCG","561307.5.peg.284","1671"
"21816",480,91,389,"AAGACCATAAATGTTTGAG","TAATCCAGGTAAGTATCGCG","561307.5.peg.284","1671"
"21817",464,93,371,"TGAGTGGTTCAATAGCAAAT","TCTAATCCAGGTAAGTATCG","561307.5.peg.284","1671"
"21818",570,93,477,"GCGTTTGAATAATATTTCT","TCTAATCCAGGTAAGTATCG","561307.5.peg.284","1671"
"21819",533,93,440,"ATAAGAACGTGATAACCAAT","TCTAATCCAGGTAAGTATCG","561307.5.peg.284","1671"
"21820",480,93,387,"AAGACCATAAATGTTTGAG","TCTAATCCAGGTAAGTATCG","561307.5.peg.284","1671"
"21821",480,105,375,"AAGACCATAAATGTTTGAG","GCCCTCAATCCATCTAATCC","561307.5.peg.284","1671"
"21822",464,105,359,"TGAGTGGTTCAATAGCAAAT","GCCCTCAATCCATCTAATCC","561307.5.peg.284","1671"
"21823",570,105,465,"GCGTTTGAATAATATTTCT","GCCCTCAATCCATCTAATCC","561307.5.peg.284","1671"
"21824",533,105,428,"ATAAGAACGTGATAACCAAT","GCCCTCAATCCATCTAATCC","561307.5.peg.284","1671"
"21825",91,464,373,"TAATCCAGGTAAGTATCGCG","TGAGTGGTTCAATAGCAAAT","561307.5.peg.284","1671"
"21826",570,464,106,"GCGTTTGAATAATATTTCT","TGAGTGGTTCAATAGCAAAT","561307.5.peg.284","1671"
"21827",93,464,371,"TCTAATCCAGGTAAGTATCG","TGAGTGGTTCAATAGCAAAT","561307.5.peg.284","1671"
"21828",105,464,359,"GCCCTCAATCCATCTAATCC","TGAGTGGTTCAATAGCAAAT","561307.5.peg.284","1671"
"21829",91,480,389,"TAATCCAGGTAAGTATCGCG","AAGACCATAAATGTTTGAG","561307.5.peg.284","1671"
"21830",93,480,387,"TCTAATCCAGGTAAGTATCG","AAGACCATAAATGTTTGAG","561307.5.peg.284","1671"
"21831",105,480,375,"GCCCTCAATCCATCTAATCC","AAGACCATAAATGTTTGAG","561307.5.peg.284","1671"
"21832",91,533,442,"TAATCCAGGTAAGTATCGCG","ATAAGAACGTGATAACCAAT","561307.5.peg.284","1671"
"21833",105,533,428,"GCCCTCAATCCATCTAATCC","ATAAGAACGTGATAACCAAT","561307.5.peg.284","1671"
"21834",93,533,440,"TCTAATCCAGGTAAGTATCG","ATAAGAACGTGATAACCAAT","561307.5.peg.284","1671"
"21835",105,570,465,"GCCCTCAATCCATCTAATCC","GCGTTTGAATAATATTTCT","561307.5.peg.284","1671"
"21836",93,570,477,"TCTAATCCAGGTAAGTATCG","GCGTTTGAATAATATTTCT","561307.5.peg.284","1671"
"21837",91,570,479,"TAATCCAGGTAAGTATCGCG","GCGTTTGAATAATATTTCT","561307.5.peg.284","1671"
"21838",464,570,106,"TGAGTGGTTCAATAGCAAAT","GCGTTTGAATAATATTTCT","561307.5.peg.284","1671"
"21839",327,2,325,"AAATCGATAGTCGTTCCATC","CGTAGTAACTGCGTTAATCT","561307.5.peg.287","1674"
"21840",591,2,589,"CCTAACATTTGTCGCAAGTA","CGTAGTAACTGCGTTAATCT","561307.5.peg.287","1674"
"21841",677,2,675,"GGCCTTGCTCTTGTTGCATA","CGTAGTAACTGCGTTAATCT","561307.5.peg.287","1674"
"21842",698,2,696,"TTCCACCTTCTACATACCAA","CGTAGTAACTGCGTTAATCT","561307.5.peg.287","1674"
"21843",722,2,720,"CCAAGGCATTGGCTAAATGA","CGTAGTAACTGCGTTAATCT","561307.5.peg.287","1674"
"21844",568,2,566,"ATTCGAGATACGCTTGTCTA","CGTAGTAACTGCGTTAATCT","561307.5.peg.287","1674"
"21845",698,327,371,"TTCCACCTTCTACATACCAA","AAATCGATAGTCGTTCCATC","561307.5.peg.287","1674"
"21846",568,327,241,"ATTCGAGATACGCTTGTCTA","AAATCGATAGTCGTTCCATC","561307.5.peg.287","1674"
"21847",2,327,325,"CGTAGTAACTGCGTTAATCT","AAATCGATAGTCGTTCCATC","561307.5.peg.287","1674"
"21848",591,327,264,"CCTAACATTTGTCGCAAGTA","AAATCGATAGTCGTTCCATC","561307.5.peg.287","1674"
"21849",722,327,395,"CCAAGGCATTGGCTAAATGA","AAATCGATAGTCGTTCCATC","561307.5.peg.287","1674"
"21850",677,327,350,"GGCCTTGCTCTTGTTGCATA","AAATCGATAGTCGTTCCATC","561307.5.peg.287","1674"
"21851",2,568,566,"CGTAGTAACTGCGTTAATCT","ATTCGAGATACGCTTGTCTA","561307.5.peg.287","1674"
"21852",698,568,130,"TTCCACCTTCTACATACCAA","ATTCGAGATACGCTTGTCTA","561307.5.peg.287","1674"
"21853",327,568,241,"AAATCGATAGTCGTTCCATC","ATTCGAGATACGCTTGTCTA","561307.5.peg.287","1674"
"21854",722,568,154,"CCAAGGCATTGGCTAAATGA","ATTCGAGATACGCTTGTCTA","561307.5.peg.287","1674"
"21855",677,568,109,"GGCCTTGCTCTTGTTGCATA","ATTCGAGATACGCTTGTCTA","561307.5.peg.287","1674"
"21856",327,591,264,"AAATCGATAGTCGTTCCATC","CCTAACATTTGTCGCAAGTA","561307.5.peg.287","1674"
"21857",2,591,589,"CGTAGTAACTGCGTTAATCT","CCTAACATTTGTCGCAAGTA","561307.5.peg.287","1674"
"21858",698,591,107,"TTCCACCTTCTACATACCAA","CCTAACATTTGTCGCAAGTA","561307.5.peg.287","1674"
"21859",722,591,131,"CCAAGGCATTGGCTAAATGA","CCTAACATTTGTCGCAAGTA","561307.5.peg.287","1674"
"21860",327,677,350,"AAATCGATAGTCGTTCCATC","GGCCTTGCTCTTGTTGCATA","561307.5.peg.287","1674"
"21861",2,677,675,"CGTAGTAACTGCGTTAATCT","GGCCTTGCTCTTGTTGCATA","561307.5.peg.287","1674"
"21862",568,677,109,"ATTCGAGATACGCTTGTCTA","GGCCTTGCTCTTGTTGCATA","561307.5.peg.287","1674"
"21863",568,698,130,"ATTCGAGATACGCTTGTCTA","TTCCACCTTCTACATACCAA","561307.5.peg.287","1674"
"21864",2,698,696,"CGTAGTAACTGCGTTAATCT","TTCCACCTTCTACATACCAA","561307.5.peg.287","1674"
"21865",591,698,107,"CCTAACATTTGTCGCAAGTA","TTCCACCTTCTACATACCAA","561307.5.peg.287","1674"
"21866",327,698,371,"AAATCGATAGTCGTTCCATC","TTCCACCTTCTACATACCAA","561307.5.peg.287","1674"
"21867",568,722,154,"ATTCGAGATACGCTTGTCTA","CCAAGGCATTGGCTAAATGA","561307.5.peg.287","1674"
"21868",2,722,720,"CGTAGTAACTGCGTTAATCT","CCAAGGCATTGGCTAAATGA","561307.5.peg.287","1674"
"21869",327,722,395,"AAATCGATAGTCGTTCCATC","CCAAGGCATTGGCTAAATGA","561307.5.peg.287","1674"
"21870",591,722,131,"CCTAACATTTGTCGCAAGTA","CCAAGGCATTGGCTAAATGA","561307.5.peg.287","1674"
"21871",249,12,237,"TCATAACAATGACATCTAC","ACGCGCGAGAAGCGAAGAAT","561307.5.peg.288","1675"
"21872",418,12,406,"AGTTACATCAGCATCTACAA","ACGCGCGAGAAGCGAAGAAT","561307.5.peg.288","1675"
"21873",249,88,161,"TCATAACAATGACATCTAC","TGCACCACACGCCATAGACA","561307.5.peg.288","1675"
"21874",418,88,330,"AGTTACATCAGCATCTACAA","TGCACCACACGCCATAGACA","561307.5.peg.288","1675"
"21875",12,249,237,"ACGCGCGAGAAGCGAAGAAT","TCATAACAATGACATCTAC","561307.5.peg.288","1675"
"21876",418,249,169,"AGTTACATCAGCATCTACAA","TCATAACAATGACATCTAC","561307.5.peg.288","1675"
"21877",88,249,161,"TGCACCACACGCCATAGACA","TCATAACAATGACATCTAC","561307.5.peg.288","1675"
"21878",88,418,330,"TGCACCACACGCCATAGACA","AGTTACATCAGCATCTACAA","561307.5.peg.288","1675"
"21879",12,418,406,"ACGCGCGAGAAGCGAAGAAT","AGTTACATCAGCATCTACAA","561307.5.peg.288","1675"
"21880",249,418,169,"TCATAACAATGACATCTAC","AGTTACATCAGCATCTACAA","561307.5.peg.288","1675"
"21881",161,9,152,"TGCCAGTCGCAATCATAATT","ATGAACTAAGCAACTTATG","561307.5.peg.29","1677"
"21882",186,9,177,"TACATTTGACTTGCACGATA","ATGAACTAAGCAACTTATG","561307.5.peg.29","1677"
"21883",9,161,152,"ATGAACTAAGCAACTTATG","TGCCAGTCGCAATCATAATT","561307.5.peg.29","1677"
"21884",9,186,177,"ATGAACTAAGCAACTTATG","TACATTTGACTTGCACGATA","561307.5.peg.29","1677"
"21885",207,100,107,"TCTGGCATCATGACAATTGT","ATGACCTTGAGAAGCAATAC","561307.5.peg.290","1678"
"21886",323,100,223,"GCACCGTTATACGATCATCG","ATGACCTTGAGAAGCAATAC","561307.5.peg.290","1678"
"21887",345,100,245,"GTAATTCAGCTAAATCTGT","ATGACCTTGAGAAGCAATAC","561307.5.peg.290","1678"
"21888",323,207,116,"GCACCGTTATACGATCATCG","TCTGGCATCATGACAATTGT","561307.5.peg.290","1678"
"21889",100,207,107,"ATGACCTTGAGAAGCAATAC","TCTGGCATCATGACAATTGT","561307.5.peg.290","1678"
"21890",345,207,138,"GTAATTCAGCTAAATCTGT","TCTGGCATCATGACAATTGT","561307.5.peg.290","1678"
"21891",100,323,223,"ATGACCTTGAGAAGCAATAC","GCACCGTTATACGATCATCG","561307.5.peg.290","1678"
"21892",207,323,116,"TCTGGCATCATGACAATTGT","GCACCGTTATACGATCATCG","561307.5.peg.290","1678"
"21893",207,345,138,"TCTGGCATCATGACAATTGT","GTAATTCAGCTAAATCTGT","561307.5.peg.290","1678"
"21894",100,345,245,"ATGACCTTGAGAAGCAATAC","GTAATTCAGCTAAATCTGT","561307.5.peg.290","1678"
"21895",483,7,476,"GACCAATCTGGCAAATAATG","GCTATGTTTAATGATAGAGG","561307.5.peg.291","1679"
"21896",158,7,151,"CTTGTGGCGTGGGCCCATCA","GCTATGTTTAATGATAGAGG","561307.5.peg.291","1679"
"21897",459,7,452,"GGTTCTAAATTAAGCGGGAC","GCTATGTTTAATGATAGAGG","561307.5.peg.291","1679"
"21898",495,7,488,"GAATCAACTTTGGACCAATC","GCTATGTTTAATGATAGAGG","561307.5.peg.291","1679"
"21899",411,7,404,"GCTAAATAATCCGTGTAGCC","GCTATGTTTAATGATAGAGG","561307.5.peg.291","1679"
"21900",168,7,161,"TCAATAATACCTTGTGGCGT","GCTATGTTTAATGATAGAGG","561307.5.peg.291","1679"
"21901",480,7,473,"CAATCTGGCAAATAATGTGG","GCTATGTTTAATGATAGAGG","561307.5.peg.291","1679"
"21902",366,7,359,"CCTGGATTGATAACACATGT","GCTATGTTTAATGATAGAGG","561307.5.peg.291","1679"
"21903",567,7,560,"TTCGTAGCTGTCGATCCAGT","GCTATGTTTAATGATAGAGG","561307.5.peg.291","1679"
"21904",384,7,377,"GGTAGTAATACATAGTCTCC","GCTATGTTTAATGATAGAGG","561307.5.peg.291","1679"
"21905",405,7,398,"TAATCCGTGTAGCCTGGATC","GCTATGTTTAATGATAGAGG","561307.5.peg.291","1679"
"21906",405,10,395,"TAATCCGTGTAGCCTGGATC","CAGGCTATGTTTAATGATAG","561307.5.peg.291","1679"
"21907",168,10,158,"TCAATAATACCTTGTGGCGT","CAGGCTATGTTTAATGATAG","561307.5.peg.291","1679"
"21908",366,10,356,"CCTGGATTGATAACACATGT","CAGGCTATGTTTAATGATAG","561307.5.peg.291","1679"
"21909",459,10,449,"GGTTCTAAATTAAGCGGGAC","CAGGCTATGTTTAATGATAG","561307.5.peg.291","1679"
"21910",495,10,485,"GAATCAACTTTGGACCAATC","CAGGCTATGTTTAATGATAG","561307.5.peg.291","1679"
"21911",411,10,401,"GCTAAATAATCCGTGTAGCC","CAGGCTATGTTTAATGATAG","561307.5.peg.291","1679"
"21912",158,10,148,"CTTGTGGCGTGGGCCCATCA","CAGGCTATGTTTAATGATAG","561307.5.peg.291","1679"
"21913",567,10,557,"TTCGTAGCTGTCGATCCAGT","CAGGCTATGTTTAATGATAG","561307.5.peg.291","1679"
"21914",384,10,374,"GGTAGTAATACATAGTCTCC","CAGGCTATGTTTAATGATAG","561307.5.peg.291","1679"
"21915",483,10,473,"GACCAATCTGGCAAATAATG","CAGGCTATGTTTAATGATAG","561307.5.peg.291","1679"
"21916",480,10,470,"CAATCTGGCAAATAATGTGG","CAGGCTATGTTTAATGATAG","561307.5.peg.291","1679"
"21917",459,17,442,"GGTTCTAAATTAAGCGGGAC","TCTATCATTAAACATAGCCT","561307.5.peg.291","1679"
"21918",158,17,141,"CTTGTGGCGTGGGCCCATCA","TCTATCATTAAACATAGCCT","561307.5.peg.291","1679"
"21919",405,17,388,"TAATCCGTGTAGCCTGGATC","TCTATCATTAAACATAGCCT","561307.5.peg.291","1679"
"21920",495,17,478,"GAATCAACTTTGGACCAATC","TCTATCATTAAACATAGCCT","561307.5.peg.291","1679"
"21921",384,17,367,"GGTAGTAATACATAGTCTCC","TCTATCATTAAACATAGCCT","561307.5.peg.291","1679"
"21922",168,17,151,"TCAATAATACCTTGTGGCGT","TCTATCATTAAACATAGCCT","561307.5.peg.291","1679"
"21923",480,17,463,"CAATCTGGCAAATAATGTGG","TCTATCATTAAACATAGCCT","561307.5.peg.291","1679"
"21924",366,17,349,"CCTGGATTGATAACACATGT","TCTATCATTAAACATAGCCT","561307.5.peg.291","1679"
"21925",483,17,466,"GACCAATCTGGCAAATAATG","TCTATCATTAAACATAGCCT","561307.5.peg.291","1679"
"21926",567,17,550,"TTCGTAGCTGTCGATCCAGT","TCTATCATTAAACATAGCCT","561307.5.peg.291","1679"
"21927",411,17,394,"GCTAAATAATCCGTGTAGCC","TCTATCATTAAACATAGCCT","561307.5.peg.291","1679"
"21928",495,29,466,"GAATCAACTTTGGACCAATC","AGGATTATGATAGTCGCCC","561307.5.peg.291","1679"
"21929",366,29,337,"CCTGGATTGATAACACATGT","AGGATTATGATAGTCGCCC","561307.5.peg.291","1679"
"21930",459,29,430,"GGTTCTAAATTAAGCGGGAC","AGGATTATGATAGTCGCCC","561307.5.peg.291","1679"
"21931",384,29,355,"GGTAGTAATACATAGTCTCC","AGGATTATGATAGTCGCCC","561307.5.peg.291","1679"
"21932",405,29,376,"TAATCCGTGTAGCCTGGATC","AGGATTATGATAGTCGCCC","561307.5.peg.291","1679"
"21933",483,29,454,"GACCAATCTGGCAAATAATG","AGGATTATGATAGTCGCCC","561307.5.peg.291","1679"
"21934",168,29,139,"TCAATAATACCTTGTGGCGT","AGGATTATGATAGTCGCCC","561307.5.peg.291","1679"
"21935",480,29,451,"CAATCTGGCAAATAATGTGG","AGGATTATGATAGTCGCCC","561307.5.peg.291","1679"
"21936",567,29,538,"TTCGTAGCTGTCGATCCAGT","AGGATTATGATAGTCGCCC","561307.5.peg.291","1679"
"21937",158,29,129,"CTTGTGGCGTGGGCCCATCA","AGGATTATGATAGTCGCCC","561307.5.peg.291","1679"
"21938",411,29,382,"GCTAAATAATCCGTGTAGCC","AGGATTATGATAGTCGCCC","561307.5.peg.291","1679"
"21939",7,158,151,"GCTATGTTTAATGATAGAGG","CTTGTGGCGTGGGCCCATCA","561307.5.peg.291","1679"
"21940",10,158,148,"CAGGCTATGTTTAATGATAG","CTTGTGGCGTGGGCCCATCA","561307.5.peg.291","1679"
"21941",411,158,253,"GCTAAATAATCCGTGTAGCC","CTTGTGGCGTGGGCCCATCA","561307.5.peg.291","1679"
"21942",384,158,226,"GGTAGTAATACATAGTCTCC","CTTGTGGCGTGGGCCCATCA","561307.5.peg.291","1679"
"21943",480,158,322,"CAATCTGGCAAATAATGTGG","CTTGTGGCGTGGGCCCATCA","561307.5.peg.291","1679"
"21944",567,158,409,"TTCGTAGCTGTCGATCCAGT","CTTGTGGCGTGGGCCCATCA","561307.5.peg.291","1679"
"21945",495,158,337,"GAATCAACTTTGGACCAATC","CTTGTGGCGTGGGCCCATCA","561307.5.peg.291","1679"
"21946",459,158,301,"GGTTCTAAATTAAGCGGGAC","CTTGTGGCGTGGGCCCATCA","561307.5.peg.291","1679"
"21947",405,158,247,"TAATCCGTGTAGCCTGGATC","CTTGTGGCGTGGGCCCATCA","561307.5.peg.291","1679"
"21948",17,158,141,"TCTATCATTAAACATAGCCT","CTTGTGGCGTGGGCCCATCA","561307.5.peg.291","1679"
"21949",29,158,129,"AGGATTATGATAGTCGCCC","CTTGTGGCGTGGGCCCATCA","561307.5.peg.291","1679"
"21950",366,158,208,"CCTGGATTGATAACACATGT","CTTGTGGCGTGGGCCCATCA","561307.5.peg.291","1679"
"21951",483,158,325,"GACCAATCTGGCAAATAATG","CTTGTGGCGTGGGCCCATCA","561307.5.peg.291","1679"
"21952",495,168,327,"GAATCAACTTTGGACCAATC","TCAATAATACCTTGTGGCGT","561307.5.peg.291","1679"
"21953",29,168,139,"AGGATTATGATAGTCGCCC","TCAATAATACCTTGTGGCGT","561307.5.peg.291","1679"
"21954",10,168,158,"CAGGCTATGTTTAATGATAG","TCAATAATACCTTGTGGCGT","561307.5.peg.291","1679"
"21955",411,168,243,"GCTAAATAATCCGTGTAGCC","TCAATAATACCTTGTGGCGT","561307.5.peg.291","1679"
"21956",405,168,237,"TAATCCGTGTAGCCTGGATC","TCAATAATACCTTGTGGCGT","561307.5.peg.291","1679"
"21957",7,168,161,"GCTATGTTTAATGATAGAGG","TCAATAATACCTTGTGGCGT","561307.5.peg.291","1679"
"21958",483,168,315,"GACCAATCTGGCAAATAATG","TCAATAATACCTTGTGGCGT","561307.5.peg.291","1679"
"21959",366,168,198,"CCTGGATTGATAACACATGT","TCAATAATACCTTGTGGCGT","561307.5.peg.291","1679"
"21960",459,168,291,"GGTTCTAAATTAAGCGGGAC","TCAATAATACCTTGTGGCGT","561307.5.peg.291","1679"
"21961",384,168,216,"GGTAGTAATACATAGTCTCC","TCAATAATACCTTGTGGCGT","561307.5.peg.291","1679"
"21962",17,168,151,"TCTATCATTAAACATAGCCT","TCAATAATACCTTGTGGCGT","561307.5.peg.291","1679"
"21963",567,168,399,"TTCGTAGCTGTCGATCCAGT","TCAATAATACCTTGTGGCGT","561307.5.peg.291","1679"
"21964",480,168,312,"CAATCTGGCAAATAATGTGG","TCAATAATACCTTGTGGCGT","561307.5.peg.291","1679"
"21965",7,366,359,"GCTATGTTTAATGATAGAGG","CCTGGATTGATAACACATGT","561307.5.peg.291","1679"
"21966",10,366,356,"CAGGCTATGTTTAATGATAG","CCTGGATTGATAACACATGT","561307.5.peg.291","1679"
"21967",17,366,349,"TCTATCATTAAACATAGCCT","CCTGGATTGATAACACATGT","561307.5.peg.291","1679"
"21968",483,366,117,"GACCAATCTGGCAAATAATG","CCTGGATTGATAACACATGT","561307.5.peg.291","1679"
"21969",495,366,129,"GAATCAACTTTGGACCAATC","CCTGGATTGATAACACATGT","561307.5.peg.291","1679"
"21970",168,366,198,"TCAATAATACCTTGTGGCGT","CCTGGATTGATAACACATGT","561307.5.peg.291","1679"
"21971",29,366,337,"AGGATTATGATAGTCGCCC","CCTGGATTGATAACACATGT","561307.5.peg.291","1679"
"21972",480,366,114,"CAATCTGGCAAATAATGTGG","CCTGGATTGATAACACATGT","561307.5.peg.291","1679"
"21973",567,366,201,"TTCGTAGCTGTCGATCCAGT","CCTGGATTGATAACACATGT","561307.5.peg.291","1679"
"21974",158,366,208,"CTTGTGGCGTGGGCCCATCA","CCTGGATTGATAACACATGT","561307.5.peg.291","1679"
"21975",158,384,226,"CTTGTGGCGTGGGCCCATCA","GGTAGTAATACATAGTCTCC","561307.5.peg.291","1679"
"21976",7,384,377,"GCTATGTTTAATGATAGAGG","GGTAGTAATACATAGTCTCC","561307.5.peg.291","1679"
"21977",495,384,111,"GAATCAACTTTGGACCAATC","GGTAGTAATACATAGTCTCC","561307.5.peg.291","1679"
"21978",168,384,216,"TCAATAATACCTTGTGGCGT","GGTAGTAATACATAGTCTCC","561307.5.peg.291","1679"
"21979",567,384,183,"TTCGTAGCTGTCGATCCAGT","GGTAGTAATACATAGTCTCC","561307.5.peg.291","1679"
"21980",29,384,355,"AGGATTATGATAGTCGCCC","GGTAGTAATACATAGTCTCC","561307.5.peg.291","1679"
"21981",10,384,374,"CAGGCTATGTTTAATGATAG","GGTAGTAATACATAGTCTCC","561307.5.peg.291","1679"
"21982",17,384,367,"TCTATCATTAAACATAGCCT","GGTAGTAATACATAGTCTCC","561307.5.peg.291","1679"
"21983",7,405,398,"GCTATGTTTAATGATAGAGG","TAATCCGTGTAGCCTGGATC","561307.5.peg.291","1679"
"21984",168,405,237,"TCAATAATACCTTGTGGCGT","TAATCCGTGTAGCCTGGATC","561307.5.peg.291","1679"
"21985",10,405,395,"CAGGCTATGTTTAATGATAG","TAATCCGTGTAGCCTGGATC","561307.5.peg.291","1679"
"21986",17,405,388,"TCTATCATTAAACATAGCCT","TAATCCGTGTAGCCTGGATC","561307.5.peg.291","1679"
"21987",567,405,162,"TTCGTAGCTGTCGATCCAGT","TAATCCGTGTAGCCTGGATC","561307.5.peg.291","1679"
"21988",158,405,247,"CTTGTGGCGTGGGCCCATCA","TAATCCGTGTAGCCTGGATC","561307.5.peg.291","1679"
"21989",29,405,376,"AGGATTATGATAGTCGCCC","TAATCCGTGTAGCCTGGATC","561307.5.peg.291","1679"
"21990",7,411,404,"GCTATGTTTAATGATAGAGG","GCTAAATAATCCGTGTAGCC","561307.5.peg.291","1679"
"21991",10,411,401,"CAGGCTATGTTTAATGATAG","GCTAAATAATCCGTGTAGCC","561307.5.peg.291","1679"
"21992",168,411,243,"TCAATAATACCTTGTGGCGT","GCTAAATAATCCGTGTAGCC","561307.5.peg.291","1679"
"21993",158,411,253,"CTTGTGGCGTGGGCCCATCA","GCTAAATAATCCGTGTAGCC","561307.5.peg.291","1679"
"21994",567,411,156,"TTCGTAGCTGTCGATCCAGT","GCTAAATAATCCGTGTAGCC","561307.5.peg.291","1679"
"21995",17,411,394,"TCTATCATTAAACATAGCCT","GCTAAATAATCCGTGTAGCC","561307.5.peg.291","1679"
"21996",29,411,382,"AGGATTATGATAGTCGCCC","GCTAAATAATCCGTGTAGCC","561307.5.peg.291","1679"
"21997",567,459,108,"TTCGTAGCTGTCGATCCAGT","GGTTCTAAATTAAGCGGGAC","561307.5.peg.291","1679"
"21998",7,459,452,"GCTATGTTTAATGATAGAGG","GGTTCTAAATTAAGCGGGAC","561307.5.peg.291","1679"
"21999",17,459,442,"TCTATCATTAAACATAGCCT","GGTTCTAAATTAAGCGGGAC","561307.5.peg.291","1679"
"22000",158,459,301,"CTTGTGGCGTGGGCCCATCA","GGTTCTAAATTAAGCGGGAC","561307.5.peg.291","1679"
"22001",168,459,291,"TCAATAATACCTTGTGGCGT","GGTTCTAAATTAAGCGGGAC","561307.5.peg.291","1679"
"22002",29,459,430,"AGGATTATGATAGTCGCCC","GGTTCTAAATTAAGCGGGAC","561307.5.peg.291","1679"
"22003",10,459,449,"CAGGCTATGTTTAATGATAG","GGTTCTAAATTAAGCGGGAC","561307.5.peg.291","1679"
"22004",29,480,451,"AGGATTATGATAGTCGCCC","CAATCTGGCAAATAATGTGG","561307.5.peg.291","1679"
"22005",10,480,470,"CAGGCTATGTTTAATGATAG","CAATCTGGCAAATAATGTGG","561307.5.peg.291","1679"
"22006",366,480,114,"CCTGGATTGATAACACATGT","CAATCTGGCAAATAATGTGG","561307.5.peg.291","1679"
"22007",17,480,463,"TCTATCATTAAACATAGCCT","CAATCTGGCAAATAATGTGG","561307.5.peg.291","1679"
"22008",7,480,473,"GCTATGTTTAATGATAGAGG","CAATCTGGCAAATAATGTGG","561307.5.peg.291","1679"
"22009",158,480,322,"CTTGTGGCGTGGGCCCATCA","CAATCTGGCAAATAATGTGG","561307.5.peg.291","1679"
"22010",168,480,312,"TCAATAATACCTTGTGGCGT","CAATCTGGCAAATAATGTGG","561307.5.peg.291","1679"
"22011",158,483,325,"CTTGTGGCGTGGGCCCATCA","GACCAATCTGGCAAATAATG","561307.5.peg.291","1679"
"22012",29,483,454,"AGGATTATGATAGTCGCCC","GACCAATCTGGCAAATAATG","561307.5.peg.291","1679"
"22013",366,483,117,"CCTGGATTGATAACACATGT","GACCAATCTGGCAAATAATG","561307.5.peg.291","1679"
"22014",17,483,466,"TCTATCATTAAACATAGCCT","GACCAATCTGGCAAATAATG","561307.5.peg.291","1679"
"22015",7,483,476,"GCTATGTTTAATGATAGAGG","GACCAATCTGGCAAATAATG","561307.5.peg.291","1679"
"22016",168,483,315,"TCAATAATACCTTGTGGCGT","GACCAATCTGGCAAATAATG","561307.5.peg.291","1679"
"22017",10,483,473,"CAGGCTATGTTTAATGATAG","GACCAATCTGGCAAATAATG","561307.5.peg.291","1679"
"22018",7,495,488,"GCTATGTTTAATGATAGAGG","GAATCAACTTTGGACCAATC","561307.5.peg.291","1679"
"22019",158,495,337,"CTTGTGGCGTGGGCCCATCA","GAATCAACTTTGGACCAATC","561307.5.peg.291","1679"
"22020",384,495,111,"GGTAGTAATACATAGTCTCC","GAATCAACTTTGGACCAATC","561307.5.peg.291","1679"
"22021",366,495,129,"CCTGGATTGATAACACATGT","GAATCAACTTTGGACCAATC","561307.5.peg.291","1679"
"22022",10,495,485,"CAGGCTATGTTTAATGATAG","GAATCAACTTTGGACCAATC","561307.5.peg.291","1679"
"22023",17,495,478,"TCTATCATTAAACATAGCCT","GAATCAACTTTGGACCAATC","561307.5.peg.291","1679"
"22024",168,495,327,"TCAATAATACCTTGTGGCGT","GAATCAACTTTGGACCAATC","561307.5.peg.291","1679"
"22025",29,495,466,"AGGATTATGATAGTCGCCC","GAATCAACTTTGGACCAATC","561307.5.peg.291","1679"
"22026",405,567,162,"TAATCCGTGTAGCCTGGATC","TTCGTAGCTGTCGATCCAGT","561307.5.peg.291","1679"
"22027",29,567,538,"AGGATTATGATAGTCGCCC","TTCGTAGCTGTCGATCCAGT","561307.5.peg.291","1679"
"22028",366,567,201,"CCTGGATTGATAACACATGT","TTCGTAGCTGTCGATCCAGT","561307.5.peg.291","1679"
"22029",459,567,108,"GGTTCTAAATTAAGCGGGAC","TTCGTAGCTGTCGATCCAGT","561307.5.peg.291","1679"
"22030",17,567,550,"TCTATCATTAAACATAGCCT","TTCGTAGCTGTCGATCCAGT","561307.5.peg.291","1679"
"22031",158,567,409,"CTTGTGGCGTGGGCCCATCA","TTCGTAGCTGTCGATCCAGT","561307.5.peg.291","1679"
"22032",384,567,183,"GGTAGTAATACATAGTCTCC","TTCGTAGCTGTCGATCCAGT","561307.5.peg.291","1679"
"22033",10,567,557,"CAGGCTATGTTTAATGATAG","TTCGTAGCTGTCGATCCAGT","561307.5.peg.291","1679"
"22034",411,567,156,"GCTAAATAATCCGTGTAGCC","TTCGTAGCTGTCGATCCAGT","561307.5.peg.291","1679"
"22035",7,567,560,"GCTATGTTTAATGATAGAGG","TTCGTAGCTGTCGATCCAGT","561307.5.peg.291","1679"
"22036",168,567,399,"TCAATAATACCTTGTGGCGT","TTCGTAGCTGTCGATCCAGT","561307.5.peg.291","1679"
"22037",345,93,252,"ATTGAATTCGGAGAGTATGA","TCTGCCCACGCCTTGATATA","561307.5.peg.292","1680"
"22038",357,93,264,"GCAAACTCCGCAATTGAATT","TCTGCCCACGCCTTGATATA","561307.5.peg.292","1680"
"22039",386,93,293,"GACGAACCACATTAATAGCC","TCTGCCCACGCCTTGATATA","561307.5.peg.292","1680"
"22040",93,345,252,"TCTGCCCACGCCTTGATATA","ATTGAATTCGGAGAGTATGA","561307.5.peg.292","1680"
"22041",93,357,264,"TCTGCCCACGCCTTGATATA","GCAAACTCCGCAATTGAATT","561307.5.peg.292","1680"
"22042",93,386,293,"TCTGCCCACGCCTTGATATA","GACGAACCACATTAATAGCC","561307.5.peg.292","1680"
"22043",154,8,146,"CTCTGTAGTTAAATTCACTT","TGTAACAATGAATCACAGGG","561307.5.peg.294","1682"
"22044",1100,8,1092,"CATCAACATTCTTCTCAACA","TGTAACAATGAATCACAGGG","561307.5.peg.294","1682"
"22045",603,8,595,"CATGGATTCGTAAATAGTGC","TGTAACAATGAATCACAGGG","561307.5.peg.294","1682"
"22046",1066,8,1058,"TGTTAACATAGATTCGTCGA","TGTAACAATGAATCACAGGG","561307.5.peg.294","1682"
"22047",197,8,189,"CTTGGACATCATGTTGATCA","TGTAACAATGAATCACAGGG","561307.5.peg.294","1682"
"22048",898,8,890,"TAATAATTCGCCAAGCGCAT","TGTAACAATGAATCACAGGG","561307.5.peg.294","1682"
"22049",154,11,143,"CTCTGTAGTTAAATTCACTT","ACGTGTAACAATGAATCACA","561307.5.peg.294","1682"
"22050",1066,11,1055,"TGTTAACATAGATTCGTCGA","ACGTGTAACAATGAATCACA","561307.5.peg.294","1682"
"22051",603,11,592,"CATGGATTCGTAAATAGTGC","ACGTGTAACAATGAATCACA","561307.5.peg.294","1682"
"22052",898,11,887,"TAATAATTCGCCAAGCGCAT","ACGTGTAACAATGAATCACA","561307.5.peg.294","1682"
"22053",197,11,186,"CTTGGACATCATGTTGATCA","ACGTGTAACAATGAATCACA","561307.5.peg.294","1682"
"22054",1100,11,1089,"CATCAACATTCTTCTCAACA","ACGTGTAACAATGAATCACA","561307.5.peg.294","1682"
"22055",1066,100,966,"TGTTAACATAGATTCGTCGA","TTCGATACGATTTGAACATG","561307.5.peg.294","1682"
"22056",898,100,798,"TAATAATTCGCCAAGCGCAT","TTCGATACGATTTGAACATG","561307.5.peg.294","1682"
"22057",603,100,503,"CATGGATTCGTAAATAGTGC","TTCGATACGATTTGAACATG","561307.5.peg.294","1682"
"22058",1100,100,1000,"CATCAACATTCTTCTCAACA","TTCGATACGATTTGAACATG","561307.5.peg.294","1682"
"22059",898,154,744,"TAATAATTCGCCAAGCGCAT","CTCTGTAGTTAAATTCACTT","561307.5.peg.294","1682"
"22060",1066,154,912,"TGTTAACATAGATTCGTCGA","CTCTGTAGTTAAATTCACTT","561307.5.peg.294","1682"
"22061",603,154,449,"CATGGATTCGTAAATAGTGC","CTCTGTAGTTAAATTCACTT","561307.5.peg.294","1682"
"22062",11,154,143,"ACGTGTAACAATGAATCACA","CTCTGTAGTTAAATTCACTT","561307.5.peg.294","1682"
"22063",8,154,146,"TGTAACAATGAATCACAGGG","CTCTGTAGTTAAATTCACTT","561307.5.peg.294","1682"
"22064",1100,154,946,"CATCAACATTCTTCTCAACA","CTCTGTAGTTAAATTCACTT","561307.5.peg.294","1682"
"22065",11,197,186,"ACGTGTAACAATGAATCACA","CTTGGACATCATGTTGATCA","561307.5.peg.294","1682"
"22066",898,197,701,"TAATAATTCGCCAAGCGCAT","CTTGGACATCATGTTGATCA","561307.5.peg.294","1682"
"22067",1066,197,869,"TGTTAACATAGATTCGTCGA","CTTGGACATCATGTTGATCA","561307.5.peg.294","1682"
"22068",8,197,189,"TGTAACAATGAATCACAGGG","CTTGGACATCATGTTGATCA","561307.5.peg.294","1682"
"22069",603,197,406,"CATGGATTCGTAAATAGTGC","CTTGGACATCATGTTGATCA","561307.5.peg.294","1682"
"22070",1100,197,903,"CATCAACATTCTTCTCAACA","CTTGGACATCATGTTGATCA","561307.5.peg.294","1682"
"22071",100,603,503,"TTCGATACGATTTGAACATG","CATGGATTCGTAAATAGTGC","561307.5.peg.294","1682"
"22072",197,603,406,"CTTGGACATCATGTTGATCA","CATGGATTCGTAAATAGTGC","561307.5.peg.294","1682"
"22073",11,603,592,"ACGTGTAACAATGAATCACA","CATGGATTCGTAAATAGTGC","561307.5.peg.294","1682"
"22074",154,603,449,"CTCTGTAGTTAAATTCACTT","CATGGATTCGTAAATAGTGC","561307.5.peg.294","1682"
"22075",898,603,295,"TAATAATTCGCCAAGCGCAT","CATGGATTCGTAAATAGTGC","561307.5.peg.294","1682"
"22076",1100,603,497,"CATCAACATTCTTCTCAACA","CATGGATTCGTAAATAGTGC","561307.5.peg.294","1682"
"22077",8,603,595,"TGTAACAATGAATCACAGGG","CATGGATTCGTAAATAGTGC","561307.5.peg.294","1682"
"22078",1066,603,463,"TGTTAACATAGATTCGTCGA","CATGGATTCGTAAATAGTGC","561307.5.peg.294","1682"
"22079",154,898,744,"CTCTGTAGTTAAATTCACTT","TAATAATTCGCCAAGCGCAT","561307.5.peg.294","1682"
"22080",197,898,701,"CTTGGACATCATGTTGATCA","TAATAATTCGCCAAGCGCAT","561307.5.peg.294","1682"
"22081",603,898,295,"CATGGATTCGTAAATAGTGC","TAATAATTCGCCAAGCGCAT","561307.5.peg.294","1682"
"22082",1066,898,168,"TGTTAACATAGATTCGTCGA","TAATAATTCGCCAAGCGCAT","561307.5.peg.294","1682"
"22083",11,898,887,"ACGTGTAACAATGAATCACA","TAATAATTCGCCAAGCGCAT","561307.5.peg.294","1682"
"22084",100,898,798,"TTCGATACGATTTGAACATG","TAATAATTCGCCAAGCGCAT","561307.5.peg.294","1682"
"22085",8,898,890,"TGTAACAATGAATCACAGGG","TAATAATTCGCCAAGCGCAT","561307.5.peg.294","1682"
"22086",1100,898,202,"CATCAACATTCTTCTCAACA","TAATAATTCGCCAAGCGCAT","561307.5.peg.294","1682"
"22087",8,1066,1058,"TGTAACAATGAATCACAGGG","TGTTAACATAGATTCGTCGA","561307.5.peg.294","1682"
"22088",197,1066,869,"CTTGGACATCATGTTGATCA","TGTTAACATAGATTCGTCGA","561307.5.peg.294","1682"
"22089",898,1066,168,"TAATAATTCGCCAAGCGCAT","TGTTAACATAGATTCGTCGA","561307.5.peg.294","1682"
"22090",603,1066,463,"CATGGATTCGTAAATAGTGC","TGTTAACATAGATTCGTCGA","561307.5.peg.294","1682"
"22091",100,1066,966,"TTCGATACGATTTGAACATG","TGTTAACATAGATTCGTCGA","561307.5.peg.294","1682"
"22092",154,1066,912,"CTCTGTAGTTAAATTCACTT","TGTTAACATAGATTCGTCGA","561307.5.peg.294","1682"
"22093",11,1066,1055,"ACGTGTAACAATGAATCACA","TGTTAACATAGATTCGTCGA","561307.5.peg.294","1682"
"22094",8,1100,1092,"TGTAACAATGAATCACAGGG","CATCAACATTCTTCTCAACA","561307.5.peg.294","1682"
"22095",154,1100,946,"CTCTGTAGTTAAATTCACTT","CATCAACATTCTTCTCAACA","561307.5.peg.294","1682"
"22096",100,1100,1000,"TTCGATACGATTTGAACATG","CATCAACATTCTTCTCAACA","561307.5.peg.294","1682"
"22097",603,1100,497,"CATGGATTCGTAAATAGTGC","CATCAACATTCTTCTCAACA","561307.5.peg.294","1682"
"22098",197,1100,903,"CTTGGACATCATGTTGATCA","CATCAACATTCTTCTCAACA","561307.5.peg.294","1682"
"22099",11,1100,1089,"ACGTGTAACAATGAATCACA","CATCAACATTCTTCTCAACA","561307.5.peg.294","1682"
"22100",898,1100,202,"TAATAATTCGCCAAGCGCAT","CATCAACATTCTTCTCAACA","561307.5.peg.294","1682"
"22101",516,162,354,"TCACCTTCACGATCAAGTAC","TCTCTCCATTAATCACTAA","561307.5.peg.297","1685"
"22102",588,162,426,"ATCGCAAACGGGAAGTTCCA","TCTCTCCATTAATCACTAA","561307.5.peg.297","1685"
"22103",585,162,423,"GCAAACGGGAAGTTCCACGG","TCTCTCCATTAATCACTAA","561307.5.peg.297","1685"
"22104",633,162,471,"ACTGTATTACCTGCCACAAC","TCTCTCCATTAATCACTAA","561307.5.peg.297","1685"
"22105",666,162,504,"ATATAAGGTGTATCCTCAGC","TCTCTCCATTAATCACTAA","561307.5.peg.297","1685"
"22106",599,162,437,"TACCAGCCATAATCGCAAAC","TCTCTCCATTAATCACTAA","561307.5.peg.297","1685"
"22107",753,162,591,"CCAATTTCTTTCGGATCACC","TCTCTCCATTAATCACTAA","561307.5.peg.297","1685"
"22108",426,162,264,"TCACCAACTGCTTCATCCCA","TCTCTCCATTAATCACTAA","561307.5.peg.297","1685"
"22109",516,219,297,"TCACCTTCACGATCAAGTAC","ATCACTTGTGATGTGTCTGC","561307.5.peg.297","1685"
"22110",599,219,380,"TACCAGCCATAATCGCAAAC","ATCACTTGTGATGTGTCTGC","561307.5.peg.297","1685"
"22111",588,219,369,"ATCGCAAACGGGAAGTTCCA","ATCACTTGTGATGTGTCTGC","561307.5.peg.297","1685"
"22112",633,219,414,"ACTGTATTACCTGCCACAAC","ATCACTTGTGATGTGTCTGC","561307.5.peg.297","1685"
"22113",753,219,534,"CCAATTTCTTTCGGATCACC","ATCACTTGTGATGTGTCTGC","561307.5.peg.297","1685"
"22114",426,219,207,"TCACCAACTGCTTCATCCCA","ATCACTTGTGATGTGTCTGC","561307.5.peg.297","1685"
"22115",585,219,366,"GCAAACGGGAAGTTCCACGG","ATCACTTGTGATGTGTCTGC","561307.5.peg.297","1685"
"22116",666,219,447,"ATATAAGGTGTATCCTCAGC","ATCACTTGTGATGTGTCTGC","561307.5.peg.297","1685"
"22117",588,426,162,"ATCGCAAACGGGAAGTTCCA","TCACCAACTGCTTCATCCCA","561307.5.peg.297","1685"
"22118",599,426,173,"TACCAGCCATAATCGCAAAC","TCACCAACTGCTTCATCCCA","561307.5.peg.297","1685"
"22119",666,426,240,"ATATAAGGTGTATCCTCAGC","TCACCAACTGCTTCATCCCA","561307.5.peg.297","1685"
"22120",585,426,159,"GCAAACGGGAAGTTCCACGG","TCACCAACTGCTTCATCCCA","561307.5.peg.297","1685"
"22121",162,426,264,"TCTCTCCATTAATCACTAA","TCACCAACTGCTTCATCCCA","561307.5.peg.297","1685"
"22122",219,426,207,"ATCACTTGTGATGTGTCTGC","TCACCAACTGCTTCATCCCA","561307.5.peg.297","1685"
"22123",753,426,327,"CCAATTTCTTTCGGATCACC","TCACCAACTGCTTCATCCCA","561307.5.peg.297","1685"
"22124",633,426,207,"ACTGTATTACCTGCCACAAC","TCACCAACTGCTTCATCCCA","561307.5.peg.297","1685"
"22125",162,516,354,"TCTCTCCATTAATCACTAA","TCACCTTCACGATCAAGTAC","561307.5.peg.297","1685"
"22126",753,516,237,"CCAATTTCTTTCGGATCACC","TCACCTTCACGATCAAGTAC","561307.5.peg.297","1685"
"22127",633,516,117,"ACTGTATTACCTGCCACAAC","TCACCTTCACGATCAAGTAC","561307.5.peg.297","1685"
"22128",219,516,297,"ATCACTTGTGATGTGTCTGC","TCACCTTCACGATCAAGTAC","561307.5.peg.297","1685"
"22129",666,516,150,"ATATAAGGTGTATCCTCAGC","TCACCTTCACGATCAAGTAC","561307.5.peg.297","1685"
"22130",162,585,423,"TCTCTCCATTAATCACTAA","GCAAACGGGAAGTTCCACGG","561307.5.peg.297","1685"
"22131",219,585,366,"ATCACTTGTGATGTGTCTGC","GCAAACGGGAAGTTCCACGG","561307.5.peg.297","1685"
"22132",426,585,159,"TCACCAACTGCTTCATCCCA","GCAAACGGGAAGTTCCACGG","561307.5.peg.297","1685"
"22133",753,585,168,"CCAATTTCTTTCGGATCACC","GCAAACGGGAAGTTCCACGG","561307.5.peg.297","1685"
"22134",219,588,369,"ATCACTTGTGATGTGTCTGC","ATCGCAAACGGGAAGTTCCA","561307.5.peg.297","1685"
"22135",426,588,162,"TCACCAACTGCTTCATCCCA","ATCGCAAACGGGAAGTTCCA","561307.5.peg.297","1685"
"22136",753,588,165,"CCAATTTCTTTCGGATCACC","ATCGCAAACGGGAAGTTCCA","561307.5.peg.297","1685"
"22137",162,588,426,"TCTCTCCATTAATCACTAA","ATCGCAAACGGGAAGTTCCA","561307.5.peg.297","1685"
"22138",219,599,380,"ATCACTTGTGATGTGTCTGC","TACCAGCCATAATCGCAAAC","561307.5.peg.297","1685"
"22139",753,599,154,"CCAATTTCTTTCGGATCACC","TACCAGCCATAATCGCAAAC","561307.5.peg.297","1685"
"22140",426,599,173,"TCACCAACTGCTTCATCCCA","TACCAGCCATAATCGCAAAC","561307.5.peg.297","1685"
"22141",162,599,437,"TCTCTCCATTAATCACTAA","TACCAGCCATAATCGCAAAC","561307.5.peg.297","1685"
"22142",426,633,207,"TCACCAACTGCTTCATCCCA","ACTGTATTACCTGCCACAAC","561307.5.peg.297","1685"
"22143",516,633,117,"TCACCTTCACGATCAAGTAC","ACTGTATTACCTGCCACAAC","561307.5.peg.297","1685"
"22144",219,633,414,"ATCACTTGTGATGTGTCTGC","ACTGTATTACCTGCCACAAC","561307.5.peg.297","1685"
"22145",753,633,120,"CCAATTTCTTTCGGATCACC","ACTGTATTACCTGCCACAAC","561307.5.peg.297","1685"
"22146",162,633,471,"TCTCTCCATTAATCACTAA","ACTGTATTACCTGCCACAAC","561307.5.peg.297","1685"
"22147",162,666,504,"TCTCTCCATTAATCACTAA","ATATAAGGTGTATCCTCAGC","561307.5.peg.297","1685"
"22148",516,666,150,"TCACCTTCACGATCAAGTAC","ATATAAGGTGTATCCTCAGC","561307.5.peg.297","1685"
"22149",426,666,240,"TCACCAACTGCTTCATCCCA","ATATAAGGTGTATCCTCAGC","561307.5.peg.297","1685"
"22150",219,666,447,"ATCACTTGTGATGTGTCTGC","ATATAAGGTGTATCCTCAGC","561307.5.peg.297","1685"
"22151",585,753,168,"GCAAACGGGAAGTTCCACGG","CCAATTTCTTTCGGATCACC","561307.5.peg.297","1685"
"22152",162,753,591,"TCTCTCCATTAATCACTAA","CCAATTTCTTTCGGATCACC","561307.5.peg.297","1685"
"22153",588,753,165,"ATCGCAAACGGGAAGTTCCA","CCAATTTCTTTCGGATCACC","561307.5.peg.297","1685"
"22154",633,753,120,"ACTGTATTACCTGCCACAAC","CCAATTTCTTTCGGATCACC","561307.5.peg.297","1685"
"22155",219,753,534,"ATCACTTGTGATGTGTCTGC","CCAATTTCTTTCGGATCACC","561307.5.peg.297","1685"
"22156",426,753,327,"TCACCAACTGCTTCATCCCA","CCAATTTCTTTCGGATCACC","561307.5.peg.297","1685"
"22157",516,753,237,"TCACCTTCACGATCAAGTAC","CCAATTTCTTTCGGATCACC","561307.5.peg.297","1685"
"22158",599,753,154,"TACCAGCCATAATCGCAAAC","CCAATTTCTTTCGGATCACC","561307.5.peg.297","1685"
"22159",225,115,110,"GCATGTACTTGAATCCATAA","ATCTTCACGACTAAATCCAC","561307.5.peg.3","1688"
"22160",115,225,110,"ATCTTCACGACTAAATCCAC","GCATGTACTTGAATCCATAA","561307.5.peg.3","1688"
"22161",407,100,307,"AATATCACTTTCAAAGCCA","ATCTAAACGTCGAATTTGGC","561307.5.peg.30","1689"
"22162",569,100,469,"CAGATCGATGAATTAAAGTA","ATCTAAACGTCGAATTTGGC","561307.5.peg.30","1689"
"22163",663,100,563,"TTTCCTCATTTAAACGGTA","ATCTAAACGTCGAATTTGGC","561307.5.peg.30","1689"
"22164",616,100,516,"AAGTATAGGTTGATTCATGT","ATCTAAACGTCGAATTTGGC","561307.5.peg.30","1689"
"22165",616,186,430,"AAGTATAGGTTGATTCATGT","ACAACTTCGCCAATGACATA","561307.5.peg.30","1689"
"22166",569,186,383,"CAGATCGATGAATTAAAGTA","ACAACTTCGCCAATGACATA","561307.5.peg.30","1689"
"22167",407,186,221,"AATATCACTTTCAAAGCCA","ACAACTTCGCCAATGACATA","561307.5.peg.30","1689"
"22168",663,186,477,"TTTCCTCATTTAAACGGTA","ACAACTTCGCCAATGACATA","561307.5.peg.30","1689"
"22169",100,407,307,"ATCTAAACGTCGAATTTGGC","AATATCACTTTCAAAGCCA","561307.5.peg.30","1689"
"22170",569,407,162,"CAGATCGATGAATTAAAGTA","AATATCACTTTCAAAGCCA","561307.5.peg.30","1689"
"22171",663,407,256,"TTTCCTCATTTAAACGGTA","AATATCACTTTCAAAGCCA","561307.5.peg.30","1689"
"22172",186,407,221,"ACAACTTCGCCAATGACATA","AATATCACTTTCAAAGCCA","561307.5.peg.30","1689"
"22173",616,407,209,"AAGTATAGGTTGATTCATGT","AATATCACTTTCAAAGCCA","561307.5.peg.30","1689"
"22174",100,569,469,"ATCTAAACGTCGAATTTGGC","CAGATCGATGAATTAAAGTA","561307.5.peg.30","1689"
"22175",186,569,383,"ACAACTTCGCCAATGACATA","CAGATCGATGAATTAAAGTA","561307.5.peg.30","1689"
"22176",407,569,162,"AATATCACTTTCAAAGCCA","CAGATCGATGAATTAAAGTA","561307.5.peg.30","1689"
"22177",100,616,516,"ATCTAAACGTCGAATTTGGC","AAGTATAGGTTGATTCATGT","561307.5.peg.30","1689"
"22178",407,616,209,"AATATCACTTTCAAAGCCA","AAGTATAGGTTGATTCATGT","561307.5.peg.30","1689"
"22179",186,616,430,"ACAACTTCGCCAATGACATA","AAGTATAGGTTGATTCATGT","561307.5.peg.30","1689"
"22180",407,663,256,"AATATCACTTTCAAAGCCA","TTTCCTCATTTAAACGGTA","561307.5.peg.30","1689"
"22181",186,663,477,"ACAACTTCGCCAATGACATA","TTTCCTCATTTAAACGGTA","561307.5.peg.30","1689"
"22182",100,663,563,"ATCTAAACGTCGAATTTGGC","TTTCCTCATTTAAACGGTA","561307.5.peg.30","1689"
"22183",754,103,651,"AACTGCTAGTCCAATCATTA","CACTATCCATGCAATGACCG","561307.5.peg.300","1690"
"22184",1176,103,1073,"CCAAGTCGCATATGACTAAC","CACTATCCATGCAATGACCG","561307.5.peg.300","1690"
"22185",732,103,629,"GCTAATGTCAGTGTGACATT","CACTATCCATGCAATGACCG","561307.5.peg.300","1690"
"22186",1203,103,1100,"GCTGGTTTAACACCGTCATC","CACTATCCATGCAATGACCG","561307.5.peg.300","1690"
"22187",103,732,629,"CACTATCCATGCAATGACCG","GCTAATGTCAGTGTGACATT","561307.5.peg.300","1690"
"22188",1176,732,444,"CCAAGTCGCATATGACTAAC","GCTAATGTCAGTGTGACATT","561307.5.peg.300","1690"
"22189",1203,732,471,"GCTGGTTTAACACCGTCATC","GCTAATGTCAGTGTGACATT","561307.5.peg.300","1690"
"22190",103,754,651,"CACTATCCATGCAATGACCG","AACTGCTAGTCCAATCATTA","561307.5.peg.300","1690"
"22191",1176,754,422,"CCAAGTCGCATATGACTAAC","AACTGCTAGTCCAATCATTA","561307.5.peg.300","1690"
"22192",1203,754,449,"GCTGGTTTAACACCGTCATC","AACTGCTAGTCCAATCATTA","561307.5.peg.300","1690"
"22193",754,1176,422,"AACTGCTAGTCCAATCATTA","CCAAGTCGCATATGACTAAC","561307.5.peg.300","1690"
"22194",103,1176,1073,"CACTATCCATGCAATGACCG","CCAAGTCGCATATGACTAAC","561307.5.peg.300","1690"
"22195",732,1176,444,"GCTAATGTCAGTGTGACATT","CCAAGTCGCATATGACTAAC","561307.5.peg.300","1690"
"22196",103,1203,1100,"CACTATCCATGCAATGACCG","GCTGGTTTAACACCGTCATC","561307.5.peg.300","1690"
"22197",732,1203,471,"GCTAATGTCAGTGTGACATT","GCTGGTTTAACACCGTCATC","561307.5.peg.300","1690"
"22198",754,1203,449,"AACTGCTAGTCCAATCATTA","GCTGGTTTAACACCGTCATC","561307.5.peg.300","1690"
"22199",465,5,460,"TTGCCTGTACGTGCCACAAC","TGCATTAGAAGAATAGGAGC","561307.5.peg.302","1692"
"22200",960,5,955,"GCATCGAGTTGATCCGACAA","TGCATTAGAAGAATAGGAGC","561307.5.peg.302","1692"
"22201",210,5,205,"GGCGATAAATCATATGTACC","TGCATTAGAAGAATAGGAGC","561307.5.peg.302","1692"
"22202",5,210,205,"TGCATTAGAAGAATAGGAGC","GGCGATAAATCATATGTACC","561307.5.peg.302","1692"
"22203",465,210,255,"TTGCCTGTACGTGCCACAAC","GGCGATAAATCATATGTACC","561307.5.peg.302","1692"
"22204",960,210,750,"GCATCGAGTTGATCCGACAA","GGCGATAAATCATATGTACC","561307.5.peg.302","1692"
"22205",5,465,460,"TGCATTAGAAGAATAGGAGC","TTGCCTGTACGTGCCACAAC","561307.5.peg.302","1692"
"22206",960,465,495,"GCATCGAGTTGATCCGACAA","TTGCCTGTACGTGCCACAAC","561307.5.peg.302","1692"
"22207",210,465,255,"GGCGATAAATCATATGTACC","TTGCCTGTACGTGCCACAAC","561307.5.peg.302","1692"
"22208",5,960,955,"TGCATTAGAAGAATAGGAGC","GCATCGAGTTGATCCGACAA","561307.5.peg.302","1692"
"22209",210,960,750,"GGCGATAAATCATATGTACC","GCATCGAGTTGATCCGACAA","561307.5.peg.302","1692"
"22210",465,960,495,"TTGCCTGTACGTGCCACAAC","GCATCGAGTTGATCCGACAA","561307.5.peg.302","1692"
"22211",495,171,324,"TCTTTGTCTTTGATTGCTGC","GTGAGTTGCGCTAGTTCTTC","561307.5.peg.304","1694"
"22212",975,171,804,"AACACATCGATTGCTTTATC","GTGAGTTGCGCTAGTTCTTC","561307.5.peg.304","1694"
"22213",414,171,243,"CCAGCTTCTCCAACTAATAT","GTGAGTTGCGCTAGTTCTTC","561307.5.peg.304","1694"
"22214",960,171,789,"TATCTGGTAATAATCGTTG","GTGAGTTGCGCTAGTTCTTC","561307.5.peg.304","1694"
"22215",311,171,140,"CGTCACGTGCTTCTTGCGTA","GTGAGTTGCGCTAGTTCTTC","561307.5.peg.304","1694"
"22216",345,171,174,"TCTTTATCACGACCAATGAC","GTGAGTTGCGCTAGTTCTTC","561307.5.peg.304","1694"
"22217",837,171,666,"TCAACAGTATCTTTAGCGCT","GTGAGTTGCGCTAGTTCTTC","561307.5.peg.304","1694"
"22218",717,171,546,"ATCTCACCACGACTTAATGC","GTGAGTTGCGCTAGTTCTTC","561307.5.peg.304","1694"
"22219",1032,171,861,"GTTTCAACTTTATCGACAGC","GTGAGTTGCGCTAGTTCTTC","561307.5.peg.304","1694"
"22220",717,311,406,"ATCTCACCACGACTTAATGC","CGTCACGTGCTTCTTGCGTA","561307.5.peg.304","1694"
"22221",171,311,140,"GTGAGTTGCGCTAGTTCTTC","CGTCACGTGCTTCTTGCGTA","561307.5.peg.304","1694"
"22222",960,311,649,"TATCTGGTAATAATCGTTG","CGTCACGTGCTTCTTGCGTA","561307.5.peg.304","1694"
"22223",837,311,526,"TCAACAGTATCTTTAGCGCT","CGTCACGTGCTTCTTGCGTA","561307.5.peg.304","1694"
"22224",414,311,103,"CCAGCTTCTCCAACTAATAT","CGTCACGTGCTTCTTGCGTA","561307.5.peg.304","1694"
"22225",975,311,664,"AACACATCGATTGCTTTATC","CGTCACGTGCTTCTTGCGTA","561307.5.peg.304","1694"
"22226",1032,311,721,"GTTTCAACTTTATCGACAGC","CGTCACGTGCTTCTTGCGTA","561307.5.peg.304","1694"
"22227",495,311,184,"TCTTTGTCTTTGATTGCTGC","CGTCACGTGCTTCTTGCGTA","561307.5.peg.304","1694"
"22228",717,345,372,"ATCTCACCACGACTTAATGC","TCTTTATCACGACCAATGAC","561307.5.peg.304","1694"
"22229",960,345,615,"TATCTGGTAATAATCGTTG","TCTTTATCACGACCAATGAC","561307.5.peg.304","1694"
"22230",975,345,630,"AACACATCGATTGCTTTATC","TCTTTATCACGACCAATGAC","561307.5.peg.304","1694"
"22231",495,345,150,"TCTTTGTCTTTGATTGCTGC","TCTTTATCACGACCAATGAC","561307.5.peg.304","1694"
"22232",171,345,174,"GTGAGTTGCGCTAGTTCTTC","TCTTTATCACGACCAATGAC","561307.5.peg.304","1694"
"22233",837,345,492,"TCAACAGTATCTTTAGCGCT","TCTTTATCACGACCAATGAC","561307.5.peg.304","1694"
"22234",1032,345,687,"GTTTCAACTTTATCGACAGC","TCTTTATCACGACCAATGAC","561307.5.peg.304","1694"
"22235",1032,414,618,"GTTTCAACTTTATCGACAGC","CCAGCTTCTCCAACTAATAT","561307.5.peg.304","1694"
"22236",717,414,303,"ATCTCACCACGACTTAATGC","CCAGCTTCTCCAACTAATAT","561307.5.peg.304","1694"
"22237",311,414,103,"CGTCACGTGCTTCTTGCGTA","CCAGCTTCTCCAACTAATAT","561307.5.peg.304","1694"
"22238",975,414,561,"AACACATCGATTGCTTTATC","CCAGCTTCTCCAACTAATAT","561307.5.peg.304","1694"
"22239",837,414,423,"TCAACAGTATCTTTAGCGCT","CCAGCTTCTCCAACTAATAT","561307.5.peg.304","1694"
"22240",171,414,243,"GTGAGTTGCGCTAGTTCTTC","CCAGCTTCTCCAACTAATAT","561307.5.peg.304","1694"
"22241",960,414,546,"TATCTGGTAATAATCGTTG","CCAGCTTCTCCAACTAATAT","561307.5.peg.304","1694"
"22242",171,495,324,"GTGAGTTGCGCTAGTTCTTC","TCTTTGTCTTTGATTGCTGC","561307.5.peg.304","1694"
"22243",717,495,222,"ATCTCACCACGACTTAATGC","TCTTTGTCTTTGATTGCTGC","561307.5.peg.304","1694"
"22244",960,495,465,"TATCTGGTAATAATCGTTG","TCTTTGTCTTTGATTGCTGC","561307.5.peg.304","1694"
"22245",975,495,480,"AACACATCGATTGCTTTATC","TCTTTGTCTTTGATTGCTGC","561307.5.peg.304","1694"
"22246",345,495,150,"TCTTTATCACGACCAATGAC","TCTTTGTCTTTGATTGCTGC","561307.5.peg.304","1694"
"22247",311,495,184,"CGTCACGTGCTTCTTGCGTA","TCTTTGTCTTTGATTGCTGC","561307.5.peg.304","1694"
"22248",837,495,342,"TCAACAGTATCTTTAGCGCT","TCTTTGTCTTTGATTGCTGC","561307.5.peg.304","1694"
"22249",1032,495,537,"GTTTCAACTTTATCGACAGC","TCTTTGTCTTTGATTGCTGC","561307.5.peg.304","1694"
"22250",837,717,120,"TCAACAGTATCTTTAGCGCT","ATCTCACCACGACTTAATGC","561307.5.peg.304","1694"
"22251",171,717,546,"GTGAGTTGCGCTAGTTCTTC","ATCTCACCACGACTTAATGC","561307.5.peg.304","1694"
"22252",311,717,406,"CGTCACGTGCTTCTTGCGTA","ATCTCACCACGACTTAATGC","561307.5.peg.304","1694"
"22253",345,717,372,"TCTTTATCACGACCAATGAC","ATCTCACCACGACTTAATGC","561307.5.peg.304","1694"
"22254",975,717,258,"AACACATCGATTGCTTTATC","ATCTCACCACGACTTAATGC","561307.5.peg.304","1694"
"22255",960,717,243,"TATCTGGTAATAATCGTTG","ATCTCACCACGACTTAATGC","561307.5.peg.304","1694"
"22256",495,717,222,"TCTTTGTCTTTGATTGCTGC","ATCTCACCACGACTTAATGC","561307.5.peg.304","1694"
"22257",1032,717,315,"GTTTCAACTTTATCGACAGC","ATCTCACCACGACTTAATGC","561307.5.peg.304","1694"
"22258",414,717,303,"CCAGCTTCTCCAACTAATAT","ATCTCACCACGACTTAATGC","561307.5.peg.304","1694"
"22259",345,837,492,"TCTTTATCACGACCAATGAC","TCAACAGTATCTTTAGCGCT","561307.5.peg.304","1694"
"22260",495,837,342,"TCTTTGTCTTTGATTGCTGC","TCAACAGTATCTTTAGCGCT","561307.5.peg.304","1694"
"22261",717,837,120,"ATCTCACCACGACTTAATGC","TCAACAGTATCTTTAGCGCT","561307.5.peg.304","1694"
"22262",975,837,138,"AACACATCGATTGCTTTATC","TCAACAGTATCTTTAGCGCT","561307.5.peg.304","1694"
"22263",1032,837,195,"GTTTCAACTTTATCGACAGC","TCAACAGTATCTTTAGCGCT","561307.5.peg.304","1694"
"22264",311,837,526,"CGTCACGTGCTTCTTGCGTA","TCAACAGTATCTTTAGCGCT","561307.5.peg.304","1694"
"22265",414,837,423,"CCAGCTTCTCCAACTAATAT","TCAACAGTATCTTTAGCGCT","561307.5.peg.304","1694"
"22266",960,837,123,"TATCTGGTAATAATCGTTG","TCAACAGTATCTTTAGCGCT","561307.5.peg.304","1694"
"22267",171,837,666,"GTGAGTTGCGCTAGTTCTTC","TCAACAGTATCTTTAGCGCT","561307.5.peg.304","1694"
"22268",345,960,615,"TCTTTATCACGACCAATGAC","TATCTGGTAATAATCGTTG","561307.5.peg.304","1694"
"22269",414,960,546,"CCAGCTTCTCCAACTAATAT","TATCTGGTAATAATCGTTG","561307.5.peg.304","1694"
"22270",495,960,465,"TCTTTGTCTTTGATTGCTGC","TATCTGGTAATAATCGTTG","561307.5.peg.304","1694"
"22271",171,960,789,"GTGAGTTGCGCTAGTTCTTC","TATCTGGTAATAATCGTTG","561307.5.peg.304","1694"
"22272",717,960,243,"ATCTCACCACGACTTAATGC","TATCTGGTAATAATCGTTG","561307.5.peg.304","1694"
"22273",837,960,123,"TCAACAGTATCTTTAGCGCT","TATCTGGTAATAATCGTTG","561307.5.peg.304","1694"
"22274",311,960,649,"CGTCACGTGCTTCTTGCGTA","TATCTGGTAATAATCGTTG","561307.5.peg.304","1694"
"22275",837,975,138,"TCAACAGTATCTTTAGCGCT","AACACATCGATTGCTTTATC","561307.5.peg.304","1694"
"22276",171,975,804,"GTGAGTTGCGCTAGTTCTTC","AACACATCGATTGCTTTATC","561307.5.peg.304","1694"
"22277",311,975,664,"CGTCACGTGCTTCTTGCGTA","AACACATCGATTGCTTTATC","561307.5.peg.304","1694"
"22278",717,975,258,"ATCTCACCACGACTTAATGC","AACACATCGATTGCTTTATC","561307.5.peg.304","1694"
"22279",345,975,630,"TCTTTATCACGACCAATGAC","AACACATCGATTGCTTTATC","561307.5.peg.304","1694"
"22280",495,975,480,"TCTTTGTCTTTGATTGCTGC","AACACATCGATTGCTTTATC","561307.5.peg.304","1694"
"22281",414,975,561,"CCAGCTTCTCCAACTAATAT","AACACATCGATTGCTTTATC","561307.5.peg.304","1694"
"22282",837,1032,195,"TCAACAGTATCTTTAGCGCT","GTTTCAACTTTATCGACAGC","561307.5.peg.304","1694"
"22283",495,1032,537,"TCTTTGTCTTTGATTGCTGC","GTTTCAACTTTATCGACAGC","561307.5.peg.304","1694"
"22284",717,1032,315,"ATCTCACCACGACTTAATGC","GTTTCAACTTTATCGACAGC","561307.5.peg.304","1694"
"22285",311,1032,721,"CGTCACGTGCTTCTTGCGTA","GTTTCAACTTTATCGACAGC","561307.5.peg.304","1694"
"22286",171,1032,861,"GTGAGTTGCGCTAGTTCTTC","GTTTCAACTTTATCGACAGC","561307.5.peg.304","1694"
"22287",414,1032,618,"CCAGCTTCTCCAACTAATAT","GTTTCAACTTTATCGACAGC","561307.5.peg.304","1694"
"22288",345,1032,687,"TCTTTATCACGACCAATGAC","GTTTCAACTTTATCGACAGC","561307.5.peg.304","1694"
"22289",313,47,266,"TAAGTTGTGAATTTGAACAG","ATCGATACCTATTGTCATA","561307.5.peg.306","1696"
"22290",194,47,147,"CGCCCATTGAAACGATGTCT","ATCGATACCTATTGTCATA","561307.5.peg.306","1696"
"22291",186,47,139,"GAAACGATGTCTTGGTTTAC","ATCGATACCTATTGTCATA","561307.5.peg.306","1696"
"22292",194,87,107,"CGCCCATTGAAACGATGTCT","GCCATGTCTACATAGTACTT","561307.5.peg.306","1696"
"22293",313,87,226,"TAAGTTGTGAATTTGAACAG","GCCATGTCTACATAGTACTT","561307.5.peg.306","1696"
"22294",47,186,139,"ATCGATACCTATTGTCATA","GAAACGATGTCTTGGTTTAC","561307.5.peg.306","1696"
"22295",313,186,127,"TAAGTTGTGAATTTGAACAG","GAAACGATGTCTTGGTTTAC","561307.5.peg.306","1696"
"22296",47,194,147,"ATCGATACCTATTGTCATA","CGCCCATTGAAACGATGTCT","561307.5.peg.306","1696"
"22297",313,194,119,"TAAGTTGTGAATTTGAACAG","CGCCCATTGAAACGATGTCT","561307.5.peg.306","1696"
"22298",87,194,107,"GCCATGTCTACATAGTACTT","CGCCCATTGAAACGATGTCT","561307.5.peg.306","1696"
"22299",186,313,127,"GAAACGATGTCTTGGTTTAC","TAAGTTGTGAATTTGAACAG","561307.5.peg.306","1696"
"22300",87,313,226,"GCCATGTCTACATAGTACTT","TAAGTTGTGAATTTGAACAG","561307.5.peg.306","1696"
"22301",47,313,266,"ATCGATACCTATTGTCATA","TAAGTTGTGAATTTGAACAG","561307.5.peg.306","1696"
"22302",194,313,119,"CGCCCATTGAAACGATGTCT","TAAGTTGTGAATTTGAACAG","561307.5.peg.306","1696"
"22303",512,240,272,"ATGTATCAATCGCTATACGT","TTATCGTCCACAATGATATT","561307.5.peg.307","1697"
"22304",537,240,297,"AAAGATAGTAACTGTTGCTC","TTATCGTCCACAATGATATT","561307.5.peg.307","1697"
"22305",512,276,236,"ATGTATCAATCGCTATACGT","GAAGGCTCTTCCACCATCAT","561307.5.peg.307","1697"
"22306",537,276,261,"AAAGATAGTAACTGTTGCTC","GAAGGCTCTTCCACCATCAT","561307.5.peg.307","1697"
"22307",240,512,272,"TTATCGTCCACAATGATATT","ATGTATCAATCGCTATACGT","561307.5.peg.307","1697"
"22308",276,512,236,"GAAGGCTCTTCCACCATCAT","ATGTATCAATCGCTATACGT","561307.5.peg.307","1697"
"22309",240,537,297,"TTATCGTCCACAATGATATT","AAAGATAGTAACTGTTGCTC","561307.5.peg.307","1697"
"22310",276,537,261,"GAAGGCTCTTCCACCATCAT","AAAGATAGTAACTGTTGCTC","561307.5.peg.307","1697"
"22311",159,11,148,"CCGTCTTCTACCCAAGTTAG","TCAAACTACTACTACAACT","561307.5.peg.312","1703"
"22312",11,159,148,"TCAAACTACTACTACAACT","CCGTCTTCTACCCAAGTTAG","561307.5.peg.312","1703"
"22313",777,126,651,"ATACTATATGGATGATCATC","ACTGCGTCGATTGAGTCTCC","561307.5.peg.314","1705"
"22314",789,126,663,"CCTAAGTTACCGATACTATA","ACTGCGTCGATTGAGTCTCC","561307.5.peg.314","1705"
"22315",885,126,759,"TAGGTAAGTAATCCACATA","ACTGCGTCGATTGAGTCTCC","561307.5.peg.314","1705"
"22316",126,777,651,"ACTGCGTCGATTGAGTCTCC","ATACTATATGGATGATCATC","561307.5.peg.314","1705"
"22317",885,777,108,"TAGGTAAGTAATCCACATA","ATACTATATGGATGATCATC","561307.5.peg.314","1705"
"22318",126,789,663,"ACTGCGTCGATTGAGTCTCC","CCTAAGTTACCGATACTATA","561307.5.peg.314","1705"
"22319",126,885,759,"ACTGCGTCGATTGAGTCTCC","TAGGTAAGTAATCCACATA","561307.5.peg.314","1705"
"22320",777,885,108,"ATACTATATGGATGATCATC","TAGGTAAGTAATCCACATA","561307.5.peg.314","1705"
"22321",474,9,465,"AACACACCCGTTTGTAACGT","GGAAGCGGAAATTGAGATAG","561307.5.peg.315","1706"
"22322",942,9,933,"TAAATAGCAAATGCCGCCGC","GGAAGCGGAAATTGAGATAG","561307.5.peg.315","1706"
"22323",848,9,839,"ATTGTGCCATCCAAATACGT","GGAAGCGGAAATTGAGATAG","561307.5.peg.315","1706"
"22324",600,9,591,"GCTACGACCGATGTCACAAT","GGAAGCGGAAATTGAGATAG","561307.5.peg.315","1706"
"22325",657,9,648,"TTAATCCATCTTGAATTGG","GGAAGCGGAAATTGAGATAG","561307.5.peg.315","1706"
"22326",523,9,514,"AAATTTGTTGTAACACCATG","GGAAGCGGAAATTGAGATAG","561307.5.peg.315","1706"
"22327",848,11,837,"ATTGTGCCATCCAAATACGT","ATGGAAGCGGAAATTGAGAT","561307.5.peg.315","1706"
"22328",523,11,512,"AAATTTGTTGTAACACCATG","ATGGAAGCGGAAATTGAGAT","561307.5.peg.315","1706"
"22329",474,11,463,"AACACACCCGTTTGTAACGT","ATGGAAGCGGAAATTGAGAT","561307.5.peg.315","1706"
"22330",600,11,589,"GCTACGACCGATGTCACAAT","ATGGAAGCGGAAATTGAGAT","561307.5.peg.315","1706"
"22331",657,11,646,"TTAATCCATCTTGAATTGG","ATGGAAGCGGAAATTGAGAT","561307.5.peg.315","1706"
"22332",942,11,931,"TAAATAGCAAATGCCGCCGC","ATGGAAGCGGAAATTGAGAT","561307.5.peg.315","1706"
"22333",600,474,126,"GCTACGACCGATGTCACAAT","AACACACCCGTTTGTAACGT","561307.5.peg.315","1706"
"22334",11,474,463,"ATGGAAGCGGAAATTGAGAT","AACACACCCGTTTGTAACGT","561307.5.peg.315","1706"
"22335",9,474,465,"GGAAGCGGAAATTGAGATAG","AACACACCCGTTTGTAACGT","561307.5.peg.315","1706"
"22336",848,474,374,"ATTGTGCCATCCAAATACGT","AACACACCCGTTTGTAACGT","561307.5.peg.315","1706"
"22337",657,474,183,"TTAATCCATCTTGAATTGG","AACACACCCGTTTGTAACGT","561307.5.peg.315","1706"
"22338",942,474,468,"TAAATAGCAAATGCCGCCGC","AACACACCCGTTTGTAACGT","561307.5.peg.315","1706"
"22339",942,523,419,"TAAATAGCAAATGCCGCCGC","AAATTTGTTGTAACACCATG","561307.5.peg.315","1706"
"22340",11,523,512,"ATGGAAGCGGAAATTGAGAT","AAATTTGTTGTAACACCATG","561307.5.peg.315","1706"
"22341",657,523,134,"TTAATCCATCTTGAATTGG","AAATTTGTTGTAACACCATG","561307.5.peg.315","1706"
"22342",9,523,514,"GGAAGCGGAAATTGAGATAG","AAATTTGTTGTAACACCATG","561307.5.peg.315","1706"
"22343",848,523,325,"ATTGTGCCATCCAAATACGT","AAATTTGTTGTAACACCATG","561307.5.peg.315","1706"
"22344",9,600,591,"GGAAGCGGAAATTGAGATAG","GCTACGACCGATGTCACAAT","561307.5.peg.315","1706"
"22345",474,600,126,"AACACACCCGTTTGTAACGT","GCTACGACCGATGTCACAAT","561307.5.peg.315","1706"
"22346",11,600,589,"ATGGAAGCGGAAATTGAGAT","GCTACGACCGATGTCACAAT","561307.5.peg.315","1706"
"22347",848,600,248,"ATTGTGCCATCCAAATACGT","GCTACGACCGATGTCACAAT","561307.5.peg.315","1706"
"22348",942,600,342,"TAAATAGCAAATGCCGCCGC","GCTACGACCGATGTCACAAT","561307.5.peg.315","1706"
"22349",9,657,648,"GGAAGCGGAAATTGAGATAG","TTAATCCATCTTGAATTGG","561307.5.peg.315","1706"
"22350",942,657,285,"TAAATAGCAAATGCCGCCGC","TTAATCCATCTTGAATTGG","561307.5.peg.315","1706"
"22351",474,657,183,"AACACACCCGTTTGTAACGT","TTAATCCATCTTGAATTGG","561307.5.peg.315","1706"
"22352",11,657,646,"ATGGAAGCGGAAATTGAGAT","TTAATCCATCTTGAATTGG","561307.5.peg.315","1706"
"22353",523,657,134,"AAATTTGTTGTAACACCATG","TTAATCCATCTTGAATTGG","561307.5.peg.315","1706"
"22354",848,657,191,"ATTGTGCCATCCAAATACGT","TTAATCCATCTTGAATTGG","561307.5.peg.315","1706"
"22355",474,848,374,"AACACACCCGTTTGTAACGT","ATTGTGCCATCCAAATACGT","561307.5.peg.315","1706"
"22356",600,848,248,"GCTACGACCGATGTCACAAT","ATTGTGCCATCCAAATACGT","561307.5.peg.315","1706"
"22357",11,848,837,"ATGGAAGCGGAAATTGAGAT","ATTGTGCCATCCAAATACGT","561307.5.peg.315","1706"
"22358",657,848,191,"TTAATCCATCTTGAATTGG","ATTGTGCCATCCAAATACGT","561307.5.peg.315","1706"
"22359",9,848,839,"GGAAGCGGAAATTGAGATAG","ATTGTGCCATCCAAATACGT","561307.5.peg.315","1706"
"22360",523,848,325,"AAATTTGTTGTAACACCATG","ATTGTGCCATCCAAATACGT","561307.5.peg.315","1706"
"22361",9,942,933,"GGAAGCGGAAATTGAGATAG","TAAATAGCAAATGCCGCCGC","561307.5.peg.315","1706"
"22362",11,942,931,"ATGGAAGCGGAAATTGAGAT","TAAATAGCAAATGCCGCCGC","561307.5.peg.315","1706"
"22363",474,942,468,"AACACACCCGTTTGTAACGT","TAAATAGCAAATGCCGCCGC","561307.5.peg.315","1706"
"22364",657,942,285,"TTAATCCATCTTGAATTGG","TAAATAGCAAATGCCGCCGC","561307.5.peg.315","1706"
"22365",523,942,419,"AAATTTGTTGTAACACCATG","TAAATAGCAAATGCCGCCGC","561307.5.peg.315","1706"
"22366",600,942,342,"GCTACGACCGATGTCACAAT","TAAATAGCAAATGCCGCCGC","561307.5.peg.315","1706"
"22367",456,231,225,"TGCGGAATCTTCGGATATAC","TCATATTCGCCTGCTGTCTG","561307.5.peg.318","1709"
"22368",465,231,234,"TAATCTTGATGCGGAATCTT","TCATATTCGCCTGCTGTCTG","561307.5.peg.318","1709"
"22369",474,231,243,"GTCGCTTGATAATCTTGATG","TCATATTCGCCTGCTGTCTG","561307.5.peg.318","1709"
"22370",456,259,197,"TGCGGAATCTTCGGATATAC","GGCATCTTAAACTGATAAT","561307.5.peg.318","1709"
"22371",474,259,215,"GTCGCTTGATAATCTTGATG","GGCATCTTAAACTGATAAT","561307.5.peg.318","1709"
"22372",465,259,206,"TAATCTTGATGCGGAATCTT","GGCATCTTAAACTGATAAT","561307.5.peg.318","1709"
"22373",456,310,146,"TGCGGAATCTTCGGATATAC","TTATCGTTAACGGTATAAA","561307.5.peg.318","1709"
"22374",474,310,164,"GTCGCTTGATAATCTTGATG","TTATCGTTAACGGTATAAA","561307.5.peg.318","1709"
"22375",465,310,155,"TAATCTTGATGCGGAATCTT","TTATCGTTAACGGTATAAA","561307.5.peg.318","1709"
"22376",231,456,225,"TCATATTCGCCTGCTGTCTG","TGCGGAATCTTCGGATATAC","561307.5.peg.318","1709"
"22377",259,456,197,"GGCATCTTAAACTGATAAT","TGCGGAATCTTCGGATATAC","561307.5.peg.318","1709"
"22378",310,456,146,"TTATCGTTAACGGTATAAA","TGCGGAATCTTCGGATATAC","561307.5.peg.318","1709"
"22379",231,465,234,"TCATATTCGCCTGCTGTCTG","TAATCTTGATGCGGAATCTT","561307.5.peg.318","1709"
"22380",310,465,155,"TTATCGTTAACGGTATAAA","TAATCTTGATGCGGAATCTT","561307.5.peg.318","1709"
"22381",259,465,206,"GGCATCTTAAACTGATAAT","TAATCTTGATGCGGAATCTT","561307.5.peg.318","1709"
"22382",231,474,243,"TCATATTCGCCTGCTGTCTG","GTCGCTTGATAATCTTGATG","561307.5.peg.318","1709"
"22383",310,474,164,"TTATCGTTAACGGTATAAA","GTCGCTTGATAATCTTGATG","561307.5.peg.318","1709"
"22384",259,474,215,"GGCATCTTAAACTGATAAT","GTCGCTTGATAATCTTGATG","561307.5.peg.318","1709"
"22385",243,97,146,"ACGCTAAATATTGAACGTTT","CCATAAACAAGCACCGACAA","561307.5.peg.319","1710"
"22386",269,97,172,"TGCCTAACATACGTCGATCT","CCATAAACAAGCACCGACAA","561307.5.peg.319","1710"
"22387",97,243,146,"CCATAAACAAGCACCGACAA","ACGCTAAATATTGAACGTTT","561307.5.peg.319","1710"
"22388",97,269,172,"CCATAAACAAGCACCGACAA","TGCCTAACATACGTCGATCT","561307.5.peg.319","1710"
"22389",498,123,375,"TTTAATGTTGCTAGCACACC","TGTAGTCCTTGTTTACCGTA","561307.5.peg.321","1713"
"22390",312,123,189,"CCAACAATGACCGCAAATAC","TGTAGTCCTTGTTTACCGTA","561307.5.peg.321","1713"
"22391",423,123,300,"ACAATTAAGTCCAAGCCTTC","TGTAGTCCTTGTTTACCGTA","561307.5.peg.321","1713"
"22392",312,154,158,"CCAACAATGACCGCAAATAC","AAATGTCGCACAAGCTGCAC","561307.5.peg.321","1713"
"22393",423,154,269,"ACAATTAAGTCCAAGCCTTC","AAATGTCGCACAAGCTGCAC","561307.5.peg.321","1713"
"22394",498,154,344,"TTTAATGTTGCTAGCACACC","AAATGTCGCACAAGCTGCAC","561307.5.peg.321","1713"
"22395",312,180,132,"CCAACAATGACCGCAAATAC","GCATAACTTAAGAATGCTTG","561307.5.peg.321","1713"
"22396",423,180,243,"ACAATTAAGTCCAAGCCTTC","GCATAACTTAAGAATGCTTG","561307.5.peg.321","1713"
"22397",498,180,318,"TTTAATGTTGCTAGCACACC","GCATAACTTAAGAATGCTTG","561307.5.peg.321","1713"
"22398",180,312,132,"GCATAACTTAAGAATGCTTG","CCAACAATGACCGCAAATAC","561307.5.peg.321","1713"
"22399",154,312,158,"AAATGTCGCACAAGCTGCAC","CCAACAATGACCGCAAATAC","561307.5.peg.321","1713"
"22400",123,312,189,"TGTAGTCCTTGTTTACCGTA","CCAACAATGACCGCAAATAC","561307.5.peg.321","1713"
"22401",423,312,111,"ACAATTAAGTCCAAGCCTTC","CCAACAATGACCGCAAATAC","561307.5.peg.321","1713"
"22402",498,312,186,"TTTAATGTTGCTAGCACACC","CCAACAATGACCGCAAATAC","561307.5.peg.321","1713"
"22403",123,423,300,"TGTAGTCCTTGTTTACCGTA","ACAATTAAGTCCAAGCCTTC","561307.5.peg.321","1713"
"22404",180,423,243,"GCATAACTTAAGAATGCTTG","ACAATTAAGTCCAAGCCTTC","561307.5.peg.321","1713"
"22405",154,423,269,"AAATGTCGCACAAGCTGCAC","ACAATTAAGTCCAAGCCTTC","561307.5.peg.321","1713"
"22406",312,423,111,"CCAACAATGACCGCAAATAC","ACAATTAAGTCCAAGCCTTC","561307.5.peg.321","1713"
"22407",123,498,375,"TGTAGTCCTTGTTTACCGTA","TTTAATGTTGCTAGCACACC","561307.5.peg.321","1713"
"22408",154,498,344,"AAATGTCGCACAAGCTGCAC","TTTAATGTTGCTAGCACACC","561307.5.peg.321","1713"
"22409",312,498,186,"CCAACAATGACCGCAAATAC","TTTAATGTTGCTAGCACACC","561307.5.peg.321","1713"
"22410",180,498,318,"GCATAACTTAAGAATGCTTG","TTTAATGTTGCTAGCACACC","561307.5.peg.321","1713"
"22411",227,96,131,"CGACATCTGTACCATGTCCT","CTTGAAGGGCCCATCATAAC","561307.5.peg.322","1714"
"22412",227,110,117,"CGACATCTGTACCATGTCCT","CAGCCGTATGAGAACTTGAA","561307.5.peg.322","1714"
"22413",96,227,131,"CTTGAAGGGCCCATCATAAC","CGACATCTGTACCATGTCCT","561307.5.peg.322","1714"
"22414",110,227,117,"CAGCCGTATGAGAACTTGAA","CGACATCTGTACCATGTCCT","561307.5.peg.322","1714"
"22415",343,8,335,"TTGACTTCATTTGTTGCAA","TTCCTATATAAATTAGAGG","561307.5.peg.323","1715"
"22416",393,8,385,"GTACCCGAGGAACCAGCTGT","TTCCTATATAAATTAGAGG","561307.5.peg.323","1715"
"22417",406,8,398,"TGCACCGGGAATGGTACCCG","TTCCTATATAAATTAGAGG","561307.5.peg.323","1715"
"22418",343,24,319,"TTGACTTCATTTGTTGCAA","TTCCCCCTCTAATTTATAT","561307.5.peg.323","1715"
"22419",393,24,369,"GTACCCGAGGAACCAGCTGT","TTCCCCCTCTAATTTATAT","561307.5.peg.323","1715"
"22420",406,24,382,"TGCACCGGGAATGGTACCCG","TTCCCCCTCTAATTTATAT","561307.5.peg.323","1715"
"22421",8,343,335,"TTCCTATATAAATTAGAGG","TTGACTTCATTTGTTGCAA","561307.5.peg.323","1715"
"22422",24,343,319,"TTCCCCCTCTAATTTATAT","TTGACTTCATTTGTTGCAA","561307.5.peg.323","1715"
"22423",8,393,385,"TTCCTATATAAATTAGAGG","GTACCCGAGGAACCAGCTGT","561307.5.peg.323","1715"
"22424",24,393,369,"TTCCCCCTCTAATTTATAT","GTACCCGAGGAACCAGCTGT","561307.5.peg.323","1715"
"22425",8,406,398,"TTCCTATATAAATTAGAGG","TGCACCGGGAATGGTACCCG","561307.5.peg.323","1715"
"22426",24,406,382,"TTCCCCCTCTAATTTATAT","TGCACCGGGAATGGTACCCG","561307.5.peg.323","1715"
"22427",264,109,155,"GTATATAGGTATGCTGGCCA","ACAGCTGTAGTATTGATAA","561307.5.peg.324","1716"
"22428",270,109,161,"TCGATTGTATATAGGTATGC","ACAGCTGTAGTATTGATAA","561307.5.peg.324","1716"
"22429",264,144,120,"GTATATAGGTATGCTGGCCA","ACACGTTCGTCTATGGTTTG","561307.5.peg.324","1716"
"22430",270,144,126,"TCGATTGTATATAGGTATGC","ACACGTTCGTCTATGGTTTG","561307.5.peg.324","1716"
"22431",264,151,113,"GTATATAGGTATGCTGGCCA","CCATGCGACACGTTCGTCTA","561307.5.peg.324","1716"
"22432",270,151,119,"TCGATTGTATATAGGTATGC","CCATGCGACACGTTCGTCTA","561307.5.peg.324","1716"
"22433",109,264,155,"ACAGCTGTAGTATTGATAA","GTATATAGGTATGCTGGCCA","561307.5.peg.324","1716"
"22434",144,264,120,"ACACGTTCGTCTATGGTTTG","GTATATAGGTATGCTGGCCA","561307.5.peg.324","1716"
"22435",151,264,113,"CCATGCGACACGTTCGTCTA","GTATATAGGTATGCTGGCCA","561307.5.peg.324","1716"
"22436",109,270,161,"ACAGCTGTAGTATTGATAA","TCGATTGTATATAGGTATGC","561307.5.peg.324","1716"
"22437",144,270,126,"ACACGTTCGTCTATGGTTTG","TCGATTGTATATAGGTATGC","561307.5.peg.324","1716"
"22438",151,270,119,"CCATGCGACACGTTCGTCTA","TCGATTGTATATAGGTATGC","561307.5.peg.324","1716"
"22439",246,101,145,"GCCACTTTCGATTTATCTTT","CAAACAAATATGCTGCCACT","561307.5.peg.325","1717"
"22440",306,101,205,"GTTGCTGGTCCTGGATATAC","CAAACAAATATGCTGCCACT","561307.5.peg.325","1717"
"22441",315,101,214,"TGTTCAGGTGTTGCTGGTCC","CAAACAAATATGCTGCCACT","561307.5.peg.325","1717"
"22442",101,246,145,"CAAACAAATATGCTGCCACT","GCCACTTTCGATTTATCTTT","561307.5.peg.325","1717"
"22443",101,306,205,"CAAACAAATATGCTGCCACT","GTTGCTGGTCCTGGATATAC","561307.5.peg.325","1717"
"22444",101,315,214,"CAAACAAATATGCTGCCACT","TGTTCAGGTGTTGCTGGTCC","561307.5.peg.325","1717"
"22445",621,11,610,"TCCAACCAATTTGTAGGATT","ACATTAATGATGAATTTGG","561307.5.peg.33","1722"
"22446",428,11,417,"CACTGCTTGTTCTAAAGTTC","ACATTAATGATGAATTTGG","561307.5.peg.33","1722"
"22447",1200,11,1189,"TATGATTCGGCAATTTCTGA","ACATTAATGATGAATTTGG","561307.5.peg.33","1722"
"22448",1062,11,1051,"CGCGCAAGGTACTTTACTCG","ACATTAATGATGAATTTGG","561307.5.peg.33","1722"
"22449",1223,11,1212,"ATATTTCTTGGAAGTGTTGA","ACATTAATGATGAATTTGG","561307.5.peg.33","1722"
"22450",657,11,646,"TGTTGTGCTTCTTCTTCGTA","ACATTAATGATGAATTTGG","561307.5.peg.33","1722"
"22451",1213,11,1202,"GAAGTGTTGACGGTATGATT","ACATTAATGATGAATTTGG","561307.5.peg.33","1722"
"22452",1838,11,1827,"AACCTTCACGACTATTCACA","ACATTAATGATGAATTTGG","561307.5.peg.33","1722"
"22453",1235,11,1224,"ACTCATCGACCAATATTTCT","ACATTAATGATGAATTTGG","561307.5.peg.33","1722"
"22454",428,69,359,"CACTGCTTGTTCTAAAGTTC","TCAGTCCAAATCACGCCTTG","561307.5.peg.33","1722"
"22455",657,69,588,"TGTTGTGCTTCTTCTTCGTA","TCAGTCCAAATCACGCCTTG","561307.5.peg.33","1722"
"22456",1213,69,1144,"GAAGTGTTGACGGTATGATT","TCAGTCCAAATCACGCCTTG","561307.5.peg.33","1722"
"22457",1223,69,1154,"ATATTTCTTGGAAGTGTTGA","TCAGTCCAAATCACGCCTTG","561307.5.peg.33","1722"
"22458",1200,69,1131,"TATGATTCGGCAATTTCTGA","TCAGTCCAAATCACGCCTTG","561307.5.peg.33","1722"
"22459",1838,69,1769,"AACCTTCACGACTATTCACA","TCAGTCCAAATCACGCCTTG","561307.5.peg.33","1722"
"22460",621,69,552,"TCCAACCAATTTGTAGGATT","TCAGTCCAAATCACGCCTTG","561307.5.peg.33","1722"
"22461",1235,69,1166,"ACTCATCGACCAATATTTCT","TCAGTCCAAATCACGCCTTG","561307.5.peg.33","1722"
"22462",1062,69,993,"CGCGCAAGGTACTTTACTCG","TCAGTCCAAATCACGCCTTG","561307.5.peg.33","1722"
"22463",11,428,417,"ACATTAATGATGAATTTGG","CACTGCTTGTTCTAAAGTTC","561307.5.peg.33","1722"
"22464",1838,428,1410,"AACCTTCACGACTATTCACA","CACTGCTTGTTCTAAAGTTC","561307.5.peg.33","1722"
"22465",1223,428,795,"ATATTTCTTGGAAGTGTTGA","CACTGCTTGTTCTAAAGTTC","561307.5.peg.33","1722"
"22466",657,428,229,"TGTTGTGCTTCTTCTTCGTA","CACTGCTTGTTCTAAAGTTC","561307.5.peg.33","1722"
"22467",621,428,193,"TCCAACCAATTTGTAGGATT","CACTGCTTGTTCTAAAGTTC","561307.5.peg.33","1722"
"22468",69,428,359,"TCAGTCCAAATCACGCCTTG","CACTGCTTGTTCTAAAGTTC","561307.5.peg.33","1722"
"22469",1235,428,807,"ACTCATCGACCAATATTTCT","CACTGCTTGTTCTAAAGTTC","561307.5.peg.33","1722"
"22470",1200,428,772,"TATGATTCGGCAATTTCTGA","CACTGCTTGTTCTAAAGTTC","561307.5.peg.33","1722"
"22471",1213,428,785,"GAAGTGTTGACGGTATGATT","CACTGCTTGTTCTAAAGTTC","561307.5.peg.33","1722"
"22472",1062,428,634,"CGCGCAAGGTACTTTACTCG","CACTGCTTGTTCTAAAGTTC","561307.5.peg.33","1722"
"22473",1062,621,441,"CGCGCAAGGTACTTTACTCG","TCCAACCAATTTGTAGGATT","561307.5.peg.33","1722"
"22474",1213,621,592,"GAAGTGTTGACGGTATGATT","TCCAACCAATTTGTAGGATT","561307.5.peg.33","1722"
"22475",11,621,610,"ACATTAATGATGAATTTGG","TCCAACCAATTTGTAGGATT","561307.5.peg.33","1722"
"22476",1200,621,579,"TATGATTCGGCAATTTCTGA","TCCAACCAATTTGTAGGATT","561307.5.peg.33","1722"
"22477",1235,621,614,"ACTCATCGACCAATATTTCT","TCCAACCAATTTGTAGGATT","561307.5.peg.33","1722"
"22478",1838,621,1217,"AACCTTCACGACTATTCACA","TCCAACCAATTTGTAGGATT","561307.5.peg.33","1722"
"22479",428,621,193,"CACTGCTTGTTCTAAAGTTC","TCCAACCAATTTGTAGGATT","561307.5.peg.33","1722"
"22480",1223,621,602,"ATATTTCTTGGAAGTGTTGA","TCCAACCAATTTGTAGGATT","561307.5.peg.33","1722"
"22481",69,621,552,"TCAGTCCAAATCACGCCTTG","TCCAACCAATTTGTAGGATT","561307.5.peg.33","1722"
"22482",1200,657,543,"TATGATTCGGCAATTTCTGA","TGTTGTGCTTCTTCTTCGTA","561307.5.peg.33","1722"
"22483",1223,657,566,"ATATTTCTTGGAAGTGTTGA","TGTTGTGCTTCTTCTTCGTA","561307.5.peg.33","1722"
"22484",428,657,229,"CACTGCTTGTTCTAAAGTTC","TGTTGTGCTTCTTCTTCGTA","561307.5.peg.33","1722"
"22485",1213,657,556,"GAAGTGTTGACGGTATGATT","TGTTGTGCTTCTTCTTCGTA","561307.5.peg.33","1722"
"22486",1838,657,1181,"AACCTTCACGACTATTCACA","TGTTGTGCTTCTTCTTCGTA","561307.5.peg.33","1722"
"22487",69,657,588,"TCAGTCCAAATCACGCCTTG","TGTTGTGCTTCTTCTTCGTA","561307.5.peg.33","1722"
"22488",11,657,646,"ACATTAATGATGAATTTGG","TGTTGTGCTTCTTCTTCGTA","561307.5.peg.33","1722"
"22489",1062,657,405,"CGCGCAAGGTACTTTACTCG","TGTTGTGCTTCTTCTTCGTA","561307.5.peg.33","1722"
"22490",1235,657,578,"ACTCATCGACCAATATTTCT","TGTTGTGCTTCTTCTTCGTA","561307.5.peg.33","1722"
"22491",11,1062,1051,"ACATTAATGATGAATTTGG","CGCGCAAGGTACTTTACTCG","561307.5.peg.33","1722"
"22492",69,1062,993,"TCAGTCCAAATCACGCCTTG","CGCGCAAGGTACTTTACTCG","561307.5.peg.33","1722"
"22493",657,1062,405,"TGTTGTGCTTCTTCTTCGTA","CGCGCAAGGTACTTTACTCG","561307.5.peg.33","1722"
"22494",1213,1062,151,"GAAGTGTTGACGGTATGATT","CGCGCAAGGTACTTTACTCG","561307.5.peg.33","1722"
"22495",1838,1062,776,"AACCTTCACGACTATTCACA","CGCGCAAGGTACTTTACTCG","561307.5.peg.33","1722"
"22496",1235,1062,173,"ACTCATCGACCAATATTTCT","CGCGCAAGGTACTTTACTCG","561307.5.peg.33","1722"
"22497",1200,1062,138,"TATGATTCGGCAATTTCTGA","CGCGCAAGGTACTTTACTCG","561307.5.peg.33","1722"
"22498",1223,1062,161,"ATATTTCTTGGAAGTGTTGA","CGCGCAAGGTACTTTACTCG","561307.5.peg.33","1722"
"22499",621,1062,441,"TCCAACCAATTTGTAGGATT","CGCGCAAGGTACTTTACTCG","561307.5.peg.33","1722"
"22500",428,1062,634,"CACTGCTTGTTCTAAAGTTC","CGCGCAAGGTACTTTACTCG","561307.5.peg.33","1722"
"22501",69,1200,1131,"TCAGTCCAAATCACGCCTTG","TATGATTCGGCAATTTCTGA","561307.5.peg.33","1722"
"22502",1062,1200,138,"CGCGCAAGGTACTTTACTCG","TATGATTCGGCAATTTCTGA","561307.5.peg.33","1722"
"22503",11,1200,1189,"ACATTAATGATGAATTTGG","TATGATTCGGCAATTTCTGA","561307.5.peg.33","1722"
"22504",428,1200,772,"CACTGCTTGTTCTAAAGTTC","TATGATTCGGCAATTTCTGA","561307.5.peg.33","1722"
"22505",621,1200,579,"TCCAACCAATTTGTAGGATT","TATGATTCGGCAATTTCTGA","561307.5.peg.33","1722"
"22506",1838,1200,638,"AACCTTCACGACTATTCACA","TATGATTCGGCAATTTCTGA","561307.5.peg.33","1722"
"22507",657,1200,543,"TGTTGTGCTTCTTCTTCGTA","TATGATTCGGCAATTTCTGA","561307.5.peg.33","1722"
"22508",1062,1213,151,"CGCGCAAGGTACTTTACTCG","GAAGTGTTGACGGTATGATT","561307.5.peg.33","1722"
"22509",11,1213,1202,"ACATTAATGATGAATTTGG","GAAGTGTTGACGGTATGATT","561307.5.peg.33","1722"
"22510",428,1213,785,"CACTGCTTGTTCTAAAGTTC","GAAGTGTTGACGGTATGATT","561307.5.peg.33","1722"
"22511",657,1213,556,"TGTTGTGCTTCTTCTTCGTA","GAAGTGTTGACGGTATGATT","561307.5.peg.33","1722"
"22512",69,1213,1144,"TCAGTCCAAATCACGCCTTG","GAAGTGTTGACGGTATGATT","561307.5.peg.33","1722"
"22513",621,1213,592,"TCCAACCAATTTGTAGGATT","GAAGTGTTGACGGTATGATT","561307.5.peg.33","1722"
"22514",1838,1213,625,"AACCTTCACGACTATTCACA","GAAGTGTTGACGGTATGATT","561307.5.peg.33","1722"
"22515",69,1223,1154,"TCAGTCCAAATCACGCCTTG","ATATTTCTTGGAAGTGTTGA","561307.5.peg.33","1722"
"22516",621,1223,602,"TCCAACCAATTTGTAGGATT","ATATTTCTTGGAAGTGTTGA","561307.5.peg.33","1722"
"22517",657,1223,566,"TGTTGTGCTTCTTCTTCGTA","ATATTTCTTGGAAGTGTTGA","561307.5.peg.33","1722"
"22518",1838,1223,615,"AACCTTCACGACTATTCACA","ATATTTCTTGGAAGTGTTGA","561307.5.peg.33","1722"
"22519",1062,1223,161,"CGCGCAAGGTACTTTACTCG","ATATTTCTTGGAAGTGTTGA","561307.5.peg.33","1722"
"22520",428,1223,795,"CACTGCTTGTTCTAAAGTTC","ATATTTCTTGGAAGTGTTGA","561307.5.peg.33","1722"
"22521",11,1223,1212,"ACATTAATGATGAATTTGG","ATATTTCTTGGAAGTGTTGA","561307.5.peg.33","1722"
"22522",69,1235,1166,"TCAGTCCAAATCACGCCTTG","ACTCATCGACCAATATTTCT","561307.5.peg.33","1722"
"22523",428,1235,807,"CACTGCTTGTTCTAAAGTTC","ACTCATCGACCAATATTTCT","561307.5.peg.33","1722"
"22524",11,1235,1224,"ACATTAATGATGAATTTGG","ACTCATCGACCAATATTTCT","561307.5.peg.33","1722"
"22525",621,1235,614,"TCCAACCAATTTGTAGGATT","ACTCATCGACCAATATTTCT","561307.5.peg.33","1722"
"22526",657,1235,578,"TGTTGTGCTTCTTCTTCGTA","ACTCATCGACCAATATTTCT","561307.5.peg.33","1722"
"22527",1062,1235,173,"CGCGCAAGGTACTTTACTCG","ACTCATCGACCAATATTTCT","561307.5.peg.33","1722"
"22528",1838,1235,603,"AACCTTCACGACTATTCACA","ACTCATCGACCAATATTTCT","561307.5.peg.33","1722"
"22529",621,1838,1217,"TCCAACCAATTTGTAGGATT","AACCTTCACGACTATTCACA","561307.5.peg.33","1722"
"22530",657,1838,1181,"TGTTGTGCTTCTTCTTCGTA","AACCTTCACGACTATTCACA","561307.5.peg.33","1722"
"22531",1200,1838,638,"TATGATTCGGCAATTTCTGA","AACCTTCACGACTATTCACA","561307.5.peg.33","1722"
"22532",1235,1838,603,"ACTCATCGACCAATATTTCT","AACCTTCACGACTATTCACA","561307.5.peg.33","1722"
"22533",11,1838,1827,"ACATTAATGATGAATTTGG","AACCTTCACGACTATTCACA","561307.5.peg.33","1722"
"22534",69,1838,1769,"TCAGTCCAAATCACGCCTTG","AACCTTCACGACTATTCACA","561307.5.peg.33","1722"
"22535",428,1838,1410,"CACTGCTTGTTCTAAAGTTC","AACCTTCACGACTATTCACA","561307.5.peg.33","1722"
"22536",1223,1838,615,"ATATTTCTTGGAAGTGTTGA","AACCTTCACGACTATTCACA","561307.5.peg.33","1722"
"22537",1062,1838,776,"CGCGCAAGGTACTTTACTCG","AACCTTCACGACTATTCACA","561307.5.peg.33","1722"
"22538",1213,1838,625,"GAAGTGTTGACGGTATGATT","AACCTTCACGACTATTCACA","561307.5.peg.33","1722"
"22539",291,181,110,"TTAGCTAGATCCTCAGTAGT","ACCAGTCCCAACAGATAATA","561307.5.peg.331","1724"
"22540",395,181,214,"CTTCAATACCATTACCTTCG","ACCAGTCCCAACAGATAATA","561307.5.peg.331","1724"
"22541",397,181,216,"GACTTCAATACCATTACCTT","ACCAGTCCCAACAGATAATA","561307.5.peg.331","1724"
"22542",397,239,158,"GACTTCAATACCATTACCTT","CTTCACGTGGGGAAGTCTGA","561307.5.peg.331","1724"
"22543",395,239,156,"CTTCAATACCATTACCTTCG","CTTCACGTGGGGAAGTCTGA","561307.5.peg.331","1724"
"22544",181,291,110,"ACCAGTCCCAACAGATAATA","TTAGCTAGATCCTCAGTAGT","561307.5.peg.331","1724"
"22545",395,291,104,"CTTCAATACCATTACCTTCG","TTAGCTAGATCCTCAGTAGT","561307.5.peg.331","1724"
"22546",397,291,106,"GACTTCAATACCATTACCTT","TTAGCTAGATCCTCAGTAGT","561307.5.peg.331","1724"
"22547",181,395,214,"ACCAGTCCCAACAGATAATA","CTTCAATACCATTACCTTCG","561307.5.peg.331","1724"
"22548",291,395,104,"TTAGCTAGATCCTCAGTAGT","CTTCAATACCATTACCTTCG","561307.5.peg.331","1724"
"22549",239,395,156,"CTTCACGTGGGGAAGTCTGA","CTTCAATACCATTACCTTCG","561307.5.peg.331","1724"
"22550",181,397,216,"ACCAGTCCCAACAGATAATA","GACTTCAATACCATTACCTT","561307.5.peg.331","1724"
"22551",239,397,158,"CTTCACGTGGGGAAGTCTGA","GACTTCAATACCATTACCTT","561307.5.peg.331","1724"
"22552",291,397,106,"TTAGCTAGATCCTCAGTAGT","GACTTCAATACCATTACCTT","561307.5.peg.331","1724"
"22553",411,83,328,"TGGCCATCGACTTCTTCAAA","CATCTGTCATTGCAGTAACA","561307.5.peg.334","1727"
"22554",477,83,394,"CCATTCTTCCAAGGTACACC","CATCTGTCATTGCAGTAACA","561307.5.peg.334","1727"
"22555",486,83,403,"GGAACCGGTCCATTCTTCCA","CATCTGTCATTGCAGTAACA","561307.5.peg.334","1727"
"22556",501,83,418,"ATCGCTTTATCTACTGGAAC","CATCTGTCATTGCAGTAACA","561307.5.peg.334","1727"
"22557",315,83,232,"TATGTTAATGCGTCATCGTT","CATCTGTCATTGCAGTAACA","561307.5.peg.334","1727"
"22558",507,83,424,"CCATAAATCGCTTTATCTAC","CATCTGTCATTGCAGTAACA","561307.5.peg.334","1727"
"22559",83,315,232,"CATCTGTCATTGCAGTAACA","TATGTTAATGCGTCATCGTT","561307.5.peg.334","1727"
"22560",477,315,162,"CCATTCTTCCAAGGTACACC","TATGTTAATGCGTCATCGTT","561307.5.peg.334","1727"
"22561",486,315,171,"GGAACCGGTCCATTCTTCCA","TATGTTAATGCGTCATCGTT","561307.5.peg.334","1727"
"22562",501,315,186,"ATCGCTTTATCTACTGGAAC","TATGTTAATGCGTCATCGTT","561307.5.peg.334","1727"
"22563",507,315,192,"CCATAAATCGCTTTATCTAC","TATGTTAATGCGTCATCGTT","561307.5.peg.334","1727"
"22564",83,411,328,"CATCTGTCATTGCAGTAACA","TGGCCATCGACTTCTTCAAA","561307.5.peg.334","1727"
"22565",315,477,162,"TATGTTAATGCGTCATCGTT","CCATTCTTCCAAGGTACACC","561307.5.peg.334","1727"
"22566",83,477,394,"CATCTGTCATTGCAGTAACA","CCATTCTTCCAAGGTACACC","561307.5.peg.334","1727"
"22567",315,486,171,"TATGTTAATGCGTCATCGTT","GGAACCGGTCCATTCTTCCA","561307.5.peg.334","1727"
"22568",83,486,403,"CATCTGTCATTGCAGTAACA","GGAACCGGTCCATTCTTCCA","561307.5.peg.334","1727"
"22569",83,501,418,"CATCTGTCATTGCAGTAACA","ATCGCTTTATCTACTGGAAC","561307.5.peg.334","1727"
"22570",315,501,186,"TATGTTAATGCGTCATCGTT","ATCGCTTTATCTACTGGAAC","561307.5.peg.334","1727"
"22571",83,507,424,"CATCTGTCATTGCAGTAACA","CCATAAATCGCTTTATCTAC","561307.5.peg.334","1727"
"22572",315,507,192,"TATGTTAATGCGTCATCGTT","CCATAAATCGCTTTATCTAC","561307.5.peg.334","1727"
"22573",138,8,130,"TCATTCAATGCTTCGCCTAA","CATGGTTAATTGGAATGAGG","561307.5.peg.335","1728"
"22574",212,8,204,"CACCAAGACGTTTGAAATAA","CATGGTTAATTGGAATGAGG","561307.5.peg.335","1728"
"22575",138,26,112,"TCATTCAATGCTTCGCCTAA","TTTAATACGAAGCGTCAACA","561307.5.peg.335","1728"
"22576",212,26,186,"CACCAAGACGTTTGAAATAA","TTTAATACGAAGCGTCAACA","561307.5.peg.335","1728"
"22577",8,138,130,"CATGGTTAATTGGAATGAGG","TCATTCAATGCTTCGCCTAA","561307.5.peg.335","1728"
"22578",26,138,112,"TTTAATACGAAGCGTCAACA","TCATTCAATGCTTCGCCTAA","561307.5.peg.335","1728"
"22579",8,212,204,"CATGGTTAATTGGAATGAGG","CACCAAGACGTTTGAAATAA","561307.5.peg.335","1728"
"22580",26,212,186,"TTTAATACGAAGCGTCAACA","CACCAAGACGTTTGAAATAA","561307.5.peg.335","1728"
"22581",396,70,326,"ATGAGTGCGCTCAGCCAATA","AAAGGCAAATGCCACAATAA","561307.5.peg.336","1729"
"22582",396,112,284,"ATGAGTGCGCTCAGCCAATA","TTCTTGACCAGTAGCAAAGC","561307.5.peg.336","1729"
"22583",70,396,326,"AAAGGCAAATGCCACAATAA","ATGAGTGCGCTCAGCCAATA","561307.5.peg.336","1729"
"22584",112,396,284,"TTCTTGACCAGTAGCAAAGC","ATGAGTGCGCTCAGCCAATA","561307.5.peg.336","1729"
"22585",727,224,503,"ATTACCCCATTGAATATCTA","AACCGTTGCGTAATACGTGT","561307.5.peg.337","1730"
"22586",939,224,715,"GTTAAACGTTCGTGTTTGTC","AACCGTTGCGTAATACGTGT","561307.5.peg.337","1730"
"22587",625,224,401,"ATCGACGACTAAGCGTTGTA","AACCGTTGCGTAATACGTGT","561307.5.peg.337","1730"
"22588",224,625,401,"AACCGTTGCGTAATACGTGT","ATCGACGACTAAGCGTTGTA","561307.5.peg.337","1730"
"22589",727,625,102,"ATTACCCCATTGAATATCTA","ATCGACGACTAAGCGTTGTA","561307.5.peg.337","1730"
"22590",939,625,314,"GTTAAACGTTCGTGTTTGTC","ATCGACGACTAAGCGTTGTA","561307.5.peg.337","1730"
"22591",224,727,503,"AACCGTTGCGTAATACGTGT","ATTACCCCATTGAATATCTA","561307.5.peg.337","1730"
"22592",939,727,212,"GTTAAACGTTCGTGTTTGTC","ATTACCCCATTGAATATCTA","561307.5.peg.337","1730"
"22593",625,727,102,"ATCGACGACTAAGCGTTGTA","ATTACCCCATTGAATATCTA","561307.5.peg.337","1730"
"22594",224,939,715,"AACCGTTGCGTAATACGTGT","GTTAAACGTTCGTGTTTGTC","561307.5.peg.337","1730"
"22595",625,939,314,"ATCGACGACTAAGCGTTGTA","GTTAAACGTTCGTGTTTGTC","561307.5.peg.337","1730"
"22596",727,939,212,"ATTACCCCATTGAATATCTA","GTTAAACGTTCGTGTTTGTC","561307.5.peg.337","1730"
"22597",183,13,170,"GCAGATGTGAAAGATTCCTG","ACTAGAAATCATAGAAAGGG","561307.5.peg.338","1731"
"22598",13,183,170,"ACTAGAAATCATAGAAAGGG","GCAGATGTGAAAGATTCCTG","561307.5.peg.338","1731"
"22599",783,7,776,"ATATGTCGTAACACTTCCGA","ATATGTGTCAAAGGAAGTGA","561307.5.peg.34","1733"
"22600",1749,7,1742,"CTTACTTGGTCCAATGTTTG","ATATGTGTCAAAGGAAGTGA","561307.5.peg.34","1733"
"22601",1155,7,1148,"GAACGAATCATTTCCATGAC","ATATGTGTCAAAGGAAGTGA","561307.5.peg.34","1733"
"22602",1646,7,1639,"TACTAGAACTAAGTCATCA","ATATGTGTCAAAGGAAGTGA","561307.5.peg.34","1733"
"22603",199,7,192,"TAATTCCGGATCATTGACAA","ATATGTGTCAAAGGAAGTGA","561307.5.peg.34","1733"
"22604",1680,7,1673,"AAGAAACGTTCCATCGACAT","ATATGTGTCAAAGGAAGTGA","561307.5.peg.34","1733"
"22605",1215,7,1208,"GTCTTCAATAAGCGTAGCAT","ATATGTGTCAAAGGAAGTGA","561307.5.peg.34","1733"
"22606",1763,7,1756,"CCATCGTACCAATACTTACT","ATATGTGTCAAAGGAAGTGA","561307.5.peg.34","1733"
"22607",542,7,535,"GAATGCGTTGTTCGAACTCA","ATATGTGTCAAAGGAAGTGA","561307.5.peg.34","1733"
"22608",1646,199,1447,"TACTAGAACTAAGTCATCA","TAATTCCGGATCATTGACAA","561307.5.peg.34","1733"
"22609",7,199,192,"ATATGTGTCAAAGGAAGTGA","TAATTCCGGATCATTGACAA","561307.5.peg.34","1733"
"22610",1215,199,1016,"GTCTTCAATAAGCGTAGCAT","TAATTCCGGATCATTGACAA","561307.5.peg.34","1733"
"22611",1763,199,1564,"CCATCGTACCAATACTTACT","TAATTCCGGATCATTGACAA","561307.5.peg.34","1733"
"22612",1155,199,956,"GAACGAATCATTTCCATGAC","TAATTCCGGATCATTGACAA","561307.5.peg.34","1733"
"22613",783,199,584,"ATATGTCGTAACACTTCCGA","TAATTCCGGATCATTGACAA","561307.5.peg.34","1733"
"22614",1680,199,1481,"AAGAAACGTTCCATCGACAT","TAATTCCGGATCATTGACAA","561307.5.peg.34","1733"
"22615",1749,199,1550,"CTTACTTGGTCCAATGTTTG","TAATTCCGGATCATTGACAA","561307.5.peg.34","1733"
"22616",542,199,343,"GAATGCGTTGTTCGAACTCA","TAATTCCGGATCATTGACAA","561307.5.peg.34","1733"
"22617",7,542,535,"ATATGTGTCAAAGGAAGTGA","GAATGCGTTGTTCGAACTCA","561307.5.peg.34","1733"
"22618",1155,542,613,"GAACGAATCATTTCCATGAC","GAATGCGTTGTTCGAACTCA","561307.5.peg.34","1733"
"22619",1680,542,1138,"AAGAAACGTTCCATCGACAT","GAATGCGTTGTTCGAACTCA","561307.5.peg.34","1733"
"22620",1749,542,1207,"CTTACTTGGTCCAATGTTTG","GAATGCGTTGTTCGAACTCA","561307.5.peg.34","1733"
"22621",1215,542,673,"GTCTTCAATAAGCGTAGCAT","GAATGCGTTGTTCGAACTCA","561307.5.peg.34","1733"
"22622",199,542,343,"TAATTCCGGATCATTGACAA","GAATGCGTTGTTCGAACTCA","561307.5.peg.34","1733"
"22623",783,542,241,"ATATGTCGTAACACTTCCGA","GAATGCGTTGTTCGAACTCA","561307.5.peg.34","1733"
"22624",1646,542,1104,"TACTAGAACTAAGTCATCA","GAATGCGTTGTTCGAACTCA","561307.5.peg.34","1733"
"22625",1763,542,1221,"CCATCGTACCAATACTTACT","GAATGCGTTGTTCGAACTCA","561307.5.peg.34","1733"
"22626",7,783,776,"ATATGTGTCAAAGGAAGTGA","ATATGTCGTAACACTTCCGA","561307.5.peg.34","1733"
"22627",542,783,241,"GAATGCGTTGTTCGAACTCA","ATATGTCGTAACACTTCCGA","561307.5.peg.34","1733"
"22628",1646,783,863,"TACTAGAACTAAGTCATCA","ATATGTCGTAACACTTCCGA","561307.5.peg.34","1733"
"22629",199,783,584,"TAATTCCGGATCATTGACAA","ATATGTCGTAACACTTCCGA","561307.5.peg.34","1733"
"22630",1749,783,966,"CTTACTTGGTCCAATGTTTG","ATATGTCGTAACACTTCCGA","561307.5.peg.34","1733"
"22631",1155,783,372,"GAACGAATCATTTCCATGAC","ATATGTCGTAACACTTCCGA","561307.5.peg.34","1733"
"22632",1763,783,980,"CCATCGTACCAATACTTACT","ATATGTCGTAACACTTCCGA","561307.5.peg.34","1733"
"22633",1215,783,432,"GTCTTCAATAAGCGTAGCAT","ATATGTCGTAACACTTCCGA","561307.5.peg.34","1733"
"22634",1680,783,897,"AAGAAACGTTCCATCGACAT","ATATGTCGTAACACTTCCGA","561307.5.peg.34","1733"
"22635",542,1155,613,"GAATGCGTTGTTCGAACTCA","GAACGAATCATTTCCATGAC","561307.5.peg.34","1733"
"22636",1763,1155,608,"CCATCGTACCAATACTTACT","GAACGAATCATTTCCATGAC","561307.5.peg.34","1733"
"22637",1749,1155,594,"CTTACTTGGTCCAATGTTTG","GAACGAATCATTTCCATGAC","561307.5.peg.34","1733"
"22638",199,1155,956,"TAATTCCGGATCATTGACAA","GAACGAATCATTTCCATGAC","561307.5.peg.34","1733"
"22639",7,1155,1148,"ATATGTGTCAAAGGAAGTGA","GAACGAATCATTTCCATGAC","561307.5.peg.34","1733"
"22640",783,1155,372,"ATATGTCGTAACACTTCCGA","GAACGAATCATTTCCATGAC","561307.5.peg.34","1733"
"22641",1646,1155,491,"TACTAGAACTAAGTCATCA","GAACGAATCATTTCCATGAC","561307.5.peg.34","1733"
"22642",1680,1155,525,"AAGAAACGTTCCATCGACAT","GAACGAATCATTTCCATGAC","561307.5.peg.34","1733"
"22643",783,1215,432,"ATATGTCGTAACACTTCCGA","GTCTTCAATAAGCGTAGCAT","561307.5.peg.34","1733"
"22644",1646,1215,431,"TACTAGAACTAAGTCATCA","GTCTTCAATAAGCGTAGCAT","561307.5.peg.34","1733"
"22645",1749,1215,534,"CTTACTTGGTCCAATGTTTG","GTCTTCAATAAGCGTAGCAT","561307.5.peg.34","1733"
"22646",542,1215,673,"GAATGCGTTGTTCGAACTCA","GTCTTCAATAAGCGTAGCAT","561307.5.peg.34","1733"
"22647",7,1215,1208,"ATATGTGTCAAAGGAAGTGA","GTCTTCAATAAGCGTAGCAT","561307.5.peg.34","1733"
"22648",1680,1215,465,"AAGAAACGTTCCATCGACAT","GTCTTCAATAAGCGTAGCAT","561307.5.peg.34","1733"
"22649",199,1215,1016,"TAATTCCGGATCATTGACAA","GTCTTCAATAAGCGTAGCAT","561307.5.peg.34","1733"
"22650",1763,1215,548,"CCATCGTACCAATACTTACT","GTCTTCAATAAGCGTAGCAT","561307.5.peg.34","1733"
"22651",542,1646,1104,"GAATGCGTTGTTCGAACTCA","TACTAGAACTAAGTCATCA","561307.5.peg.34","1733"
"22652",7,1646,1639,"ATATGTGTCAAAGGAAGTGA","TACTAGAACTAAGTCATCA","561307.5.peg.34","1733"
"22653",1155,1646,491,"GAACGAATCATTTCCATGAC","TACTAGAACTAAGTCATCA","561307.5.peg.34","1733"
"22654",1749,1646,103,"CTTACTTGGTCCAATGTTTG","TACTAGAACTAAGTCATCA","561307.5.peg.34","1733"
"22655",1215,1646,431,"GTCTTCAATAAGCGTAGCAT","TACTAGAACTAAGTCATCA","561307.5.peg.34","1733"
"22656",783,1646,863,"ATATGTCGTAACACTTCCGA","TACTAGAACTAAGTCATCA","561307.5.peg.34","1733"
"22657",1763,1646,117,"CCATCGTACCAATACTTACT","TACTAGAACTAAGTCATCA","561307.5.peg.34","1733"
"22658",199,1646,1447,"TAATTCCGGATCATTGACAA","TACTAGAACTAAGTCATCA","561307.5.peg.34","1733"
"22659",783,1680,897,"ATATGTCGTAACACTTCCGA","AAGAAACGTTCCATCGACAT","561307.5.peg.34","1733"
"22660",542,1680,1138,"GAATGCGTTGTTCGAACTCA","AAGAAACGTTCCATCGACAT","561307.5.peg.34","1733"
"22661",1215,1680,465,"GTCTTCAATAAGCGTAGCAT","AAGAAACGTTCCATCGACAT","561307.5.peg.34","1733"
"22662",1155,1680,525,"GAACGAATCATTTCCATGAC","AAGAAACGTTCCATCGACAT","561307.5.peg.34","1733"
"22663",7,1680,1673,"ATATGTGTCAAAGGAAGTGA","AAGAAACGTTCCATCGACAT","561307.5.peg.34","1733"
"22664",199,1680,1481,"TAATTCCGGATCATTGACAA","AAGAAACGTTCCATCGACAT","561307.5.peg.34","1733"
"22665",1646,1749,103,"TACTAGAACTAAGTCATCA","CTTACTTGGTCCAATGTTTG","561307.5.peg.34","1733"
"22666",783,1749,966,"ATATGTCGTAACACTTCCGA","CTTACTTGGTCCAATGTTTG","561307.5.peg.34","1733"
"22667",7,1749,1742,"ATATGTGTCAAAGGAAGTGA","CTTACTTGGTCCAATGTTTG","561307.5.peg.34","1733"
"22668",199,1749,1550,"TAATTCCGGATCATTGACAA","CTTACTTGGTCCAATGTTTG","561307.5.peg.34","1733"
"22669",1215,1749,534,"GTCTTCAATAAGCGTAGCAT","CTTACTTGGTCCAATGTTTG","561307.5.peg.34","1733"
"22670",542,1749,1207,"GAATGCGTTGTTCGAACTCA","CTTACTTGGTCCAATGTTTG","561307.5.peg.34","1733"
"22671",1155,1749,594,"GAACGAATCATTTCCATGAC","CTTACTTGGTCCAATGTTTG","561307.5.peg.34","1733"
"22672",1646,1763,117,"TACTAGAACTAAGTCATCA","CCATCGTACCAATACTTACT","561307.5.peg.34","1733"
"22673",7,1763,1756,"ATATGTGTCAAAGGAAGTGA","CCATCGTACCAATACTTACT","561307.5.peg.34","1733"
"22674",783,1763,980,"ATATGTCGTAACACTTCCGA","CCATCGTACCAATACTTACT","561307.5.peg.34","1733"
"22675",542,1763,1221,"GAATGCGTTGTTCGAACTCA","CCATCGTACCAATACTTACT","561307.5.peg.34","1733"
"22676",1215,1763,548,"GTCTTCAATAAGCGTAGCAT","CCATCGTACCAATACTTACT","561307.5.peg.34","1733"
"22677",199,1763,1564,"TAATTCCGGATCATTGACAA","CCATCGTACCAATACTTACT","561307.5.peg.34","1733"
"22678",1155,1763,608,"GAACGAATCATTTCCATGAC","CCATCGTACCAATACTTACT","561307.5.peg.34","1733"
"22679",384,129,255,"ATAAAGTTAAAGTCACGAG","CATATAGTCTCGGAATAAT","561307.5.peg.341","1735"
"22680",409,129,280,"CCATTATCTGTACTTAGTT","CATATAGTCTCGGAATAAT","561307.5.peg.341","1735"
"22681",477,129,348,"CCTAAGATTGGTGCCAAAGC","CATATAGTCTCGGAATAAT","561307.5.peg.341","1735"
"22682",489,129,360,"CCTAAAGTACTCCCTAAGAT","CATATAGTCTCGGAATAAT","561307.5.peg.341","1735"
"22683",129,384,255,"CATATAGTCTCGGAATAAT","ATAAAGTTAAAGTCACGAG","561307.5.peg.341","1735"
"22684",489,384,105,"CCTAAAGTACTCCCTAAGAT","ATAAAGTTAAAGTCACGAG","561307.5.peg.341","1735"
"22685",129,409,280,"CATATAGTCTCGGAATAAT","CCATTATCTGTACTTAGTT","561307.5.peg.341","1735"
"22686",129,477,348,"CATATAGTCTCGGAATAAT","CCTAAGATTGGTGCCAAAGC","561307.5.peg.341","1735"
"22687",129,489,360,"CATATAGTCTCGGAATAAT","CCTAAAGTACTCCCTAAGAT","561307.5.peg.341","1735"
"22688",384,489,105,"ATAAAGTTAAAGTCACGAG","CCTAAAGTACTCCCTAAGAT","561307.5.peg.341","1735"
"22689",401,273,128,"ATTAAACACAGCATTAGAA","GCAATTGTAATCATCTTACG","561307.5.peg.343","1737"
"22690",607,273,334,"ATGTTGCTCAGGTAAGTCTT","GCAATTGTAATCATCTTACG","561307.5.peg.343","1737"
"22691",393,273,120,"ACAGCATTAGAAGGGTACAT","GCAATTGTAATCATCTTACG","561307.5.peg.343","1737"
"22692",618,273,345,"TTAACCATTCTATGTTGCTC","GCAATTGTAATCATCTTACG","561307.5.peg.343","1737"
"22693",273,393,120,"GCAATTGTAATCATCTTACG","ACAGCATTAGAAGGGTACAT","561307.5.peg.343","1737"
"22694",607,393,214,"ATGTTGCTCAGGTAAGTCTT","ACAGCATTAGAAGGGTACAT","561307.5.peg.343","1737"
"22695",618,393,225,"TTAACCATTCTATGTTGCTC","ACAGCATTAGAAGGGTACAT","561307.5.peg.343","1737"
"22696",273,401,128,"GCAATTGTAATCATCTTACG","ATTAAACACAGCATTAGAA","561307.5.peg.343","1737"
"22697",607,401,206,"ATGTTGCTCAGGTAAGTCTT","ATTAAACACAGCATTAGAA","561307.5.peg.343","1737"
"22698",618,401,217,"TTAACCATTCTATGTTGCTC","ATTAAACACAGCATTAGAA","561307.5.peg.343","1737"
"22699",401,607,206,"ATTAAACACAGCATTAGAA","ATGTTGCTCAGGTAAGTCTT","561307.5.peg.343","1737"
"22700",273,607,334,"GCAATTGTAATCATCTTACG","ATGTTGCTCAGGTAAGTCTT","561307.5.peg.343","1737"
"22701",393,607,214,"ACAGCATTAGAAGGGTACAT","ATGTTGCTCAGGTAAGTCTT","561307.5.peg.343","1737"
"22702",273,618,345,"GCAATTGTAATCATCTTACG","TTAACCATTCTATGTTGCTC","561307.5.peg.343","1737"
"22703",393,618,225,"ACAGCATTAGAAGGGTACAT","TTAACCATTCTATGTTGCTC","561307.5.peg.343","1737"
"22704",401,618,217,"ATTAAACACAGCATTAGAA","TTAACCATTCTATGTTGCTC","561307.5.peg.343","1737"
"22705",564,159,405,"TCAATTAACTCATCTGGCAA","ACAATGAAGAATGTCGATGA","561307.5.peg.344","1738"
"22706",268,159,109,"CGTGATTAACACCATCATAG","ACAATGAAGAATGTCGATGA","561307.5.peg.344","1738"
"22707",514,159,355,"CAGTTCAGAATAAATCCCTT","ACAATGAAGAATGTCGATGA","561307.5.peg.344","1738"
"22708",514,195,319,"CAGTTCAGAATAAATCCCTT","GGAGCTATAGGTAAGTTAAT","561307.5.peg.344","1738"
"22709",564,195,369,"TCAATTAACTCATCTGGCAA","GGAGCTATAGGTAAGTTAAT","561307.5.peg.344","1738"
"22710",564,207,357,"TCAATTAACTCATCTGGCAA","AATGCTTCTTCGGGAGCTAT","561307.5.peg.344","1738"
"22711",514,207,307,"CAGTTCAGAATAAATCCCTT","AATGCTTCTTCGGGAGCTAT","561307.5.peg.344","1738"
"22712",159,268,109,"ACAATGAAGAATGTCGATGA","CGTGATTAACACCATCATAG","561307.5.peg.344","1738"
"22713",564,268,296,"TCAATTAACTCATCTGGCAA","CGTGATTAACACCATCATAG","561307.5.peg.344","1738"
"22714",514,268,246,"CAGTTCAGAATAAATCCCTT","CGTGATTAACACCATCATAG","561307.5.peg.344","1738"
"22715",268,514,246,"CGTGATTAACACCATCATAG","CAGTTCAGAATAAATCCCTT","561307.5.peg.344","1738"
"22716",159,514,355,"ACAATGAAGAATGTCGATGA","CAGTTCAGAATAAATCCCTT","561307.5.peg.344","1738"
"22717",195,514,319,"GGAGCTATAGGTAAGTTAAT","CAGTTCAGAATAAATCCCTT","561307.5.peg.344","1738"
"22718",207,514,307,"AATGCTTCTTCGGGAGCTAT","CAGTTCAGAATAAATCCCTT","561307.5.peg.344","1738"
"22719",159,564,405,"ACAATGAAGAATGTCGATGA","TCAATTAACTCATCTGGCAA","561307.5.peg.344","1738"
"22720",207,564,357,"AATGCTTCTTCGGGAGCTAT","TCAATTAACTCATCTGGCAA","561307.5.peg.344","1738"
"22721",195,564,369,"GGAGCTATAGGTAAGTTAAT","TCAATTAACTCATCTGGCAA","561307.5.peg.344","1738"
"22722",268,564,296,"CGTGATTAACACCATCATAG","TCAATTAACTCATCTGGCAA","561307.5.peg.344","1738"
"22723",141,6,135,"TTTCCTTCTGTAAATCCTTG","ACTATGGTAATTATAGGAGG","561307.5.peg.347","1741"
"22724",323,6,317,"CTTGTTGCTGTTTAACTTGT","ACTATGGTAATTATAGGAGG","561307.5.peg.347","1741"
"22725",141,9,132,"TTTCCTTCTGTAAATCCTTG","CAACTATGGTAATTATAGG","561307.5.peg.347","1741"
"22726",323,9,314,"CTTGTTGCTGTTTAACTTGT","CAACTATGGTAATTATAGG","561307.5.peg.347","1741"
"22727",323,22,301,"CTTGTTGCTGTTTAACTTGT","TGACGTCGGGTCATCAACTA","561307.5.peg.347","1741"
"22728",141,22,119,"TTTCCTTCTGTAAATCCTTG","TGACGTCGGGTCATCAACTA","561307.5.peg.347","1741"
"22729",6,141,135,"ACTATGGTAATTATAGGAGG","TTTCCTTCTGTAAATCCTTG","561307.5.peg.347","1741"
"22730",323,141,182,"CTTGTTGCTGTTTAACTTGT","TTTCCTTCTGTAAATCCTTG","561307.5.peg.347","1741"
"22731",9,141,132,"CAACTATGGTAATTATAGG","TTTCCTTCTGTAAATCCTTG","561307.5.peg.347","1741"
"22732",22,141,119,"TGACGTCGGGTCATCAACTA","TTTCCTTCTGTAAATCCTTG","561307.5.peg.347","1741"
"22733",9,323,314,"CAACTATGGTAATTATAGG","CTTGTTGCTGTTTAACTTGT","561307.5.peg.347","1741"
"22734",6,323,317,"ACTATGGTAATTATAGGAGG","CTTGTTGCTGTTTAACTTGT","561307.5.peg.347","1741"
"22735",141,323,182,"TTTCCTTCTGTAAATCCTTG","CTTGTTGCTGTTTAACTTGT","561307.5.peg.347","1741"
"22736",22,323,301,"TGACGTCGGGTCATCAACTA","CTTGTTGCTGTTTAACTTGT","561307.5.peg.347","1741"
"22737",251,11,240,"GTGCACCCATTCTTTCTAAT","ACAAGTATGTCGTGTAATGA","561307.5.peg.348","1742"
"22738",11,251,240,"ACAAGTATGTCGTGTAATGA","GTGCACCCATTCTTTCTAAT","561307.5.peg.348","1742"
"22739",666,91,575,"TACGTTGTTGGAACTAATTC","TCATCATATAAGACTGACT","561307.5.peg.349","1743"
"22740",747,91,656,"TCACTCGCACCAATAACAAA","TCATCATATAAGACTGACT","561307.5.peg.349","1743"
"22741",432,91,341,"AATGGCGACATAGGATGAAT","TCATCATATAAGACTGACT","561307.5.peg.349","1743"
"22742",678,91,587,"CCTTTCATCACATACGTTGT","TCATCATATAAGACTGACT","561307.5.peg.349","1743"
"22743",583,91,492,"TAAATTAAACATCCCTGTTG","TCATCATATAAGACTGACT","561307.5.peg.349","1743"
"22744",416,91,325,"GAATCGGTGTGCCTGTTCGC","TCATCATATAAGACTGACT","561307.5.peg.349","1743"
"22745",441,91,350,"ATCTTCGCTAATGGCGACAT","TCATCATATAAGACTGACT","561307.5.peg.349","1743"
"22746",652,91,561,"TAATTCCGGCAACATTTCCT","TCATCATATAAGACTGACT","561307.5.peg.349","1743"
"22747",432,162,270,"AATGGCGACATAGGATGAAT","TCTTCTGAGACATCAACGTT","561307.5.peg.349","1743"
"22748",583,162,421,"TAAATTAAACATCCCTGTTG","TCTTCTGAGACATCAACGTT","561307.5.peg.349","1743"
"22749",416,162,254,"GAATCGGTGTGCCTGTTCGC","TCTTCTGAGACATCAACGTT","561307.5.peg.349","1743"
"22750",678,162,516,"CCTTTCATCACATACGTTGT","TCTTCTGAGACATCAACGTT","561307.5.peg.349","1743"
"22751",652,162,490,"TAATTCCGGCAACATTTCCT","TCTTCTGAGACATCAACGTT","561307.5.peg.349","1743"
"22752",747,162,585,"TCACTCGCACCAATAACAAA","TCTTCTGAGACATCAACGTT","561307.5.peg.349","1743"
"22753",666,162,504,"TACGTTGTTGGAACTAATTC","TCTTCTGAGACATCAACGTT","561307.5.peg.349","1743"
"22754",441,162,279,"ATCTTCGCTAATGGCGACAT","TCTTCTGAGACATCAACGTT","561307.5.peg.349","1743"
"22755",162,416,254,"TCTTCTGAGACATCAACGTT","GAATCGGTGTGCCTGTTCGC","561307.5.peg.349","1743"
"22756",583,416,167,"TAAATTAAACATCCCTGTTG","GAATCGGTGTGCCTGTTCGC","561307.5.peg.349","1743"
"22757",747,416,331,"TCACTCGCACCAATAACAAA","GAATCGGTGTGCCTGTTCGC","561307.5.peg.349","1743"
"22758",666,416,250,"TACGTTGTTGGAACTAATTC","GAATCGGTGTGCCTGTTCGC","561307.5.peg.349","1743"
"22759",678,416,262,"CCTTTCATCACATACGTTGT","GAATCGGTGTGCCTGTTCGC","561307.5.peg.349","1743"
"22760",652,416,236,"TAATTCCGGCAACATTTCCT","GAATCGGTGTGCCTGTTCGC","561307.5.peg.349","1743"
"22761",91,416,325,"TCATCATATAAGACTGACT","GAATCGGTGTGCCTGTTCGC","561307.5.peg.349","1743"
"22762",678,432,246,"CCTTTCATCACATACGTTGT","AATGGCGACATAGGATGAAT","561307.5.peg.349","1743"
"22763",747,432,315,"TCACTCGCACCAATAACAAA","AATGGCGACATAGGATGAAT","561307.5.peg.349","1743"
"22764",91,432,341,"TCATCATATAAGACTGACT","AATGGCGACATAGGATGAAT","561307.5.peg.349","1743"
"22765",162,432,270,"TCTTCTGAGACATCAACGTT","AATGGCGACATAGGATGAAT","561307.5.peg.349","1743"
"22766",652,432,220,"TAATTCCGGCAACATTTCCT","AATGGCGACATAGGATGAAT","561307.5.peg.349","1743"
"22767",583,432,151,"TAAATTAAACATCCCTGTTG","AATGGCGACATAGGATGAAT","561307.5.peg.349","1743"
"22768",666,432,234,"TACGTTGTTGGAACTAATTC","AATGGCGACATAGGATGAAT","561307.5.peg.349","1743"
"22769",91,441,350,"TCATCATATAAGACTGACT","ATCTTCGCTAATGGCGACAT","561307.5.peg.349","1743"
"22770",583,441,142,"TAAATTAAACATCCCTGTTG","ATCTTCGCTAATGGCGACAT","561307.5.peg.349","1743"
"22771",747,441,306,"TCACTCGCACCAATAACAAA","ATCTTCGCTAATGGCGACAT","561307.5.peg.349","1743"
"22772",652,441,211,"TAATTCCGGCAACATTTCCT","ATCTTCGCTAATGGCGACAT","561307.5.peg.349","1743"
"22773",162,441,279,"TCTTCTGAGACATCAACGTT","ATCTTCGCTAATGGCGACAT","561307.5.peg.349","1743"
"22774",666,441,225,"TACGTTGTTGGAACTAATTC","ATCTTCGCTAATGGCGACAT","561307.5.peg.349","1743"
"22775",678,441,237,"CCTTTCATCACATACGTTGT","ATCTTCGCTAATGGCGACAT","561307.5.peg.349","1743"
"22776",162,583,421,"TCTTCTGAGACATCAACGTT","TAAATTAAACATCCCTGTTG","561307.5.peg.349","1743"
"22777",432,583,151,"AATGGCGACATAGGATGAAT","TAAATTAAACATCCCTGTTG","561307.5.peg.349","1743"
"22778",91,583,492,"TCATCATATAAGACTGACT","TAAATTAAACATCCCTGTTG","561307.5.peg.349","1743"
"22779",747,583,164,"TCACTCGCACCAATAACAAA","TAAATTAAACATCCCTGTTG","561307.5.peg.349","1743"
"22780",441,583,142,"ATCTTCGCTAATGGCGACAT","TAAATTAAACATCCCTGTTG","561307.5.peg.349","1743"
"22781",416,583,167,"GAATCGGTGTGCCTGTTCGC","TAAATTAAACATCCCTGTTG","561307.5.peg.349","1743"
"22782",441,652,211,"ATCTTCGCTAATGGCGACAT","TAATTCCGGCAACATTTCCT","561307.5.peg.349","1743"
"22783",91,652,561,"TCATCATATAAGACTGACT","TAATTCCGGCAACATTTCCT","561307.5.peg.349","1743"
"22784",432,652,220,"AATGGCGACATAGGATGAAT","TAATTCCGGCAACATTTCCT","561307.5.peg.349","1743"
"22785",162,652,490,"TCTTCTGAGACATCAACGTT","TAATTCCGGCAACATTTCCT","561307.5.peg.349","1743"
"22786",416,652,236,"GAATCGGTGTGCCTGTTCGC","TAATTCCGGCAACATTTCCT","561307.5.peg.349","1743"
"22787",432,666,234,"AATGGCGACATAGGATGAAT","TACGTTGTTGGAACTAATTC","561307.5.peg.349","1743"
"22788",416,666,250,"GAATCGGTGTGCCTGTTCGC","TACGTTGTTGGAACTAATTC","561307.5.peg.349","1743"
"22789",162,666,504,"TCTTCTGAGACATCAACGTT","TACGTTGTTGGAACTAATTC","561307.5.peg.349","1743"
"22790",91,666,575,"TCATCATATAAGACTGACT","TACGTTGTTGGAACTAATTC","561307.5.peg.349","1743"
"22791",441,666,225,"ATCTTCGCTAATGGCGACAT","TACGTTGTTGGAACTAATTC","561307.5.peg.349","1743"
"22792",432,678,246,"AATGGCGACATAGGATGAAT","CCTTTCATCACATACGTTGT","561307.5.peg.349","1743"
"22793",441,678,237,"ATCTTCGCTAATGGCGACAT","CCTTTCATCACATACGTTGT","561307.5.peg.349","1743"
"22794",162,678,516,"TCTTCTGAGACATCAACGTT","CCTTTCATCACATACGTTGT","561307.5.peg.349","1743"
"22795",91,678,587,"TCATCATATAAGACTGACT","CCTTTCATCACATACGTTGT","561307.5.peg.349","1743"
"22796",416,678,262,"GAATCGGTGTGCCTGTTCGC","CCTTTCATCACATACGTTGT","561307.5.peg.349","1743"
"22797",441,747,306,"ATCTTCGCTAATGGCGACAT","TCACTCGCACCAATAACAAA","561307.5.peg.349","1743"
"22798",416,747,331,"GAATCGGTGTGCCTGTTCGC","TCACTCGCACCAATAACAAA","561307.5.peg.349","1743"
"22799",162,747,585,"TCTTCTGAGACATCAACGTT","TCACTCGCACCAATAACAAA","561307.5.peg.349","1743"
"22800",583,747,164,"TAAATTAAACATCCCTGTTG","TCACTCGCACCAATAACAAA","561307.5.peg.349","1743"
"22801",91,747,656,"TCATCATATAAGACTGACT","TCACTCGCACCAATAACAAA","561307.5.peg.349","1743"
"22802",432,747,315,"AATGGCGACATAGGATGAAT","TCACTCGCACCAATAACAAA","561307.5.peg.349","1743"
"22803",528,242,286,"ACTACCGGTCCTGGATGTGG","AACCGAATATCAGTGCAATG","561307.5.peg.350","1745"
"22804",537,242,295,"TTTGCGATGACTACCGGTCC","AACCGAATATCAGTGCAATG","561307.5.peg.350","1745"
"22805",531,242,289,"ATGACTACCGGTCCTGGATG","AACCGAATATCAGTGCAATG","561307.5.peg.350","1745"
"22806",669,242,427,"CCTTCTCGTGTATACGCAGA","AACCGAATATCAGTGCAATG","561307.5.peg.350","1745"
"22807",610,242,368,"TGCAATGAGTGTAACTGGAA","AACCGAATATCAGTGCAATG","561307.5.peg.350","1745"
"22808",615,242,373,"GGCCCTGCAATGAGTGTAAC","AACCGAATATCAGTGCAATG","561307.5.peg.350","1745"
"22809",242,528,286,"AACCGAATATCAGTGCAATG","ACTACCGGTCCTGGATGTGG","561307.5.peg.350","1745"
"22810",669,528,141,"CCTTCTCGTGTATACGCAGA","ACTACCGGTCCTGGATGTGG","561307.5.peg.350","1745"
"22811",242,531,289,"AACCGAATATCAGTGCAATG","ATGACTACCGGTCCTGGATG","561307.5.peg.350","1745"
"22812",669,531,138,"CCTTCTCGTGTATACGCAGA","ATGACTACCGGTCCTGGATG","561307.5.peg.350","1745"
"22813",242,537,295,"AACCGAATATCAGTGCAATG","TTTGCGATGACTACCGGTCC","561307.5.peg.350","1745"
"22814",669,537,132,"CCTTCTCGTGTATACGCAGA","TTTGCGATGACTACCGGTCC","561307.5.peg.350","1745"
"22815",242,610,368,"AACCGAATATCAGTGCAATG","TGCAATGAGTGTAACTGGAA","561307.5.peg.350","1745"
"22816",242,615,373,"AACCGAATATCAGTGCAATG","GGCCCTGCAATGAGTGTAAC","561307.5.peg.350","1745"
"22817",242,669,427,"AACCGAATATCAGTGCAATG","CCTTCTCGTGTATACGCAGA","561307.5.peg.350","1745"
"22818",531,669,138,"ATGACTACCGGTCCTGGATG","CCTTCTCGTGTATACGCAGA","561307.5.peg.350","1745"
"22819",528,669,141,"ACTACCGGTCCTGGATGTGG","CCTTCTCGTGTATACGCAGA","561307.5.peg.350","1745"
"22820",537,669,132,"TTTGCGATGACTACCGGTCC","CCTTCTCGTGTATACGCAGA","561307.5.peg.350","1745"
"22821",351,231,120,"TGTGTTGTTTCCTTAACTTG","GTTACTTGTGTTGCGTTTGA","561307.5.peg.352","1747"
"22822",636,231,405,"ACCGCTCGTTGTCCTGCATG","GTTACTTGTGTTGCGTTTGA","561307.5.peg.352","1747"
"22823",471,231,240,"TTACTTTCTGATGCCGTTCT","GTTACTTGTGTTGCGTTTGA","561307.5.peg.352","1747"
"22824",1453,231,1222,"AAACCATTATCCCAAGTTA","GTTACTTGTGTTGCGTTTGA","561307.5.peg.352","1747"
"22825",495,231,264,"TCTGCTGATCTTGTCACACG","GTTACTTGTGTTGCGTTTGA","561307.5.peg.352","1747"
"22826",495,285,210,"TCTGCTGATCTTGTCACACG","TTTGCTGGTTGTGCAGTTTG","561307.5.peg.352","1747"
"22827",636,285,351,"ACCGCTCGTTGTCCTGCATG","TTTGCTGGTTGTGCAGTTTG","561307.5.peg.352","1747"
"22828",471,285,186,"TTACTTTCTGATGCCGTTCT","TTTGCTGGTTGTGCAGTTTG","561307.5.peg.352","1747"
"22829",1453,285,1168,"AAACCATTATCCCAAGTTA","TTTGCTGGTTGTGCAGTTTG","561307.5.peg.352","1747"
"22830",1453,351,1102,"AAACCATTATCCCAAGTTA","TGTGTTGTTTCCTTAACTTG","561307.5.peg.352","1747"
"22831",495,351,144,"TCTGCTGATCTTGTCACACG","TGTGTTGTTTCCTTAACTTG","561307.5.peg.352","1747"
"22832",636,351,285,"ACCGCTCGTTGTCCTGCATG","TGTGTTGTTTCCTTAACTTG","561307.5.peg.352","1747"
"22833",231,351,120,"GTTACTTGTGTTGCGTTTGA","TGTGTTGTTTCCTTAACTTG","561307.5.peg.352","1747"
"22834",471,351,120,"TTACTTTCTGATGCCGTTCT","TGTGTTGTTTCCTTAACTTG","561307.5.peg.352","1747"
"22835",351,471,120,"TGTGTTGTTTCCTTAACTTG","TTACTTTCTGATGCCGTTCT","561307.5.peg.352","1747"
"22836",636,471,165,"ACCGCTCGTTGTCCTGCATG","TTACTTTCTGATGCCGTTCT","561307.5.peg.352","1747"
"22837",231,471,240,"GTTACTTGTGTTGCGTTTGA","TTACTTTCTGATGCCGTTCT","561307.5.peg.352","1747"
"22838",285,471,186,"TTTGCTGGTTGTGCAGTTTG","TTACTTTCTGATGCCGTTCT","561307.5.peg.352","1747"
"22839",1453,471,982,"AAACCATTATCCCAAGTTA","TTACTTTCTGATGCCGTTCT","561307.5.peg.352","1747"
"22840",285,495,210,"TTTGCTGGTTGTGCAGTTTG","TCTGCTGATCTTGTCACACG","561307.5.peg.352","1747"
"22841",351,495,144,"TGTGTTGTTTCCTTAACTTG","TCTGCTGATCTTGTCACACG","561307.5.peg.352","1747"
"22842",231,495,264,"GTTACTTGTGTTGCGTTTGA","TCTGCTGATCTTGTCACACG","561307.5.peg.352","1747"
"22843",1453,495,958,"AAACCATTATCCCAAGTTA","TCTGCTGATCTTGTCACACG","561307.5.peg.352","1747"
"22844",636,495,141,"ACCGCTCGTTGTCCTGCATG","TCTGCTGATCTTGTCACACG","561307.5.peg.352","1747"
"22845",231,636,405,"GTTACTTGTGTTGCGTTTGA","ACCGCTCGTTGTCCTGCATG","561307.5.peg.352","1747"
"22846",285,636,351,"TTTGCTGGTTGTGCAGTTTG","ACCGCTCGTTGTCCTGCATG","561307.5.peg.352","1747"
"22847",351,636,285,"TGTGTTGTTTCCTTAACTTG","ACCGCTCGTTGTCCTGCATG","561307.5.peg.352","1747"
"22848",1453,636,817,"AAACCATTATCCCAAGTTA","ACCGCTCGTTGTCCTGCATG","561307.5.peg.352","1747"
"22849",495,636,141,"TCTGCTGATCTTGTCACACG","ACCGCTCGTTGTCCTGCATG","561307.5.peg.352","1747"
"22850",471,636,165,"TTACTTTCTGATGCCGTTCT","ACCGCTCGTTGTCCTGCATG","561307.5.peg.352","1747"
"22851",231,1453,1222,"GTTACTTGTGTTGCGTTTGA","AAACCATTATCCCAAGTTA","561307.5.peg.352","1747"
"22852",285,1453,1168,"TTTGCTGGTTGTGCAGTTTG","AAACCATTATCCCAAGTTA","561307.5.peg.352","1747"
"22853",471,1453,982,"TTACTTTCTGATGCCGTTCT","AAACCATTATCCCAAGTTA","561307.5.peg.352","1747"
"22854",495,1453,958,"TCTGCTGATCTTGTCACACG","AAACCATTATCCCAAGTTA","561307.5.peg.352","1747"
"22855",351,1453,1102,"TGTGTTGTTTCCTTAACTTG","AAACCATTATCCCAAGTTA","561307.5.peg.352","1747"
"22856",636,1453,817,"ACCGCTCGTTGTCCTGCATG","AAACCATTATCCCAAGTTA","561307.5.peg.352","1747"
"22857",256,150,106,"TTCAGCTGTAATTTCCATTC","CTTAAACTTCGACGTCCGAC","561307.5.peg.353","1748"
"22858",390,150,240,"TGACTATTATCAGCATCACC","CTTAAACTTCGACGTCCGAC","561307.5.peg.353","1748"
"22859",502,150,352,"TTCACTAACACATGCCATCG","CTTAAACTTCGACGTCCGAC","561307.5.peg.353","1748"
"22860",252,150,102,"GCTGTAATTTCCATTCCGGT","CTTAAACTTCGACGTCCGAC","561307.5.peg.353","1748"
"22861",150,252,102,"CTTAAACTTCGACGTCCGAC","GCTGTAATTTCCATTCCGGT","561307.5.peg.353","1748"
"22862",390,252,138,"TGACTATTATCAGCATCACC","GCTGTAATTTCCATTCCGGT","561307.5.peg.353","1748"
"22863",502,252,250,"TTCACTAACACATGCCATCG","GCTGTAATTTCCATTCCGGT","561307.5.peg.353","1748"
"22864",150,256,106,"CTTAAACTTCGACGTCCGAC","TTCAGCTGTAATTTCCATTC","561307.5.peg.353","1748"
"22865",502,256,246,"TTCACTAACACATGCCATCG","TTCAGCTGTAATTTCCATTC","561307.5.peg.353","1748"
"22866",390,256,134,"TGACTATTATCAGCATCACC","TTCAGCTGTAATTTCCATTC","561307.5.peg.353","1748"
"22867",150,390,240,"CTTAAACTTCGACGTCCGAC","TGACTATTATCAGCATCACC","561307.5.peg.353","1748"
"22868",252,390,138,"GCTGTAATTTCCATTCCGGT","TGACTATTATCAGCATCACC","561307.5.peg.353","1748"
"22869",256,390,134,"TTCAGCTGTAATTTCCATTC","TGACTATTATCAGCATCACC","561307.5.peg.353","1748"
"22870",502,390,112,"TTCACTAACACATGCCATCG","TGACTATTATCAGCATCACC","561307.5.peg.353","1748"
"22871",252,502,250,"GCTGTAATTTCCATTCCGGT","TTCACTAACACATGCCATCG","561307.5.peg.353","1748"
"22872",390,502,112,"TGACTATTATCAGCATCACC","TTCACTAACACATGCCATCG","561307.5.peg.353","1748"
"22873",150,502,352,"CTTAAACTTCGACGTCCGAC","TTCACTAACACATGCCATCG","561307.5.peg.353","1748"
"22874",256,502,246,"TTCAGCTGTAATTTCCATTC","TTCACTAACACATGCCATCG","561307.5.peg.353","1748"
"22875",455,245,210,"CAGAACCGTCTAACTCTTGG","TAACTTCTTTACCATTTACG","561307.5.peg.354","1749"
"22876",458,245,213,"TTTCAGAACCGTCTAACTCT","TAACTTCTTTACCATTTACG","561307.5.peg.354","1749"
"22877",455,282,173,"CAGAACCGTCTAACTCTTGG","CAAGGTAATTTGCTTGCATC","561307.5.peg.354","1749"
"22878",458,282,176,"TTTCAGAACCGTCTAACTCT","CAAGGTAATTTGCTTGCATC","561307.5.peg.354","1749"
"22879",245,455,210,"TAACTTCTTTACCATTTACG","CAGAACCGTCTAACTCTTGG","561307.5.peg.354","1749"
"22880",282,455,173,"CAAGGTAATTTGCTTGCATC","CAGAACCGTCTAACTCTTGG","561307.5.peg.354","1749"
"22881",245,458,213,"TAACTTCTTTACCATTTACG","TTTCAGAACCGTCTAACTCT","561307.5.peg.354","1749"
"22882",282,458,176,"CAAGGTAATTTGCTTGCATC","TTTCAGAACCGTCTAACTCT","561307.5.peg.354","1749"
"22883",276,28,248,"TTAGATAAGTCTTCAGCAAC","GGTGTTTCCTCCTTGTAATT","561307.5.peg.355","1750"
"22884",618,28,590,"ATAGCAACAACTGGTTTATG","GGTGTTTCCTCCTTGTAATT","561307.5.peg.355","1750"
"22885",174,28,146,"CGATGATGTATTGAATTGT","GGTGTTTCCTCCTTGTAATT","561307.5.peg.355","1750"
"22886",28,174,146,"GGTGTTTCCTCCTTGTAATT","CGATGATGTATTGAATTGT","561307.5.peg.355","1750"
"22887",276,174,102,"TTAGATAAGTCTTCAGCAAC","CGATGATGTATTGAATTGT","561307.5.peg.355","1750"
"22888",618,174,444,"ATAGCAACAACTGGTTTATG","CGATGATGTATTGAATTGT","561307.5.peg.355","1750"
"22889",28,276,248,"GGTGTTTCCTCCTTGTAATT","TTAGATAAGTCTTCAGCAAC","561307.5.peg.355","1750"
"22890",618,276,342,"ATAGCAACAACTGGTTTATG","TTAGATAAGTCTTCAGCAAC","561307.5.peg.355","1750"
"22891",174,276,102,"CGATGATGTATTGAATTGT","TTAGATAAGTCTTCAGCAAC","561307.5.peg.355","1750"
"22892",28,618,590,"GGTGTTTCCTCCTTGTAATT","ATAGCAACAACTGGTTTATG","561307.5.peg.355","1750"
"22893",174,618,444,"CGATGATGTATTGAATTGT","ATAGCAACAACTGGTTTATG","561307.5.peg.355","1750"
"22894",276,618,342,"TTAGATAAGTCTTCAGCAAC","ATAGCAACAACTGGTTTATG","561307.5.peg.355","1750"
"22895",526,98,428,"CTCTTCGATGTATTTCAAAG","CATTACCATGTTCGCTTTCG","561307.5.peg.357","1752"
"22896",679,98,581,"TTTGGCAGTTGCATAAGTTG","CATTACCATGTTCGCTTTCG","561307.5.peg.357","1752"
"22897",697,98,599,"GCTTGCTTCTACACCTTCTT","CATTACCATGTTCGCTTTCG","561307.5.peg.357","1752"
"22898",213,98,115,"GAGTTACCCATTTGTCCTTC","CATTACCATGTTCGCTTTCG","561307.5.peg.357","1752"
"22899",681,98,583,"TCTTTGGCAGTTGCATAAGT","CATTACCATGTTCGCTTTCG","561307.5.peg.357","1752"
"22900",681,171,510,"TCTTTGGCAGTTGCATAAGT","CTCGCTTCGATTTGAGTCGT","561307.5.peg.357","1752"
"22901",526,171,355,"CTCTTCGATGTATTTCAAAG","CTCGCTTCGATTTGAGTCGT","561307.5.peg.357","1752"
"22902",697,171,526,"GCTTGCTTCTACACCTTCTT","CTCGCTTCGATTTGAGTCGT","561307.5.peg.357","1752"
"22903",679,171,508,"TTTGGCAGTTGCATAAGTTG","CTCGCTTCGATTTGAGTCGT","561307.5.peg.357","1752"
"22904",98,213,115,"CATTACCATGTTCGCTTTCG","GAGTTACCCATTTGTCCTTC","561307.5.peg.357","1752"
"22905",679,213,466,"TTTGGCAGTTGCATAAGTTG","GAGTTACCCATTTGTCCTTC","561307.5.peg.357","1752"
"22906",526,213,313,"CTCTTCGATGTATTTCAAAG","GAGTTACCCATTTGTCCTTC","561307.5.peg.357","1752"
"22907",681,213,468,"TCTTTGGCAGTTGCATAAGT","GAGTTACCCATTTGTCCTTC","561307.5.peg.357","1752"
"22908",697,213,484,"GCTTGCTTCTACACCTTCTT","GAGTTACCCATTTGTCCTTC","561307.5.peg.357","1752"
"22909",98,526,428,"CATTACCATGTTCGCTTTCG","CTCTTCGATGTATTTCAAAG","561307.5.peg.357","1752"
"22910",171,526,355,"CTCGCTTCGATTTGAGTCGT","CTCTTCGATGTATTTCAAAG","561307.5.peg.357","1752"
"22911",213,526,313,"GAGTTACCCATTTGTCCTTC","CTCTTCGATGTATTTCAAAG","561307.5.peg.357","1752"
"22912",679,526,153,"TTTGGCAGTTGCATAAGTTG","CTCTTCGATGTATTTCAAAG","561307.5.peg.357","1752"
"22913",681,526,155,"TCTTTGGCAGTTGCATAAGT","CTCTTCGATGTATTTCAAAG","561307.5.peg.357","1752"
"22914",697,526,171,"GCTTGCTTCTACACCTTCTT","CTCTTCGATGTATTTCAAAG","561307.5.peg.357","1752"
"22915",213,679,466,"GAGTTACCCATTTGTCCTTC","TTTGGCAGTTGCATAAGTTG","561307.5.peg.357","1752"
"22916",526,679,153,"CTCTTCGATGTATTTCAAAG","TTTGGCAGTTGCATAAGTTG","561307.5.peg.357","1752"
"22917",98,679,581,"CATTACCATGTTCGCTTTCG","TTTGGCAGTTGCATAAGTTG","561307.5.peg.357","1752"
"22918",171,679,508,"CTCGCTTCGATTTGAGTCGT","TTTGGCAGTTGCATAAGTTG","561307.5.peg.357","1752"
"22919",98,681,583,"CATTACCATGTTCGCTTTCG","TCTTTGGCAGTTGCATAAGT","561307.5.peg.357","1752"
"22920",213,681,468,"GAGTTACCCATTTGTCCTTC","TCTTTGGCAGTTGCATAAGT","561307.5.peg.357","1752"
"22921",171,681,510,"CTCGCTTCGATTTGAGTCGT","TCTTTGGCAGTTGCATAAGT","561307.5.peg.357","1752"
"22922",526,681,155,"CTCTTCGATGTATTTCAAAG","TCTTTGGCAGTTGCATAAGT","561307.5.peg.357","1752"
"22923",98,697,599,"CATTACCATGTTCGCTTTCG","GCTTGCTTCTACACCTTCTT","561307.5.peg.357","1752"
"22924",526,697,171,"CTCTTCGATGTATTTCAAAG","GCTTGCTTCTACACCTTCTT","561307.5.peg.357","1752"
"22925",171,697,526,"CTCGCTTCGATTTGAGTCGT","GCTTGCTTCTACACCTTCTT","561307.5.peg.357","1752"
"22926",213,697,484,"GAGTTACCCATTTGTCCTTC","GCTTGCTTCTACACCTTCTT","561307.5.peg.357","1752"
"22927",483,104,379,"ACGATGTTCATCATTGGTAC","ATACTTCTACTTCAACAGTT","561307.5.peg.358","1753"
"22928",489,104,385,"CCATTAACGATGTTCATCAT","ATACTTCTACTTCAACAGTT","561307.5.peg.358","1753"
"22929",531,104,427,"TGAATTCTTGGAATGCAAT","ATACTTCTACTTCAACAGTT","561307.5.peg.358","1753"
"22930",561,104,457,"TTGAACGTTGTAGCACCTAC","ATACTTCTACTTCAACAGTT","561307.5.peg.358","1753"
"22931",104,483,379,"ATACTTCTACTTCAACAGTT","ACGATGTTCATCATTGGTAC","561307.5.peg.358","1753"
"22932",104,489,385,"ATACTTCTACTTCAACAGTT","CCATTAACGATGTTCATCAT","561307.5.peg.358","1753"
"22933",104,531,427,"ATACTTCTACTTCAACAGTT","TGAATTCTTGGAATGCAAT","561307.5.peg.358","1753"
"22934",104,561,457,"ATACTTCTACTTCAACAGTT","TTGAACGTTGTAGCACCTAC","561307.5.peg.358","1753"
"22935",286,144,142,"CGCCATTGATTGACCAGGTT","GTTGGTGACATATCATTATT","561307.5.peg.36","1755"
"22936",286,162,124,"CGCCATTGATTGACCAGGTT","CGATCCCCTTTGTTAAGGGT","561307.5.peg.36","1755"
"22937",286,166,120,"CGCCATTGATTGACCAGGTT","AACACGATCCCCTTTGTTAA","561307.5.peg.36","1755"
"22938",144,286,142,"GTTGGTGACATATCATTATT","CGCCATTGATTGACCAGGTT","561307.5.peg.36","1755"
"22939",162,286,124,"CGATCCCCTTTGTTAAGGGT","CGCCATTGATTGACCAGGTT","561307.5.peg.36","1755"
"22940",166,286,120,"AACACGATCCCCTTTGTTAA","CGCCATTGATTGACCAGGTT","561307.5.peg.36","1755"
"22941",192,13,179,"GCCGCGTGGCCTTCATATTG","AGCCTAGTTAAGTATGCAAA","561307.5.peg.361","1757"
"22942",206,13,193,"TTTCATCTGGTGGTGCCGCG","AGCCTAGTTAAGTATGCAAA","561307.5.peg.361","1757"
"22943",192,18,174,"GCCGCGTGGCCTTCATATTG","CTCCCTTTGCATACTTAACT","561307.5.peg.361","1757"
"22944",206,18,188,"TTTCATCTGGTGGTGCCGCG","CTCCCTTTGCATACTTAACT","561307.5.peg.361","1757"
"22945",13,192,179,"AGCCTAGTTAAGTATGCAAA","GCCGCGTGGCCTTCATATTG","561307.5.peg.361","1757"
"22946",18,192,174,"CTCCCTTTGCATACTTAACT","GCCGCGTGGCCTTCATATTG","561307.5.peg.361","1757"
"22947",13,206,193,"AGCCTAGTTAAGTATGCAAA","TTTCATCTGGTGGTGCCGCG","561307.5.peg.361","1757"
"22948",18,206,188,"CTCCCTTTGCATACTTAACT","TTTCATCTGGTGGTGCCGCG","561307.5.peg.361","1757"
"22949",522,90,432,"TGCATAATACGTTTATCATC","ACTGACATAGGTTCATATTC","561307.5.peg.362","1758"
"22950",315,90,225,"TCTTCCATATCCTCATCTTC","ACTGACATAGGTTCATATTC","561307.5.peg.362","1758"
"22951",1059,90,969,"GAGTTAAACGATCAACATT","ACTGACATAGGTTCATATTC","561307.5.peg.362","1758"
"22952",800,90,710,"ATTCATCACGTAAATCATGA","ACTGACATAGGTTCATATTC","561307.5.peg.362","1758"
"22953",1004,90,914,"GTGGAATCATTGGAATTACA","ACTGACATAGGTTCATATTC","561307.5.peg.362","1758"
"22954",735,90,645,"GCTTCTTGTAACACTTCATC","ACTGACATAGGTTCATATTC","561307.5.peg.362","1758"
"22955",558,90,468,"GCGCCTAAACTTTGACCTTT","ACTGACATAGGTTCATATTC","561307.5.peg.362","1758"
"22956",370,90,280,"AATAACAGTATCTCCATCCA","ACTGACATAGGTTCATATTC","561307.5.peg.362","1758"
"22957",1206,90,1116,"TATATTGTTCGCGAATGTT","ACTGACATAGGTTCATATTC","561307.5.peg.362","1758"
"22958",1014,90,924,"CTTAATCGATGTGGAATCAT","ACTGACATAGGTTCATATTC","561307.5.peg.362","1758"
"22959",1023,90,933,"TACCATTACTTAATCGATG","ACTGACATAGGTTCATATTC","561307.5.peg.362","1758"
"22960",1014,148,866,"CTTAATCGATGTGGAATCAT","ATTAAATCTCTAAACGAGT","561307.5.peg.362","1758"
"22961",1023,148,875,"TACCATTACTTAATCGATG","ATTAAATCTCTAAACGAGT","561307.5.peg.362","1758"
"22962",558,148,410,"GCGCCTAAACTTTGACCTTT","ATTAAATCTCTAAACGAGT","561307.5.peg.362","1758"
"22963",735,148,587,"GCTTCTTGTAACACTTCATC","ATTAAATCTCTAAACGAGT","561307.5.peg.362","1758"
"22964",522,148,374,"TGCATAATACGTTTATCATC","ATTAAATCTCTAAACGAGT","561307.5.peg.362","1758"
"22965",370,148,222,"AATAACAGTATCTCCATCCA","ATTAAATCTCTAAACGAGT","561307.5.peg.362","1758"
"22966",315,148,167,"TCTTCCATATCCTCATCTTC","ATTAAATCTCTAAACGAGT","561307.5.peg.362","1758"
"22967",1059,148,911,"GAGTTAAACGATCAACATT","ATTAAATCTCTAAACGAGT","561307.5.peg.362","1758"
"22968",800,148,652,"ATTCATCACGTAAATCATGA","ATTAAATCTCTAAACGAGT","561307.5.peg.362","1758"
"22969",1206,148,1058,"TATATTGTTCGCGAATGTT","ATTAAATCTCTAAACGAGT","561307.5.peg.362","1758"
"22970",1004,148,856,"GTGGAATCATTGGAATTACA","ATTAAATCTCTAAACGAGT","561307.5.peg.362","1758"
"22971",558,315,243,"GCGCCTAAACTTTGACCTTT","TCTTCCATATCCTCATCTTC","561307.5.peg.362","1758"
"22972",1014,315,699,"CTTAATCGATGTGGAATCAT","TCTTCCATATCCTCATCTTC","561307.5.peg.362","1758"
"22973",800,315,485,"ATTCATCACGTAAATCATGA","TCTTCCATATCCTCATCTTC","561307.5.peg.362","1758"
"22974",1206,315,891,"TATATTGTTCGCGAATGTT","TCTTCCATATCCTCATCTTC","561307.5.peg.362","1758"
"22975",1004,315,689,"GTGGAATCATTGGAATTACA","TCTTCCATATCCTCATCTTC","561307.5.peg.362","1758"
"22976",735,315,420,"GCTTCTTGTAACACTTCATC","TCTTCCATATCCTCATCTTC","561307.5.peg.362","1758"
"22977",522,315,207,"TGCATAATACGTTTATCATC","TCTTCCATATCCTCATCTTC","561307.5.peg.362","1758"
"22978",1059,315,744,"GAGTTAAACGATCAACATT","TCTTCCATATCCTCATCTTC","561307.5.peg.362","1758"
"22979",148,315,167,"ATTAAATCTCTAAACGAGT","TCTTCCATATCCTCATCTTC","561307.5.peg.362","1758"
"22980",1023,315,708,"TACCATTACTTAATCGATG","TCTTCCATATCCTCATCTTC","561307.5.peg.362","1758"
"22981",90,315,225,"ACTGACATAGGTTCATATTC","TCTTCCATATCCTCATCTTC","561307.5.peg.362","1758"
"22982",735,370,365,"GCTTCTTGTAACACTTCATC","AATAACAGTATCTCCATCCA","561307.5.peg.362","1758"
"22983",800,370,430,"ATTCATCACGTAAATCATGA","AATAACAGTATCTCCATCCA","561307.5.peg.362","1758"
"22984",1004,370,634,"GTGGAATCATTGGAATTACA","AATAACAGTATCTCCATCCA","561307.5.peg.362","1758"
"22985",1023,370,653,"TACCATTACTTAATCGATG","AATAACAGTATCTCCATCCA","561307.5.peg.362","1758"
"22986",522,370,152,"TGCATAATACGTTTATCATC","AATAACAGTATCTCCATCCA","561307.5.peg.362","1758"
"22987",1014,370,644,"CTTAATCGATGTGGAATCAT","AATAACAGTATCTCCATCCA","561307.5.peg.362","1758"
"22988",1059,370,689,"GAGTTAAACGATCAACATT","AATAACAGTATCTCCATCCA","561307.5.peg.362","1758"
"22989",1206,370,836,"TATATTGTTCGCGAATGTT","AATAACAGTATCTCCATCCA","561307.5.peg.362","1758"
"22990",558,370,188,"GCGCCTAAACTTTGACCTTT","AATAACAGTATCTCCATCCA","561307.5.peg.362","1758"
"22991",90,370,280,"ACTGACATAGGTTCATATTC","AATAACAGTATCTCCATCCA","561307.5.peg.362","1758"
"22992",148,370,222,"ATTAAATCTCTAAACGAGT","AATAACAGTATCTCCATCCA","561307.5.peg.362","1758"
"22993",1059,522,537,"GAGTTAAACGATCAACATT","TGCATAATACGTTTATCATC","561307.5.peg.362","1758"
"22994",1206,522,684,"TATATTGTTCGCGAATGTT","TGCATAATACGTTTATCATC","561307.5.peg.362","1758"
"22995",315,522,207,"TCTTCCATATCCTCATCTTC","TGCATAATACGTTTATCATC","561307.5.peg.362","1758"
"22996",800,522,278,"ATTCATCACGTAAATCATGA","TGCATAATACGTTTATCATC","561307.5.peg.362","1758"
"22997",148,522,374,"ATTAAATCTCTAAACGAGT","TGCATAATACGTTTATCATC","561307.5.peg.362","1758"
"22998",370,522,152,"AATAACAGTATCTCCATCCA","TGCATAATACGTTTATCATC","561307.5.peg.362","1758"
"22999",735,522,213,"GCTTCTTGTAACACTTCATC","TGCATAATACGTTTATCATC","561307.5.peg.362","1758"
"23000",1023,522,501,"TACCATTACTTAATCGATG","TGCATAATACGTTTATCATC","561307.5.peg.362","1758"
"23001",1014,522,492,"CTTAATCGATGTGGAATCAT","TGCATAATACGTTTATCATC","561307.5.peg.362","1758"
"23002",1004,522,482,"GTGGAATCATTGGAATTACA","TGCATAATACGTTTATCATC","561307.5.peg.362","1758"
"23003",90,522,432,"ACTGACATAGGTTCATATTC","TGCATAATACGTTTATCATC","561307.5.peg.362","1758"
"23004",735,558,177,"GCTTCTTGTAACACTTCATC","GCGCCTAAACTTTGACCTTT","561307.5.peg.362","1758"
"23005",90,558,468,"ACTGACATAGGTTCATATTC","GCGCCTAAACTTTGACCTTT","561307.5.peg.362","1758"
"23006",315,558,243,"TCTTCCATATCCTCATCTTC","GCGCCTAAACTTTGACCTTT","561307.5.peg.362","1758"
"23007",800,558,242,"ATTCATCACGTAAATCATGA","GCGCCTAAACTTTGACCTTT","561307.5.peg.362","1758"
"23008",148,558,410,"ATTAAATCTCTAAACGAGT","GCGCCTAAACTTTGACCTTT","561307.5.peg.362","1758"
"23009",370,558,188,"AATAACAGTATCTCCATCCA","GCGCCTAAACTTTGACCTTT","561307.5.peg.362","1758"
"23010",1014,558,456,"CTTAATCGATGTGGAATCAT","GCGCCTAAACTTTGACCTTT","561307.5.peg.362","1758"
"23011",1206,558,648,"TATATTGTTCGCGAATGTT","GCGCCTAAACTTTGACCTTT","561307.5.peg.362","1758"
"23012",1059,558,501,"GAGTTAAACGATCAACATT","GCGCCTAAACTTTGACCTTT","561307.5.peg.362","1758"
"23013",1004,558,446,"GTGGAATCATTGGAATTACA","GCGCCTAAACTTTGACCTTT","561307.5.peg.362","1758"
"23014",1023,558,465,"TACCATTACTTAATCGATG","GCGCCTAAACTTTGACCTTT","561307.5.peg.362","1758"
"23015",148,735,587,"ATTAAATCTCTAAACGAGT","GCTTCTTGTAACACTTCATC","561307.5.peg.362","1758"
"23016",1004,735,269,"GTGGAATCATTGGAATTACA","GCTTCTTGTAACACTTCATC","561307.5.peg.362","1758"
"23017",315,735,420,"TCTTCCATATCCTCATCTTC","GCTTCTTGTAACACTTCATC","561307.5.peg.362","1758"
"23018",1059,735,324,"GAGTTAAACGATCAACATT","GCTTCTTGTAACACTTCATC","561307.5.peg.362","1758"
"23019",1014,735,279,"CTTAATCGATGTGGAATCAT","GCTTCTTGTAACACTTCATC","561307.5.peg.362","1758"
"23020",1206,735,471,"TATATTGTTCGCGAATGTT","GCTTCTTGTAACACTTCATC","561307.5.peg.362","1758"
"23021",558,735,177,"GCGCCTAAACTTTGACCTTT","GCTTCTTGTAACACTTCATC","561307.5.peg.362","1758"
"23022",370,735,365,"AATAACAGTATCTCCATCCA","GCTTCTTGTAACACTTCATC","561307.5.peg.362","1758"
"23023",90,735,645,"ACTGACATAGGTTCATATTC","GCTTCTTGTAACACTTCATC","561307.5.peg.362","1758"
"23024",1023,735,288,"TACCATTACTTAATCGATG","GCTTCTTGTAACACTTCATC","561307.5.peg.362","1758"
"23025",522,735,213,"TGCATAATACGTTTATCATC","GCTTCTTGTAACACTTCATC","561307.5.peg.362","1758"
"23026",315,800,485,"TCTTCCATATCCTCATCTTC","ATTCATCACGTAAATCATGA","561307.5.peg.362","1758"
"23027",1206,800,406,"TATATTGTTCGCGAATGTT","ATTCATCACGTAAATCATGA","561307.5.peg.362","1758"
"23028",90,800,710,"ACTGACATAGGTTCATATTC","ATTCATCACGTAAATCATGA","561307.5.peg.362","1758"
"23029",1014,800,214,"CTTAATCGATGTGGAATCAT","ATTCATCACGTAAATCATGA","561307.5.peg.362","1758"
"23030",1004,800,204,"GTGGAATCATTGGAATTACA","ATTCATCACGTAAATCATGA","561307.5.peg.362","1758"
"23031",522,800,278,"TGCATAATACGTTTATCATC","ATTCATCACGTAAATCATGA","561307.5.peg.362","1758"
"23032",148,800,652,"ATTAAATCTCTAAACGAGT","ATTCATCACGTAAATCATGA","561307.5.peg.362","1758"
"23033",370,800,430,"AATAACAGTATCTCCATCCA","ATTCATCACGTAAATCATGA","561307.5.peg.362","1758"
"23034",1023,800,223,"TACCATTACTTAATCGATG","ATTCATCACGTAAATCATGA","561307.5.peg.362","1758"
"23035",558,800,242,"GCGCCTAAACTTTGACCTTT","ATTCATCACGTAAATCATGA","561307.5.peg.362","1758"
"23036",1059,800,259,"GAGTTAAACGATCAACATT","ATTCATCACGTAAATCATGA","561307.5.peg.362","1758"
"23037",735,1004,269,"GCTTCTTGTAACACTTCATC","GTGGAATCATTGGAATTACA","561307.5.peg.362","1758"
"23038",800,1004,204,"ATTCATCACGTAAATCATGA","GTGGAATCATTGGAATTACA","561307.5.peg.362","1758"
"23039",522,1004,482,"TGCATAATACGTTTATCATC","GTGGAATCATTGGAATTACA","561307.5.peg.362","1758"
"23040",1206,1004,202,"TATATTGTTCGCGAATGTT","GTGGAATCATTGGAATTACA","561307.5.peg.362","1758"
"23041",90,1004,914,"ACTGACATAGGTTCATATTC","GTGGAATCATTGGAATTACA","561307.5.peg.362","1758"
"23042",148,1004,856,"ATTAAATCTCTAAACGAGT","GTGGAATCATTGGAATTACA","561307.5.peg.362","1758"
"23043",315,1004,689,"TCTTCCATATCCTCATCTTC","GTGGAATCATTGGAATTACA","561307.5.peg.362","1758"
"23044",370,1004,634,"AATAACAGTATCTCCATCCA","GTGGAATCATTGGAATTACA","561307.5.peg.362","1758"
"23045",558,1004,446,"GCGCCTAAACTTTGACCTTT","GTGGAATCATTGGAATTACA","561307.5.peg.362","1758"
"23046",90,1014,924,"ACTGACATAGGTTCATATTC","CTTAATCGATGTGGAATCAT","561307.5.peg.362","1758"
"23047",522,1014,492,"TGCATAATACGTTTATCATC","CTTAATCGATGTGGAATCAT","561307.5.peg.362","1758"
"23048",735,1014,279,"GCTTCTTGTAACACTTCATC","CTTAATCGATGTGGAATCAT","561307.5.peg.362","1758"
"23049",370,1014,644,"AATAACAGTATCTCCATCCA","CTTAATCGATGTGGAATCAT","561307.5.peg.362","1758"
"23050",800,1014,214,"ATTCATCACGTAAATCATGA","CTTAATCGATGTGGAATCAT","561307.5.peg.362","1758"
"23051",315,1014,699,"TCTTCCATATCCTCATCTTC","CTTAATCGATGTGGAATCAT","561307.5.peg.362","1758"
"23052",558,1014,456,"GCGCCTAAACTTTGACCTTT","CTTAATCGATGTGGAATCAT","561307.5.peg.362","1758"
"23053",1206,1014,192,"TATATTGTTCGCGAATGTT","CTTAATCGATGTGGAATCAT","561307.5.peg.362","1758"
"23054",148,1014,866,"ATTAAATCTCTAAACGAGT","CTTAATCGATGTGGAATCAT","561307.5.peg.362","1758"
"23055",90,1023,933,"ACTGACATAGGTTCATATTC","TACCATTACTTAATCGATG","561307.5.peg.362","1758"
"23056",1206,1023,183,"TATATTGTTCGCGAATGTT","TACCATTACTTAATCGATG","561307.5.peg.362","1758"
"23057",148,1023,875,"ATTAAATCTCTAAACGAGT","TACCATTACTTAATCGATG","561307.5.peg.362","1758"
"23058",522,1023,501,"TGCATAATACGTTTATCATC","TACCATTACTTAATCGATG","561307.5.peg.362","1758"
"23059",315,1023,708,"TCTTCCATATCCTCATCTTC","TACCATTACTTAATCGATG","561307.5.peg.362","1758"
"23060",735,1023,288,"GCTTCTTGTAACACTTCATC","TACCATTACTTAATCGATG","561307.5.peg.362","1758"
"23061",370,1023,653,"AATAACAGTATCTCCATCCA","TACCATTACTTAATCGATG","561307.5.peg.362","1758"
"23062",558,1023,465,"GCGCCTAAACTTTGACCTTT","TACCATTACTTAATCGATG","561307.5.peg.362","1758"
"23063",800,1023,223,"ATTCATCACGTAAATCATGA","TACCATTACTTAATCGATG","561307.5.peg.362","1758"
"23064",90,1059,969,"ACTGACATAGGTTCATATTC","GAGTTAAACGATCAACATT","561307.5.peg.362","1758"
"23065",1206,1059,147,"TATATTGTTCGCGAATGTT","GAGTTAAACGATCAACATT","561307.5.peg.362","1758"
"23066",800,1059,259,"ATTCATCACGTAAATCATGA","GAGTTAAACGATCAACATT","561307.5.peg.362","1758"
"23067",315,1059,744,"TCTTCCATATCCTCATCTTC","GAGTTAAACGATCAACATT","561307.5.peg.362","1758"
"23068",558,1059,501,"GCGCCTAAACTTTGACCTTT","GAGTTAAACGATCAACATT","561307.5.peg.362","1758"
"23069",522,1059,537,"TGCATAATACGTTTATCATC","GAGTTAAACGATCAACATT","561307.5.peg.362","1758"
"23070",735,1059,324,"GCTTCTTGTAACACTTCATC","GAGTTAAACGATCAACATT","561307.5.peg.362","1758"
"23071",148,1059,911,"ATTAAATCTCTAAACGAGT","GAGTTAAACGATCAACATT","561307.5.peg.362","1758"
"23072",370,1059,689,"AATAACAGTATCTCCATCCA","GAGTTAAACGATCAACATT","561307.5.peg.362","1758"
"23073",800,1206,406,"ATTCATCACGTAAATCATGA","TATATTGTTCGCGAATGTT","561307.5.peg.362","1758"
"23074",1023,1206,183,"TACCATTACTTAATCGATG","TATATTGTTCGCGAATGTT","561307.5.peg.362","1758"
"23075",522,1206,684,"TGCATAATACGTTTATCATC","TATATTGTTCGCGAATGTT","561307.5.peg.362","1758"
"23076",1059,1206,147,"GAGTTAAACGATCAACATT","TATATTGTTCGCGAATGTT","561307.5.peg.362","1758"
"23077",90,1206,1116,"ACTGACATAGGTTCATATTC","TATATTGTTCGCGAATGTT","561307.5.peg.362","1758"
"23078",1014,1206,192,"CTTAATCGATGTGGAATCAT","TATATTGTTCGCGAATGTT","561307.5.peg.362","1758"
"23079",315,1206,891,"TCTTCCATATCCTCATCTTC","TATATTGTTCGCGAATGTT","561307.5.peg.362","1758"
"23080",558,1206,648,"GCGCCTAAACTTTGACCTTT","TATATTGTTCGCGAATGTT","561307.5.peg.362","1758"
"23081",148,1206,1058,"ATTAAATCTCTAAACGAGT","TATATTGTTCGCGAATGTT","561307.5.peg.362","1758"
"23082",735,1206,471,"GCTTCTTGTAACACTTCATC","TATATTGTTCGCGAATGTT","561307.5.peg.362","1758"
"23083",1004,1206,202,"GTGGAATCATTGGAATTACA","TATATTGTTCGCGAATGTT","561307.5.peg.362","1758"
"23084",370,1206,836,"AATAACAGTATCTCCATCCA","TATATTGTTCGCGAATGTT","561307.5.peg.362","1758"
"23085",621,327,294,"TTACTTGCATCTGTACTCTG","TGTGTCGTTTCCTGTTGTGC","561307.5.peg.369","1765"
"23086",1051,327,724,"AGGGTCAATATAAGCGGGCA","TGTGTCGTTTCCTGTTGTGC","561307.5.peg.369","1765"
"23087",681,327,354,"AACTAAATGCTCTCATTCT","TGTGTCGTTTCCTGTTGTGC","561307.5.peg.369","1765"
"23088",726,327,399,"GTAATATCTGTGCCAGCTAC","TGTGTCGTTTCCTGTTGTGC","561307.5.peg.369","1765"
"23089",933,327,606,"TGATCTCCAGCCATAATTGG","TGTGTCGTTTCCTGTTGTGC","561307.5.peg.369","1765"
"23090",1254,327,927,"GCAATAACGTTATCTCCACT","TGTGTCGTTTCCTGTTGTGC","561307.5.peg.369","1765"
"23091",846,327,519,"TCACCTTTAACAGCAGAATT","TGTGTCGTTTCCTGTTGTGC","561307.5.peg.369","1765"
"23092",432,327,105,"TTGCTTGATTGAGTTGTTGC","TGTGTCGTTTCCTGTTGTGC","561307.5.peg.369","1765"
"23093",806,327,479,"TCAGTTTGACATAACCTGCT","TGTGTCGTTTCCTGTTGTGC","561307.5.peg.369","1765"
"23094",600,327,273,"GGAGCTGATTCATTGTTTGA","TGTGTCGTTTCCTGTTGTGC","561307.5.peg.369","1765"
"23095",936,327,609,"ACTTGATCTCCAGCCATAAT","TGTGTCGTTTCCTGTTGTGC","561307.5.peg.369","1765"
"23096",1302,327,975,"ATGCATTACTATCCGTATT","TGTGTCGTTTCCTGTTGTGC","561307.5.peg.369","1765"
"23097",801,327,474,"TTGACATAACCTGCTTGGTG","TGTGTCGTTTCCTGTTGTGC","561307.5.peg.369","1765"
"23098",936,432,504,"ACTTGATCTCCAGCCATAAT","TTGCTTGATTGAGTTGTTGC","561307.5.peg.369","1765"
"23099",933,432,501,"TGATCTCCAGCCATAATTGG","TTGCTTGATTGAGTTGTTGC","561307.5.peg.369","1765"
"23100",621,432,189,"TTACTTGCATCTGTACTCTG","TTGCTTGATTGAGTTGTTGC","561307.5.peg.369","1765"
"23101",327,432,105,"TGTGTCGTTTCCTGTTGTGC","TTGCTTGATTGAGTTGTTGC","561307.5.peg.369","1765"
"23102",726,432,294,"GTAATATCTGTGCCAGCTAC","TTGCTTGATTGAGTTGTTGC","561307.5.peg.369","1765"
"23103",600,432,168,"GGAGCTGATTCATTGTTTGA","TTGCTTGATTGAGTTGTTGC","561307.5.peg.369","1765"
"23104",1302,432,870,"ATGCATTACTATCCGTATT","TTGCTTGATTGAGTTGTTGC","561307.5.peg.369","1765"
"23105",1254,432,822,"GCAATAACGTTATCTCCACT","TTGCTTGATTGAGTTGTTGC","561307.5.peg.369","1765"
"23106",681,432,249,"AACTAAATGCTCTCATTCT","TTGCTTGATTGAGTTGTTGC","561307.5.peg.369","1765"
"23107",846,432,414,"TCACCTTTAACAGCAGAATT","TTGCTTGATTGAGTTGTTGC","561307.5.peg.369","1765"
"23108",801,432,369,"TTGACATAACCTGCTTGGTG","TTGCTTGATTGAGTTGTTGC","561307.5.peg.369","1765"
"23109",806,432,374,"TCAGTTTGACATAACCTGCT","TTGCTTGATTGAGTTGTTGC","561307.5.peg.369","1765"
"23110",1051,432,619,"AGGGTCAATATAAGCGGGCA","TTGCTTGATTGAGTTGTTGC","561307.5.peg.369","1765"
"23111",806,600,206,"TCAGTTTGACATAACCTGCT","GGAGCTGATTCATTGTTTGA","561307.5.peg.369","1765"
"23112",327,600,273,"TGTGTCGTTTCCTGTTGTGC","GGAGCTGATTCATTGTTTGA","561307.5.peg.369","1765"
"23113",1051,600,451,"AGGGTCAATATAAGCGGGCA","GGAGCTGATTCATTGTTTGA","561307.5.peg.369","1765"
"23114",1254,600,654,"GCAATAACGTTATCTCCACT","GGAGCTGATTCATTGTTTGA","561307.5.peg.369","1765"
"23115",1302,600,702,"ATGCATTACTATCCGTATT","GGAGCTGATTCATTGTTTGA","561307.5.peg.369","1765"
"23116",432,600,168,"TTGCTTGATTGAGTTGTTGC","GGAGCTGATTCATTGTTTGA","561307.5.peg.369","1765"
"23117",801,600,201,"TTGACATAACCTGCTTGGTG","GGAGCTGATTCATTGTTTGA","561307.5.peg.369","1765"
"23118",933,600,333,"TGATCTCCAGCCATAATTGG","GGAGCTGATTCATTGTTTGA","561307.5.peg.369","1765"
"23119",936,600,336,"ACTTGATCTCCAGCCATAAT","GGAGCTGATTCATTGTTTGA","561307.5.peg.369","1765"
"23120",726,600,126,"GTAATATCTGTGCCAGCTAC","GGAGCTGATTCATTGTTTGA","561307.5.peg.369","1765"
"23121",846,600,246,"TCACCTTTAACAGCAGAATT","GGAGCTGATTCATTGTTTGA","561307.5.peg.369","1765"
"23122",806,621,185,"TCAGTTTGACATAACCTGCT","TTACTTGCATCTGTACTCTG","561307.5.peg.369","1765"
"23123",1051,621,430,"AGGGTCAATATAAGCGGGCA","TTACTTGCATCTGTACTCTG","561307.5.peg.369","1765"
"23124",327,621,294,"TGTGTCGTTTCCTGTTGTGC","TTACTTGCATCTGTACTCTG","561307.5.peg.369","1765"
"23125",1254,621,633,"GCAATAACGTTATCTCCACT","TTACTTGCATCTGTACTCTG","561307.5.peg.369","1765"
"23126",936,621,315,"ACTTGATCTCCAGCCATAAT","TTACTTGCATCTGTACTCTG","561307.5.peg.369","1765"
"23127",1302,621,681,"ATGCATTACTATCCGTATT","TTACTTGCATCTGTACTCTG","561307.5.peg.369","1765"
"23128",846,621,225,"TCACCTTTAACAGCAGAATT","TTACTTGCATCTGTACTCTG","561307.5.peg.369","1765"
"23129",726,621,105,"GTAATATCTGTGCCAGCTAC","TTACTTGCATCTGTACTCTG","561307.5.peg.369","1765"
"23130",933,621,312,"TGATCTCCAGCCATAATTGG","TTACTTGCATCTGTACTCTG","561307.5.peg.369","1765"
"23131",801,621,180,"TTGACATAACCTGCTTGGTG","TTACTTGCATCTGTACTCTG","561307.5.peg.369","1765"
"23132",432,621,189,"TTGCTTGATTGAGTTGTTGC","TTACTTGCATCTGTACTCTG","561307.5.peg.369","1765"
"23133",801,681,120,"TTGACATAACCTGCTTGGTG","AACTAAATGCTCTCATTCT","561307.5.peg.369","1765"
"23134",1051,681,370,"AGGGTCAATATAAGCGGGCA","AACTAAATGCTCTCATTCT","561307.5.peg.369","1765"
"23135",933,681,252,"TGATCTCCAGCCATAATTGG","AACTAAATGCTCTCATTCT","561307.5.peg.369","1765"
"23136",936,681,255,"ACTTGATCTCCAGCCATAAT","AACTAAATGCTCTCATTCT","561307.5.peg.369","1765"
"23137",1254,681,573,"GCAATAACGTTATCTCCACT","AACTAAATGCTCTCATTCT","561307.5.peg.369","1765"
"23138",846,681,165,"TCACCTTTAACAGCAGAATT","AACTAAATGCTCTCATTCT","561307.5.peg.369","1765"
"23139",327,681,354,"TGTGTCGTTTCCTGTTGTGC","AACTAAATGCTCTCATTCT","561307.5.peg.369","1765"
"23140",806,681,125,"TCAGTTTGACATAACCTGCT","AACTAAATGCTCTCATTCT","561307.5.peg.369","1765"
"23141",1302,681,621,"ATGCATTACTATCCGTATT","AACTAAATGCTCTCATTCT","561307.5.peg.369","1765"
"23142",432,681,249,"TTGCTTGATTGAGTTGTTGC","AACTAAATGCTCTCATTCT","561307.5.peg.369","1765"
"23143",1254,726,528,"GCAATAACGTTATCTCCACT","GTAATATCTGTGCCAGCTAC","561307.5.peg.369","1765"
"23144",327,726,399,"TGTGTCGTTTCCTGTTGTGC","GTAATATCTGTGCCAGCTAC","561307.5.peg.369","1765"
"23145",432,726,294,"TTGCTTGATTGAGTTGTTGC","GTAATATCTGTGCCAGCTAC","561307.5.peg.369","1765"
"23146",1302,726,576,"ATGCATTACTATCCGTATT","GTAATATCTGTGCCAGCTAC","561307.5.peg.369","1765"
"23147",621,726,105,"TTACTTGCATCTGTACTCTG","GTAATATCTGTGCCAGCTAC","561307.5.peg.369","1765"
"23148",1051,726,325,"AGGGTCAATATAAGCGGGCA","GTAATATCTGTGCCAGCTAC","561307.5.peg.369","1765"
"23149",933,726,207,"TGATCTCCAGCCATAATTGG","GTAATATCTGTGCCAGCTAC","561307.5.peg.369","1765"
"23150",936,726,210,"ACTTGATCTCCAGCCATAAT","GTAATATCTGTGCCAGCTAC","561307.5.peg.369","1765"
"23151",600,726,126,"GGAGCTGATTCATTGTTTGA","GTAATATCTGTGCCAGCTAC","561307.5.peg.369","1765"
"23152",846,726,120,"TCACCTTTAACAGCAGAATT","GTAATATCTGTGCCAGCTAC","561307.5.peg.369","1765"
"23153",327,801,474,"TGTGTCGTTTCCTGTTGTGC","TTGACATAACCTGCTTGGTG","561307.5.peg.369","1765"
"23154",621,801,180,"TTACTTGCATCTGTACTCTG","TTGACATAACCTGCTTGGTG","561307.5.peg.369","1765"
"23155",1254,801,453,"GCAATAACGTTATCTCCACT","TTGACATAACCTGCTTGGTG","561307.5.peg.369","1765"
"23156",1302,801,501,"ATGCATTACTATCCGTATT","TTGACATAACCTGCTTGGTG","561307.5.peg.369","1765"
"23157",600,801,201,"GGAGCTGATTCATTGTTTGA","TTGACATAACCTGCTTGGTG","561307.5.peg.369","1765"
"23158",432,801,369,"TTGCTTGATTGAGTTGTTGC","TTGACATAACCTGCTTGGTG","561307.5.peg.369","1765"
"23159",936,801,135,"ACTTGATCTCCAGCCATAAT","TTGACATAACCTGCTTGGTG","561307.5.peg.369","1765"
"23160",681,801,120,"AACTAAATGCTCTCATTCT","TTGACATAACCTGCTTGGTG","561307.5.peg.369","1765"
"23161",1051,801,250,"AGGGTCAATATAAGCGGGCA","TTGACATAACCTGCTTGGTG","561307.5.peg.369","1765"
"23162",933,801,132,"TGATCTCCAGCCATAATTGG","TTGACATAACCTGCTTGGTG","561307.5.peg.369","1765"
"23163",327,806,479,"TGTGTCGTTTCCTGTTGTGC","TCAGTTTGACATAACCTGCT","561307.5.peg.369","1765"
"23164",1051,806,245,"AGGGTCAATATAAGCGGGCA","TCAGTTTGACATAACCTGCT","561307.5.peg.369","1765"
"23165",681,806,125,"AACTAAATGCTCTCATTCT","TCAGTTTGACATAACCTGCT","561307.5.peg.369","1765"
"23166",1302,806,496,"ATGCATTACTATCCGTATT","TCAGTTTGACATAACCTGCT","561307.5.peg.369","1765"
"23167",600,806,206,"GGAGCTGATTCATTGTTTGA","TCAGTTTGACATAACCTGCT","561307.5.peg.369","1765"
"23168",933,806,127,"TGATCTCCAGCCATAATTGG","TCAGTTTGACATAACCTGCT","561307.5.peg.369","1765"
"23169",1254,806,448,"GCAATAACGTTATCTCCACT","TCAGTTTGACATAACCTGCT","561307.5.peg.369","1765"
"23170",432,806,374,"TTGCTTGATTGAGTTGTTGC","TCAGTTTGACATAACCTGCT","561307.5.peg.369","1765"
"23171",936,806,130,"ACTTGATCTCCAGCCATAAT","TCAGTTTGACATAACCTGCT","561307.5.peg.369","1765"
"23172",621,806,185,"TTACTTGCATCTGTACTCTG","TCAGTTTGACATAACCTGCT","561307.5.peg.369","1765"
"23173",327,846,519,"TGTGTCGTTTCCTGTTGTGC","TCACCTTTAACAGCAGAATT","561307.5.peg.369","1765"
"23174",1051,846,205,"AGGGTCAATATAAGCGGGCA","TCACCTTTAACAGCAGAATT","561307.5.peg.369","1765"
"23175",681,846,165,"AACTAAATGCTCTCATTCT","TCACCTTTAACAGCAGAATT","561307.5.peg.369","1765"
"23176",432,846,414,"TTGCTTGATTGAGTTGTTGC","TCACCTTTAACAGCAGAATT","561307.5.peg.369","1765"
"23177",621,846,225,"TTACTTGCATCTGTACTCTG","TCACCTTTAACAGCAGAATT","561307.5.peg.369","1765"
"23178",600,846,246,"GGAGCTGATTCATTGTTTGA","TCACCTTTAACAGCAGAATT","561307.5.peg.369","1765"
"23179",726,846,120,"GTAATATCTGTGCCAGCTAC","TCACCTTTAACAGCAGAATT","561307.5.peg.369","1765"
"23180",1254,846,408,"GCAATAACGTTATCTCCACT","TCACCTTTAACAGCAGAATT","561307.5.peg.369","1765"
"23181",1302,846,456,"ATGCATTACTATCCGTATT","TCACCTTTAACAGCAGAATT","561307.5.peg.369","1765"
"23182",726,933,207,"GTAATATCTGTGCCAGCTAC","TGATCTCCAGCCATAATTGG","561307.5.peg.369","1765"
"23183",327,933,606,"TGTGTCGTTTCCTGTTGTGC","TGATCTCCAGCCATAATTGG","561307.5.peg.369","1765"
"23184",1302,933,369,"ATGCATTACTATCCGTATT","TGATCTCCAGCCATAATTGG","561307.5.peg.369","1765"
"23185",621,933,312,"TTACTTGCATCTGTACTCTG","TGATCTCCAGCCATAATTGG","561307.5.peg.369","1765"
"23186",600,933,333,"GGAGCTGATTCATTGTTTGA","TGATCTCCAGCCATAATTGG","561307.5.peg.369","1765"
"23187",681,933,252,"AACTAAATGCTCTCATTCT","TGATCTCCAGCCATAATTGG","561307.5.peg.369","1765"
"23188",432,933,501,"TTGCTTGATTGAGTTGTTGC","TGATCTCCAGCCATAATTGG","561307.5.peg.369","1765"
"23189",1051,933,118,"AGGGTCAATATAAGCGGGCA","TGATCTCCAGCCATAATTGG","561307.5.peg.369","1765"
"23190",1254,933,321,"GCAATAACGTTATCTCCACT","TGATCTCCAGCCATAATTGG","561307.5.peg.369","1765"
"23191",801,933,132,"TTGACATAACCTGCTTGGTG","TGATCTCCAGCCATAATTGG","561307.5.peg.369","1765"
"23192",806,933,127,"TCAGTTTGACATAACCTGCT","TGATCTCCAGCCATAATTGG","561307.5.peg.369","1765"
"23193",621,936,315,"TTACTTGCATCTGTACTCTG","ACTTGATCTCCAGCCATAAT","561307.5.peg.369","1765"
"23194",681,936,255,"AACTAAATGCTCTCATTCT","ACTTGATCTCCAGCCATAAT","561307.5.peg.369","1765"
"23195",432,936,504,"TTGCTTGATTGAGTTGTTGC","ACTTGATCTCCAGCCATAAT","561307.5.peg.369","1765"
"23196",1302,936,366,"ATGCATTACTATCCGTATT","ACTTGATCTCCAGCCATAAT","561307.5.peg.369","1765"
"23197",327,936,609,"TGTGTCGTTTCCTGTTGTGC","ACTTGATCTCCAGCCATAAT","561307.5.peg.369","1765"
"23198",600,936,336,"GGAGCTGATTCATTGTTTGA","ACTTGATCTCCAGCCATAAT","561307.5.peg.369","1765"
"23199",1051,936,115,"AGGGTCAATATAAGCGGGCA","ACTTGATCTCCAGCCATAAT","561307.5.peg.369","1765"
"23200",726,936,210,"GTAATATCTGTGCCAGCTAC","ACTTGATCTCCAGCCATAAT","561307.5.peg.369","1765"
"23201",806,936,130,"TCAGTTTGACATAACCTGCT","ACTTGATCTCCAGCCATAAT","561307.5.peg.369","1765"
"23202",1254,936,318,"GCAATAACGTTATCTCCACT","ACTTGATCTCCAGCCATAAT","561307.5.peg.369","1765"
"23203",801,936,135,"TTGACATAACCTGCTTGGTG","ACTTGATCTCCAGCCATAAT","561307.5.peg.369","1765"
"23204",327,1051,724,"TGTGTCGTTTCCTGTTGTGC","AGGGTCAATATAAGCGGGCA","561307.5.peg.369","1765"
"23205",621,1051,430,"TTACTTGCATCTGTACTCTG","AGGGTCAATATAAGCGGGCA","561307.5.peg.369","1765"
"23206",726,1051,325,"GTAATATCTGTGCCAGCTAC","AGGGTCAATATAAGCGGGCA","561307.5.peg.369","1765"
"23207",1254,1051,203,"GCAATAACGTTATCTCCACT","AGGGTCAATATAAGCGGGCA","561307.5.peg.369","1765"
"23208",806,1051,245,"TCAGTTTGACATAACCTGCT","AGGGTCAATATAAGCGGGCA","561307.5.peg.369","1765"
"23209",846,1051,205,"TCACCTTTAACAGCAGAATT","AGGGTCAATATAAGCGGGCA","561307.5.peg.369","1765"
"23210",681,1051,370,"AACTAAATGCTCTCATTCT","AGGGTCAATATAAGCGGGCA","561307.5.peg.369","1765"
"23211",1302,1051,251,"ATGCATTACTATCCGTATT","AGGGTCAATATAAGCGGGCA","561307.5.peg.369","1765"
"23212",801,1051,250,"TTGACATAACCTGCTTGGTG","AGGGTCAATATAAGCGGGCA","561307.5.peg.369","1765"
"23213",936,1051,115,"ACTTGATCTCCAGCCATAAT","AGGGTCAATATAAGCGGGCA","561307.5.peg.369","1765"
"23214",432,1051,619,"TTGCTTGATTGAGTTGTTGC","AGGGTCAATATAAGCGGGCA","561307.5.peg.369","1765"
"23215",600,1051,451,"GGAGCTGATTCATTGTTTGA","AGGGTCAATATAAGCGGGCA","561307.5.peg.369","1765"
"23216",933,1051,118,"TGATCTCCAGCCATAATTGG","AGGGTCAATATAAGCGGGCA","561307.5.peg.369","1765"
"23217",801,1254,453,"TTGACATAACCTGCTTGGTG","GCAATAACGTTATCTCCACT","561307.5.peg.369","1765"
"23218",621,1254,633,"TTACTTGCATCTGTACTCTG","GCAATAACGTTATCTCCACT","561307.5.peg.369","1765"
"23219",933,1254,321,"TGATCTCCAGCCATAATTGG","GCAATAACGTTATCTCCACT","561307.5.peg.369","1765"
"23220",681,1254,573,"AACTAAATGCTCTCATTCT","GCAATAACGTTATCTCCACT","561307.5.peg.369","1765"
"23221",846,1254,408,"TCACCTTTAACAGCAGAATT","GCAATAACGTTATCTCCACT","561307.5.peg.369","1765"
"23222",327,1254,927,"TGTGTCGTTTCCTGTTGTGC","GCAATAACGTTATCTCCACT","561307.5.peg.369","1765"
"23223",726,1254,528,"GTAATATCTGTGCCAGCTAC","GCAATAACGTTATCTCCACT","561307.5.peg.369","1765"
"23224",936,1254,318,"ACTTGATCTCCAGCCATAAT","GCAATAACGTTATCTCCACT","561307.5.peg.369","1765"
"23225",806,1254,448,"TCAGTTTGACATAACCTGCT","GCAATAACGTTATCTCCACT","561307.5.peg.369","1765"
"23226",432,1254,822,"TTGCTTGATTGAGTTGTTGC","GCAATAACGTTATCTCCACT","561307.5.peg.369","1765"
"23227",600,1254,654,"GGAGCTGATTCATTGTTTGA","GCAATAACGTTATCTCCACT","561307.5.peg.369","1765"
"23228",1051,1254,203,"AGGGTCAATATAAGCGGGCA","GCAATAACGTTATCTCCACT","561307.5.peg.369","1765"
"23229",806,1302,496,"TCAGTTTGACATAACCTGCT","ATGCATTACTATCCGTATT","561307.5.peg.369","1765"
"23230",801,1302,501,"TTGACATAACCTGCTTGGTG","ATGCATTACTATCCGTATT","561307.5.peg.369","1765"
"23231",621,1302,681,"TTACTTGCATCTGTACTCTG","ATGCATTACTATCCGTATT","561307.5.peg.369","1765"
"23232",432,1302,870,"TTGCTTGATTGAGTTGTTGC","ATGCATTACTATCCGTATT","561307.5.peg.369","1765"
"23233",327,1302,975,"TGTGTCGTTTCCTGTTGTGC","ATGCATTACTATCCGTATT","561307.5.peg.369","1765"
"23234",681,1302,621,"AACTAAATGCTCTCATTCT","ATGCATTACTATCCGTATT","561307.5.peg.369","1765"
"23235",846,1302,456,"TCACCTTTAACAGCAGAATT","ATGCATTACTATCCGTATT","561307.5.peg.369","1765"
"23236",600,1302,702,"GGAGCTGATTCATTGTTTGA","ATGCATTACTATCCGTATT","561307.5.peg.369","1765"
"23237",726,1302,576,"GTAATATCTGTGCCAGCTAC","ATGCATTACTATCCGTATT","561307.5.peg.369","1765"
"23238",933,1302,369,"TGATCTCCAGCCATAATTGG","ATGCATTACTATCCGTATT","561307.5.peg.369","1765"
"23239",1051,1302,251,"AGGGTCAATATAAGCGGGCA","ATGCATTACTATCCGTATT","561307.5.peg.369","1765"
"23240",936,1302,366,"ACTTGATCTCCAGCCATAAT","ATGCATTACTATCCGTATT","561307.5.peg.369","1765"
"23241",144,10,134,"TAGAGTGCTAAAGGAAATAC","TTATCTTCAACCAAAGAAA","561307.5.peg.37","1766"
"23242",144,30,114,"TAGAGTGCTAAAGGAAATAC","AATCATCAATCCCTTTCTT","561307.5.peg.37","1766"
"23243",10,144,134,"TTATCTTCAACCAAAGAAA","TAGAGTGCTAAAGGAAATAC","561307.5.peg.37","1766"
"23244",30,144,114,"AATCATCAATCCCTTTCTT","TAGAGTGCTAAAGGAAATAC","561307.5.peg.37","1766"
"23245",307,100,207,"AACTCTATATTGACCAGCAA","AGCGACAGGATTCATTAATA","561307.5.peg.374","1771"
"23246",369,100,269,"AACTGTACCTTAAAGGCTGA","AGCGACAGGATTCATTAATA","561307.5.peg.374","1771"
"23247",364,100,264,"TACCTTAAAGGCTGAAGGCC","AGCGACAGGATTCATTAATA","561307.5.peg.374","1771"
"23248",399,100,299,"TTTGAGCTACTTCATTATC","AGCGACAGGATTCATTAATA","561307.5.peg.374","1771"
"23249",376,100,276,"TAGTTGCAACTGTACCTTAA","AGCGACAGGATTCATTAATA","561307.5.peg.374","1771"
"23250",364,114,250,"TACCTTAAAGGCTGAAGGCC","GAATCTGCGGCATTAGCGAC","561307.5.peg.374","1771"
"23251",307,114,193,"AACTCTATATTGACCAGCAA","GAATCTGCGGCATTAGCGAC","561307.5.peg.374","1771"
"23252",376,114,262,"TAGTTGCAACTGTACCTTAA","GAATCTGCGGCATTAGCGAC","561307.5.peg.374","1771"
"23253",369,114,255,"AACTGTACCTTAAAGGCTGA","GAATCTGCGGCATTAGCGAC","561307.5.peg.374","1771"
"23254",399,114,285,"TTTGAGCTACTTCATTATC","GAATCTGCGGCATTAGCGAC","561307.5.peg.374","1771"
"23255",100,307,207,"AGCGACAGGATTCATTAATA","AACTCTATATTGACCAGCAA","561307.5.peg.374","1771"
"23256",114,307,193,"GAATCTGCGGCATTAGCGAC","AACTCTATATTGACCAGCAA","561307.5.peg.374","1771"
"23257",114,364,250,"GAATCTGCGGCATTAGCGAC","TACCTTAAAGGCTGAAGGCC","561307.5.peg.374","1771"
"23258",100,364,264,"AGCGACAGGATTCATTAATA","TACCTTAAAGGCTGAAGGCC","561307.5.peg.374","1771"
"23259",114,369,255,"GAATCTGCGGCATTAGCGAC","AACTGTACCTTAAAGGCTGA","561307.5.peg.374","1771"
"23260",100,369,269,"AGCGACAGGATTCATTAATA","AACTGTACCTTAAAGGCTGA","561307.5.peg.374","1771"
"23261",114,376,262,"GAATCTGCGGCATTAGCGAC","TAGTTGCAACTGTACCTTAA","561307.5.peg.374","1771"
"23262",100,376,276,"AGCGACAGGATTCATTAATA","TAGTTGCAACTGTACCTTAA","561307.5.peg.374","1771"
"23263",100,399,299,"AGCGACAGGATTCATTAATA","TTTGAGCTACTTCATTATC","561307.5.peg.374","1771"
"23264",114,399,285,"GAATCTGCGGCATTAGCGAC","TTTGAGCTACTTCATTATC","561307.5.peg.374","1771"
"23265",636,201,435,"TATCTTCCACCTACATCATC","TCTTCTTTGTCGTAATCAAC","561307.5.peg.38","1777"
"23266",201,636,435,"TCTTCTTTGTCGTAATCAAC","TATCTTCCACCTACATCATC","561307.5.peg.38","1777"
"23267",122,8,114,"GTTCTGAAATACCTATTACG","TATATCAGTGAATGACTAGG","561307.5.peg.385","1783"
"23268",114,8,106,"ATACCTATTACGTGGTAATC","TATATCAGTGAATGACTAGG","561307.5.peg.385","1783"
"23269",288,8,280,"TAACGTGCAGAGTATATACC","TATATCAGTGAATGACTAGG","561307.5.peg.385","1783"
"23270",114,11,103,"ATACCTATTACGTGGTAATC","ACGTATATCAGTGAATGACT","561307.5.peg.385","1783"
"23271",288,11,277,"TAACGTGCAGAGTATATACC","ACGTATATCAGTGAATGACT","561307.5.peg.385","1783"
"23272",122,11,111,"GTTCTGAAATACCTATTACG","ACGTATATCAGTGAATGACT","561307.5.peg.385","1783"
"23273",8,114,106,"TATATCAGTGAATGACTAGG","ATACCTATTACGTGGTAATC","561307.5.peg.385","1783"
"23274",288,114,174,"TAACGTGCAGAGTATATACC","ATACCTATTACGTGGTAATC","561307.5.peg.385","1783"
"23275",11,114,103,"ACGTATATCAGTGAATGACT","ATACCTATTACGTGGTAATC","561307.5.peg.385","1783"
"23276",8,122,114,"TATATCAGTGAATGACTAGG","GTTCTGAAATACCTATTACG","561307.5.peg.385","1783"
"23277",288,122,166,"TAACGTGCAGAGTATATACC","GTTCTGAAATACCTATTACG","561307.5.peg.385","1783"
"23278",11,122,111,"ACGTATATCAGTGAATGACT","GTTCTGAAATACCTATTACG","561307.5.peg.385","1783"
"23279",8,288,280,"TATATCAGTGAATGACTAGG","TAACGTGCAGAGTATATACC","561307.5.peg.385","1783"
"23280",11,288,277,"ACGTATATCAGTGAATGACT","TAACGTGCAGAGTATATACC","561307.5.peg.385","1783"
"23281",114,288,174,"ATACCTATTACGTGGTAATC","TAACGTGCAGAGTATATACC","561307.5.peg.385","1783"
"23282",122,288,166,"GTTCTGAAATACCTATTACG","TAACGTGCAGAGTATATACC","561307.5.peg.385","1783"
"23283",307,168,139,"GCCAATCACTGGGATTGATA","TCTCCTGGTCTTGGCCCATA","561307.5.peg.386","1784"
"23284",317,168,149,"GTTCAATTACGCCAATCACT","TCTCCTGGTCTTGGCCCATA","561307.5.peg.386","1784"
"23285",307,177,130,"GCCAATCACTGGGATTGATA","TTTACTTGTTCTCCTGGTCT","561307.5.peg.386","1784"
"23286",317,177,140,"GTTCAATTACGCCAATCACT","TTTACTTGTTCTCCTGGTCT","561307.5.peg.386","1784"
"23287",168,307,139,"TCTCCTGGTCTTGGCCCATA","GCCAATCACTGGGATTGATA","561307.5.peg.386","1784"
"23288",177,307,130,"TTTACTTGTTCTCCTGGTCT","GCCAATCACTGGGATTGATA","561307.5.peg.386","1784"
"23289",168,317,149,"TCTCCTGGTCTTGGCCCATA","GTTCAATTACGCCAATCACT","561307.5.peg.386","1784"
"23290",177,317,140,"TTTACTTGTTCTCCTGGTCT","GTTCAATTACGCCAATCACT","561307.5.peg.386","1784"
"23291",407,1,406,"CTTGTAAGTCACGGATAACT","GTGTAATCACGTTTACGAGG","561307.5.peg.387","1785"
"23292",267,1,266,"CAGTTCATATCCCAGACAAC","GTGTAATCACGTTTACGAGG","561307.5.peg.387","1785"
"23293",416,1,415,"AACGATCAACTTGTAAGTCA","GTGTAATCACGTTTACGAGG","561307.5.peg.387","1785"
"23294",393,1,392,"TAACTGGGAAAGTATTCAT","GTGTAATCACGTTTACGAGG","561307.5.peg.387","1785"
"23295",378,1,377,"TTCATTGGCTCTAAACGAAT","GTGTAATCACGTTTACGAGG","561307.5.peg.387","1785"
"23296",393,4,389,"TAACTGGGAAAGTATTCAT","CTTGTGTAATCACGTTTACG","561307.5.peg.387","1785"
"23297",267,4,263,"CAGTTCATATCCCAGACAAC","CTTGTGTAATCACGTTTACG","561307.5.peg.387","1785"
"23298",416,4,412,"AACGATCAACTTGTAAGTCA","CTTGTGTAATCACGTTTACG","561307.5.peg.387","1785"
"23299",407,4,403,"CTTGTAAGTCACGGATAACT","CTTGTGTAATCACGTTTACG","561307.5.peg.387","1785"
"23300",378,4,374,"TTCATTGGCTCTAAACGAAT","CTTGTGTAATCACGTTTACG","561307.5.peg.387","1785"
"23301",407,10,397,"CTTGTAAGTCACGGATAACT","TACACAAGTAAGTCTAAAGG","561307.5.peg.387","1785"
"23302",267,10,257,"CAGTTCATATCCCAGACAAC","TACACAAGTAAGTCTAAAGG","561307.5.peg.387","1785"
"23303",378,10,368,"TTCATTGGCTCTAAACGAAT","TACACAAGTAAGTCTAAAGG","561307.5.peg.387","1785"
"23304",416,10,406,"AACGATCAACTTGTAAGTCA","TACACAAGTAAGTCTAAAGG","561307.5.peg.387","1785"
"23305",393,10,383,"TAACTGGGAAAGTATTCAT","TACACAAGTAAGTCTAAAGG","561307.5.peg.387","1785"
"23306",407,12,395,"CTTGTAAGTCACGGATAACT","TTACACAAGTAAGTCTAAA","561307.5.peg.387","1785"
"23307",267,12,255,"CAGTTCATATCCCAGACAAC","TTACACAAGTAAGTCTAAA","561307.5.peg.387","1785"
"23308",378,12,366,"TTCATTGGCTCTAAACGAAT","TTACACAAGTAAGTCTAAA","561307.5.peg.387","1785"
"23309",416,12,404,"AACGATCAACTTGTAAGTCA","TTACACAAGTAAGTCTAAA","561307.5.peg.387","1785"
"23310",393,12,381,"TAACTGGGAAAGTATTCAT","TTACACAAGTAAGTCTAAA","561307.5.peg.387","1785"
"23311",407,78,329,"CTTGTAAGTCACGGATAACT","TAGATTGTGTTTCATGTTG","561307.5.peg.387","1785"
"23312",267,78,189,"CAGTTCATATCCCAGACAAC","TAGATTGTGTTTCATGTTG","561307.5.peg.387","1785"
"23313",393,78,315,"TAACTGGGAAAGTATTCAT","TAGATTGTGTTTCATGTTG","561307.5.peg.387","1785"
"23314",416,78,338,"AACGATCAACTTGTAAGTCA","TAGATTGTGTTTCATGTTG","561307.5.peg.387","1785"
"23315",378,78,300,"TTCATTGGCTCTAAACGAAT","TAGATTGTGTTTCATGTTG","561307.5.peg.387","1785"
"23316",10,267,257,"TACACAAGTAAGTCTAAAGG","CAGTTCATATCCCAGACAAC","561307.5.peg.387","1785"
"23317",78,267,189,"TAGATTGTGTTTCATGTTG","CAGTTCATATCCCAGACAAC","561307.5.peg.387","1785"
"23318",1,267,266,"GTGTAATCACGTTTACGAGG","CAGTTCATATCCCAGACAAC","561307.5.peg.387","1785"
"23319",4,267,263,"CTTGTGTAATCACGTTTACG","CAGTTCATATCCCAGACAAC","561307.5.peg.387","1785"
"23320",393,267,126,"TAACTGGGAAAGTATTCAT","CAGTTCATATCCCAGACAAC","561307.5.peg.387","1785"
"23321",416,267,149,"AACGATCAACTTGTAAGTCA","CAGTTCATATCCCAGACAAC","561307.5.peg.387","1785"
"23322",12,267,255,"TTACACAAGTAAGTCTAAA","CAGTTCATATCCCAGACAAC","561307.5.peg.387","1785"
"23323",407,267,140,"CTTGTAAGTCACGGATAACT","CAGTTCATATCCCAGACAAC","561307.5.peg.387","1785"
"23324",378,267,111,"TTCATTGGCTCTAAACGAAT","CAGTTCATATCCCAGACAAC","561307.5.peg.387","1785"
"23325",12,378,366,"TTACACAAGTAAGTCTAAA","TTCATTGGCTCTAAACGAAT","561307.5.peg.387","1785"
"23326",1,378,377,"GTGTAATCACGTTTACGAGG","TTCATTGGCTCTAAACGAAT","561307.5.peg.387","1785"
"23327",10,378,368,"TACACAAGTAAGTCTAAAGG","TTCATTGGCTCTAAACGAAT","561307.5.peg.387","1785"
"23328",4,378,374,"CTTGTGTAATCACGTTTACG","TTCATTGGCTCTAAACGAAT","561307.5.peg.387","1785"
"23329",78,378,300,"TAGATTGTGTTTCATGTTG","TTCATTGGCTCTAAACGAAT","561307.5.peg.387","1785"
"23330",267,378,111,"CAGTTCATATCCCAGACAAC","TTCATTGGCTCTAAACGAAT","561307.5.peg.387","1785"
"23331",1,393,392,"GTGTAATCACGTTTACGAGG","TAACTGGGAAAGTATTCAT","561307.5.peg.387","1785"
"23332",4,393,389,"CTTGTGTAATCACGTTTACG","TAACTGGGAAAGTATTCAT","561307.5.peg.387","1785"
"23333",10,393,383,"TACACAAGTAAGTCTAAAGG","TAACTGGGAAAGTATTCAT","561307.5.peg.387","1785"
"23334",12,393,381,"TTACACAAGTAAGTCTAAA","TAACTGGGAAAGTATTCAT","561307.5.peg.387","1785"
"23335",267,393,126,"CAGTTCATATCCCAGACAAC","TAACTGGGAAAGTATTCAT","561307.5.peg.387","1785"
"23336",78,393,315,"TAGATTGTGTTTCATGTTG","TAACTGGGAAAGTATTCAT","561307.5.peg.387","1785"
"23337",10,407,397,"TACACAAGTAAGTCTAAAGG","CTTGTAAGTCACGGATAACT","561307.5.peg.387","1785"
"23338",78,407,329,"TAGATTGTGTTTCATGTTG","CTTGTAAGTCACGGATAACT","561307.5.peg.387","1785"
"23339",1,407,406,"GTGTAATCACGTTTACGAGG","CTTGTAAGTCACGGATAACT","561307.5.peg.387","1785"
"23340",267,407,140,"CAGTTCATATCCCAGACAAC","CTTGTAAGTCACGGATAACT","561307.5.peg.387","1785"
"23341",4,407,403,"CTTGTGTAATCACGTTTACG","CTTGTAAGTCACGGATAACT","561307.5.peg.387","1785"
"23342",12,407,395,"TTACACAAGTAAGTCTAAA","CTTGTAAGTCACGGATAACT","561307.5.peg.387","1785"
"23343",4,416,412,"CTTGTGTAATCACGTTTACG","AACGATCAACTTGTAAGTCA","561307.5.peg.387","1785"
"23344",10,416,406,"TACACAAGTAAGTCTAAAGG","AACGATCAACTTGTAAGTCA","561307.5.peg.387","1785"
"23345",1,416,415,"GTGTAATCACGTTTACGAGG","AACGATCAACTTGTAAGTCA","561307.5.peg.387","1785"
"23346",12,416,404,"TTACACAAGTAAGTCTAAA","AACGATCAACTTGTAAGTCA","561307.5.peg.387","1785"
"23347",267,416,149,"CAGTTCATATCCCAGACAAC","AACGATCAACTTGTAAGTCA","561307.5.peg.387","1785"
"23348",78,416,338,"TAGATTGTGTTTCATGTTG","AACGATCAACTTGTAAGTCA","561307.5.peg.387","1785"
"23349",759,86,673,"TCATCACCAGGGATTGCAGT","TTGTTGACATTAAGCCCGCT","561307.5.peg.388","1786"
"23350",713,86,627,"TAGCATAAATAGCGCCTTGT","TTGTTGACATTAAGCCCGCT","561307.5.peg.388","1786"
"23351",852,86,766,"TTCTCTTCTAAGAAGTACCA","TTGTTGACATTAAGCCCGCT","561307.5.peg.388","1786"
"23352",288,86,202,"TCTGTCATCGCTTTAACAGG","TTGTTGACATTAAGCCCGCT","561307.5.peg.388","1786"
"23353",341,86,255,"TATTGAACATTACGCCCATA","TTGTTGACATTAAGCCCGCT","561307.5.peg.388","1786"
"23354",275,86,189,"TAACAGGTGGTTGGTTTGCA","TTGTTGACATTAAGCCCGCT","561307.5.peg.388","1786"
"23355",703,86,617,"AGCGCCTTGTTGGTAAACAA","TTGTTGACATTAAGCCCGCT","561307.5.peg.388","1786"
"23356",770,86,684,"GTCGCAGTTTATCATCACCA","TTGTTGACATTAAGCCCGCT","561307.5.peg.388","1786"
"23357",900,86,814,"TCACGCGTTGCGATATCACG","TTGTTGACATTAAGCCCGCT","561307.5.peg.388","1786"
"23358",234,86,148,"GTATCATCAAAGTGAATCCA","TTGTTGACATTAAGCCCGCT","561307.5.peg.388","1786"
"23359",341,156,185,"TATTGAACATTACGCCCATA","ACAGAGTGCGAACGCTTTAC","561307.5.peg.388","1786"
"23360",770,156,614,"GTCGCAGTTTATCATCACCA","ACAGAGTGCGAACGCTTTAC","561307.5.peg.388","1786"
"23361",852,156,696,"TTCTCTTCTAAGAAGTACCA","ACAGAGTGCGAACGCTTTAC","561307.5.peg.388","1786"
"23362",900,156,744,"TCACGCGTTGCGATATCACG","ACAGAGTGCGAACGCTTTAC","561307.5.peg.388","1786"
"23363",288,156,132,"TCTGTCATCGCTTTAACAGG","ACAGAGTGCGAACGCTTTAC","561307.5.peg.388","1786"
"23364",275,156,119,"TAACAGGTGGTTGGTTTGCA","ACAGAGTGCGAACGCTTTAC","561307.5.peg.388","1786"
"23365",713,156,557,"TAGCATAAATAGCGCCTTGT","ACAGAGTGCGAACGCTTTAC","561307.5.peg.388","1786"
"23366",759,156,603,"TCATCACCAGGGATTGCAGT","ACAGAGTGCGAACGCTTTAC","561307.5.peg.388","1786"
"23367",703,156,547,"AGCGCCTTGTTGGTAAACAA","ACAGAGTGCGAACGCTTTAC","561307.5.peg.388","1786"
"23368",713,184,529,"TAGCATAAATAGCGCCTTGT","CGCACCATTAATGCCACCTT","561307.5.peg.388","1786"
"23369",770,184,586,"GTCGCAGTTTATCATCACCA","CGCACCATTAATGCCACCTT","561307.5.peg.388","1786"
"23370",703,184,519,"AGCGCCTTGTTGGTAAACAA","CGCACCATTAATGCCACCTT","561307.5.peg.388","1786"
"23371",759,184,575,"TCATCACCAGGGATTGCAGT","CGCACCATTAATGCCACCTT","561307.5.peg.388","1786"
"23372",341,184,157,"TATTGAACATTACGCCCATA","CGCACCATTAATGCCACCTT","561307.5.peg.388","1786"
"23373",900,184,716,"TCACGCGTTGCGATATCACG","CGCACCATTAATGCCACCTT","561307.5.peg.388","1786"
"23374",288,184,104,"TCTGTCATCGCTTTAACAGG","CGCACCATTAATGCCACCTT","561307.5.peg.388","1786"
"23375",852,184,668,"TTCTCTTCTAAGAAGTACCA","CGCACCATTAATGCCACCTT","561307.5.peg.388","1786"
"23376",86,234,148,"TTGTTGACATTAAGCCCGCT","GTATCATCAAAGTGAATCCA","561307.5.peg.388","1786"
"23377",852,234,618,"TTCTCTTCTAAGAAGTACCA","GTATCATCAAAGTGAATCCA","561307.5.peg.388","1786"
"23378",341,234,107,"TATTGAACATTACGCCCATA","GTATCATCAAAGTGAATCCA","561307.5.peg.388","1786"
"23379",900,234,666,"TCACGCGTTGCGATATCACG","GTATCATCAAAGTGAATCCA","561307.5.peg.388","1786"
"23380",759,234,525,"TCATCACCAGGGATTGCAGT","GTATCATCAAAGTGAATCCA","561307.5.peg.388","1786"
"23381",713,234,479,"TAGCATAAATAGCGCCTTGT","GTATCATCAAAGTGAATCCA","561307.5.peg.388","1786"
"23382",770,234,536,"GTCGCAGTTTATCATCACCA","GTATCATCAAAGTGAATCCA","561307.5.peg.388","1786"
"23383",703,234,469,"AGCGCCTTGTTGGTAAACAA","GTATCATCAAAGTGAATCCA","561307.5.peg.388","1786"
"23384",759,275,484,"TCATCACCAGGGATTGCAGT","TAACAGGTGGTTGGTTTGCA","561307.5.peg.388","1786"
"23385",86,275,189,"TTGTTGACATTAAGCCCGCT","TAACAGGTGGTTGGTTTGCA","561307.5.peg.388","1786"
"23386",713,275,438,"TAGCATAAATAGCGCCTTGT","TAACAGGTGGTTGGTTTGCA","561307.5.peg.388","1786"
"23387",852,275,577,"TTCTCTTCTAAGAAGTACCA","TAACAGGTGGTTGGTTTGCA","561307.5.peg.388","1786"
"23388",900,275,625,"TCACGCGTTGCGATATCACG","TAACAGGTGGTTGGTTTGCA","561307.5.peg.388","1786"
"23389",156,275,119,"ACAGAGTGCGAACGCTTTAC","TAACAGGTGGTTGGTTTGCA","561307.5.peg.388","1786"
"23390",770,275,495,"GTCGCAGTTTATCATCACCA","TAACAGGTGGTTGGTTTGCA","561307.5.peg.388","1786"
"23391",703,275,428,"AGCGCCTTGTTGGTAAACAA","TAACAGGTGGTTGGTTTGCA","561307.5.peg.388","1786"
"23392",86,288,202,"TTGTTGACATTAAGCCCGCT","TCTGTCATCGCTTTAACAGG","561307.5.peg.388","1786"
"23393",900,288,612,"TCACGCGTTGCGATATCACG","TCTGTCATCGCTTTAACAGG","561307.5.peg.388","1786"
"23394",852,288,564,"TTCTCTTCTAAGAAGTACCA","TCTGTCATCGCTTTAACAGG","561307.5.peg.388","1786"
"23395",703,288,415,"AGCGCCTTGTTGGTAAACAA","TCTGTCATCGCTTTAACAGG","561307.5.peg.388","1786"
"23396",184,288,104,"CGCACCATTAATGCCACCTT","TCTGTCATCGCTTTAACAGG","561307.5.peg.388","1786"
"23397",759,288,471,"TCATCACCAGGGATTGCAGT","TCTGTCATCGCTTTAACAGG","561307.5.peg.388","1786"
"23398",713,288,425,"TAGCATAAATAGCGCCTTGT","TCTGTCATCGCTTTAACAGG","561307.5.peg.388","1786"
"23399",770,288,482,"GTCGCAGTTTATCATCACCA","TCTGTCATCGCTTTAACAGG","561307.5.peg.388","1786"
"23400",156,288,132,"ACAGAGTGCGAACGCTTTAC","TCTGTCATCGCTTTAACAGG","561307.5.peg.388","1786"
"23401",184,341,157,"CGCACCATTAATGCCACCTT","TATTGAACATTACGCCCATA","561307.5.peg.388","1786"
"23402",759,341,418,"TCATCACCAGGGATTGCAGT","TATTGAACATTACGCCCATA","561307.5.peg.388","1786"
"23403",86,341,255,"TTGTTGACATTAAGCCCGCT","TATTGAACATTACGCCCATA","561307.5.peg.388","1786"
"23404",770,341,429,"GTCGCAGTTTATCATCACCA","TATTGAACATTACGCCCATA","561307.5.peg.388","1786"
"23405",703,341,362,"AGCGCCTTGTTGGTAAACAA","TATTGAACATTACGCCCATA","561307.5.peg.388","1786"
"23406",900,341,559,"TCACGCGTTGCGATATCACG","TATTGAACATTACGCCCATA","561307.5.peg.388","1786"
"23407",852,341,511,"TTCTCTTCTAAGAAGTACCA","TATTGAACATTACGCCCATA","561307.5.peg.388","1786"
"23408",713,341,372,"TAGCATAAATAGCGCCTTGT","TATTGAACATTACGCCCATA","561307.5.peg.388","1786"
"23409",156,341,185,"ACAGAGTGCGAACGCTTTAC","TATTGAACATTACGCCCATA","561307.5.peg.388","1786"
"23410",234,341,107,"GTATCATCAAAGTGAATCCA","TATTGAACATTACGCCCATA","561307.5.peg.388","1786"
"23411",900,703,197,"TCACGCGTTGCGATATCACG","AGCGCCTTGTTGGTAAACAA","561307.5.peg.388","1786"
"23412",156,703,547,"ACAGAGTGCGAACGCTTTAC","AGCGCCTTGTTGGTAAACAA","561307.5.peg.388","1786"
"23413",86,703,617,"TTGTTGACATTAAGCCCGCT","AGCGCCTTGTTGGTAAACAA","561307.5.peg.388","1786"
"23414",341,703,362,"TATTGAACATTACGCCCATA","AGCGCCTTGTTGGTAAACAA","561307.5.peg.388","1786"
"23415",234,703,469,"GTATCATCAAAGTGAATCCA","AGCGCCTTGTTGGTAAACAA","561307.5.peg.388","1786"
"23416",288,703,415,"TCTGTCATCGCTTTAACAGG","AGCGCCTTGTTGGTAAACAA","561307.5.peg.388","1786"
"23417",184,703,519,"CGCACCATTAATGCCACCTT","AGCGCCTTGTTGGTAAACAA","561307.5.peg.388","1786"
"23418",852,703,149,"TTCTCTTCTAAGAAGTACCA","AGCGCCTTGTTGGTAAACAA","561307.5.peg.388","1786"
"23419",275,703,428,"TAACAGGTGGTTGGTTTGCA","AGCGCCTTGTTGGTAAACAA","561307.5.peg.388","1786"
"23420",156,713,557,"ACAGAGTGCGAACGCTTTAC","TAGCATAAATAGCGCCTTGT","561307.5.peg.388","1786"
"23421",275,713,438,"TAACAGGTGGTTGGTTTGCA","TAGCATAAATAGCGCCTTGT","561307.5.peg.388","1786"
"23422",234,713,479,"GTATCATCAAAGTGAATCCA","TAGCATAAATAGCGCCTTGT","561307.5.peg.388","1786"
"23423",900,713,187,"TCACGCGTTGCGATATCACG","TAGCATAAATAGCGCCTTGT","561307.5.peg.388","1786"
"23424",184,713,529,"CGCACCATTAATGCCACCTT","TAGCATAAATAGCGCCTTGT","561307.5.peg.388","1786"
"23425",86,713,627,"TTGTTGACATTAAGCCCGCT","TAGCATAAATAGCGCCTTGT","561307.5.peg.388","1786"
"23426",341,713,372,"TATTGAACATTACGCCCATA","TAGCATAAATAGCGCCTTGT","561307.5.peg.388","1786"
"23427",288,713,425,"TCTGTCATCGCTTTAACAGG","TAGCATAAATAGCGCCTTGT","561307.5.peg.388","1786"
"23428",852,713,139,"TTCTCTTCTAAGAAGTACCA","TAGCATAAATAGCGCCTTGT","561307.5.peg.388","1786"
"23429",86,759,673,"TTGTTGACATTAAGCCCGCT","TCATCACCAGGGATTGCAGT","561307.5.peg.388","1786"
"23430",288,759,471,"TCTGTCATCGCTTTAACAGG","TCATCACCAGGGATTGCAGT","561307.5.peg.388","1786"
"23431",234,759,525,"GTATCATCAAAGTGAATCCA","TCATCACCAGGGATTGCAGT","561307.5.peg.388","1786"
"23432",900,759,141,"TCACGCGTTGCGATATCACG","TCATCACCAGGGATTGCAGT","561307.5.peg.388","1786"
"23433",275,759,484,"TAACAGGTGGTTGGTTTGCA","TCATCACCAGGGATTGCAGT","561307.5.peg.388","1786"
"23434",156,759,603,"ACAGAGTGCGAACGCTTTAC","TCATCACCAGGGATTGCAGT","561307.5.peg.388","1786"
"23435",184,759,575,"CGCACCATTAATGCCACCTT","TCATCACCAGGGATTGCAGT","561307.5.peg.388","1786"
"23436",341,759,418,"TATTGAACATTACGCCCATA","TCATCACCAGGGATTGCAGT","561307.5.peg.388","1786"
"23437",275,770,495,"TAACAGGTGGTTGGTTTGCA","GTCGCAGTTTATCATCACCA","561307.5.peg.388","1786"
"23438",900,770,130,"TCACGCGTTGCGATATCACG","GTCGCAGTTTATCATCACCA","561307.5.peg.388","1786"
"23439",184,770,586,"CGCACCATTAATGCCACCTT","GTCGCAGTTTATCATCACCA","561307.5.peg.388","1786"
"23440",234,770,536,"GTATCATCAAAGTGAATCCA","GTCGCAGTTTATCATCACCA","561307.5.peg.388","1786"
"23441",341,770,429,"TATTGAACATTACGCCCATA","GTCGCAGTTTATCATCACCA","561307.5.peg.388","1786"
"23442",86,770,684,"TTGTTGACATTAAGCCCGCT","GTCGCAGTTTATCATCACCA","561307.5.peg.388","1786"
"23443",156,770,614,"ACAGAGTGCGAACGCTTTAC","GTCGCAGTTTATCATCACCA","561307.5.peg.388","1786"
"23444",288,770,482,"TCTGTCATCGCTTTAACAGG","GTCGCAGTTTATCATCACCA","561307.5.peg.388","1786"
"23445",184,852,668,"CGCACCATTAATGCCACCTT","TTCTCTTCTAAGAAGTACCA","561307.5.peg.388","1786"
"23446",86,852,766,"TTGTTGACATTAAGCCCGCT","TTCTCTTCTAAGAAGTACCA","561307.5.peg.388","1786"
"23447",275,852,577,"TAACAGGTGGTTGGTTTGCA","TTCTCTTCTAAGAAGTACCA","561307.5.peg.388","1786"
"23448",713,852,139,"TAGCATAAATAGCGCCTTGT","TTCTCTTCTAAGAAGTACCA","561307.5.peg.388","1786"
"23449",234,852,618,"GTATCATCAAAGTGAATCCA","TTCTCTTCTAAGAAGTACCA","561307.5.peg.388","1786"
"23450",156,852,696,"ACAGAGTGCGAACGCTTTAC","TTCTCTTCTAAGAAGTACCA","561307.5.peg.388","1786"
"23451",288,852,564,"TCTGTCATCGCTTTAACAGG","TTCTCTTCTAAGAAGTACCA","561307.5.peg.388","1786"
"23452",703,852,149,"AGCGCCTTGTTGGTAAACAA","TTCTCTTCTAAGAAGTACCA","561307.5.peg.388","1786"
"23453",341,852,511,"TATTGAACATTACGCCCATA","TTCTCTTCTAAGAAGTACCA","561307.5.peg.388","1786"
"23454",184,900,716,"CGCACCATTAATGCCACCTT","TCACGCGTTGCGATATCACG","561307.5.peg.388","1786"
"23455",86,900,814,"TTGTTGACATTAAGCCCGCT","TCACGCGTTGCGATATCACG","561307.5.peg.388","1786"
"23456",288,900,612,"TCTGTCATCGCTTTAACAGG","TCACGCGTTGCGATATCACG","561307.5.peg.388","1786"
"23457",759,900,141,"TCATCACCAGGGATTGCAGT","TCACGCGTTGCGATATCACG","561307.5.peg.388","1786"
"23458",156,900,744,"ACAGAGTGCGAACGCTTTAC","TCACGCGTTGCGATATCACG","561307.5.peg.388","1786"
"23459",703,900,197,"AGCGCCTTGTTGGTAAACAA","TCACGCGTTGCGATATCACG","561307.5.peg.388","1786"
"23460",341,900,559,"TATTGAACATTACGCCCATA","TCACGCGTTGCGATATCACG","561307.5.peg.388","1786"
"23461",713,900,187,"TAGCATAAATAGCGCCTTGT","TCACGCGTTGCGATATCACG","561307.5.peg.388","1786"
"23462",770,900,130,"GTCGCAGTTTATCATCACCA","TCACGCGTTGCGATATCACG","561307.5.peg.388","1786"
"23463",275,900,625,"TAACAGGTGGTTGGTTTGCA","TCACGCGTTGCGATATCACG","561307.5.peg.388","1786"
"23464",234,900,666,"GTATCATCAAAGTGAATCCA","TCACGCGTTGCGATATCACG","561307.5.peg.388","1786"
"23465",152,8,144,"CTTCAGCACCTTGTGTTGCT","TTAAATATTCGTTCACAGGG","561307.5.peg.389","1787"
"23466",152,10,142,"CTTCAGCACCTTGTGTTGCT","ATTAAATATTCGTTCACAG","561307.5.peg.389","1787"
"23467",8,152,144,"TTAAATATTCGTTCACAGGG","CTTCAGCACCTTGTGTTGCT","561307.5.peg.389","1787"
"23468",10,152,142,"ATTAAATATTCGTTCACAG","CTTCAGCACCTTGTGTTGCT","561307.5.peg.389","1787"
"23469",452,103,349,"GTGCGAATGCTTTCAATGAT","TTTGTCGATAAGCCATTGAA","561307.5.peg.39","1788"
"23470",474,103,371,"CTCCATGCCCACTCACGTAC","TTTGTCGATAAGCCATTGAA","561307.5.peg.39","1788"
"23471",416,103,313,"TGGCAACTTCGAAACGTACT","TTTGTCGATAAGCCATTGAA","561307.5.peg.39","1788"
"23472",621,103,518,"TCCTCTGGTGGCGCAGCATA","TTTGTCGATAAGCCATTGAA","561307.5.peg.39","1788"
"23473",474,149,325,"CTCCATGCCCACTCACGTAC","CTTTACCTTCACCAACATCT","561307.5.peg.39","1788"
"23474",416,149,267,"TGGCAACTTCGAAACGTACT","CTTTACCTTCACCAACATCT","561307.5.peg.39","1788"
"23475",621,149,472,"TCCTCTGGTGGCGCAGCATA","CTTTACCTTCACCAACATCT","561307.5.peg.39","1788"
"23476",452,149,303,"GTGCGAATGCTTTCAATGAT","CTTTACCTTCACCAACATCT","561307.5.peg.39","1788"
"23477",149,416,267,"CTTTACCTTCACCAACATCT","TGGCAACTTCGAAACGTACT","561307.5.peg.39","1788"
"23478",103,416,313,"TTTGTCGATAAGCCATTGAA","TGGCAACTTCGAAACGTACT","561307.5.peg.39","1788"
"23479",621,416,205,"TCCTCTGGTGGCGCAGCATA","TGGCAACTTCGAAACGTACT","561307.5.peg.39","1788"
"23480",149,452,303,"CTTTACCTTCACCAACATCT","GTGCGAATGCTTTCAATGAT","561307.5.peg.39","1788"
"23481",103,452,349,"TTTGTCGATAAGCCATTGAA","GTGCGAATGCTTTCAATGAT","561307.5.peg.39","1788"
"23482",621,452,169,"TCCTCTGGTGGCGCAGCATA","GTGCGAATGCTTTCAATGAT","561307.5.peg.39","1788"
"23483",103,474,371,"TTTGTCGATAAGCCATTGAA","CTCCATGCCCACTCACGTAC","561307.5.peg.39","1788"
"23484",149,474,325,"CTTTACCTTCACCAACATCT","CTCCATGCCCACTCACGTAC","561307.5.peg.39","1788"
"23485",621,474,147,"TCCTCTGGTGGCGCAGCATA","CTCCATGCCCACTCACGTAC","561307.5.peg.39","1788"
"23486",103,621,518,"TTTGTCGATAAGCCATTGAA","TCCTCTGGTGGCGCAGCATA","561307.5.peg.39","1788"
"23487",149,621,472,"CTTTACCTTCACCAACATCT","TCCTCTGGTGGCGCAGCATA","561307.5.peg.39","1788"
"23488",474,621,147,"CTCCATGCCCACTCACGTAC","TCCTCTGGTGGCGCAGCATA","561307.5.peg.39","1788"
"23489",416,621,205,"TGGCAACTTCGAAACGTACT","TCCTCTGGTGGCGCAGCATA","561307.5.peg.39","1788"
"23490",452,621,169,"GTGCGAATGCTTTCAATGAT","TCCTCTGGTGGCGCAGCATA","561307.5.peg.39","1788"
"23491",387,96,291,"GTTCTCGTCACTAGTAGTCT","AAATAGCATCCTGGTTCCAT","561307.5.peg.390","1789"
"23492",441,96,345,"GCAGAATATGCATTCGGATA","AAATAGCATCCTGGTTCCAT","561307.5.peg.390","1789"
"23493",545,96,449,"GTCCTAAACATTGTCCAATA","AAATAGCATCCTGGTTCCAT","561307.5.peg.390","1789"
"23494",447,96,351,"TCTTGAGCAGAATATGCATT","AAATAGCATCCTGGTTCCAT","561307.5.peg.390","1789"
"23495",567,96,471,"AATCAACGTCATATACACA","AAATAGCATCCTGGTTCCAT","561307.5.peg.390","1789"
"23496",891,96,795,"TCTTCTTCTGTTTGCTGTAA","AAATAGCATCCTGGTTCCAT","561307.5.peg.390","1789"
"23497",96,387,291,"AAATAGCATCCTGGTTCCAT","GTTCTCGTCACTAGTAGTCT","561307.5.peg.390","1789"
"23498",567,387,180,"AATCAACGTCATATACACA","GTTCTCGTCACTAGTAGTCT","561307.5.peg.390","1789"
"23499",545,387,158,"GTCCTAAACATTGTCCAATA","GTTCTCGTCACTAGTAGTCT","561307.5.peg.390","1789"
"23500",891,387,504,"TCTTCTTCTGTTTGCTGTAA","GTTCTCGTCACTAGTAGTCT","561307.5.peg.390","1789"
"23501",96,441,345,"AAATAGCATCCTGGTTCCAT","GCAGAATATGCATTCGGATA","561307.5.peg.390","1789"
"23502",545,441,104,"GTCCTAAACATTGTCCAATA","GCAGAATATGCATTCGGATA","561307.5.peg.390","1789"
"23503",891,441,450,"TCTTCTTCTGTTTGCTGTAA","GCAGAATATGCATTCGGATA","561307.5.peg.390","1789"
"23504",567,441,126,"AATCAACGTCATATACACA","GCAGAATATGCATTCGGATA","561307.5.peg.390","1789"
"23505",891,447,444,"TCTTCTTCTGTTTGCTGTAA","TCTTGAGCAGAATATGCATT","561307.5.peg.390","1789"
"23506",567,447,120,"AATCAACGTCATATACACA","TCTTGAGCAGAATATGCATT","561307.5.peg.390","1789"
"23507",96,447,351,"AAATAGCATCCTGGTTCCAT","TCTTGAGCAGAATATGCATT","561307.5.peg.390","1789"
"23508",96,545,449,"AAATAGCATCCTGGTTCCAT","GTCCTAAACATTGTCCAATA","561307.5.peg.390","1789"
"23509",441,545,104,"GCAGAATATGCATTCGGATA","GTCCTAAACATTGTCCAATA","561307.5.peg.390","1789"
"23510",387,545,158,"GTTCTCGTCACTAGTAGTCT","GTCCTAAACATTGTCCAATA","561307.5.peg.390","1789"
"23511",891,545,346,"TCTTCTTCTGTTTGCTGTAA","GTCCTAAACATTGTCCAATA","561307.5.peg.390","1789"
"23512",387,567,180,"GTTCTCGTCACTAGTAGTCT","AATCAACGTCATATACACA","561307.5.peg.390","1789"
"23513",441,567,126,"GCAGAATATGCATTCGGATA","AATCAACGTCATATACACA","561307.5.peg.390","1789"
"23514",891,567,324,"TCTTCTTCTGTTTGCTGTAA","AATCAACGTCATATACACA","561307.5.peg.390","1789"
"23515",96,567,471,"AAATAGCATCCTGGTTCCAT","AATCAACGTCATATACACA","561307.5.peg.390","1789"
"23516",447,567,120,"TCTTGAGCAGAATATGCATT","AATCAACGTCATATACACA","561307.5.peg.390","1789"
"23517",447,891,444,"TCTTGAGCAGAATATGCATT","TCTTCTTCTGTTTGCTGTAA","561307.5.peg.390","1789"
"23518",96,891,795,"AAATAGCATCCTGGTTCCAT","TCTTCTTCTGTTTGCTGTAA","561307.5.peg.390","1789"
"23519",545,891,346,"GTCCTAAACATTGTCCAATA","TCTTCTTCTGTTTGCTGTAA","561307.5.peg.390","1789"
"23520",387,891,504,"GTTCTCGTCACTAGTAGTCT","TCTTCTTCTGTTTGCTGTAA","561307.5.peg.390","1789"
"23521",567,891,324,"AATCAACGTCATATACACA","TCTTCTTCTGTTTGCTGTAA","561307.5.peg.390","1789"
"23522",441,891,450,"GCAGAATATGCATTCGGATA","TCTTCTTCTGTTTGCTGTAA","561307.5.peg.390","1789"
"23523",651,237,414,"TGTCGATATTCAGCTTTGAC","TTAGATAAGCCACTCAAGCT","561307.5.peg.392","1791"
"23524",933,237,696,"GTACGGTCCTCTTTAAATAT","TTAGATAAGCCACTCAAGCT","561307.5.peg.392","1791"
"23525",981,237,744,"CAGTCTCACGATTTAATAA","TTAGATAAGCCACTCAAGCT","561307.5.peg.392","1791"
"23526",966,237,729,"ATAATGGATGGTATGCTTT","TTAGATAAGCCACTCAAGCT","561307.5.peg.392","1791"
"23527",1137,237,900,"AACTGACTACCATCAAGTGT","TTAGATAAGCCACTCAAGCT","561307.5.peg.392","1791"
"23528",237,651,414,"TTAGATAAGCCACTCAAGCT","TGTCGATATTCAGCTTTGAC","561307.5.peg.392","1791"
"23529",966,651,315,"ATAATGGATGGTATGCTTT","TGTCGATATTCAGCTTTGAC","561307.5.peg.392","1791"
"23530",933,651,282,"GTACGGTCCTCTTTAAATAT","TGTCGATATTCAGCTTTGAC","561307.5.peg.392","1791"
"23531",981,651,330,"CAGTCTCACGATTTAATAA","TGTCGATATTCAGCTTTGAC","561307.5.peg.392","1791"
"23532",1137,651,486,"AACTGACTACCATCAAGTGT","TGTCGATATTCAGCTTTGAC","561307.5.peg.392","1791"
"23533",1137,933,204,"AACTGACTACCATCAAGTGT","GTACGGTCCTCTTTAAATAT","561307.5.peg.392","1791"
"23534",651,933,282,"TGTCGATATTCAGCTTTGAC","GTACGGTCCTCTTTAAATAT","561307.5.peg.392","1791"
"23535",237,933,696,"TTAGATAAGCCACTCAAGCT","GTACGGTCCTCTTTAAATAT","561307.5.peg.392","1791"
"23536",651,966,315,"TGTCGATATTCAGCTTTGAC","ATAATGGATGGTATGCTTT","561307.5.peg.392","1791"
"23537",237,966,729,"TTAGATAAGCCACTCAAGCT","ATAATGGATGGTATGCTTT","561307.5.peg.392","1791"
"23538",1137,966,171,"AACTGACTACCATCAAGTGT","ATAATGGATGGTATGCTTT","561307.5.peg.392","1791"
"23539",651,981,330,"TGTCGATATTCAGCTTTGAC","CAGTCTCACGATTTAATAA","561307.5.peg.392","1791"
"23540",237,981,744,"TTAGATAAGCCACTCAAGCT","CAGTCTCACGATTTAATAA","561307.5.peg.392","1791"
"23541",1137,981,156,"AACTGACTACCATCAAGTGT","CAGTCTCACGATTTAATAA","561307.5.peg.392","1791"
"23542",651,1137,486,"TGTCGATATTCAGCTTTGAC","AACTGACTACCATCAAGTGT","561307.5.peg.392","1791"
"23543",981,1137,156,"CAGTCTCACGATTTAATAA","AACTGACTACCATCAAGTGT","561307.5.peg.392","1791"
"23544",237,1137,900,"TTAGATAAGCCACTCAAGCT","AACTGACTACCATCAAGTGT","561307.5.peg.392","1791"
"23545",966,1137,171,"ATAATGGATGGTATGCTTT","AACTGACTACCATCAAGTGT","561307.5.peg.392","1791"
"23546",933,1137,204,"GTACGGTCCTCTTTAAATAT","AACTGACTACCATCAAGTGT","561307.5.peg.392","1791"
"23547",381,185,196,"AAAGCAGCACACACAGTCAA","GAAACATGACTTTACCTGAT","561307.5.peg.396","1795"
"23548",381,246,135,"AAAGCAGCACACACAGTCAA","GTATTCAATTGAGAATGCTG","561307.5.peg.396","1795"
"23549",185,381,196,"GAAACATGACTTTACCTGAT","AAAGCAGCACACACAGTCAA","561307.5.peg.396","1795"
"23550",246,381,135,"GTATTCAATTGAGAATGCTG","AAAGCAGCACACACAGTCAA","561307.5.peg.396","1795"
"23551",245,10,235,"CGTCTTCTCCGATATCAACT","TTTAAAGCGGTAGAAGATAG","561307.5.peg.397","1796"
"23552",487,10,477,"GGCATCTGTTCCTGGAACTT","TTTAAAGCGGTAGAAGATAG","561307.5.peg.397","1796"
"23553",762,10,752,"AAGCGTGCTTGCATCCAAAT","TTTAAAGCGGTAGAAGATAG","561307.5.peg.397","1796"
"23554",558,10,548,"CTTAAAGCATCTGCACGATT","TTTAAAGCGGTAGAAGATAG","561307.5.peg.397","1796"
"23555",270,10,260,"GCACCACAAACGATTTGTAC","TTTAAAGCGGTAGAAGATAG","561307.5.peg.397","1796"
"23556",373,10,363,"TGAACGTTCACCGCGTAATT","TTTAAAGCGGTAGAAGATAG","561307.5.peg.397","1796"
"23557",756,10,746,"GCTTGCATCCAAATTGGCGA","TTTAAAGCGGTAGAAGATAG","561307.5.peg.397","1796"
"23558",495,10,485,"GCTTGTAAGGCATCTGTTCC","TTTAAAGCGGTAGAAGATAG","561307.5.peg.397","1796"
"23559",294,10,284,"TATTGTCCTGCATCAACGTT","TTTAAAGCGGTAGAAGATAG","561307.5.peg.397","1796"
"23560",714,10,704,"ACAACACGTGCACTATAATA","TTTAAAGCGGTAGAAGATAG","561307.5.peg.397","1796"
"23561",636,10,626,"AGCTCATTTGATGTTGTCTC","TTTAAAGCGGTAGAAGATAG","561307.5.peg.397","1796"
"23562",1092,10,1082,"GATGTATGACGAATTGAAAC","TTTAAAGCGGTAGAAGATAG","561307.5.peg.397","1796"
"23563",714,245,469,"ACAACACGTGCACTATAATA","CGTCTTCTCCGATATCAACT","561307.5.peg.397","1796"
"23564",373,245,128,"TGAACGTTCACCGCGTAATT","CGTCTTCTCCGATATCAACT","561307.5.peg.397","1796"
"23565",1092,245,847,"GATGTATGACGAATTGAAAC","CGTCTTCTCCGATATCAACT","561307.5.peg.397","1796"
"23566",10,245,235,"TTTAAAGCGGTAGAAGATAG","CGTCTTCTCCGATATCAACT","561307.5.peg.397","1796"
"23567",756,245,511,"GCTTGCATCCAAATTGGCGA","CGTCTTCTCCGATATCAACT","561307.5.peg.397","1796"
"23568",558,245,313,"CTTAAAGCATCTGCACGATT","CGTCTTCTCCGATATCAACT","561307.5.peg.397","1796"
"23569",495,245,250,"GCTTGTAAGGCATCTGTTCC","CGTCTTCTCCGATATCAACT","561307.5.peg.397","1796"
"23570",762,245,517,"AAGCGTGCTTGCATCCAAAT","CGTCTTCTCCGATATCAACT","561307.5.peg.397","1796"
"23571",636,245,391,"AGCTCATTTGATGTTGTCTC","CGTCTTCTCCGATATCAACT","561307.5.peg.397","1796"
"23572",487,245,242,"GGCATCTGTTCCTGGAACTT","CGTCTTCTCCGATATCAACT","561307.5.peg.397","1796"
"23573",762,270,492,"AAGCGTGCTTGCATCCAAAT","GCACCACAAACGATTTGTAC","561307.5.peg.397","1796"
"23574",636,270,366,"AGCTCATTTGATGTTGTCTC","GCACCACAAACGATTTGTAC","561307.5.peg.397","1796"
"23575",714,270,444,"ACAACACGTGCACTATAATA","GCACCACAAACGATTTGTAC","561307.5.peg.397","1796"
"23576",756,270,486,"GCTTGCATCCAAATTGGCGA","GCACCACAAACGATTTGTAC","561307.5.peg.397","1796"
"23577",487,270,217,"GGCATCTGTTCCTGGAACTT","GCACCACAAACGATTTGTAC","561307.5.peg.397","1796"
"23578",373,270,103,"TGAACGTTCACCGCGTAATT","GCACCACAAACGATTTGTAC","561307.5.peg.397","1796"
"23579",10,270,260,"TTTAAAGCGGTAGAAGATAG","GCACCACAAACGATTTGTAC","561307.5.peg.397","1796"
"23580",495,270,225,"GCTTGTAAGGCATCTGTTCC","GCACCACAAACGATTTGTAC","561307.5.peg.397","1796"
"23581",558,270,288,"CTTAAAGCATCTGCACGATT","GCACCACAAACGATTTGTAC","561307.5.peg.397","1796"
"23582",1092,270,822,"GATGTATGACGAATTGAAAC","GCACCACAAACGATTTGTAC","561307.5.peg.397","1796"
"23583",636,294,342,"AGCTCATTTGATGTTGTCTC","TATTGTCCTGCATCAACGTT","561307.5.peg.397","1796"
"23584",10,294,284,"TTTAAAGCGGTAGAAGATAG","TATTGTCCTGCATCAACGTT","561307.5.peg.397","1796"
"23585",495,294,201,"GCTTGTAAGGCATCTGTTCC","TATTGTCCTGCATCAACGTT","561307.5.peg.397","1796"
"23586",1092,294,798,"GATGTATGACGAATTGAAAC","TATTGTCCTGCATCAACGTT","561307.5.peg.397","1796"
"23587",714,294,420,"ACAACACGTGCACTATAATA","TATTGTCCTGCATCAACGTT","561307.5.peg.397","1796"
"23588",487,294,193,"GGCATCTGTTCCTGGAACTT","TATTGTCCTGCATCAACGTT","561307.5.peg.397","1796"
"23589",756,294,462,"GCTTGCATCCAAATTGGCGA","TATTGTCCTGCATCAACGTT","561307.5.peg.397","1796"
"23590",558,294,264,"CTTAAAGCATCTGCACGATT","TATTGTCCTGCATCAACGTT","561307.5.peg.397","1796"
"23591",762,294,468,"AAGCGTGCTTGCATCCAAAT","TATTGTCCTGCATCAACGTT","561307.5.peg.397","1796"
"23592",10,373,363,"TTTAAAGCGGTAGAAGATAG","TGAACGTTCACCGCGTAATT","561307.5.peg.397","1796"
"23593",245,373,128,"CGTCTTCTCCGATATCAACT","TGAACGTTCACCGCGTAATT","561307.5.peg.397","1796"
"23594",270,373,103,"GCACCACAAACGATTTGTAC","TGAACGTTCACCGCGTAATT","561307.5.peg.397","1796"
"23595",636,373,263,"AGCTCATTTGATGTTGTCTC","TGAACGTTCACCGCGTAATT","561307.5.peg.397","1796"
"23596",1092,373,719,"GATGTATGACGAATTGAAAC","TGAACGTTCACCGCGTAATT","561307.5.peg.397","1796"
"23597",762,373,389,"AAGCGTGCTTGCATCCAAAT","TGAACGTTCACCGCGTAATT","561307.5.peg.397","1796"
"23598",558,373,185,"CTTAAAGCATCTGCACGATT","TGAACGTTCACCGCGTAATT","561307.5.peg.397","1796"
"23599",714,373,341,"ACAACACGTGCACTATAATA","TGAACGTTCACCGCGTAATT","561307.5.peg.397","1796"
"23600",487,373,114,"GGCATCTGTTCCTGGAACTT","TGAACGTTCACCGCGTAATT","561307.5.peg.397","1796"
"23601",495,373,122,"GCTTGTAAGGCATCTGTTCC","TGAACGTTCACCGCGTAATT","561307.5.peg.397","1796"
"23602",756,373,383,"GCTTGCATCCAAATTGGCGA","TGAACGTTCACCGCGTAATT","561307.5.peg.397","1796"
"23603",373,487,114,"TGAACGTTCACCGCGTAATT","GGCATCTGTTCCTGGAACTT","561307.5.peg.397","1796"
"23604",245,487,242,"CGTCTTCTCCGATATCAACT","GGCATCTGTTCCTGGAACTT","561307.5.peg.397","1796"
"23605",756,487,269,"GCTTGCATCCAAATTGGCGA","GGCATCTGTTCCTGGAACTT","561307.5.peg.397","1796"
"23606",762,487,275,"AAGCGTGCTTGCATCCAAAT","GGCATCTGTTCCTGGAACTT","561307.5.peg.397","1796"
"23607",636,487,149,"AGCTCATTTGATGTTGTCTC","GGCATCTGTTCCTGGAACTT","561307.5.peg.397","1796"
"23608",1092,487,605,"GATGTATGACGAATTGAAAC","GGCATCTGTTCCTGGAACTT","561307.5.peg.397","1796"
"23609",294,487,193,"TATTGTCCTGCATCAACGTT","GGCATCTGTTCCTGGAACTT","561307.5.peg.397","1796"
"23610",714,487,227,"ACAACACGTGCACTATAATA","GGCATCTGTTCCTGGAACTT","561307.5.peg.397","1796"
"23611",270,487,217,"GCACCACAAACGATTTGTAC","GGCATCTGTTCCTGGAACTT","561307.5.peg.397","1796"
"23612",10,487,477,"TTTAAAGCGGTAGAAGATAG","GGCATCTGTTCCTGGAACTT","561307.5.peg.397","1796"
"23613",1092,495,597,"GATGTATGACGAATTGAAAC","GCTTGTAAGGCATCTGTTCC","561307.5.peg.397","1796"
"23614",762,495,267,"AAGCGTGCTTGCATCCAAAT","GCTTGTAAGGCATCTGTTCC","561307.5.peg.397","1796"
"23615",714,495,219,"ACAACACGTGCACTATAATA","GCTTGTAAGGCATCTGTTCC","561307.5.peg.397","1796"
"23616",373,495,122,"TGAACGTTCACCGCGTAATT","GCTTGTAAGGCATCTGTTCC","561307.5.peg.397","1796"
"23617",294,495,201,"TATTGTCCTGCATCAACGTT","GCTTGTAAGGCATCTGTTCC","561307.5.peg.397","1796"
"23618",636,495,141,"AGCTCATTTGATGTTGTCTC","GCTTGTAAGGCATCTGTTCC","561307.5.peg.397","1796"
"23619",245,495,250,"CGTCTTCTCCGATATCAACT","GCTTGTAAGGCATCTGTTCC","561307.5.peg.397","1796"
"23620",756,495,261,"GCTTGCATCCAAATTGGCGA","GCTTGTAAGGCATCTGTTCC","561307.5.peg.397","1796"
"23621",10,495,485,"TTTAAAGCGGTAGAAGATAG","GCTTGTAAGGCATCTGTTCC","561307.5.peg.397","1796"
"23622",270,495,225,"GCACCACAAACGATTTGTAC","GCTTGTAAGGCATCTGTTCC","561307.5.peg.397","1796"
"23623",756,558,198,"GCTTGCATCCAAATTGGCGA","CTTAAAGCATCTGCACGATT","561307.5.peg.397","1796"
"23624",762,558,204,"AAGCGTGCTTGCATCCAAAT","CTTAAAGCATCTGCACGATT","561307.5.peg.397","1796"
"23625",1092,558,534,"GATGTATGACGAATTGAAAC","CTTAAAGCATCTGCACGATT","561307.5.peg.397","1796"
"23626",270,558,288,"GCACCACAAACGATTTGTAC","CTTAAAGCATCTGCACGATT","561307.5.peg.397","1796"
"23627",373,558,185,"TGAACGTTCACCGCGTAATT","CTTAAAGCATCTGCACGATT","561307.5.peg.397","1796"
"23628",245,558,313,"CGTCTTCTCCGATATCAACT","CTTAAAGCATCTGCACGATT","561307.5.peg.397","1796"
"23629",10,558,548,"TTTAAAGCGGTAGAAGATAG","CTTAAAGCATCTGCACGATT","561307.5.peg.397","1796"
"23630",294,558,264,"TATTGTCCTGCATCAACGTT","CTTAAAGCATCTGCACGATT","561307.5.peg.397","1796"
"23631",714,558,156,"ACAACACGTGCACTATAATA","CTTAAAGCATCTGCACGATT","561307.5.peg.397","1796"
"23632",762,636,126,"AAGCGTGCTTGCATCCAAAT","AGCTCATTTGATGTTGTCTC","561307.5.peg.397","1796"
"23633",10,636,626,"TTTAAAGCGGTAGAAGATAG","AGCTCATTTGATGTTGTCTC","561307.5.peg.397","1796"
"23634",294,636,342,"TATTGTCCTGCATCAACGTT","AGCTCATTTGATGTTGTCTC","561307.5.peg.397","1796"
"23635",270,636,366,"GCACCACAAACGATTTGTAC","AGCTCATTTGATGTTGTCTC","561307.5.peg.397","1796"
"23636",245,636,391,"CGTCTTCTCCGATATCAACT","AGCTCATTTGATGTTGTCTC","561307.5.peg.397","1796"
"23637",1092,636,456,"GATGTATGACGAATTGAAAC","AGCTCATTTGATGTTGTCTC","561307.5.peg.397","1796"
"23638",495,636,141,"GCTTGTAAGGCATCTGTTCC","AGCTCATTTGATGTTGTCTC","561307.5.peg.397","1796"
"23639",373,636,263,"TGAACGTTCACCGCGTAATT","AGCTCATTTGATGTTGTCTC","561307.5.peg.397","1796"
"23640",756,636,120,"GCTTGCATCCAAATTGGCGA","AGCTCATTTGATGTTGTCTC","561307.5.peg.397","1796"
"23641",487,636,149,"GGCATCTGTTCCTGGAACTT","AGCTCATTTGATGTTGTCTC","561307.5.peg.397","1796"
"23642",294,714,420,"TATTGTCCTGCATCAACGTT","ACAACACGTGCACTATAATA","561307.5.peg.397","1796"
"23643",10,714,704,"TTTAAAGCGGTAGAAGATAG","ACAACACGTGCACTATAATA","561307.5.peg.397","1796"
"23644",270,714,444,"GCACCACAAACGATTTGTAC","ACAACACGTGCACTATAATA","561307.5.peg.397","1796"
"23645",495,714,219,"GCTTGTAAGGCATCTGTTCC","ACAACACGTGCACTATAATA","561307.5.peg.397","1796"
"23646",558,714,156,"CTTAAAGCATCTGCACGATT","ACAACACGTGCACTATAATA","561307.5.peg.397","1796"
"23647",245,714,469,"CGTCTTCTCCGATATCAACT","ACAACACGTGCACTATAATA","561307.5.peg.397","1796"
"23648",373,714,341,"TGAACGTTCACCGCGTAATT","ACAACACGTGCACTATAATA","561307.5.peg.397","1796"
"23649",1092,714,378,"GATGTATGACGAATTGAAAC","ACAACACGTGCACTATAATA","561307.5.peg.397","1796"
"23650",487,714,227,"GGCATCTGTTCCTGGAACTT","ACAACACGTGCACTATAATA","561307.5.peg.397","1796"
"23651",373,756,383,"TGAACGTTCACCGCGTAATT","GCTTGCATCCAAATTGGCGA","561307.5.peg.397","1796"
"23652",636,756,120,"AGCTCATTTGATGTTGTCTC","GCTTGCATCCAAATTGGCGA","561307.5.peg.397","1796"
"23653",245,756,511,"CGTCTTCTCCGATATCAACT","GCTTGCATCCAAATTGGCGA","561307.5.peg.397","1796"
"23654",487,756,269,"GGCATCTGTTCCTGGAACTT","GCTTGCATCCAAATTGGCGA","561307.5.peg.397","1796"
"23655",558,756,198,"CTTAAAGCATCTGCACGATT","GCTTGCATCCAAATTGGCGA","561307.5.peg.397","1796"
"23656",1092,756,336,"GATGTATGACGAATTGAAAC","GCTTGCATCCAAATTGGCGA","561307.5.peg.397","1796"
"23657",294,756,462,"TATTGTCCTGCATCAACGTT","GCTTGCATCCAAATTGGCGA","561307.5.peg.397","1796"
"23658",495,756,261,"GCTTGTAAGGCATCTGTTCC","GCTTGCATCCAAATTGGCGA","561307.5.peg.397","1796"
"23659",270,756,486,"GCACCACAAACGATTTGTAC","GCTTGCATCCAAATTGGCGA","561307.5.peg.397","1796"
"23660",10,756,746,"TTTAAAGCGGTAGAAGATAG","GCTTGCATCCAAATTGGCGA","561307.5.peg.397","1796"
"23661",10,762,752,"TTTAAAGCGGTAGAAGATAG","AAGCGTGCTTGCATCCAAAT","561307.5.peg.397","1796"
"23662",373,762,389,"TGAACGTTCACCGCGTAATT","AAGCGTGCTTGCATCCAAAT","561307.5.peg.397","1796"
"23663",270,762,492,"GCACCACAAACGATTTGTAC","AAGCGTGCTTGCATCCAAAT","561307.5.peg.397","1796"
"23664",495,762,267,"GCTTGTAAGGCATCTGTTCC","AAGCGTGCTTGCATCCAAAT","561307.5.peg.397","1796"
"23665",245,762,517,"CGTCTTCTCCGATATCAACT","AAGCGTGCTTGCATCCAAAT","561307.5.peg.397","1796"
"23666",636,762,126,"AGCTCATTTGATGTTGTCTC","AAGCGTGCTTGCATCCAAAT","561307.5.peg.397","1796"
"23667",558,762,204,"CTTAAAGCATCTGCACGATT","AAGCGTGCTTGCATCCAAAT","561307.5.peg.397","1796"
"23668",1092,762,330,"GATGTATGACGAATTGAAAC","AAGCGTGCTTGCATCCAAAT","561307.5.peg.397","1796"
"23669",294,762,468,"TATTGTCCTGCATCAACGTT","AAGCGTGCTTGCATCCAAAT","561307.5.peg.397","1796"
"23670",487,762,275,"GGCATCTGTTCCTGGAACTT","AAGCGTGCTTGCATCCAAAT","561307.5.peg.397","1796"
"23671",245,1092,847,"CGTCTTCTCCGATATCAACT","GATGTATGACGAATTGAAAC","561307.5.peg.397","1796"
"23672",373,1092,719,"TGAACGTTCACCGCGTAATT","GATGTATGACGAATTGAAAC","561307.5.peg.397","1796"
"23673",714,1092,378,"ACAACACGTGCACTATAATA","GATGTATGACGAATTGAAAC","561307.5.peg.397","1796"
"23674",294,1092,798,"TATTGTCCTGCATCAACGTT","GATGTATGACGAATTGAAAC","561307.5.peg.397","1796"
"23675",487,1092,605,"GGCATCTGTTCCTGGAACTT","GATGTATGACGAATTGAAAC","561307.5.peg.397","1796"
"23676",762,1092,330,"AAGCGTGCTTGCATCCAAAT","GATGTATGACGAATTGAAAC","561307.5.peg.397","1796"
"23677",495,1092,597,"GCTTGTAAGGCATCTGTTCC","GATGTATGACGAATTGAAAC","561307.5.peg.397","1796"
"23678",636,1092,456,"AGCTCATTTGATGTTGTCTC","GATGTATGACGAATTGAAAC","561307.5.peg.397","1796"
"23679",270,1092,822,"GCACCACAAACGATTTGTAC","GATGTATGACGAATTGAAAC","561307.5.peg.397","1796"
"23680",10,1092,1082,"TTTAAAGCGGTAGAAGATAG","GATGTATGACGAATTGAAAC","561307.5.peg.397","1796"
"23681",558,1092,534,"CTTAAAGCATCTGCACGATT","GATGTATGACGAATTGAAAC","561307.5.peg.397","1796"
"23682",756,1092,336,"GCTTGCATCCAAATTGGCGA","GATGTATGACGAATTGAAAC","561307.5.peg.397","1796"
"23683",204,11,193,"AACGCAGGTTTATCTTCATT","AATGAATAGTTCGAATAGGG","561307.5.peg.398","1797"
"23684",506,11,495,"TATCTTGCATATCACGTGCA","AATGAATAGTTCGAATAGGG","561307.5.peg.398","1797"
"23685",495,11,484,"TCACGTGCAGGGTGTGATTT","AATGAATAGTTCGAATAGGG","561307.5.peg.398","1797"
"23686",348,11,337,"CCGATTTCAATATGACGACC","AATGAATAGTTCGAATAGGG","561307.5.peg.398","1797"
"23687",11,204,193,"AATGAATAGTTCGAATAGGG","AACGCAGGTTTATCTTCATT","561307.5.peg.398","1797"
"23688",495,204,291,"TCACGTGCAGGGTGTGATTT","AACGCAGGTTTATCTTCATT","561307.5.peg.398","1797"
"23689",348,204,144,"CCGATTTCAATATGACGACC","AACGCAGGTTTATCTTCATT","561307.5.peg.398","1797"
"23690",506,204,302,"TATCTTGCATATCACGTGCA","AACGCAGGTTTATCTTCATT","561307.5.peg.398","1797"
"23691",11,348,337,"AATGAATAGTTCGAATAGGG","CCGATTTCAATATGACGACC","561307.5.peg.398","1797"
"23692",495,348,147,"TCACGTGCAGGGTGTGATTT","CCGATTTCAATATGACGACC","561307.5.peg.398","1797"
"23693",204,348,144,"AACGCAGGTTTATCTTCATT","CCGATTTCAATATGACGACC","561307.5.peg.398","1797"
"23694",506,348,158,"TATCTTGCATATCACGTGCA","CCGATTTCAATATGACGACC","561307.5.peg.398","1797"
"23695",11,495,484,"AATGAATAGTTCGAATAGGG","TCACGTGCAGGGTGTGATTT","561307.5.peg.398","1797"
"23696",348,495,147,"CCGATTTCAATATGACGACC","TCACGTGCAGGGTGTGATTT","561307.5.peg.398","1797"
"23697",204,495,291,"AACGCAGGTTTATCTTCATT","TCACGTGCAGGGTGTGATTT","561307.5.peg.398","1797"
"23698",348,506,158,"CCGATTTCAATATGACGACC","TATCTTGCATATCACGTGCA","561307.5.peg.398","1797"
"23699",11,506,495,"AATGAATAGTTCGAATAGGG","TATCTTGCATATCACGTGCA","561307.5.peg.398","1797"
"23700",204,506,302,"AACGCAGGTTTATCTTCATT","TATCTTGCATATCACGTGCA","561307.5.peg.398","1797"
"23701",590,9,581,"ACTATCTTCAAATCGTTGT","GTAAATGCGATGTTGCATGG","561307.5.peg.40","1800"
"23702",649,9,640,"AGGGTATGTGGTACCACTTA","GTAAATGCGATGTTGCATGG","561307.5.peg.40","1800"
"23703",661,9,652,"GTGTCTATCGATAGGGTATG","GTAAATGCGATGTTGCATGG","561307.5.peg.40","1800"
"23704",668,9,659,"TTGTCTCGTGTCTATCGATA","GTAAATGCGATGTTGCATGG","561307.5.peg.40","1800"
"23705",590,11,579,"ACTATCTTCAAATCGTTGT","AACATCGCATTTACTTGAGT","561307.5.peg.40","1800"
"23706",649,11,638,"AGGGTATGTGGTACCACTTA","AACATCGCATTTACTTGAGT","561307.5.peg.40","1800"
"23707",661,11,650,"GTGTCTATCGATAGGGTATG","AACATCGCATTTACTTGAGT","561307.5.peg.40","1800"
"23708",668,11,657,"TTGTCTCGTGTCTATCGATA","AACATCGCATTTACTTGAGT","561307.5.peg.40","1800"
"23709",590,12,578,"ACTATCTTCAAATCGTTGT","CAAGTAAATGCGATGTTGCA","561307.5.peg.40","1800"
"23710",649,12,637,"AGGGTATGTGGTACCACTTA","CAAGTAAATGCGATGTTGCA","561307.5.peg.40","1800"
"23711",661,12,649,"GTGTCTATCGATAGGGTATG","CAAGTAAATGCGATGTTGCA","561307.5.peg.40","1800"
"23712",668,12,656,"TTGTCTCGTGTCTATCGATA","CAAGTAAATGCGATGTTGCA","561307.5.peg.40","1800"
"23713",590,90,500,"ACTATCTTCAAATCGTTGT","AAGTCGTCAACCCACTCTTC","561307.5.peg.40","1800"
"23714",649,90,559,"AGGGTATGTGGTACCACTTA","AAGTCGTCAACCCACTCTTC","561307.5.peg.40","1800"
"23715",661,90,571,"GTGTCTATCGATAGGGTATG","AAGTCGTCAACCCACTCTTC","561307.5.peg.40","1800"
"23716",668,90,578,"TTGTCTCGTGTCTATCGATA","AAGTCGTCAACCCACTCTTC","561307.5.peg.40","1800"
"23717",9,590,581,"GTAAATGCGATGTTGCATGG","ACTATCTTCAAATCGTTGT","561307.5.peg.40","1800"
"23718",11,590,579,"AACATCGCATTTACTTGAGT","ACTATCTTCAAATCGTTGT","561307.5.peg.40","1800"
"23719",12,590,578,"CAAGTAAATGCGATGTTGCA","ACTATCTTCAAATCGTTGT","561307.5.peg.40","1800"
"23720",90,590,500,"AAGTCGTCAACCCACTCTTC","ACTATCTTCAAATCGTTGT","561307.5.peg.40","1800"
"23721",9,649,640,"GTAAATGCGATGTTGCATGG","AGGGTATGTGGTACCACTTA","561307.5.peg.40","1800"
"23722",11,649,638,"AACATCGCATTTACTTGAGT","AGGGTATGTGGTACCACTTA","561307.5.peg.40","1800"
"23723",12,649,637,"CAAGTAAATGCGATGTTGCA","AGGGTATGTGGTACCACTTA","561307.5.peg.40","1800"
"23724",90,649,559,"AAGTCGTCAACCCACTCTTC","AGGGTATGTGGTACCACTTA","561307.5.peg.40","1800"
"23725",9,661,652,"GTAAATGCGATGTTGCATGG","GTGTCTATCGATAGGGTATG","561307.5.peg.40","1800"
"23726",11,661,650,"AACATCGCATTTACTTGAGT","GTGTCTATCGATAGGGTATG","561307.5.peg.40","1800"
"23727",12,661,649,"CAAGTAAATGCGATGTTGCA","GTGTCTATCGATAGGGTATG","561307.5.peg.40","1800"
"23728",90,661,571,"AAGTCGTCAACCCACTCTTC","GTGTCTATCGATAGGGTATG","561307.5.peg.40","1800"
"23729",9,668,659,"GTAAATGCGATGTTGCATGG","TTGTCTCGTGTCTATCGATA","561307.5.peg.40","1800"
"23730",11,668,657,"AACATCGCATTTACTTGAGT","TTGTCTCGTGTCTATCGATA","561307.5.peg.40","1800"
"23731",12,668,656,"CAAGTAAATGCGATGTTGCA","TTGTCTCGTGTCTATCGATA","561307.5.peg.40","1800"
"23732",90,668,578,"AAGTCGTCAACCCACTCTTC","TTGTCTCGTGTCTATCGATA","561307.5.peg.40","1800"
"23733",147,10,137,"GCTTCAACATTCGGCTCCAT","TGGTACGATTCTGAATTCGC","561307.5.peg.404","1805"
"23734",147,30,117,"GCTTCAACATTCGGCTCCAT","ATTGTCAATGCAACAGTTGT","561307.5.peg.404","1805"
"23735",10,147,137,"TGGTACGATTCTGAATTCGC","GCTTCAACATTCGGCTCCAT","561307.5.peg.404","1805"
"23736",30,147,117,"ATTGTCAATGCAACAGTTGT","GCTTCAACATTCGGCTCCAT","561307.5.peg.404","1805"
"23737",269,133,136,"TTCCAGTAATCCAATGACTG","ATTCAAAGTACCGCTATCTG","561307.5.peg.406","1807"
"23738",337,133,204,"TTCAGAAGTGCGTTCATCTT","ATTCAAAGTACCGCTATCTG","561307.5.peg.406","1807"
"23739",133,269,136,"ATTCAAAGTACCGCTATCTG","TTCCAGTAATCCAATGACTG","561307.5.peg.406","1807"
"23740",133,337,204,"ATTCAAAGTACCGCTATCTG","TTCAGAAGTGCGTTCATCTT","561307.5.peg.406","1807"
"23741",173,9,164,"CTGTTGCCGCATTGACTTGT","CATAATTTGTATCCTTAGG","561307.5.peg.407","1808"
"23742",359,9,350,"ATGCATTGTTTAACACGGTT","CATAATTTGTATCCTTAGG","561307.5.peg.407","1808"
"23743",492,9,483,"GTAGTTAAGCTCTTATATCC","CATAATTTGTATCCTTAGG","561307.5.peg.407","1808"
"23744",148,9,139,"GTCTGCGCCTATGTATACAA","CATAATTTGTATCCTTAGG","561307.5.peg.407","1808"
"23745",9,148,139,"CATAATTTGTATCCTTAGG","GTCTGCGCCTATGTATACAA","561307.5.peg.407","1808"
"23746",359,148,211,"ATGCATTGTTTAACACGGTT","GTCTGCGCCTATGTATACAA","561307.5.peg.407","1808"
"23747",492,148,344,"GTAGTTAAGCTCTTATATCC","GTCTGCGCCTATGTATACAA","561307.5.peg.407","1808"
"23748",9,173,164,"CATAATTTGTATCCTTAGG","CTGTTGCCGCATTGACTTGT","561307.5.peg.407","1808"
"23749",492,173,319,"GTAGTTAAGCTCTTATATCC","CTGTTGCCGCATTGACTTGT","561307.5.peg.407","1808"
"23750",359,173,186,"ATGCATTGTTTAACACGGTT","CTGTTGCCGCATTGACTTGT","561307.5.peg.407","1808"
"23751",9,359,350,"CATAATTTGTATCCTTAGG","ATGCATTGTTTAACACGGTT","561307.5.peg.407","1808"
"23752",148,359,211,"GTCTGCGCCTATGTATACAA","ATGCATTGTTTAACACGGTT","561307.5.peg.407","1808"
"23753",173,359,186,"CTGTTGCCGCATTGACTTGT","ATGCATTGTTTAACACGGTT","561307.5.peg.407","1808"
"23754",492,359,133,"GTAGTTAAGCTCTTATATCC","ATGCATTGTTTAACACGGTT","561307.5.peg.407","1808"
"23755",148,492,344,"GTCTGCGCCTATGTATACAA","GTAGTTAAGCTCTTATATCC","561307.5.peg.407","1808"
"23756",359,492,133,"ATGCATTGTTTAACACGGTT","GTAGTTAAGCTCTTATATCC","561307.5.peg.407","1808"
"23757",9,492,483,"CATAATTTGTATCCTTAGG","GTAGTTAAGCTCTTATATCC","561307.5.peg.407","1808"
"23758",173,492,319,"CTGTTGCCGCATTGACTTGT","GTAGTTAAGCTCTTATATCC","561307.5.peg.407","1808"
"23759",486,258,228,"AAATCAATTGGACGAGAGTT","TTAGCTACTGGTTTAGTTTC","561307.5.peg.408","1809"
"23760",486,270,216,"AAATCAATTGGACGAGAGTT","ACTGAGACAGCATTAGCTAC","561307.5.peg.408","1809"
"23761",258,486,228,"TTAGCTACTGGTTTAGTTTC","AAATCAATTGGACGAGAGTT","561307.5.peg.408","1809"
"23762",270,486,216,"ACTGAGACAGCATTAGCTAC","AAATCAATTGGACGAGAGTT","561307.5.peg.408","1809"
"23763",249,126,123,"TATGCTTGAAACGTATGCTC","GTTTGTTCAGCGCCAGCAGT","561307.5.peg.41","1811"
"23764",328,126,202,"AGCAACTAAATGGCCATCTT","GTTTGTTCAGCGCCAGCAGT","561307.5.peg.41","1811"
"23765",338,126,212,"CATCATGCATAGCAACTAAA","GTTTGTTCAGCGCCAGCAGT","561307.5.peg.41","1811"
"23766",328,168,160,"AGCAACTAAATGGCCATCTT","GTATGCCATTGAATAGCCTG","561307.5.peg.41","1811"
"23767",338,168,170,"CATCATGCATAGCAACTAAA","GTATGCCATTGAATAGCCTG","561307.5.peg.41","1811"
"23768",126,249,123,"GTTTGTTCAGCGCCAGCAGT","TATGCTTGAAACGTATGCTC","561307.5.peg.41","1811"
"23769",126,328,202,"GTTTGTTCAGCGCCAGCAGT","AGCAACTAAATGGCCATCTT","561307.5.peg.41","1811"
"23770",168,328,160,"GTATGCCATTGAATAGCCTG","AGCAACTAAATGGCCATCTT","561307.5.peg.41","1811"
"23771",126,338,212,"GTTTGTTCAGCGCCAGCAGT","CATCATGCATAGCAACTAAA","561307.5.peg.41","1811"
"23772",168,338,170,"GTATGCCATTGAATAGCCTG","CATCATGCATAGCAACTAAA","561307.5.peg.41","1811"
"23773",162,47,115,"AACTGACCTTGGATTGTAAT","GCGTAATTGACCATTTCATA","561307.5.peg.410","1812"
"23774",173,47,126,"ACTTAATGGTTAACTGACCT","GCGTAATTGACCATTTCATA","561307.5.peg.410","1812"
"23775",187,47,140,"AACGACTTCTGTTGACTTAA","GCGTAATTGACCATTTCATA","561307.5.peg.410","1812"
"23776",275,47,228,"CTGTAGTAGTTACATCTAGT","GCGTAATTGACCATTTCATA","561307.5.peg.410","1812"
"23777",47,162,115,"GCGTAATTGACCATTTCATA","AACTGACCTTGGATTGTAAT","561307.5.peg.410","1812"
"23778",275,162,113,"CTGTAGTAGTTACATCTAGT","AACTGACCTTGGATTGTAAT","561307.5.peg.410","1812"
"23779",47,173,126,"GCGTAATTGACCATTTCATA","ACTTAATGGTTAACTGACCT","561307.5.peg.410","1812"
"23780",275,173,102,"CTGTAGTAGTTACATCTAGT","ACTTAATGGTTAACTGACCT","561307.5.peg.410","1812"
"23781",47,187,140,"GCGTAATTGACCATTTCATA","AACGACTTCTGTTGACTTAA","561307.5.peg.410","1812"
"23782",47,275,228,"GCGTAATTGACCATTTCATA","CTGTAGTAGTTACATCTAGT","561307.5.peg.410","1812"
"23783",173,275,102,"ACTTAATGGTTAACTGACCT","CTGTAGTAGTTACATCTAGT","561307.5.peg.410","1812"
"23784",162,275,113,"AACTGACCTTGGATTGTAAT","CTGTAGTAGTTACATCTAGT","561307.5.peg.410","1812"
"23785",268,32,236,"ATGATCGCCAGATGATAAAC","TCATTTGCAATTCGTCCTTT","561307.5.peg.411","1813"
"23786",295,32,263,"TGCGACTTTAACTGCTAGTT","TCATTTGCAATTCGTCCTTT","561307.5.peg.411","1813"
"23787",258,32,226,"GATGATAAACTGGCAGTTGC","TCATTTGCAATTCGTCCTTT","561307.5.peg.411","1813"
"23788",455,32,423,"ATAATTCGCTAATGATACGA","TCATTTGCAATTCGTCCTTT","561307.5.peg.411","1813"
"23789",295,84,211,"TGCGACTTTAACTGCTAGTT","TATTGATGCCCATTATGAAA","561307.5.peg.411","1813"
"23790",258,84,174,"GATGATAAACTGGCAGTTGC","TATTGATGCCCATTATGAAA","561307.5.peg.411","1813"
"23791",455,84,371,"ATAATTCGCTAATGATACGA","TATTGATGCCCATTATGAAA","561307.5.peg.411","1813"
"23792",268,84,184,"ATGATCGCCAGATGATAAAC","TATTGATGCCCATTATGAAA","561307.5.peg.411","1813"
"23793",84,258,174,"TATTGATGCCCATTATGAAA","GATGATAAACTGGCAGTTGC","561307.5.peg.411","1813"
"23794",32,258,226,"TCATTTGCAATTCGTCCTTT","GATGATAAACTGGCAGTTGC","561307.5.peg.411","1813"
"23795",455,258,197,"ATAATTCGCTAATGATACGA","GATGATAAACTGGCAGTTGC","561307.5.peg.411","1813"
"23796",84,268,184,"TATTGATGCCCATTATGAAA","ATGATCGCCAGATGATAAAC","561307.5.peg.411","1813"
"23797",32,268,236,"TCATTTGCAATTCGTCCTTT","ATGATCGCCAGATGATAAAC","561307.5.peg.411","1813"
"23798",455,268,187,"ATAATTCGCTAATGATACGA","ATGATCGCCAGATGATAAAC","561307.5.peg.411","1813"
"23799",32,295,263,"TCATTTGCAATTCGTCCTTT","TGCGACTTTAACTGCTAGTT","561307.5.peg.411","1813"
"23800",84,295,211,"TATTGATGCCCATTATGAAA","TGCGACTTTAACTGCTAGTT","561307.5.peg.411","1813"
"23801",455,295,160,"ATAATTCGCTAATGATACGA","TGCGACTTTAACTGCTAGTT","561307.5.peg.411","1813"
"23802",32,455,423,"TCATTTGCAATTCGTCCTTT","ATAATTCGCTAATGATACGA","561307.5.peg.411","1813"
"23803",84,455,371,"TATTGATGCCCATTATGAAA","ATAATTCGCTAATGATACGA","561307.5.peg.411","1813"
"23804",295,455,160,"TGCGACTTTAACTGCTAGTT","ATAATTCGCTAATGATACGA","561307.5.peg.411","1813"
"23805",258,455,197,"GATGATAAACTGGCAGTTGC","ATAATTCGCTAATGATACGA","561307.5.peg.411","1813"
"23806",268,455,187,"ATGATCGCCAGATGATAAAC","ATAATTCGCTAATGATACGA","561307.5.peg.411","1813"
"23807",240,4,236,"ATTGATGAACCTTGACATT","ATGTGTCTGTCAACCCATAA","561307.5.peg.412","1814"
"23808",4,240,236,"ATGTGTCTGTCAACCCATAA","ATTGATGAACCTTGACATT","561307.5.peg.412","1814"
"23809",478,186,292,"TTGCTTCAGCAACTCATCGA","CCGCGATGCGCAAATATATA","561307.5.peg.416","1818"
"23810",478,225,253,"TTGCTTCAGCAACTCATCGA","AATGCAAGTTGCGTTTGCTC","561307.5.peg.416","1818"
"23811",186,478,292,"CCGCGATGCGCAAATATATA","TTGCTTCAGCAACTCATCGA","561307.5.peg.416","1818"
"23812",225,478,253,"AATGCAAGTTGCGTTTGCTC","TTGCTTCAGCAACTCATCGA","561307.5.peg.416","1818"
"23813",480,219,261,"TCAACTTTAAAGGACGGTTC","CCAACACCTTCTTTAGGCTT","561307.5.peg.418","1820"
"23814",486,219,267,"TTACCATCAACTTTAAAGGA","CCAACACCTTCTTTAGGCTT","561307.5.peg.418","1820"
"23815",480,225,255,"TCAACTTTAAAGGACGGTTC","CATGTACCAACACCTTCTTT","561307.5.peg.418","1820"
"23816",486,225,261,"TTACCATCAACTTTAAAGGA","CATGTACCAACACCTTCTTT","561307.5.peg.418","1820"
"23817",219,480,261,"CCAACACCTTCTTTAGGCTT","TCAACTTTAAAGGACGGTTC","561307.5.peg.418","1820"
"23818",225,480,255,"CATGTACCAACACCTTCTTT","TCAACTTTAAAGGACGGTTC","561307.5.peg.418","1820"
"23819",219,486,267,"CCAACACCTTCTTTAGGCTT","TTACCATCAACTTTAAAGGA","561307.5.peg.418","1820"
"23820",225,486,261,"CATGTACCAACACCTTCTTT","TTACCATCAACTTTAAAGGA","561307.5.peg.418","1820"
"23821",477,179,298,"TTTGTAAATACATCTGGTGC","TGCCATCATCCATTCGTACA","561307.5.peg.42","1822"
"23822",579,179,400,"TGAGAACCACCCAATACAAT","TGCCATCATCCATTCGTACA","561307.5.peg.42","1822"
"23823",387,179,208,"TCATGAATGCTCATTTGACG","TGCCATCATCCATTCGTACA","561307.5.peg.42","1822"
"23824",351,179,172,"CCACCCTTACCACCACCGTA","TGCCATCATCCATTCGTACA","561307.5.peg.42","1822"
"23825",558,179,379,"GGTTTACCTGTGATGAAACC","TGCCATCATCCATTCGTACA","561307.5.peg.42","1822"
"23826",462,179,283,"GGTGCTGGAATATCTTTGTT","TGCCATCATCCATTCGTACA","561307.5.peg.42","1822"
"23827",483,179,304,"GTGAGTTTGTAAATACATC","TGCCATCATCCATTCGTACA","561307.5.peg.42","1822"
"23828",351,224,127,"CCACCCTTACCACCACCGTA","CAGCATCATTATGTTGCGCA","561307.5.peg.42","1822"
"23829",483,224,259,"GTGAGTTTGTAAATACATC","CAGCATCATTATGTTGCGCA","561307.5.peg.42","1822"
"23830",579,224,355,"TGAGAACCACCCAATACAAT","CAGCATCATTATGTTGCGCA","561307.5.peg.42","1822"
"23831",387,224,163,"TCATGAATGCTCATTTGACG","CAGCATCATTATGTTGCGCA","561307.5.peg.42","1822"
"23832",477,224,253,"TTTGTAAATACATCTGGTGC","CAGCATCATTATGTTGCGCA","561307.5.peg.42","1822"
"23833",462,224,238,"GGTGCTGGAATATCTTTGTT","CAGCATCATTATGTTGCGCA","561307.5.peg.42","1822"
"23834",558,224,334,"GGTTTACCTGTGATGAAACC","CAGCATCATTATGTTGCGCA","561307.5.peg.42","1822"
"23835",558,275,283,"GGTTTACCTGTGATGAAACC","CTTCTTCATCAACATCTGGG","561307.5.peg.42","1822"
"23836",579,275,304,"TGAGAACCACCCAATACAAT","CTTCTTCATCAACATCTGGG","561307.5.peg.42","1822"
"23837",462,275,187,"GGTGCTGGAATATCTTTGTT","CTTCTTCATCAACATCTGGG","561307.5.peg.42","1822"
"23838",477,275,202,"TTTGTAAATACATCTGGTGC","CTTCTTCATCAACATCTGGG","561307.5.peg.42","1822"
"23839",387,275,112,"TCATGAATGCTCATTTGACG","CTTCTTCATCAACATCTGGG","561307.5.peg.42","1822"
"23840",483,275,208,"GTGAGTTTGTAAATACATC","CTTCTTCATCAACATCTGGG","561307.5.peg.42","1822"
"23841",483,351,132,"GTGAGTTTGTAAATACATC","CCACCCTTACCACCACCGTA","561307.5.peg.42","1822"
"23842",579,351,228,"TGAGAACCACCCAATACAAT","CCACCCTTACCACCACCGTA","561307.5.peg.42","1822"
"23843",558,351,207,"GGTTTACCTGTGATGAAACC","CCACCCTTACCACCACCGTA","561307.5.peg.42","1822"
"23844",477,351,126,"TTTGTAAATACATCTGGTGC","CCACCCTTACCACCACCGTA","561307.5.peg.42","1822"
"23845",224,351,127,"CAGCATCATTATGTTGCGCA","CCACCCTTACCACCACCGTA","561307.5.peg.42","1822"
"23846",179,351,172,"TGCCATCATCCATTCGTACA","CCACCCTTACCACCACCGTA","561307.5.peg.42","1822"
"23847",462,351,111,"GGTGCTGGAATATCTTTGTT","CCACCCTTACCACCACCGTA","561307.5.peg.42","1822"
"23848",179,387,208,"TGCCATCATCCATTCGTACA","TCATGAATGCTCATTTGACG","561307.5.peg.42","1822"
"23849",224,387,163,"CAGCATCATTATGTTGCGCA","TCATGAATGCTCATTTGACG","561307.5.peg.42","1822"
"23850",275,387,112,"CTTCTTCATCAACATCTGGG","TCATGAATGCTCATTTGACG","561307.5.peg.42","1822"
"23851",558,387,171,"GGTTTACCTGTGATGAAACC","TCATGAATGCTCATTTGACG","561307.5.peg.42","1822"
"23852",579,387,192,"TGAGAACCACCCAATACAAT","TCATGAATGCTCATTTGACG","561307.5.peg.42","1822"
"23853",275,462,187,"CTTCTTCATCAACATCTGGG","GGTGCTGGAATATCTTTGTT","561307.5.peg.42","1822"
"23854",179,462,283,"TGCCATCATCCATTCGTACA","GGTGCTGGAATATCTTTGTT","561307.5.peg.42","1822"
"23855",579,462,117,"TGAGAACCACCCAATACAAT","GGTGCTGGAATATCTTTGTT","561307.5.peg.42","1822"
"23856",224,462,238,"CAGCATCATTATGTTGCGCA","GGTGCTGGAATATCTTTGTT","561307.5.peg.42","1822"
"23857",351,462,111,"CCACCCTTACCACCACCGTA","GGTGCTGGAATATCTTTGTT","561307.5.peg.42","1822"
"23858",275,477,202,"CTTCTTCATCAACATCTGGG","TTTGTAAATACATCTGGTGC","561307.5.peg.42","1822"
"23859",179,477,298,"TGCCATCATCCATTCGTACA","TTTGTAAATACATCTGGTGC","561307.5.peg.42","1822"
"23860",224,477,253,"CAGCATCATTATGTTGCGCA","TTTGTAAATACATCTGGTGC","561307.5.peg.42","1822"
"23861",351,477,126,"CCACCCTTACCACCACCGTA","TTTGTAAATACATCTGGTGC","561307.5.peg.42","1822"
"23862",579,477,102,"TGAGAACCACCCAATACAAT","TTTGTAAATACATCTGGTGC","561307.5.peg.42","1822"
"23863",351,483,132,"CCACCCTTACCACCACCGTA","GTGAGTTTGTAAATACATC","561307.5.peg.42","1822"
"23864",179,483,304,"TGCCATCATCCATTCGTACA","GTGAGTTTGTAAATACATC","561307.5.peg.42","1822"
"23865",224,483,259,"CAGCATCATTATGTTGCGCA","GTGAGTTTGTAAATACATC","561307.5.peg.42","1822"
"23866",275,483,208,"CTTCTTCATCAACATCTGGG","GTGAGTTTGTAAATACATC","561307.5.peg.42","1822"
"23867",387,558,171,"TCATGAATGCTCATTTGACG","GGTTTACCTGTGATGAAACC","561307.5.peg.42","1822"
"23868",351,558,207,"CCACCCTTACCACCACCGTA","GGTTTACCTGTGATGAAACC","561307.5.peg.42","1822"
"23869",224,558,334,"CAGCATCATTATGTTGCGCA","GGTTTACCTGTGATGAAACC","561307.5.peg.42","1822"
"23870",179,558,379,"TGCCATCATCCATTCGTACA","GGTTTACCTGTGATGAAACC","561307.5.peg.42","1822"
"23871",275,558,283,"CTTCTTCATCAACATCTGGG","GGTTTACCTGTGATGAAACC","561307.5.peg.42","1822"
"23872",179,579,400,"TGCCATCATCCATTCGTACA","TGAGAACCACCCAATACAAT","561307.5.peg.42","1822"
"23873",351,579,228,"CCACCCTTACCACCACCGTA","TGAGAACCACCCAATACAAT","561307.5.peg.42","1822"
"23874",387,579,192,"TCATGAATGCTCATTTGACG","TGAGAACCACCCAATACAAT","561307.5.peg.42","1822"
"23875",275,579,304,"CTTCTTCATCAACATCTGGG","TGAGAACCACCCAATACAAT","561307.5.peg.42","1822"
"23876",462,579,117,"GGTGCTGGAATATCTTTGTT","TGAGAACCACCCAATACAAT","561307.5.peg.42","1822"
"23877",224,579,355,"CAGCATCATTATGTTGCGCA","TGAGAACCACCCAATACAAT","561307.5.peg.42","1822"
"23878",477,579,102,"TTTGTAAATACATCTGGTGC","TGAGAACCACCCAATACAAT","561307.5.peg.42","1822"
"23879",423,4,419,"ATAAGACCAAGTACGCCTGA","TATGAACAAATTTAAGGAGG","561307.5.peg.420","1823"
"23880",4,423,419,"TATGAACAAATTTAAGGAGG","ATAAGACCAAGTACGCCTGA","561307.5.peg.420","1823"
"23881",312,61,251,"GTTGATGATAATCCAACTGA","TTTACCGCCGCCACCACTTG","561307.5.peg.422","1825"
"23882",648,61,587,"GCAATGATTGTTCCAGTATC","TTTACCGCCGCCACCACTTG","561307.5.peg.422","1825"
"23883",201,61,140,"CTTGTACTTCAATATGCTT","TTTACCGCCGCCACCACTTG","561307.5.peg.422","1825"
"23884",605,61,544,"CTTCTGTTGTAATACGACAT","TTTACCGCCGCCACCACTTG","561307.5.peg.422","1825"
"23885",452,61,391,"TATGCTCTACTTGTACACGA","TTTACCGCCGCCACCACTTG","561307.5.peg.422","1825"
"23886",957,61,896,"TTAGTACCTCTATCTAGAGA","TTTACCGCCGCCACCACTTG","561307.5.peg.422","1825"
"23887",722,61,661,"AAGGTGATATCTCAGCACCT","TTTACCGCCGCCACCACTTG","561307.5.peg.422","1825"
"23888",1208,61,1147,"CTCGTGTAGCTAATAATGAT","TTTACCGCCGCCACCACTTG","561307.5.peg.422","1825"
"23889",1352,61,1291,"GACGTTCAAGTCGTTCCCAT","TTTACCGCCGCCACCACTTG","561307.5.peg.422","1825"
"23890",1403,61,1342,"TTGAAGCACGTAACAACATT","TTTACCGCCGCCACCACTTG","561307.5.peg.422","1825"
"23891",1044,61,983,"TTGATGCTAATTCATAGTC","TTTACCGCCGCCACCACTTG","561307.5.peg.422","1825"
"23892",1038,61,977,"GCTAATTCATAGTCTGGTTT","TTTACCGCCGCCACCACTTG","561307.5.peg.422","1825"
"23893",601,61,540,"TGTTGTAATACGACATTGGA","TTTACCGCCGCCACCACTTG","561307.5.peg.422","1825"
"23894",1192,61,1131,"TGATTGGTGTGCATCTCTAA","TTTACCGCCGCCACCACTTG","561307.5.peg.422","1825"
"23895",605,201,404,"CTTCTGTTGTAATACGACAT","CTTGTACTTCAATATGCTT","561307.5.peg.422","1825"
"23896",61,201,140,"TTTACCGCCGCCACCACTTG","CTTGTACTTCAATATGCTT","561307.5.peg.422","1825"
"23897",1038,201,837,"GCTAATTCATAGTCTGGTTT","CTTGTACTTCAATATGCTT","561307.5.peg.422","1825"
"23898",722,201,521,"AAGGTGATATCTCAGCACCT","CTTGTACTTCAATATGCTT","561307.5.peg.422","1825"
"23899",312,201,111,"GTTGATGATAATCCAACTGA","CTTGTACTTCAATATGCTT","561307.5.peg.422","1825"
"23900",1208,201,1007,"CTCGTGTAGCTAATAATGAT","CTTGTACTTCAATATGCTT","561307.5.peg.422","1825"
"23901",648,201,447,"GCAATGATTGTTCCAGTATC","CTTGTACTTCAATATGCTT","561307.5.peg.422","1825"
"23902",1044,201,843,"TTGATGCTAATTCATAGTC","CTTGTACTTCAATATGCTT","561307.5.peg.422","1825"
"23903",1403,201,1202,"TTGAAGCACGTAACAACATT","CTTGTACTTCAATATGCTT","561307.5.peg.422","1825"
"23904",1352,201,1151,"GACGTTCAAGTCGTTCCCAT","CTTGTACTTCAATATGCTT","561307.5.peg.422","1825"
"23905",1192,201,991,"TGATTGGTGTGCATCTCTAA","CTTGTACTTCAATATGCTT","561307.5.peg.422","1825"
"23906",601,201,400,"TGTTGTAATACGACATTGGA","CTTGTACTTCAATATGCTT","561307.5.peg.422","1825"
"23907",452,201,251,"TATGCTCTACTTGTACACGA","CTTGTACTTCAATATGCTT","561307.5.peg.422","1825"
"23908",957,201,756,"TTAGTACCTCTATCTAGAGA","CTTGTACTTCAATATGCTT","561307.5.peg.422","1825"
"23909",452,312,140,"TATGCTCTACTTGTACACGA","GTTGATGATAATCCAACTGA","561307.5.peg.422","1825"
"23910",957,312,645,"TTAGTACCTCTATCTAGAGA","GTTGATGATAATCCAACTGA","561307.5.peg.422","1825"
"23911",605,312,293,"CTTCTGTTGTAATACGACAT","GTTGATGATAATCCAACTGA","561307.5.peg.422","1825"
"23912",1038,312,726,"GCTAATTCATAGTCTGGTTT","GTTGATGATAATCCAACTGA","561307.5.peg.422","1825"
"23913",648,312,336,"GCAATGATTGTTCCAGTATC","GTTGATGATAATCCAACTGA","561307.5.peg.422","1825"
"23914",1208,312,896,"CTCGTGTAGCTAATAATGAT","GTTGATGATAATCCAACTGA","561307.5.peg.422","1825"
"23915",601,312,289,"TGTTGTAATACGACATTGGA","GTTGATGATAATCCAACTGA","561307.5.peg.422","1825"
"23916",1403,312,1091,"TTGAAGCACGTAACAACATT","GTTGATGATAATCCAACTGA","561307.5.peg.422","1825"
"23917",201,312,111,"CTTGTACTTCAATATGCTT","GTTGATGATAATCCAACTGA","561307.5.peg.422","1825"
"23918",722,312,410,"AAGGTGATATCTCAGCACCT","GTTGATGATAATCCAACTGA","561307.5.peg.422","1825"
"23919",1352,312,1040,"GACGTTCAAGTCGTTCCCAT","GTTGATGATAATCCAACTGA","561307.5.peg.422","1825"
"23920",61,312,251,"TTTACCGCCGCCACCACTTG","GTTGATGATAATCCAACTGA","561307.5.peg.422","1825"
"23921",1044,312,732,"TTGATGCTAATTCATAGTC","GTTGATGATAATCCAACTGA","561307.5.peg.422","1825"
"23922",1192,312,880,"TGATTGGTGTGCATCTCTAA","GTTGATGATAATCCAACTGA","561307.5.peg.422","1825"
"23923",722,452,270,"AAGGTGATATCTCAGCACCT","TATGCTCTACTTGTACACGA","561307.5.peg.422","1825"
"23924",312,452,140,"GTTGATGATAATCCAACTGA","TATGCTCTACTTGTACACGA","561307.5.peg.422","1825"
"23925",648,452,196,"GCAATGATTGTTCCAGTATC","TATGCTCTACTTGTACACGA","561307.5.peg.422","1825"
"23926",1038,452,586,"GCTAATTCATAGTCTGGTTT","TATGCTCTACTTGTACACGA","561307.5.peg.422","1825"
"23927",605,452,153,"CTTCTGTTGTAATACGACAT","TATGCTCTACTTGTACACGA","561307.5.peg.422","1825"
"23928",201,452,251,"CTTGTACTTCAATATGCTT","TATGCTCTACTTGTACACGA","561307.5.peg.422","1825"
"23929",1403,452,951,"TTGAAGCACGTAACAACATT","TATGCTCTACTTGTACACGA","561307.5.peg.422","1825"
"23930",61,452,391,"TTTACCGCCGCCACCACTTG","TATGCTCTACTTGTACACGA","561307.5.peg.422","1825"
"23931",1192,452,740,"TGATTGGTGTGCATCTCTAA","TATGCTCTACTTGTACACGA","561307.5.peg.422","1825"
"23932",957,452,505,"TTAGTACCTCTATCTAGAGA","TATGCTCTACTTGTACACGA","561307.5.peg.422","1825"
"23933",1044,452,592,"TTGATGCTAATTCATAGTC","TATGCTCTACTTGTACACGA","561307.5.peg.422","1825"
"23934",601,452,149,"TGTTGTAATACGACATTGGA","TATGCTCTACTTGTACACGA","561307.5.peg.422","1825"
"23935",1352,452,900,"GACGTTCAAGTCGTTCCCAT","TATGCTCTACTTGTACACGA","561307.5.peg.422","1825"
"23936",1208,452,756,"CTCGTGTAGCTAATAATGAT","TATGCTCTACTTGTACACGA","561307.5.peg.422","1825"
"23937",1352,601,751,"GACGTTCAAGTCGTTCCCAT","TGTTGTAATACGACATTGGA","561307.5.peg.422","1825"
"23938",1044,601,443,"TTGATGCTAATTCATAGTC","TGTTGTAATACGACATTGGA","561307.5.peg.422","1825"
"23939",1038,601,437,"GCTAATTCATAGTCTGGTTT","TGTTGTAATACGACATTGGA","561307.5.peg.422","1825"
"23940",452,601,149,"TATGCTCTACTTGTACACGA","TGTTGTAATACGACATTGGA","561307.5.peg.422","1825"
"23941",1192,601,591,"TGATTGGTGTGCATCTCTAA","TGTTGTAATACGACATTGGA","561307.5.peg.422","1825"
"23942",201,601,400,"CTTGTACTTCAATATGCTT","TGTTGTAATACGACATTGGA","561307.5.peg.422","1825"
"23943",722,601,121,"AAGGTGATATCTCAGCACCT","TGTTGTAATACGACATTGGA","561307.5.peg.422","1825"
"23944",61,601,540,"TTTACCGCCGCCACCACTTG","TGTTGTAATACGACATTGGA","561307.5.peg.422","1825"
"23945",1403,601,802,"TTGAAGCACGTAACAACATT","TGTTGTAATACGACATTGGA","561307.5.peg.422","1825"
"23946",957,601,356,"TTAGTACCTCTATCTAGAGA","TGTTGTAATACGACATTGGA","561307.5.peg.422","1825"
"23947",312,601,289,"GTTGATGATAATCCAACTGA","TGTTGTAATACGACATTGGA","561307.5.peg.422","1825"
"23948",1208,601,607,"CTCGTGTAGCTAATAATGAT","TGTTGTAATACGACATTGGA","561307.5.peg.422","1825"
"23949",61,605,544,"TTTACCGCCGCCACCACTTG","CTTCTGTTGTAATACGACAT","561307.5.peg.422","1825"
"23950",1192,605,587,"TGATTGGTGTGCATCTCTAA","CTTCTGTTGTAATACGACAT","561307.5.peg.422","1825"
"23951",452,605,153,"TATGCTCTACTTGTACACGA","CTTCTGTTGTAATACGACAT","561307.5.peg.422","1825"
"23952",1038,605,433,"GCTAATTCATAGTCTGGTTT","CTTCTGTTGTAATACGACAT","561307.5.peg.422","1825"
"23953",957,605,352,"TTAGTACCTCTATCTAGAGA","CTTCTGTTGTAATACGACAT","561307.5.peg.422","1825"
"23954",1352,605,747,"GACGTTCAAGTCGTTCCCAT","CTTCTGTTGTAATACGACAT","561307.5.peg.422","1825"
"23955",201,605,404,"CTTGTACTTCAATATGCTT","CTTCTGTTGTAATACGACAT","561307.5.peg.422","1825"
"23956",1044,605,439,"TTGATGCTAATTCATAGTC","CTTCTGTTGTAATACGACAT","561307.5.peg.422","1825"
"23957",312,605,293,"GTTGATGATAATCCAACTGA","CTTCTGTTGTAATACGACAT","561307.5.peg.422","1825"
"23958",722,605,117,"AAGGTGATATCTCAGCACCT","CTTCTGTTGTAATACGACAT","561307.5.peg.422","1825"
"23959",1403,605,798,"TTGAAGCACGTAACAACATT","CTTCTGTTGTAATACGACAT","561307.5.peg.422","1825"
"23960",1208,605,603,"CTCGTGTAGCTAATAATGAT","CTTCTGTTGTAATACGACAT","561307.5.peg.422","1825"
"23961",452,648,196,"TATGCTCTACTTGTACACGA","GCAATGATTGTTCCAGTATC","561307.5.peg.422","1825"
"23962",1352,648,704,"GACGTTCAAGTCGTTCCCAT","GCAATGATTGTTCCAGTATC","561307.5.peg.422","1825"
"23963",201,648,447,"CTTGTACTTCAATATGCTT","GCAATGATTGTTCCAGTATC","561307.5.peg.422","1825"
"23964",1208,648,560,"CTCGTGTAGCTAATAATGAT","GCAATGATTGTTCCAGTATC","561307.5.peg.422","1825"
"23965",1044,648,396,"TTGATGCTAATTCATAGTC","GCAATGATTGTTCCAGTATC","561307.5.peg.422","1825"
"23966",1192,648,544,"TGATTGGTGTGCATCTCTAA","GCAATGATTGTTCCAGTATC","561307.5.peg.422","1825"
"23967",312,648,336,"GTTGATGATAATCCAACTGA","GCAATGATTGTTCCAGTATC","561307.5.peg.422","1825"
"23968",61,648,587,"TTTACCGCCGCCACCACTTG","GCAATGATTGTTCCAGTATC","561307.5.peg.422","1825"
"23969",957,648,309,"TTAGTACCTCTATCTAGAGA","GCAATGATTGTTCCAGTATC","561307.5.peg.422","1825"
"23970",1403,648,755,"TTGAAGCACGTAACAACATT","GCAATGATTGTTCCAGTATC","561307.5.peg.422","1825"
"23971",1038,648,390,"GCTAATTCATAGTCTGGTTT","GCAATGATTGTTCCAGTATC","561307.5.peg.422","1825"
"23972",1208,722,486,"CTCGTGTAGCTAATAATGAT","AAGGTGATATCTCAGCACCT","561307.5.peg.422","1825"
"23973",312,722,410,"GTTGATGATAATCCAACTGA","AAGGTGATATCTCAGCACCT","561307.5.peg.422","1825"
"23974",1352,722,630,"GACGTTCAAGTCGTTCCCAT","AAGGTGATATCTCAGCACCT","561307.5.peg.422","1825"
"23975",1403,722,681,"TTGAAGCACGTAACAACATT","AAGGTGATATCTCAGCACCT","561307.5.peg.422","1825"
"23976",61,722,661,"TTTACCGCCGCCACCACTTG","AAGGTGATATCTCAGCACCT","561307.5.peg.422","1825"
"23977",605,722,117,"CTTCTGTTGTAATACGACAT","AAGGTGATATCTCAGCACCT","561307.5.peg.422","1825"
"23978",957,722,235,"TTAGTACCTCTATCTAGAGA","AAGGTGATATCTCAGCACCT","561307.5.peg.422","1825"
"23979",201,722,521,"CTTGTACTTCAATATGCTT","AAGGTGATATCTCAGCACCT","561307.5.peg.422","1825"
"23980",601,722,121,"TGTTGTAATACGACATTGGA","AAGGTGATATCTCAGCACCT","561307.5.peg.422","1825"
"23981",1044,722,322,"TTGATGCTAATTCATAGTC","AAGGTGATATCTCAGCACCT","561307.5.peg.422","1825"
"23982",1192,722,470,"TGATTGGTGTGCATCTCTAA","AAGGTGATATCTCAGCACCT","561307.5.peg.422","1825"
"23983",1038,722,316,"GCTAATTCATAGTCTGGTTT","AAGGTGATATCTCAGCACCT","561307.5.peg.422","1825"
"23984",452,722,270,"TATGCTCTACTTGTACACGA","AAGGTGATATCTCAGCACCT","561307.5.peg.422","1825"
"23985",1352,957,395,"GACGTTCAAGTCGTTCCCAT","TTAGTACCTCTATCTAGAGA","561307.5.peg.422","1825"
"23986",722,957,235,"AAGGTGATATCTCAGCACCT","TTAGTACCTCTATCTAGAGA","561307.5.peg.422","1825"
"23987",1192,957,235,"TGATTGGTGTGCATCTCTAA","TTAGTACCTCTATCTAGAGA","561307.5.peg.422","1825"
"23988",1208,957,251,"CTCGTGTAGCTAATAATGAT","TTAGTACCTCTATCTAGAGA","561307.5.peg.422","1825"
"23989",452,957,505,"TATGCTCTACTTGTACACGA","TTAGTACCTCTATCTAGAGA","561307.5.peg.422","1825"
"23990",312,957,645,"GTTGATGATAATCCAACTGA","TTAGTACCTCTATCTAGAGA","561307.5.peg.422","1825"
"23991",1403,957,446,"TTGAAGCACGTAACAACATT","TTAGTACCTCTATCTAGAGA","561307.5.peg.422","1825"
"23992",648,957,309,"GCAATGATTGTTCCAGTATC","TTAGTACCTCTATCTAGAGA","561307.5.peg.422","1825"
"23993",605,957,352,"CTTCTGTTGTAATACGACAT","TTAGTACCTCTATCTAGAGA","561307.5.peg.422","1825"
"23994",201,957,756,"CTTGTACTTCAATATGCTT","TTAGTACCTCTATCTAGAGA","561307.5.peg.422","1825"
"23995",61,957,896,"TTTACCGCCGCCACCACTTG","TTAGTACCTCTATCTAGAGA","561307.5.peg.422","1825"
"23996",601,957,356,"TGTTGTAATACGACATTGGA","TTAGTACCTCTATCTAGAGA","561307.5.peg.422","1825"
"23997",722,1038,316,"AAGGTGATATCTCAGCACCT","GCTAATTCATAGTCTGGTTT","561307.5.peg.422","1825"
"23998",605,1038,433,"CTTCTGTTGTAATACGACAT","GCTAATTCATAGTCTGGTTT","561307.5.peg.422","1825"
"23999",312,1038,726,"GTTGATGATAATCCAACTGA","GCTAATTCATAGTCTGGTTT","561307.5.peg.422","1825"
"24000",452,1038,586,"TATGCTCTACTTGTACACGA","GCTAATTCATAGTCTGGTTT","561307.5.peg.422","1825"
"24001",1192,1038,154,"TGATTGGTGTGCATCTCTAA","GCTAATTCATAGTCTGGTTT","561307.5.peg.422","1825"
"24002",1352,1038,314,"GACGTTCAAGTCGTTCCCAT","GCTAATTCATAGTCTGGTTT","561307.5.peg.422","1825"
"24003",601,1038,437,"TGTTGTAATACGACATTGGA","GCTAATTCATAGTCTGGTTT","561307.5.peg.422","1825"
"24004",1208,1038,170,"CTCGTGTAGCTAATAATGAT","GCTAATTCATAGTCTGGTTT","561307.5.peg.422","1825"
"24005",201,1038,837,"CTTGTACTTCAATATGCTT","GCTAATTCATAGTCTGGTTT","561307.5.peg.422","1825"
"24006",61,1038,977,"TTTACCGCCGCCACCACTTG","GCTAATTCATAGTCTGGTTT","561307.5.peg.422","1825"
"24007",648,1038,390,"GCAATGATTGTTCCAGTATC","GCTAATTCATAGTCTGGTTT","561307.5.peg.422","1825"
"24008",1403,1038,365,"TTGAAGCACGTAACAACATT","GCTAATTCATAGTCTGGTTT","561307.5.peg.422","1825"
"24009",601,1044,443,"TGTTGTAATACGACATTGGA","TTGATGCTAATTCATAGTC","561307.5.peg.422","1825"
"24010",312,1044,732,"GTTGATGATAATCCAACTGA","TTGATGCTAATTCATAGTC","561307.5.peg.422","1825"
"24011",201,1044,843,"CTTGTACTTCAATATGCTT","TTGATGCTAATTCATAGTC","561307.5.peg.422","1825"
"24012",1403,1044,359,"TTGAAGCACGTAACAACATT","TTGATGCTAATTCATAGTC","561307.5.peg.422","1825"
"24013",452,1044,592,"TATGCTCTACTTGTACACGA","TTGATGCTAATTCATAGTC","561307.5.peg.422","1825"
"24014",722,1044,322,"AAGGTGATATCTCAGCACCT","TTGATGCTAATTCATAGTC","561307.5.peg.422","1825"
"24015",61,1044,983,"TTTACCGCCGCCACCACTTG","TTGATGCTAATTCATAGTC","561307.5.peg.422","1825"
"24016",1192,1044,148,"TGATTGGTGTGCATCTCTAA","TTGATGCTAATTCATAGTC","561307.5.peg.422","1825"
"24017",648,1044,396,"GCAATGATTGTTCCAGTATC","TTGATGCTAATTCATAGTC","561307.5.peg.422","1825"
"24018",605,1044,439,"CTTCTGTTGTAATACGACAT","TTGATGCTAATTCATAGTC","561307.5.peg.422","1825"
"24019",1208,1044,164,"CTCGTGTAGCTAATAATGAT","TTGATGCTAATTCATAGTC","561307.5.peg.422","1825"
"24020",1352,1044,308,"GACGTTCAAGTCGTTCCCAT","TTGATGCTAATTCATAGTC","561307.5.peg.422","1825"
"24021",605,1192,587,"CTTCTGTTGTAATACGACAT","TGATTGGTGTGCATCTCTAA","561307.5.peg.422","1825"
"24022",601,1192,591,"TGTTGTAATACGACATTGGA","TGATTGGTGTGCATCTCTAA","561307.5.peg.422","1825"
"24023",61,1192,1131,"TTTACCGCCGCCACCACTTG","TGATTGGTGTGCATCTCTAA","561307.5.peg.422","1825"
"24024",201,1192,991,"CTTGTACTTCAATATGCTT","TGATTGGTGTGCATCTCTAA","561307.5.peg.422","1825"
"24025",312,1192,880,"GTTGATGATAATCCAACTGA","TGATTGGTGTGCATCTCTAA","561307.5.peg.422","1825"
"24026",1044,1192,148,"TTGATGCTAATTCATAGTC","TGATTGGTGTGCATCTCTAA","561307.5.peg.422","1825"
"24027",957,1192,235,"TTAGTACCTCTATCTAGAGA","TGATTGGTGTGCATCTCTAA","561307.5.peg.422","1825"
"24028",1352,1192,160,"GACGTTCAAGTCGTTCCCAT","TGATTGGTGTGCATCTCTAA","561307.5.peg.422","1825"
"24029",452,1192,740,"TATGCTCTACTTGTACACGA","TGATTGGTGTGCATCTCTAA","561307.5.peg.422","1825"
"24030",1038,1192,154,"GCTAATTCATAGTCTGGTTT","TGATTGGTGTGCATCTCTAA","561307.5.peg.422","1825"
"24031",722,1192,470,"AAGGTGATATCTCAGCACCT","TGATTGGTGTGCATCTCTAA","561307.5.peg.422","1825"
"24032",1403,1192,211,"TTGAAGCACGTAACAACATT","TGATTGGTGTGCATCTCTAA","561307.5.peg.422","1825"
"24033",648,1192,544,"GCAATGATTGTTCCAGTATC","TGATTGGTGTGCATCTCTAA","561307.5.peg.422","1825"
"24034",1403,1208,195,"TTGAAGCACGTAACAACATT","CTCGTGTAGCTAATAATGAT","561307.5.peg.422","1825"
"24035",452,1208,756,"TATGCTCTACTTGTACACGA","CTCGTGTAGCTAATAATGAT","561307.5.peg.422","1825"
"24036",61,1208,1147,"TTTACCGCCGCCACCACTTG","CTCGTGTAGCTAATAATGAT","561307.5.peg.422","1825"
"24037",605,1208,603,"CTTCTGTTGTAATACGACAT","CTCGTGTAGCTAATAATGAT","561307.5.peg.422","1825"
"24038",1038,1208,170,"GCTAATTCATAGTCTGGTTT","CTCGTGTAGCTAATAATGAT","561307.5.peg.422","1825"
"24039",648,1208,560,"GCAATGATTGTTCCAGTATC","CTCGTGTAGCTAATAATGAT","561307.5.peg.422","1825"
"24040",957,1208,251,"TTAGTACCTCTATCTAGAGA","CTCGTGTAGCTAATAATGAT","561307.5.peg.422","1825"
"24041",601,1208,607,"TGTTGTAATACGACATTGGA","CTCGTGTAGCTAATAATGAT","561307.5.peg.422","1825"
"24042",722,1208,486,"AAGGTGATATCTCAGCACCT","CTCGTGTAGCTAATAATGAT","561307.5.peg.422","1825"
"24043",312,1208,896,"GTTGATGATAATCCAACTGA","CTCGTGTAGCTAATAATGAT","561307.5.peg.422","1825"
"24044",201,1208,1007,"CTTGTACTTCAATATGCTT","CTCGTGTAGCTAATAATGAT","561307.5.peg.422","1825"
"24045",1352,1208,144,"GACGTTCAAGTCGTTCCCAT","CTCGTGTAGCTAATAATGAT","561307.5.peg.422","1825"
"24046",1044,1208,164,"TTGATGCTAATTCATAGTC","CTCGTGTAGCTAATAATGAT","561307.5.peg.422","1825"
"24047",61,1352,1291,"TTTACCGCCGCCACCACTTG","GACGTTCAAGTCGTTCCCAT","561307.5.peg.422","1825"
"24048",648,1352,704,"GCAATGATTGTTCCAGTATC","GACGTTCAAGTCGTTCCCAT","561307.5.peg.422","1825"
"24049",201,1352,1151,"CTTGTACTTCAATATGCTT","GACGTTCAAGTCGTTCCCAT","561307.5.peg.422","1825"
"24050",452,1352,900,"TATGCTCTACTTGTACACGA","GACGTTCAAGTCGTTCCCAT","561307.5.peg.422","1825"
"24051",1044,1352,308,"TTGATGCTAATTCATAGTC","GACGTTCAAGTCGTTCCCAT","561307.5.peg.422","1825"
"24052",1208,1352,144,"CTCGTGTAGCTAATAATGAT","GACGTTCAAGTCGTTCCCAT","561307.5.peg.422","1825"
"24053",601,1352,751,"TGTTGTAATACGACATTGGA","GACGTTCAAGTCGTTCCCAT","561307.5.peg.422","1825"
"24054",957,1352,395,"TTAGTACCTCTATCTAGAGA","GACGTTCAAGTCGTTCCCAT","561307.5.peg.422","1825"
"24055",605,1352,747,"CTTCTGTTGTAATACGACAT","GACGTTCAAGTCGTTCCCAT","561307.5.peg.422","1825"
"24056",1192,1352,160,"TGATTGGTGTGCATCTCTAA","GACGTTCAAGTCGTTCCCAT","561307.5.peg.422","1825"
"24057",312,1352,1040,"GTTGATGATAATCCAACTGA","GACGTTCAAGTCGTTCCCAT","561307.5.peg.422","1825"
"24058",722,1352,630,"AAGGTGATATCTCAGCACCT","GACGTTCAAGTCGTTCCCAT","561307.5.peg.422","1825"
"24059",1038,1352,314,"GCTAATTCATAGTCTGGTTT","GACGTTCAAGTCGTTCCCAT","561307.5.peg.422","1825"
"24060",312,1403,1091,"GTTGATGATAATCCAACTGA","TTGAAGCACGTAACAACATT","561307.5.peg.422","1825"
"24061",452,1403,951,"TATGCTCTACTTGTACACGA","TTGAAGCACGTAACAACATT","561307.5.peg.422","1825"
"24062",201,1403,1202,"CTTGTACTTCAATATGCTT","TTGAAGCACGTAACAACATT","561307.5.peg.422","1825"
"24063",601,1403,802,"TGTTGTAATACGACATTGGA","TTGAAGCACGTAACAACATT","561307.5.peg.422","1825"
"24064",1044,1403,359,"TTGATGCTAATTCATAGTC","TTGAAGCACGTAACAACATT","561307.5.peg.422","1825"
"24065",1192,1403,211,"TGATTGGTGTGCATCTCTAA","TTGAAGCACGTAACAACATT","561307.5.peg.422","1825"
"24066",1208,1403,195,"CTCGTGTAGCTAATAATGAT","TTGAAGCACGTAACAACATT","561307.5.peg.422","1825"
"24067",957,1403,446,"TTAGTACCTCTATCTAGAGA","TTGAAGCACGTAACAACATT","561307.5.peg.422","1825"
"24068",722,1403,681,"AAGGTGATATCTCAGCACCT","TTGAAGCACGTAACAACATT","561307.5.peg.422","1825"
"24069",61,1403,1342,"TTTACCGCCGCCACCACTTG","TTGAAGCACGTAACAACATT","561307.5.peg.422","1825"
"24070",605,1403,798,"CTTCTGTTGTAATACGACAT","TTGAAGCACGTAACAACATT","561307.5.peg.422","1825"
"24071",1038,1403,365,"GCTAATTCATAGTCTGGTTT","TTGAAGCACGTAACAACATT","561307.5.peg.422","1825"
"24072",648,1403,755,"GCAATGATTGTTCCAGTATC","TTGAAGCACGTAACAACATT","561307.5.peg.422","1825"
"24073",432,43,389,"TGAGCTAAACCGCTATCTGT","TGTCACTTGTTGCATATCAT","561307.5.peg.424","1827"
"24074",221,43,178,"ATATTTGAGGTGCGTATGTT","TGTCACTTGTTGCATATCAT","561307.5.peg.424","1827"
"24075",392,43,349,"GACCATCATAAGTTGCAGGG","TGTCACTTGTTGCATATCAT","561307.5.peg.424","1827"
"24076",462,43,419,"CTTCCAGTTACCCTTGATAC","TGTCACTTGTTGCATATCAT","561307.5.peg.424","1827"
"24077",179,43,136,"TTACATCTATATCGAAACGT","TGTCACTTGTTGCATATCAT","561307.5.peg.424","1827"
"24078",395,43,352,"AGCGACCATCATAAGTTGCA","TGTCACTTGTTGCATATCAT","561307.5.peg.424","1827"
"24079",536,43,493,"AACCATTTGCTGGTTTCTTC","TGTCACTTGTTGCATATCAT","561307.5.peg.424","1827"
"24080",392,179,213,"GACCATCATAAGTTGCAGGG","TTACATCTATATCGAAACGT","561307.5.peg.424","1827"
"24081",536,179,357,"AACCATTTGCTGGTTTCTTC","TTACATCTATATCGAAACGT","561307.5.peg.424","1827"
"24082",432,179,253,"TGAGCTAAACCGCTATCTGT","TTACATCTATATCGAAACGT","561307.5.peg.424","1827"
"24083",462,179,283,"CTTCCAGTTACCCTTGATAC","TTACATCTATATCGAAACGT","561307.5.peg.424","1827"
"24084",43,179,136,"TGTCACTTGTTGCATATCAT","TTACATCTATATCGAAACGT","561307.5.peg.424","1827"
"24085",395,179,216,"AGCGACCATCATAAGTTGCA","TTACATCTATATCGAAACGT","561307.5.peg.424","1827"
"24086",43,221,178,"TGTCACTTGTTGCATATCAT","ATATTTGAGGTGCGTATGTT","561307.5.peg.424","1827"
"24087",395,221,174,"AGCGACCATCATAAGTTGCA","ATATTTGAGGTGCGTATGTT","561307.5.peg.424","1827"
"24088",536,221,315,"AACCATTTGCTGGTTTCTTC","ATATTTGAGGTGCGTATGTT","561307.5.peg.424","1827"
"24089",392,221,171,"GACCATCATAAGTTGCAGGG","ATATTTGAGGTGCGTATGTT","561307.5.peg.424","1827"
"24090",432,221,211,"TGAGCTAAACCGCTATCTGT","ATATTTGAGGTGCGTATGTT","561307.5.peg.424","1827"
"24091",462,221,241,"CTTCCAGTTACCCTTGATAC","ATATTTGAGGTGCGTATGTT","561307.5.peg.424","1827"
"24092",179,392,213,"TTACATCTATATCGAAACGT","GACCATCATAAGTTGCAGGG","561307.5.peg.424","1827"
"24093",536,392,144,"AACCATTTGCTGGTTTCTTC","GACCATCATAAGTTGCAGGG","561307.5.peg.424","1827"
"24094",43,392,349,"TGTCACTTGTTGCATATCAT","GACCATCATAAGTTGCAGGG","561307.5.peg.424","1827"
"24095",221,392,171,"ATATTTGAGGTGCGTATGTT","GACCATCATAAGTTGCAGGG","561307.5.peg.424","1827"
"24096",43,395,352,"TGTCACTTGTTGCATATCAT","AGCGACCATCATAAGTTGCA","561307.5.peg.424","1827"
"24097",221,395,174,"ATATTTGAGGTGCGTATGTT","AGCGACCATCATAAGTTGCA","561307.5.peg.424","1827"
"24098",536,395,141,"AACCATTTGCTGGTTTCTTC","AGCGACCATCATAAGTTGCA","561307.5.peg.424","1827"
"24099",179,395,216,"TTACATCTATATCGAAACGT","AGCGACCATCATAAGTTGCA","561307.5.peg.424","1827"
"24100",43,432,389,"TGTCACTTGTTGCATATCAT","TGAGCTAAACCGCTATCTGT","561307.5.peg.424","1827"
"24101",179,432,253,"TTACATCTATATCGAAACGT","TGAGCTAAACCGCTATCTGT","561307.5.peg.424","1827"
"24102",221,432,211,"ATATTTGAGGTGCGTATGTT","TGAGCTAAACCGCTATCTGT","561307.5.peg.424","1827"
"24103",536,432,104,"AACCATTTGCTGGTTTCTTC","TGAGCTAAACCGCTATCTGT","561307.5.peg.424","1827"
"24104",43,462,419,"TGTCACTTGTTGCATATCAT","CTTCCAGTTACCCTTGATAC","561307.5.peg.424","1827"
"24105",179,462,283,"TTACATCTATATCGAAACGT","CTTCCAGTTACCCTTGATAC","561307.5.peg.424","1827"
"24106",221,462,241,"ATATTTGAGGTGCGTATGTT","CTTCCAGTTACCCTTGATAC","561307.5.peg.424","1827"
"24107",432,536,104,"TGAGCTAAACCGCTATCTGT","AACCATTTGCTGGTTTCTTC","561307.5.peg.424","1827"
"24108",179,536,357,"TTACATCTATATCGAAACGT","AACCATTTGCTGGTTTCTTC","561307.5.peg.424","1827"
"24109",43,536,493,"TGTCACTTGTTGCATATCAT","AACCATTTGCTGGTTTCTTC","561307.5.peg.424","1827"
"24110",221,536,315,"ATATTTGAGGTGCGTATGTT","AACCATTTGCTGGTTTCTTC","561307.5.peg.424","1827"
"24111",392,536,144,"GACCATCATAAGTTGCAGGG","AACCATTTGCTGGTTTCTTC","561307.5.peg.424","1827"
"24112",395,536,141,"AGCGACCATCATAAGTTGCA","AACCATTTGCTGGTTTCTTC","561307.5.peg.424","1827"
"24113",130,9,121,"TGATTGATAGATACTGAGAA","ATGTTGTAAATGCTAAAGG","561307.5.peg.428","1831"
"24114",9,130,121,"ATGTTGTAAATGCTAAAGG","TGATTGATAGATACTGAGAA","561307.5.peg.428","1831"
"24115",473,111,362,"CTGGCGCCATTGTTCGACCA","TCTGAAATGACAATTGGCAA","561307.5.peg.43","1833"
"24116",521,111,410,"ATAACGGACCATAACCACGT","TCTGAAATGACAATTGGCAA","561307.5.peg.43","1833"
"24117",473,159,314,"CTGGCGCCATTGTTCGACCA","CCATATATTTATTGCCTTC","561307.5.peg.43","1833"
"24118",521,159,362,"ATAACGGACCATAACCACGT","CCATATATTTATTGCCTTC","561307.5.peg.43","1833"
"24119",111,473,362,"TCTGAAATGACAATTGGCAA","CTGGCGCCATTGTTCGACCA","561307.5.peg.43","1833"
"24120",159,473,314,"CCATATATTTATTGCCTTC","CTGGCGCCATTGTTCGACCA","561307.5.peg.43","1833"
"24121",111,521,410,"TCTGAAATGACAATTGGCAA","ATAACGGACCATAACCACGT","561307.5.peg.43","1833"
"24122",159,521,362,"CCATATATTTATTGCCTTC","ATAACGGACCATAACCACGT","561307.5.peg.43","1833"
"24123",144,7,137,"ATTGACGGCAAATGCTCTCC","TATATACAGAAGTTGATAGG","561307.5.peg.433","1837"
"24124",159,7,152,"TTGGCAAGTTCTCTCATTGA","TATATACAGAAGTTGATAGG","561307.5.peg.433","1837"
"24125",208,7,201,"AAATCTTCATAAGCACGTT","TATATACAGAAGTTGATAGG","561307.5.peg.433","1837"
"24126",208,84,124,"AAATCTTCATAAGCACGTT","GCTTAATCTGTTCATAAAT","561307.5.peg.433","1837"
"24127",7,144,137,"TATATACAGAAGTTGATAGG","ATTGACGGCAAATGCTCTCC","561307.5.peg.433","1837"
"24128",7,159,152,"TATATACAGAAGTTGATAGG","TTGGCAAGTTCTCTCATTGA","561307.5.peg.433","1837"
"24129",7,208,201,"TATATACAGAAGTTGATAGG","AAATCTTCATAAGCACGTT","561307.5.peg.433","1837"
"24130",84,208,124,"GCTTAATCTGTTCATAAAT","AAATCTTCATAAGCACGTT","561307.5.peg.433","1837"
"24131",360,57,303,"ATGTTGTCGATTGATAGCTC","TCATTTAAGCTTTGGGCTAA","561307.5.peg.435","1839"
"24132",276,57,219,"GCATAAGGGAATATTTCATC","TCATTTAAGCTTTGGGCTAA","561307.5.peg.435","1839"
"24133",660,57,603,"GTAGTCACTTCTTTATGCGT","TCATTTAAGCTTTGGGCTAA","561307.5.peg.435","1839"
"24134",300,57,243,"AATTCTTCGATGCCTTGTGG","TCATTTAAGCTTTGGGCTAA","561307.5.peg.435","1839"
"24135",636,57,579,"GTGTAACCTGTCGGATTATT","TCATTTAAGCTTTGGGCTAA","561307.5.peg.435","1839"
"24136",645,57,588,"TGCGTAGGTGTGTAACCTGT","TCATTTAAGCTTTGGGCTAA","561307.5.peg.435","1839"
"24137",290,57,233,"TGCCTTGTGGTGGCGCATAA","TCATTTAAGCTTTGGGCTAA","561307.5.peg.435","1839"
"24138",471,57,414,"TAATTACCCCAATTATGCTC","TCATTTAAGCTTTGGGCTAA","561307.5.peg.435","1839"
"24139",303,57,246,"CGTAATTCTTCGATGCCTTG","TCATTTAAGCTTTGGGCTAA","561307.5.peg.435","1839"
"24140",290,64,226,"TGCCTTGTGGTGGCGCATAA","AGTTGTTCATTTAAGCTTT","561307.5.peg.435","1839"
"24141",276,64,212,"GCATAAGGGAATATTTCATC","AGTTGTTCATTTAAGCTTT","561307.5.peg.435","1839"
"24142",300,64,236,"AATTCTTCGATGCCTTGTGG","AGTTGTTCATTTAAGCTTT","561307.5.peg.435","1839"
"24143",636,64,572,"GTGTAACCTGTCGGATTATT","AGTTGTTCATTTAAGCTTT","561307.5.peg.435","1839"
"24144",360,64,296,"ATGTTGTCGATTGATAGCTC","AGTTGTTCATTTAAGCTTT","561307.5.peg.435","1839"
"24145",660,64,596,"GTAGTCACTTCTTTATGCGT","AGTTGTTCATTTAAGCTTT","561307.5.peg.435","1839"
"24146",303,64,239,"CGTAATTCTTCGATGCCTTG","AGTTGTTCATTTAAGCTTT","561307.5.peg.435","1839"
"24147",471,64,407,"TAATTACCCCAATTATGCTC","AGTTGTTCATTTAAGCTTT","561307.5.peg.435","1839"
"24148",645,64,581,"TGCGTAGGTGTGTAACCTGT","AGTTGTTCATTTAAGCTTT","561307.5.peg.435","1839"
"24149",57,276,219,"TCATTTAAGCTTTGGGCTAA","GCATAAGGGAATATTTCATC","561307.5.peg.435","1839"
"24150",636,276,360,"GTGTAACCTGTCGGATTATT","GCATAAGGGAATATTTCATC","561307.5.peg.435","1839"
"24151",471,276,195,"TAATTACCCCAATTATGCTC","GCATAAGGGAATATTTCATC","561307.5.peg.435","1839"
"24152",645,276,369,"TGCGTAGGTGTGTAACCTGT","GCATAAGGGAATATTTCATC","561307.5.peg.435","1839"
"24153",64,276,212,"AGTTGTTCATTTAAGCTTT","GCATAAGGGAATATTTCATC","561307.5.peg.435","1839"
"24154",660,276,384,"GTAGTCACTTCTTTATGCGT","GCATAAGGGAATATTTCATC","561307.5.peg.435","1839"
"24155",645,290,355,"TGCGTAGGTGTGTAACCTGT","TGCCTTGTGGTGGCGCATAA","561307.5.peg.435","1839"
"24156",64,290,226,"AGTTGTTCATTTAAGCTTT","TGCCTTGTGGTGGCGCATAA","561307.5.peg.435","1839"
"24157",660,290,370,"GTAGTCACTTCTTTATGCGT","TGCCTTGTGGTGGCGCATAA","561307.5.peg.435","1839"
"24158",57,290,233,"TCATTTAAGCTTTGGGCTAA","TGCCTTGTGGTGGCGCATAA","561307.5.peg.435","1839"
"24159",471,290,181,"TAATTACCCCAATTATGCTC","TGCCTTGTGGTGGCGCATAA","561307.5.peg.435","1839"
"24160",636,290,346,"GTGTAACCTGTCGGATTATT","TGCCTTGTGGTGGCGCATAA","561307.5.peg.435","1839"
"24161",64,300,236,"AGTTGTTCATTTAAGCTTT","AATTCTTCGATGCCTTGTGG","561307.5.peg.435","1839"
"24162",636,300,336,"GTGTAACCTGTCGGATTATT","AATTCTTCGATGCCTTGTGG","561307.5.peg.435","1839"
"24163",57,300,243,"TCATTTAAGCTTTGGGCTAA","AATTCTTCGATGCCTTGTGG","561307.5.peg.435","1839"
"24164",645,300,345,"TGCGTAGGTGTGTAACCTGT","AATTCTTCGATGCCTTGTGG","561307.5.peg.435","1839"
"24165",471,300,171,"TAATTACCCCAATTATGCTC","AATTCTTCGATGCCTTGTGG","561307.5.peg.435","1839"
"24166",660,300,360,"GTAGTCACTTCTTTATGCGT","AATTCTTCGATGCCTTGTGG","561307.5.peg.435","1839"
"24167",57,303,246,"TCATTTAAGCTTTGGGCTAA","CGTAATTCTTCGATGCCTTG","561307.5.peg.435","1839"
"24168",471,303,168,"TAATTACCCCAATTATGCTC","CGTAATTCTTCGATGCCTTG","561307.5.peg.435","1839"
"24169",660,303,357,"GTAGTCACTTCTTTATGCGT","CGTAATTCTTCGATGCCTTG","561307.5.peg.435","1839"
"24170",636,303,333,"GTGTAACCTGTCGGATTATT","CGTAATTCTTCGATGCCTTG","561307.5.peg.435","1839"
"24171",645,303,342,"TGCGTAGGTGTGTAACCTGT","CGTAATTCTTCGATGCCTTG","561307.5.peg.435","1839"
"24172",64,303,239,"AGTTGTTCATTTAAGCTTT","CGTAATTCTTCGATGCCTTG","561307.5.peg.435","1839"
"24173",645,360,285,"TGCGTAGGTGTGTAACCTGT","ATGTTGTCGATTGATAGCTC","561307.5.peg.435","1839"
"24174",636,360,276,"GTGTAACCTGTCGGATTATT","ATGTTGTCGATTGATAGCTC","561307.5.peg.435","1839"
"24175",471,360,111,"TAATTACCCCAATTATGCTC","ATGTTGTCGATTGATAGCTC","561307.5.peg.435","1839"
"24176",57,360,303,"TCATTTAAGCTTTGGGCTAA","ATGTTGTCGATTGATAGCTC","561307.5.peg.435","1839"
"24177",660,360,300,"GTAGTCACTTCTTTATGCGT","ATGTTGTCGATTGATAGCTC","561307.5.peg.435","1839"
"24178",64,360,296,"AGTTGTTCATTTAAGCTTT","ATGTTGTCGATTGATAGCTC","561307.5.peg.435","1839"
"24179",660,471,189,"GTAGTCACTTCTTTATGCGT","TAATTACCCCAATTATGCTC","561307.5.peg.435","1839"
"24180",57,471,414,"TCATTTAAGCTTTGGGCTAA","TAATTACCCCAATTATGCTC","561307.5.peg.435","1839"
"24181",64,471,407,"AGTTGTTCATTTAAGCTTT","TAATTACCCCAATTATGCTC","561307.5.peg.435","1839"
"24182",303,471,168,"CGTAATTCTTCGATGCCTTG","TAATTACCCCAATTATGCTC","561307.5.peg.435","1839"
"24183",276,471,195,"GCATAAGGGAATATTTCATC","TAATTACCCCAATTATGCTC","561307.5.peg.435","1839"
"24184",360,471,111,"ATGTTGTCGATTGATAGCTC","TAATTACCCCAATTATGCTC","561307.5.peg.435","1839"
"24185",300,471,171,"AATTCTTCGATGCCTTGTGG","TAATTACCCCAATTATGCTC","561307.5.peg.435","1839"
"24186",636,471,165,"GTGTAACCTGTCGGATTATT","TAATTACCCCAATTATGCTC","561307.5.peg.435","1839"
"24187",290,471,181,"TGCCTTGTGGTGGCGCATAA","TAATTACCCCAATTATGCTC","561307.5.peg.435","1839"
"24188",645,471,174,"TGCGTAGGTGTGTAACCTGT","TAATTACCCCAATTATGCTC","561307.5.peg.435","1839"
"24189",471,636,165,"TAATTACCCCAATTATGCTC","GTGTAACCTGTCGGATTATT","561307.5.peg.435","1839"
"24190",57,636,579,"TCATTTAAGCTTTGGGCTAA","GTGTAACCTGTCGGATTATT","561307.5.peg.435","1839"
"24191",290,636,346,"TGCCTTGTGGTGGCGCATAA","GTGTAACCTGTCGGATTATT","561307.5.peg.435","1839"
"24192",64,636,572,"AGTTGTTCATTTAAGCTTT","GTGTAACCTGTCGGATTATT","561307.5.peg.435","1839"
"24193",303,636,333,"CGTAATTCTTCGATGCCTTG","GTGTAACCTGTCGGATTATT","561307.5.peg.435","1839"
"24194",276,636,360,"GCATAAGGGAATATTTCATC","GTGTAACCTGTCGGATTATT","561307.5.peg.435","1839"
"24195",300,636,336,"AATTCTTCGATGCCTTGTGG","GTGTAACCTGTCGGATTATT","561307.5.peg.435","1839"
"24196",360,636,276,"ATGTTGTCGATTGATAGCTC","GTGTAACCTGTCGGATTATT","561307.5.peg.435","1839"
"24197",57,645,588,"TCATTTAAGCTTTGGGCTAA","TGCGTAGGTGTGTAACCTGT","561307.5.peg.435","1839"
"24198",303,645,342,"CGTAATTCTTCGATGCCTTG","TGCGTAGGTGTGTAACCTGT","561307.5.peg.435","1839"
"24199",300,645,345,"AATTCTTCGATGCCTTGTGG","TGCGTAGGTGTGTAACCTGT","561307.5.peg.435","1839"
"24200",360,645,285,"ATGTTGTCGATTGATAGCTC","TGCGTAGGTGTGTAACCTGT","561307.5.peg.435","1839"
"24201",471,645,174,"TAATTACCCCAATTATGCTC","TGCGTAGGTGTGTAACCTGT","561307.5.peg.435","1839"
"24202",276,645,369,"GCATAAGGGAATATTTCATC","TGCGTAGGTGTGTAACCTGT","561307.5.peg.435","1839"
"24203",64,645,581,"AGTTGTTCATTTAAGCTTT","TGCGTAGGTGTGTAACCTGT","561307.5.peg.435","1839"
"24204",290,645,355,"TGCCTTGTGGTGGCGCATAA","TGCGTAGGTGTGTAACCTGT","561307.5.peg.435","1839"
"24205",471,660,189,"TAATTACCCCAATTATGCTC","GTAGTCACTTCTTTATGCGT","561307.5.peg.435","1839"
"24206",300,660,360,"AATTCTTCGATGCCTTGTGG","GTAGTCACTTCTTTATGCGT","561307.5.peg.435","1839"
"24207",276,660,384,"GCATAAGGGAATATTTCATC","GTAGTCACTTCTTTATGCGT","561307.5.peg.435","1839"
"24208",303,660,357,"CGTAATTCTTCGATGCCTTG","GTAGTCACTTCTTTATGCGT","561307.5.peg.435","1839"
"24209",57,660,603,"TCATTTAAGCTTTGGGCTAA","GTAGTCACTTCTTTATGCGT","561307.5.peg.435","1839"
"24210",360,660,300,"ATGTTGTCGATTGATAGCTC","GTAGTCACTTCTTTATGCGT","561307.5.peg.435","1839"
"24211",290,660,370,"TGCCTTGTGGTGGCGCATAA","GTAGTCACTTCTTTATGCGT","561307.5.peg.435","1839"
"24212",64,660,596,"AGTTGTTCATTTAAGCTTT","GTAGTCACTTCTTTATGCGT","561307.5.peg.435","1839"
"24213",530,139,391,"CAGTGATTGTGTATGGAACT","TTTATCTAATGGCTTAGCTG","561307.5.peg.437","1841"
"24214",530,179,351,"CAGTGATTGTGTATGGAACT","CATGGACTTTAGAATATCCA","561307.5.peg.437","1841"
"24215",530,197,333,"CAGTGATTGTGTATGGAACT","CAGTGATTGCATATGGAACA","561307.5.peg.437","1841"
"24216",530,204,326,"CAGTGATTGTGTATGGAACT","CCGTTCACAGTGATTGCATA","561307.5.peg.437","1841"
"24217",139,530,391,"TTTATCTAATGGCTTAGCTG","CAGTGATTGTGTATGGAACT","561307.5.peg.437","1841"
"24218",179,530,351,"CATGGACTTTAGAATATCCA","CAGTGATTGTGTATGGAACT","561307.5.peg.437","1841"
"24219",197,530,333,"CAGTGATTGCATATGGAACA","CAGTGATTGTGTATGGAACT","561307.5.peg.437","1841"
"24220",204,530,326,"CCGTTCACAGTGATTGCATA","CAGTGATTGTGTATGGAACT","561307.5.peg.437","1841"
"24221",366,148,218,"CCGAGTACAGGTGTTTGATA","ATCTTTCTTAGATTCGGCTT","561307.5.peg.438","1842"
"24222",378,148,230,"GATTGAGAACGGCCGAGTAC","ATCTTTCTTAGATTCGGCTT","561307.5.peg.438","1842"
"24223",389,148,241,"TGTCCCACCCTGATTGAGAA","ATCTTTCTTAGATTCGGCTT","561307.5.peg.438","1842"
"24224",366,228,138,"CCGAGTACAGGTGTTTGATA","CGTTTATATTGCCCCCAGTT","561307.5.peg.438","1842"
"24225",378,228,150,"GATTGAGAACGGCCGAGTAC","CGTTTATATTGCCCCCAGTT","561307.5.peg.438","1842"
"24226",389,228,161,"TGTCCCACCCTGATTGAGAA","CGTTTATATTGCCCCCAGTT","561307.5.peg.438","1842"
"24227",148,366,218,"ATCTTTCTTAGATTCGGCTT","CCGAGTACAGGTGTTTGATA","561307.5.peg.438","1842"
"24228",228,366,138,"CGTTTATATTGCCCCCAGTT","CCGAGTACAGGTGTTTGATA","561307.5.peg.438","1842"
"24229",148,378,230,"ATCTTTCTTAGATTCGGCTT","GATTGAGAACGGCCGAGTAC","561307.5.peg.438","1842"
"24230",228,378,150,"CGTTTATATTGCCCCCAGTT","GATTGAGAACGGCCGAGTAC","561307.5.peg.438","1842"
"24231",148,389,241,"ATCTTTCTTAGATTCGGCTT","TGTCCCACCCTGATTGAGAA","561307.5.peg.438","1842"
"24232",228,389,161,"CGTTTATATTGCCCCCAGTT","TGTCCCACCCTGATTGAGAA","561307.5.peg.438","1842"
"24233",120,8,112,"ATCTTTGCAAATGAAGTAGC","GAAGGATAATATTGAAAGGG","561307.5.peg.439","1843"
"24234",344,8,336,"ACTATTCCAATAACCATTT","GAAGGATAATATTGAAAGGG","561307.5.peg.439","1843"
"24235",378,8,370,"TTGAAACTGAATAAGATCC","GAAGGATAATATTGAAAGGG","561307.5.peg.439","1843"
"24236",344,120,224,"ACTATTCCAATAACCATTT","ATCTTTGCAAATGAAGTAGC","561307.5.peg.439","1843"
"24237",8,120,112,"GAAGGATAATATTGAAAGGG","ATCTTTGCAAATGAAGTAGC","561307.5.peg.439","1843"
"24238",378,120,258,"TTGAAACTGAATAAGATCC","ATCTTTGCAAATGAAGTAGC","561307.5.peg.439","1843"
"24239",8,344,336,"GAAGGATAATATTGAAAGGG","ACTATTCCAATAACCATTT","561307.5.peg.439","1843"
"24240",120,344,224,"ATCTTTGCAAATGAAGTAGC","ACTATTCCAATAACCATTT","561307.5.peg.439","1843"
"24241",120,378,258,"ATCTTTGCAAATGAAGTAGC","TTGAAACTGAATAAGATCC","561307.5.peg.439","1843"
"24242",8,378,370,"GAAGGATAATATTGAAAGGG","TTGAAACTGAATAAGATCC","561307.5.peg.439","1843"
"24243",346,93,253,"ATGTATTTGTACGAGTGCTT","TTTCTCAACTCTACTCCATT","561307.5.peg.44","1844"
"24244",267,93,174,"TGCGCGATTGATGGCTGTCC","TTTCTCAACTCTACTCCATT","561307.5.peg.44","1844"
"24245",276,93,183,"TTACTGTCATGCGCGATTGA","TTTCTCAACTCTACTCCATT","561307.5.peg.44","1844"
"24246",402,93,309,"GGTGCTACGACGTCTCCATC","TTTCTCAACTCTACTCCATT","561307.5.peg.44","1844"
"24247",267,130,137,"TGCGCGATTGATGGCTGTCC","GAAGAAATATGTGTTAAAG","561307.5.peg.44","1844"
"24248",276,130,146,"TTACTGTCATGCGCGATTGA","GAAGAAATATGTGTTAAAG","561307.5.peg.44","1844"
"24249",402,130,272,"GGTGCTACGACGTCTCCATC","GAAGAAATATGTGTTAAAG","561307.5.peg.44","1844"
"24250",346,130,216,"ATGTATTTGTACGAGTGCTT","GAAGAAATATGTGTTAAAG","561307.5.peg.44","1844"
"24251",93,267,174,"TTTCTCAACTCTACTCCATT","TGCGCGATTGATGGCTGTCC","561307.5.peg.44","1844"
"24252",402,267,135,"GGTGCTACGACGTCTCCATC","TGCGCGATTGATGGCTGTCC","561307.5.peg.44","1844"
"24253",130,267,137,"GAAGAAATATGTGTTAAAG","TGCGCGATTGATGGCTGTCC","561307.5.peg.44","1844"
"24254",93,276,183,"TTTCTCAACTCTACTCCATT","TTACTGTCATGCGCGATTGA","561307.5.peg.44","1844"
"24255",130,276,146,"GAAGAAATATGTGTTAAAG","TTACTGTCATGCGCGATTGA","561307.5.peg.44","1844"
"24256",402,276,126,"GGTGCTACGACGTCTCCATC","TTACTGTCATGCGCGATTGA","561307.5.peg.44","1844"
"24257",93,346,253,"TTTCTCAACTCTACTCCATT","ATGTATTTGTACGAGTGCTT","561307.5.peg.44","1844"
"24258",130,346,216,"GAAGAAATATGTGTTAAAG","ATGTATTTGTACGAGTGCTT","561307.5.peg.44","1844"
"24259",93,402,309,"TTTCTCAACTCTACTCCATT","GGTGCTACGACGTCTCCATC","561307.5.peg.44","1844"
"24260",130,402,272,"GAAGAAATATGTGTTAAAG","GGTGCTACGACGTCTCCATC","561307.5.peg.44","1844"
"24261",267,402,135,"TGCGCGATTGATGGCTGTCC","GGTGCTACGACGTCTCCATC","561307.5.peg.44","1844"
"24262",276,402,126,"TTACTGTCATGCGCGATTGA","GGTGCTACGACGTCTCCATC","561307.5.peg.44","1844"
"24263",429,206,223,"AGTAATCTAATCGTTCCATG","TTTCTGCAACGATATTGGCG","561307.5.peg.441","1846"
"24264",350,206,144,"CTTTCATATCTGTAGTGCCT","TTTCTGCAACGATATTGGCG","561307.5.peg.441","1846"
"24265",546,206,340,"AATAAATTCCAGATCCAGT","TTTCTGCAACGATATTGGCG","561307.5.peg.441","1846"
"24266",633,206,427,"TTGCATTGTCACCAATAAA","TTTCTGCAACGATATTGGCG","561307.5.peg.441","1846"
"24267",620,206,414,"CAATAAATGGAACTGAGCTA","TTTCTGCAACGATATTGGCG","561307.5.peg.441","1846"
"24268",350,243,107,"CTTTCATATCTGTAGTGCCT","TGACCACTCAATGCGAGTAT","561307.5.peg.441","1846"
"24269",620,243,377,"CAATAAATGGAACTGAGCTA","TGACCACTCAATGCGAGTAT","561307.5.peg.441","1846"
"24270",633,243,390,"TTGCATTGTCACCAATAAA","TGACCACTCAATGCGAGTAT","561307.5.peg.441","1846"
"24271",546,243,303,"AATAAATTCCAGATCCAGT","TGACCACTCAATGCGAGTAT","561307.5.peg.441","1846"
"24272",429,243,186,"AGTAATCTAATCGTTCCATG","TGACCACTCAATGCGAGTAT","561307.5.peg.441","1846"
"24273",206,350,144,"TTTCTGCAACGATATTGGCG","CTTTCATATCTGTAGTGCCT","561307.5.peg.441","1846"
"24274",546,350,196,"AATAAATTCCAGATCCAGT","CTTTCATATCTGTAGTGCCT","561307.5.peg.441","1846"
"24275",633,350,283,"TTGCATTGTCACCAATAAA","CTTTCATATCTGTAGTGCCT","561307.5.peg.441","1846"
"24276",243,350,107,"TGACCACTCAATGCGAGTAT","CTTTCATATCTGTAGTGCCT","561307.5.peg.441","1846"
"24277",620,350,270,"CAATAAATGGAACTGAGCTA","CTTTCATATCTGTAGTGCCT","561307.5.peg.441","1846"
"24278",206,429,223,"TTTCTGCAACGATATTGGCG","AGTAATCTAATCGTTCCATG","561307.5.peg.441","1846"
"24279",243,429,186,"TGACCACTCAATGCGAGTAT","AGTAATCTAATCGTTCCATG","561307.5.peg.441","1846"
"24280",620,429,191,"CAATAAATGGAACTGAGCTA","AGTAATCTAATCGTTCCATG","561307.5.peg.441","1846"
"24281",546,429,117,"AATAAATTCCAGATCCAGT","AGTAATCTAATCGTTCCATG","561307.5.peg.441","1846"
"24282",633,429,204,"TTGCATTGTCACCAATAAA","AGTAATCTAATCGTTCCATG","561307.5.peg.441","1846"
"24283",206,546,340,"TTTCTGCAACGATATTGGCG","AATAAATTCCAGATCCAGT","561307.5.peg.441","1846"
"24284",243,546,303,"TGACCACTCAATGCGAGTAT","AATAAATTCCAGATCCAGT","561307.5.peg.441","1846"
"24285",429,546,117,"AGTAATCTAATCGTTCCATG","AATAAATTCCAGATCCAGT","561307.5.peg.441","1846"
"24286",350,546,196,"CTTTCATATCTGTAGTGCCT","AATAAATTCCAGATCCAGT","561307.5.peg.441","1846"
"24287",243,620,377,"TGACCACTCAATGCGAGTAT","CAATAAATGGAACTGAGCTA","561307.5.peg.441","1846"
"24288",206,620,414,"TTTCTGCAACGATATTGGCG","CAATAAATGGAACTGAGCTA","561307.5.peg.441","1846"
"24289",350,620,270,"CTTTCATATCTGTAGTGCCT","CAATAAATGGAACTGAGCTA","561307.5.peg.441","1846"
"24290",429,620,191,"AGTAATCTAATCGTTCCATG","CAATAAATGGAACTGAGCTA","561307.5.peg.441","1846"
"24291",206,633,427,"TTTCTGCAACGATATTGGCG","TTGCATTGTCACCAATAAA","561307.5.peg.441","1846"
"24292",243,633,390,"TGACCACTCAATGCGAGTAT","TTGCATTGTCACCAATAAA","561307.5.peg.441","1846"
"24293",350,633,283,"CTTTCATATCTGTAGTGCCT","TTGCATTGTCACCAATAAA","561307.5.peg.441","1846"
"24294",429,633,204,"AGTAATCTAATCGTTCCATG","TTGCATTGTCACCAATAAA","561307.5.peg.441","1846"
"24295",390,214,176,"ATTAGCTTAATAACACCACC","CTGTGATCCTATATCAACTG","561307.5.peg.444","1849"
"24296",390,216,174,"ATTAGCTTAATAACACCACC","AACTGTGATCCTATATCAAC","561307.5.peg.444","1849"
"24297",214,390,176,"CTGTGATCCTATATCAACTG","ATTAGCTTAATAACACCACC","561307.5.peg.444","1849"
"24298",216,390,174,"AACTGTGATCCTATATCAAC","ATTAGCTTAATAACACCACC","561307.5.peg.444","1849"
"24299",383,11,372,"TACCTTGTCGTAAACCAACT","AACACAACTAAACAAATGG","561307.5.peg.448","1853"
"24300",648,11,637,"TCTGAATCAGTAACCATATA","AACACAACTAAACAAATGG","561307.5.peg.448","1853"
"24301",11,383,372,"AACACAACTAAACAAATGG","TACCTTGTCGTAAACCAACT","561307.5.peg.448","1853"
"24302",648,383,265,"TCTGAATCAGTAACCATATA","TACCTTGTCGTAAACCAACT","561307.5.peg.448","1853"
"24303",11,648,637,"AACACAACTAAACAAATGG","TCTGAATCAGTAACCATATA","561307.5.peg.448","1853"
"24304",383,648,265,"TACCTTGTCGTAAACCAACT","TCTGAATCAGTAACCATATA","561307.5.peg.448","1853"
"24305",297,135,162,"GCAAATCCAAGCAATGCCCA","TGCCACTATATTGTACAAA","561307.5.peg.450","1856"
"24306",135,297,162,"TGCCACTATATTGTACAAA","GCAAATCCAAGCAATGCCCA","561307.5.peg.450","1856"
"24307",393,246,147,"TCTGGATCTGGTTTAGGATT","CCCGTTTGATTTGATTCGTG","561307.5.peg.451","1857"
"24308",626,246,380,"GTTGATCGGGATCTGGTGAC","CCCGTTTGATTTGATTCGTG","561307.5.peg.451","1857"
"24309",633,246,387,"TCCCCAGGTTGATCGGGATC","CCCGTTTGATTTGATTCGTG","561307.5.peg.451","1857"
"24310",621,246,375,"TCGGGATCTGGTGACGGGTT","CCCGTTTGATTTGATTCGTG","561307.5.peg.451","1857"
"24311",497,246,251,"TTGGATCTGGATTTGGTTTC","CCCGTTTGATTTGATTCGTG","561307.5.peg.451","1857"
"24312",615,246,369,"TCTGGTGACGGGTTAGGATT","CCCGTTTGATTTGATTCGTG","561307.5.peg.451","1857"
"24313",399,246,153,"GGGTTATCTGGATCTGGTTT","CCCGTTTGATTTGATTCGTG","561307.5.peg.451","1857"
"24314",648,246,402,"CCAGAATGATTGGAATCCCC","CCCGTTTGATTTGATTCGTG","561307.5.peg.451","1857"
"24315",639,246,393,"TTGGAATCCCCAGGTTGATC","CCCGTTTGATTTGATTCGTG","561307.5.peg.451","1857"
"24316",561,246,315,"GGCTTTGGTTTATCTGGATC","CCCGTTTGATTTGATTCGTG","561307.5.peg.451","1857"
"24317",648,393,255,"CCAGAATGATTGGAATCCCC","TCTGGATCTGGTTTAGGATT","561307.5.peg.451","1857"
"24318",621,393,228,"TCGGGATCTGGTGACGGGTT","TCTGGATCTGGTTTAGGATT","561307.5.peg.451","1857"
"24319",561,393,168,"GGCTTTGGTTTATCTGGATC","TCTGGATCTGGTTTAGGATT","561307.5.peg.451","1857"
"24320",246,393,147,"CCCGTTTGATTTGATTCGTG","TCTGGATCTGGTTTAGGATT","561307.5.peg.451","1857"
"24321",615,393,222,"TCTGGTGACGGGTTAGGATT","TCTGGATCTGGTTTAGGATT","561307.5.peg.451","1857"
"24322",633,393,240,"TCCCCAGGTTGATCGGGATC","TCTGGATCTGGTTTAGGATT","561307.5.peg.451","1857"
"24323",626,393,233,"GTTGATCGGGATCTGGTGAC","TCTGGATCTGGTTTAGGATT","561307.5.peg.451","1857"
"24324",497,393,104,"TTGGATCTGGATTTGGTTTC","TCTGGATCTGGTTTAGGATT","561307.5.peg.451","1857"
"24325",639,393,246,"TTGGAATCCCCAGGTTGATC","TCTGGATCTGGTTTAGGATT","561307.5.peg.451","1857"
"24326",246,399,153,"CCCGTTTGATTTGATTCGTG","GGGTTATCTGGATCTGGTTT","561307.5.peg.451","1857"
"24327",621,399,222,"TCGGGATCTGGTGACGGGTT","GGGTTATCTGGATCTGGTTT","561307.5.peg.451","1857"
"24328",615,399,216,"TCTGGTGACGGGTTAGGATT","GGGTTATCTGGATCTGGTTT","561307.5.peg.451","1857"
"24329",561,399,162,"GGCTTTGGTTTATCTGGATC","GGGTTATCTGGATCTGGTTT","561307.5.peg.451","1857"
"24330",626,399,227,"GTTGATCGGGATCTGGTGAC","GGGTTATCTGGATCTGGTTT","561307.5.peg.451","1857"
"24331",633,399,234,"TCCCCAGGTTGATCGGGATC","GGGTTATCTGGATCTGGTTT","561307.5.peg.451","1857"
"24332",639,399,240,"TTGGAATCCCCAGGTTGATC","GGGTTATCTGGATCTGGTTT","561307.5.peg.451","1857"
"24333",648,399,249,"CCAGAATGATTGGAATCCCC","GGGTTATCTGGATCTGGTTT","561307.5.peg.451","1857"
"24334",633,497,136,"TCCCCAGGTTGATCGGGATC","TTGGATCTGGATTTGGTTTC","561307.5.peg.451","1857"
"24335",615,497,118,"TCTGGTGACGGGTTAGGATT","TTGGATCTGGATTTGGTTTC","561307.5.peg.451","1857"
"24336",648,497,151,"CCAGAATGATTGGAATCCCC","TTGGATCTGGATTTGGTTTC","561307.5.peg.451","1857"
"24337",393,497,104,"TCTGGATCTGGTTTAGGATT","TTGGATCTGGATTTGGTTTC","561307.5.peg.451","1857"
"24338",246,497,251,"CCCGTTTGATTTGATTCGTG","TTGGATCTGGATTTGGTTTC","561307.5.peg.451","1857"
"24339",626,497,129,"GTTGATCGGGATCTGGTGAC","TTGGATCTGGATTTGGTTTC","561307.5.peg.451","1857"
"24340",639,497,142,"TTGGAATCCCCAGGTTGATC","TTGGATCTGGATTTGGTTTC","561307.5.peg.451","1857"
"24341",621,497,124,"TCGGGATCTGGTGACGGGTT","TTGGATCTGGATTTGGTTTC","561307.5.peg.451","1857"
"24342",399,561,162,"GGGTTATCTGGATCTGGTTT","GGCTTTGGTTTATCTGGATC","561307.5.peg.451","1857"
"24343",393,561,168,"TCTGGATCTGGTTTAGGATT","GGCTTTGGTTTATCTGGATC","561307.5.peg.451","1857"
"24344",246,561,315,"CCCGTTTGATTTGATTCGTG","GGCTTTGGTTTATCTGGATC","561307.5.peg.451","1857"
"24345",399,615,216,"GGGTTATCTGGATCTGGTTT","TCTGGTGACGGGTTAGGATT","561307.5.peg.451","1857"
"24346",246,615,369,"CCCGTTTGATTTGATTCGTG","TCTGGTGACGGGTTAGGATT","561307.5.peg.451","1857"
"24347",497,615,118,"TTGGATCTGGATTTGGTTTC","TCTGGTGACGGGTTAGGATT","561307.5.peg.451","1857"
"24348",393,615,222,"TCTGGATCTGGTTTAGGATT","TCTGGTGACGGGTTAGGATT","561307.5.peg.451","1857"
"24349",393,621,228,"TCTGGATCTGGTTTAGGATT","TCGGGATCTGGTGACGGGTT","561307.5.peg.451","1857"
"24350",497,621,124,"TTGGATCTGGATTTGGTTTC","TCGGGATCTGGTGACGGGTT","561307.5.peg.451","1857"
"24351",399,621,222,"GGGTTATCTGGATCTGGTTT","TCGGGATCTGGTGACGGGTT","561307.5.peg.451","1857"
"24352",246,621,375,"CCCGTTTGATTTGATTCGTG","TCGGGATCTGGTGACGGGTT","561307.5.peg.451","1857"
"24353",399,626,227,"GGGTTATCTGGATCTGGTTT","GTTGATCGGGATCTGGTGAC","561307.5.peg.451","1857"
"24354",246,626,380,"CCCGTTTGATTTGATTCGTG","GTTGATCGGGATCTGGTGAC","561307.5.peg.451","1857"
"24355",393,626,233,"TCTGGATCTGGTTTAGGATT","GTTGATCGGGATCTGGTGAC","561307.5.peg.451","1857"
"24356",497,626,129,"TTGGATCTGGATTTGGTTTC","GTTGATCGGGATCTGGTGAC","561307.5.peg.451","1857"
"24357",393,633,240,"TCTGGATCTGGTTTAGGATT","TCCCCAGGTTGATCGGGATC","561307.5.peg.451","1857"
"24358",399,633,234,"GGGTTATCTGGATCTGGTTT","TCCCCAGGTTGATCGGGATC","561307.5.peg.451","1857"
"24359",497,633,136,"TTGGATCTGGATTTGGTTTC","TCCCCAGGTTGATCGGGATC","561307.5.peg.451","1857"
"24360",246,633,387,"CCCGTTTGATTTGATTCGTG","TCCCCAGGTTGATCGGGATC","561307.5.peg.451","1857"
"24361",393,639,246,"TCTGGATCTGGTTTAGGATT","TTGGAATCCCCAGGTTGATC","561307.5.peg.451","1857"
"24362",497,639,142,"TTGGATCTGGATTTGGTTTC","TTGGAATCCCCAGGTTGATC","561307.5.peg.451","1857"
"24363",399,639,240,"GGGTTATCTGGATCTGGTTT","TTGGAATCCCCAGGTTGATC","561307.5.peg.451","1857"
"24364",246,639,393,"CCCGTTTGATTTGATTCGTG","TTGGAATCCCCAGGTTGATC","561307.5.peg.451","1857"
"24365",393,648,255,"TCTGGATCTGGTTTAGGATT","CCAGAATGATTGGAATCCCC","561307.5.peg.451","1857"
"24366",497,648,151,"TTGGATCTGGATTTGGTTTC","CCAGAATGATTGGAATCCCC","561307.5.peg.451","1857"
"24367",399,648,249,"GGGTTATCTGGATCTGGTTT","CCAGAATGATTGGAATCCCC","561307.5.peg.451","1857"
"24368",246,648,402,"CCCGTTTGATTTGATTCGTG","CCAGAATGATTGGAATCCCC","561307.5.peg.451","1857"
"24369",356,168,188,"TGTCGTATTCATTAATCAGC","TAGCCATTATTCCACATTTC","561307.5.peg.453","1859"
"24370",393,168,225,"ATTCATGCTCTCTTAACAT","TAGCCATTATTCCACATTTC","561307.5.peg.453","1859"
"24371",168,356,188,"TAGCCATTATTCCACATTTC","TGTCGTATTCATTAATCAGC","561307.5.peg.453","1859"
"24372",168,393,225,"TAGCCATTATTCCACATTTC","ATTCATGCTCTCTTAACAT","561307.5.peg.453","1859"
"24373",357,140,217,"TCGGGTATTTCGATACTAAT","GATATTGACATAATCATGA","561307.5.peg.457","1863"
"24374",357,201,156,"TCGGGTATTTCGATACTAAT","TTGAAATAATCACGTAGGCC","561307.5.peg.457","1863"
"24375",140,357,217,"GATATTGACATAATCATGA","TCGGGTATTTCGATACTAAT","561307.5.peg.457","1863"
"24376",201,357,156,"TTGAAATAATCACGTAGGCC","TCGGGTATTTCGATACTAAT","561307.5.peg.457","1863"
"24377",151,33,118,"ATAAGGATTATCAGTTGCGA","TCATACATTCACATCCTTA","561307.5.peg.458","1864"
"24378",138,33,105,"GTTGCGAGGGCAATTTCCAT","TCATACATTCACATCCTTA","561307.5.peg.458","1864"
"24379",387,33,354,"ATTCGAGTTCTTAATTCAGC","TCATACATTCACATCCTTA","561307.5.peg.458","1864"
"24380",168,33,135,"GCTTGCTCAAGCACCTCATA","TCATACATTCACATCCTTA","561307.5.peg.458","1864"
"24381",33,138,105,"TCATACATTCACATCCTTA","GTTGCGAGGGCAATTTCCAT","561307.5.peg.458","1864"
"24382",387,138,249,"ATTCGAGTTCTTAATTCAGC","GTTGCGAGGGCAATTTCCAT","561307.5.peg.458","1864"
"24383",33,151,118,"TCATACATTCACATCCTTA","ATAAGGATTATCAGTTGCGA","561307.5.peg.458","1864"
"24384",387,151,236,"ATTCGAGTTCTTAATTCAGC","ATAAGGATTATCAGTTGCGA","561307.5.peg.458","1864"
"24385",33,168,135,"TCATACATTCACATCCTTA","GCTTGCTCAAGCACCTCATA","561307.5.peg.458","1864"
"24386",387,168,219,"ATTCGAGTTCTTAATTCAGC","GCTTGCTCAAGCACCTCATA","561307.5.peg.458","1864"
"24387",33,387,354,"TCATACATTCACATCCTTA","ATTCGAGTTCTTAATTCAGC","561307.5.peg.458","1864"
"24388",138,387,249,"GTTGCGAGGGCAATTTCCAT","ATTCGAGTTCTTAATTCAGC","561307.5.peg.458","1864"
"24389",151,387,236,"ATAAGGATTATCAGTTGCGA","ATTCGAGTTCTTAATTCAGC","561307.5.peg.458","1864"
"24390",168,387,219,"GCTTGCTCAAGCACCTCATA","ATTCGAGTTCTTAATTCAGC","561307.5.peg.458","1864"
"24391",375,159,216,"TCAAATAACATATCAGCAGA","ACTGTACAAGCTACATTGCA","561307.5.peg.459","1865"
"24392",474,159,315,"TGATAATGTGCATCTCTCAT","ACTGTACAAGCTACATTGCA","561307.5.peg.459","1865"
"24393",159,375,216,"ACTGTACAAGCTACATTGCA","TCAAATAACATATCAGCAGA","561307.5.peg.459","1865"
"24394",159,474,315,"ACTGTACAAGCTACATTGCA","TGATAATGTGCATCTCTCAT","561307.5.peg.459","1865"
"24395",248,55,193,"AGCCATGTACTGCGCCTAAT","ACGTTCTTCTCTAGTCCATT","561307.5.peg.460","1867"
"24396",339,55,284,"TGGCTGTCATATTTAGTATC","ACGTTCTTCTCTAGTCCATT","561307.5.peg.460","1867"
"24397",359,55,304,"CGCTACCGCTATATACACCA","ACGTTCTTCTCTAGTCCATT","561307.5.peg.460","1867"
"24398",171,55,116,"CATTTAATAAGCCTGTTTC","ACGTTCTTCTCTAGTCCATT","561307.5.peg.460","1867"
"24399",510,55,455,"TCTGGTTGTTGGCTAATTAC","ACGTTCTTCTCTAGTCCATT","561307.5.peg.460","1867"
"24400",528,55,473,"AAATGACTCGTATATCCTTC","ACGTTCTTCTCTAGTCCATT","561307.5.peg.460","1867"
"24401",359,171,188,"CGCTACCGCTATATACACCA","CATTTAATAAGCCTGTTTC","561307.5.peg.460","1867"
"24402",55,171,116,"ACGTTCTTCTCTAGTCCATT","CATTTAATAAGCCTGTTTC","561307.5.peg.460","1867"
"24403",339,171,168,"TGGCTGTCATATTTAGTATC","CATTTAATAAGCCTGTTTC","561307.5.peg.460","1867"
"24404",510,171,339,"TCTGGTTGTTGGCTAATTAC","CATTTAATAAGCCTGTTTC","561307.5.peg.460","1867"
"24405",528,171,357,"AAATGACTCGTATATCCTTC","CATTTAATAAGCCTGTTTC","561307.5.peg.460","1867"
"24406",55,248,193,"ACGTTCTTCTCTAGTCCATT","AGCCATGTACTGCGCCTAAT","561307.5.peg.460","1867"
"24407",359,248,111,"CGCTACCGCTATATACACCA","AGCCATGTACTGCGCCTAAT","561307.5.peg.460","1867"
"24408",528,248,280,"AAATGACTCGTATATCCTTC","AGCCATGTACTGCGCCTAAT","561307.5.peg.460","1867"
"24409",510,248,262,"TCTGGTTGTTGGCTAATTAC","AGCCATGTACTGCGCCTAAT","561307.5.peg.460","1867"
"24410",55,339,284,"ACGTTCTTCTCTAGTCCATT","TGGCTGTCATATTTAGTATC","561307.5.peg.460","1867"
"24411",528,339,189,"AAATGACTCGTATATCCTTC","TGGCTGTCATATTTAGTATC","561307.5.peg.460","1867"
"24412",171,339,168,"CATTTAATAAGCCTGTTTC","TGGCTGTCATATTTAGTATC","561307.5.peg.460","1867"
"24413",510,339,171,"TCTGGTTGTTGGCTAATTAC","TGGCTGTCATATTTAGTATC","561307.5.peg.460","1867"
"24414",510,359,151,"TCTGGTTGTTGGCTAATTAC","CGCTACCGCTATATACACCA","561307.5.peg.460","1867"
"24415",171,359,188,"CATTTAATAAGCCTGTTTC","CGCTACCGCTATATACACCA","561307.5.peg.460","1867"
"24416",55,359,304,"ACGTTCTTCTCTAGTCCATT","CGCTACCGCTATATACACCA","561307.5.peg.460","1867"
"24417",248,359,111,"AGCCATGTACTGCGCCTAAT","CGCTACCGCTATATACACCA","561307.5.peg.460","1867"
"24418",528,359,169,"AAATGACTCGTATATCCTTC","CGCTACCGCTATATACACCA","561307.5.peg.460","1867"
"24419",55,510,455,"ACGTTCTTCTCTAGTCCATT","TCTGGTTGTTGGCTAATTAC","561307.5.peg.460","1867"
"24420",171,510,339,"CATTTAATAAGCCTGTTTC","TCTGGTTGTTGGCTAATTAC","561307.5.peg.460","1867"
"24421",248,510,262,"AGCCATGTACTGCGCCTAAT","TCTGGTTGTTGGCTAATTAC","561307.5.peg.460","1867"
"24422",359,510,151,"CGCTACCGCTATATACACCA","TCTGGTTGTTGGCTAATTAC","561307.5.peg.460","1867"
"24423",339,510,171,"TGGCTGTCATATTTAGTATC","TCTGGTTGTTGGCTAATTAC","561307.5.peg.460","1867"
"24424",171,528,357,"CATTTAATAAGCCTGTTTC","AAATGACTCGTATATCCTTC","561307.5.peg.460","1867"
"24425",339,528,189,"TGGCTGTCATATTTAGTATC","AAATGACTCGTATATCCTTC","561307.5.peg.460","1867"
"24426",248,528,280,"AGCCATGTACTGCGCCTAAT","AAATGACTCGTATATCCTTC","561307.5.peg.460","1867"
"24427",55,528,473,"ACGTTCTTCTCTAGTCCATT","AAATGACTCGTATATCCTTC","561307.5.peg.460","1867"
"24428",359,528,169,"CGCTACCGCTATATACACCA","AAATGACTCGTATATCCTTC","561307.5.peg.460","1867"
"24429",468,320,148,"CCCCAAACCCAATGTGCTAC","ACAAAGCGAAAGGAATATGT","561307.5.peg.462","1869"
"24430",320,468,148,"ACAAAGCGAAAGGAATATGT","CCCCAAACCCAATGTGCTAC","561307.5.peg.462","1869"
"24431",627,424,203,"CTAAATCTAAGTGGTTAGT","TTCGATAAAGATTCATAAC","561307.5.peg.466","1873"
"24432",904,424,480,"CATTCCACTTGTTGAAGCAC","TTCGATAAAGATTCATAAC","561307.5.peg.466","1873"
"24433",635,424,211,"TGTCGTTTCTAAATCTAAG","TTCGATAAAGATTCATAAC","561307.5.peg.466","1873"
"24434",424,627,203,"TTCGATAAAGATTCATAAC","CTAAATCTAAGTGGTTAGT","561307.5.peg.466","1873"
"24435",904,627,277,"CATTCCACTTGTTGAAGCAC","CTAAATCTAAGTGGTTAGT","561307.5.peg.466","1873"
"24436",424,635,211,"TTCGATAAAGATTCATAAC","TGTCGTTTCTAAATCTAAG","561307.5.peg.466","1873"
"24437",904,635,269,"CATTCCACTTGTTGAAGCAC","TGTCGTTTCTAAATCTAAG","561307.5.peg.466","1873"
"24438",635,904,269,"TGTCGTTTCTAAATCTAAG","CATTCCACTTGTTGAAGCAC","561307.5.peg.466","1873"
"24439",627,904,277,"CTAAATCTAAGTGGTTAGT","CATTCCACTTGTTGAAGCAC","561307.5.peg.466","1873"
"24440",424,904,480,"TTCGATAAAGATTCATAAC","CATTCCACTTGTTGAAGCAC","561307.5.peg.466","1873"
"24441",364,207,157,"TGAAAGCATTCCACGTAAAC","TCATAGTCGAAATGTGAGTT","561307.5.peg.467","1874"
"24442",483,207,276,"GTGATTTGGTCTGGAAATGT","TCATAGTCGAAATGTGAGTT","561307.5.peg.467","1874"
"24443",492,207,285,"TTTACCGGTGTGATTTGGTC","TCATAGTCGAAATGTGAGTT","561307.5.peg.467","1874"
"24444",483,364,119,"GTGATTTGGTCTGGAAATGT","TGAAAGCATTCCACGTAAAC","561307.5.peg.467","1874"
"24445",207,364,157,"TCATAGTCGAAATGTGAGTT","TGAAAGCATTCCACGTAAAC","561307.5.peg.467","1874"
"24446",492,364,128,"TTTACCGGTGTGATTTGGTC","TGAAAGCATTCCACGTAAAC","561307.5.peg.467","1874"
"24447",207,483,276,"TCATAGTCGAAATGTGAGTT","GTGATTTGGTCTGGAAATGT","561307.5.peg.467","1874"
"24448",364,483,119,"TGAAAGCATTCCACGTAAAC","GTGATTTGGTCTGGAAATGT","561307.5.peg.467","1874"
"24449",364,492,128,"TGAAAGCATTCCACGTAAAC","TTTACCGGTGTGATTTGGTC","561307.5.peg.467","1874"
"24450",207,492,285,"TCATAGTCGAAATGTGAGTT","TTTACCGGTGTGATTTGGTC","561307.5.peg.467","1874"
"24451",192,10,182,"TGATGTCTACTTGCCACTTC","TGAGGACGCAATGGTTATGT","561307.5.peg.468","1875"
"24452",432,10,422,"GCAATTAGCGGGAATGTTAA","TGAGGACGCAATGGTTATGT","561307.5.peg.468","1875"
"24453",305,10,295,"GTAACGCACCAATTAGTCCA","TGAGGACGCAATGGTTATGT","561307.5.peg.468","1875"
"24454",286,10,276,"AGGGCCTTCTGTAACCGCTA","TGAGGACGCAATGGTTATGT","561307.5.peg.468","1875"
"24455",375,10,365,"TATGATGAACAGGAATAAG","TGAGGACGCAATGGTTATGT","561307.5.peg.468","1875"
"24456",286,19,267,"AGGGCCTTCTGTAACCGCTA","TGGTGAAGGTGAGGACGCAA","561307.5.peg.468","1875"
"24457",305,19,286,"GTAACGCACCAATTAGTCCA","TGGTGAAGGTGAGGACGCAA","561307.5.peg.468","1875"
"24458",192,19,173,"TGATGTCTACTTGCCACTTC","TGGTGAAGGTGAGGACGCAA","561307.5.peg.468","1875"
"24459",375,19,356,"TATGATGAACAGGAATAAG","TGGTGAAGGTGAGGACGCAA","561307.5.peg.468","1875"
"24460",432,19,413,"GCAATTAGCGGGAATGTTAA","TGGTGAAGGTGAGGACGCAA","561307.5.peg.468","1875"
"24461",305,28,277,"GTAACGCACCAATTAGTCCA","AATTATTATGGTGAAGGTG","561307.5.peg.468","1875"
"24462",375,28,347,"TATGATGAACAGGAATAAG","AATTATTATGGTGAAGGTG","561307.5.peg.468","1875"
"24463",286,28,258,"AGGGCCTTCTGTAACCGCTA","AATTATTATGGTGAAGGTG","561307.5.peg.468","1875"
"24464",432,28,404,"GCAATTAGCGGGAATGTTAA","AATTATTATGGTGAAGGTG","561307.5.peg.468","1875"
"24465",192,28,164,"TGATGTCTACTTGCCACTTC","AATTATTATGGTGAAGGTG","561307.5.peg.468","1875"
"24466",10,192,182,"TGAGGACGCAATGGTTATGT","TGATGTCTACTTGCCACTTC","561307.5.peg.468","1875"
"24467",432,192,240,"GCAATTAGCGGGAATGTTAA","TGATGTCTACTTGCCACTTC","561307.5.peg.468","1875"
"24468",305,192,113,"GTAACGCACCAATTAGTCCA","TGATGTCTACTTGCCACTTC","561307.5.peg.468","1875"
"24469",19,192,173,"TGGTGAAGGTGAGGACGCAA","TGATGTCTACTTGCCACTTC","561307.5.peg.468","1875"
"24470",375,192,183,"TATGATGAACAGGAATAAG","TGATGTCTACTTGCCACTTC","561307.5.peg.468","1875"
"24471",28,192,164,"AATTATTATGGTGAAGGTG","TGATGTCTACTTGCCACTTC","561307.5.peg.468","1875"
"24472",28,286,258,"AATTATTATGGTGAAGGTG","AGGGCCTTCTGTAACCGCTA","561307.5.peg.468","1875"
"24473",10,286,276,"TGAGGACGCAATGGTTATGT","AGGGCCTTCTGTAACCGCTA","561307.5.peg.468","1875"
"24474",432,286,146,"GCAATTAGCGGGAATGTTAA","AGGGCCTTCTGTAACCGCTA","561307.5.peg.468","1875"
"24475",19,286,267,"TGGTGAAGGTGAGGACGCAA","AGGGCCTTCTGTAACCGCTA","561307.5.peg.468","1875"
"24476",192,305,113,"TGATGTCTACTTGCCACTTC","GTAACGCACCAATTAGTCCA","561307.5.peg.468","1875"
"24477",28,305,277,"AATTATTATGGTGAAGGTG","GTAACGCACCAATTAGTCCA","561307.5.peg.468","1875"
"24478",10,305,295,"TGAGGACGCAATGGTTATGT","GTAACGCACCAATTAGTCCA","561307.5.peg.468","1875"
"24479",19,305,286,"TGGTGAAGGTGAGGACGCAA","GTAACGCACCAATTAGTCCA","561307.5.peg.468","1875"
"24480",432,305,127,"GCAATTAGCGGGAATGTTAA","GTAACGCACCAATTAGTCCA","561307.5.peg.468","1875"
"24481",10,375,365,"TGAGGACGCAATGGTTATGT","TATGATGAACAGGAATAAG","561307.5.peg.468","1875"
"24482",28,375,347,"AATTATTATGGTGAAGGTG","TATGATGAACAGGAATAAG","561307.5.peg.468","1875"
"24483",192,375,183,"TGATGTCTACTTGCCACTTC","TATGATGAACAGGAATAAG","561307.5.peg.468","1875"
"24484",19,375,356,"TGGTGAAGGTGAGGACGCAA","TATGATGAACAGGAATAAG","561307.5.peg.468","1875"
"24485",10,432,422,"TGAGGACGCAATGGTTATGT","GCAATTAGCGGGAATGTTAA","561307.5.peg.468","1875"
"24486",305,432,127,"GTAACGCACCAATTAGTCCA","GCAATTAGCGGGAATGTTAA","561307.5.peg.468","1875"
"24487",19,432,413,"TGGTGAAGGTGAGGACGCAA","GCAATTAGCGGGAATGTTAA","561307.5.peg.468","1875"
"24488",192,432,240,"TGATGTCTACTTGCCACTTC","GCAATTAGCGGGAATGTTAA","561307.5.peg.468","1875"
"24489",286,432,146,"AGGGCCTTCTGTAACCGCTA","GCAATTAGCGGGAATGTTAA","561307.5.peg.468","1875"
"24490",28,432,404,"AATTATTATGGTGAAGGTG","GCAATTAGCGGGAATGTTAA","561307.5.peg.468","1875"
"24491",108,8,100,"CGCTCAAGATCAAAGACTTG","ATACCATAAATTAGCTGAGG","561307.5.peg.469","1876"
"24492",8,108,100,"ATACCATAAATTAGCTGAGG","CGCTCAAGATCAAAGACTTG","561307.5.peg.469","1876"
"24493",171,49,122,"TCAAATAGCTGACTAATCGC","ATCAATGAGCAGCGAATTCA","561307.5.peg.470","1878"
"24494",49,171,122,"ATCAATGAGCAGCGAATTCA","TCAAATAGCTGACTAATCGC","561307.5.peg.470","1878"
"24495",614,132,482,"CAGCACATGAACCACAAGTA","ATGGTTTGTTCATATCAGT","561307.5.peg.472","1880"
"24496",445,132,313,"AGCTGGTACGTTTGTCCTCA","ATGGTTTGTTCATATCAGT","561307.5.peg.472","1880"
"24497",792,132,660,"TCGCGAGTAACGATATCACG","ATGGTTTGTTCATATCAGT","561307.5.peg.472","1880"
"24498",693,132,561,"GCAAGTGCAGTACCGTTGTA","ATGGTTTGTTCATATCAGT","561307.5.peg.472","1880"
"24499",330,132,198,"TCTGCAATAATTTCACGTGA","ATGGTTTGTTCATATCAGT","561307.5.peg.472","1880"
"24500",610,132,478,"ACATGAACCACAAGTAGGGC","ATGGTTTGTTCATATCAGT","561307.5.peg.472","1880"
"24501",247,132,115,"GAATTCAAATGGAATGGCAC","ATGGTTTGTTCATATCAGT","561307.5.peg.472","1880"
"24502",486,132,354,"GCAGATAAGCCAGCTTTCAT","ATGGTTTGTTCATATCAGT","561307.5.peg.472","1880"
"24503",610,189,421,"ACATGAACCACAAGTAGGGC","TCTCTCAAGTGAACATGTCC","561307.5.peg.472","1880"
"24504",486,189,297,"GCAGATAAGCCAGCTTTCAT","TCTCTCAAGTGAACATGTCC","561307.5.peg.472","1880"
"24505",330,189,141,"TCTGCAATAATTTCACGTGA","TCTCTCAAGTGAACATGTCC","561307.5.peg.472","1880"
"24506",792,189,603,"TCGCGAGTAACGATATCACG","TCTCTCAAGTGAACATGTCC","561307.5.peg.472","1880"
"24507",445,189,256,"AGCTGGTACGTTTGTCCTCA","TCTCTCAAGTGAACATGTCC","561307.5.peg.472","1880"
"24508",614,189,425,"CAGCACATGAACCACAAGTA","TCTCTCAAGTGAACATGTCC","561307.5.peg.472","1880"
"24509",693,189,504,"GCAAGTGCAGTACCGTTGTA","TCTCTCAAGTGAACATGTCC","561307.5.peg.472","1880"
"24510",132,247,115,"ATGGTTTGTTCATATCAGT","GAATTCAAATGGAATGGCAC","561307.5.peg.472","1880"
"24511",486,247,239,"GCAGATAAGCCAGCTTTCAT","GAATTCAAATGGAATGGCAC","561307.5.peg.472","1880"
"24512",610,247,363,"ACATGAACCACAAGTAGGGC","GAATTCAAATGGAATGGCAC","561307.5.peg.472","1880"
"24513",792,247,545,"TCGCGAGTAACGATATCACG","GAATTCAAATGGAATGGCAC","561307.5.peg.472","1880"
"24514",445,247,198,"AGCTGGTACGTTTGTCCTCA","GAATTCAAATGGAATGGCAC","561307.5.peg.472","1880"
"24515",614,247,367,"CAGCACATGAACCACAAGTA","GAATTCAAATGGAATGGCAC","561307.5.peg.472","1880"
"24516",693,247,446,"GCAAGTGCAGTACCGTTGTA","GAATTCAAATGGAATGGCAC","561307.5.peg.472","1880"
"24517",792,330,462,"TCGCGAGTAACGATATCACG","TCTGCAATAATTTCACGTGA","561307.5.peg.472","1880"
"24518",132,330,198,"ATGGTTTGTTCATATCAGT","TCTGCAATAATTTCACGTGA","561307.5.peg.472","1880"
"24519",445,330,115,"AGCTGGTACGTTTGTCCTCA","TCTGCAATAATTTCACGTGA","561307.5.peg.472","1880"
"24520",189,330,141,"TCTCTCAAGTGAACATGTCC","TCTGCAATAATTTCACGTGA","561307.5.peg.472","1880"
"24521",486,330,156,"GCAGATAAGCCAGCTTTCAT","TCTGCAATAATTTCACGTGA","561307.5.peg.472","1880"
"24522",693,330,363,"GCAAGTGCAGTACCGTTGTA","TCTGCAATAATTTCACGTGA","561307.5.peg.472","1880"
"24523",614,330,284,"CAGCACATGAACCACAAGTA","TCTGCAATAATTTCACGTGA","561307.5.peg.472","1880"
"24524",610,330,280,"ACATGAACCACAAGTAGGGC","TCTGCAATAATTTCACGTGA","561307.5.peg.472","1880"
"24525",189,445,256,"TCTCTCAAGTGAACATGTCC","AGCTGGTACGTTTGTCCTCA","561307.5.peg.472","1880"
"24526",614,445,169,"CAGCACATGAACCACAAGTA","AGCTGGTACGTTTGTCCTCA","561307.5.peg.472","1880"
"24527",610,445,165,"ACATGAACCACAAGTAGGGC","AGCTGGTACGTTTGTCCTCA","561307.5.peg.472","1880"
"24528",792,445,347,"TCGCGAGTAACGATATCACG","AGCTGGTACGTTTGTCCTCA","561307.5.peg.472","1880"
"24529",132,445,313,"ATGGTTTGTTCATATCAGT","AGCTGGTACGTTTGTCCTCA","561307.5.peg.472","1880"
"24530",330,445,115,"TCTGCAATAATTTCACGTGA","AGCTGGTACGTTTGTCCTCA","561307.5.peg.472","1880"
"24531",693,445,248,"GCAAGTGCAGTACCGTTGTA","AGCTGGTACGTTTGTCCTCA","561307.5.peg.472","1880"
"24532",247,445,198,"GAATTCAAATGGAATGGCAC","AGCTGGTACGTTTGTCCTCA","561307.5.peg.472","1880"
"24533",693,486,207,"GCAAGTGCAGTACCGTTGTA","GCAGATAAGCCAGCTTTCAT","561307.5.peg.472","1880"
"24534",792,486,306,"TCGCGAGTAACGATATCACG","GCAGATAAGCCAGCTTTCAT","561307.5.peg.472","1880"
"24535",132,486,354,"ATGGTTTGTTCATATCAGT","GCAGATAAGCCAGCTTTCAT","561307.5.peg.472","1880"
"24536",330,486,156,"TCTGCAATAATTTCACGTGA","GCAGATAAGCCAGCTTTCAT","561307.5.peg.472","1880"
"24537",189,486,297,"TCTCTCAAGTGAACATGTCC","GCAGATAAGCCAGCTTTCAT","561307.5.peg.472","1880"
"24538",247,486,239,"GAATTCAAATGGAATGGCAC","GCAGATAAGCCAGCTTTCAT","561307.5.peg.472","1880"
"24539",610,486,124,"ACATGAACCACAAGTAGGGC","GCAGATAAGCCAGCTTTCAT","561307.5.peg.472","1880"
"24540",614,486,128,"CAGCACATGAACCACAAGTA","GCAGATAAGCCAGCTTTCAT","561307.5.peg.472","1880"
"24541",330,610,280,"TCTGCAATAATTTCACGTGA","ACATGAACCACAAGTAGGGC","561307.5.peg.472","1880"
"24542",189,610,421,"TCTCTCAAGTGAACATGTCC","ACATGAACCACAAGTAGGGC","561307.5.peg.472","1880"
"24543",132,610,478,"ATGGTTTGTTCATATCAGT","ACATGAACCACAAGTAGGGC","561307.5.peg.472","1880"
"24544",247,610,363,"GAATTCAAATGGAATGGCAC","ACATGAACCACAAGTAGGGC","561307.5.peg.472","1880"
"24545",445,610,165,"AGCTGGTACGTTTGTCCTCA","ACATGAACCACAAGTAGGGC","561307.5.peg.472","1880"
"24546",792,610,182,"TCGCGAGTAACGATATCACG","ACATGAACCACAAGTAGGGC","561307.5.peg.472","1880"
"24547",486,610,124,"GCAGATAAGCCAGCTTTCAT","ACATGAACCACAAGTAGGGC","561307.5.peg.472","1880"
"24548",132,614,482,"ATGGTTTGTTCATATCAGT","CAGCACATGAACCACAAGTA","561307.5.peg.472","1880"
"24549",247,614,367,"GAATTCAAATGGAATGGCAC","CAGCACATGAACCACAAGTA","561307.5.peg.472","1880"
"24550",445,614,169,"AGCTGGTACGTTTGTCCTCA","CAGCACATGAACCACAAGTA","561307.5.peg.472","1880"
"24551",330,614,284,"TCTGCAATAATTTCACGTGA","CAGCACATGAACCACAAGTA","561307.5.peg.472","1880"
"24552",792,614,178,"TCGCGAGTAACGATATCACG","CAGCACATGAACCACAAGTA","561307.5.peg.472","1880"
"24553",486,614,128,"GCAGATAAGCCAGCTTTCAT","CAGCACATGAACCACAAGTA","561307.5.peg.472","1880"
"24554",189,614,425,"TCTCTCAAGTGAACATGTCC","CAGCACATGAACCACAAGTA","561307.5.peg.472","1880"
"24555",486,693,207,"GCAGATAAGCCAGCTTTCAT","GCAAGTGCAGTACCGTTGTA","561307.5.peg.472","1880"
"24556",247,693,446,"GAATTCAAATGGAATGGCAC","GCAAGTGCAGTACCGTTGTA","561307.5.peg.472","1880"
"24557",330,693,363,"TCTGCAATAATTTCACGTGA","GCAAGTGCAGTACCGTTGTA","561307.5.peg.472","1880"
"24558",445,693,248,"AGCTGGTACGTTTGTCCTCA","GCAAGTGCAGTACCGTTGTA","561307.5.peg.472","1880"
"24559",132,693,561,"ATGGTTTGTTCATATCAGT","GCAAGTGCAGTACCGTTGTA","561307.5.peg.472","1880"
"24560",189,693,504,"TCTCTCAAGTGAACATGTCC","GCAAGTGCAGTACCGTTGTA","561307.5.peg.472","1880"
"24561",486,792,306,"GCAGATAAGCCAGCTTTCAT","TCGCGAGTAACGATATCACG","561307.5.peg.472","1880"
"24562",330,792,462,"TCTGCAATAATTTCACGTGA","TCGCGAGTAACGATATCACG","561307.5.peg.472","1880"
"24563",445,792,347,"AGCTGGTACGTTTGTCCTCA","TCGCGAGTAACGATATCACG","561307.5.peg.472","1880"
"24564",610,792,182,"ACATGAACCACAAGTAGGGC","TCGCGAGTAACGATATCACG","561307.5.peg.472","1880"
"24565",132,792,660,"ATGGTTTGTTCATATCAGT","TCGCGAGTAACGATATCACG","561307.5.peg.472","1880"
"24566",189,792,603,"TCTCTCAAGTGAACATGTCC","TCGCGAGTAACGATATCACG","561307.5.peg.472","1880"
"24567",247,792,545,"GAATTCAAATGGAATGGCAC","TCGCGAGTAACGATATCACG","561307.5.peg.472","1880"
"24568",614,792,178,"CAGCACATGAACCACAAGTA","TCGCGAGTAACGATATCACG","561307.5.peg.472","1880"
"24569",423,219,204,"TGTCCAGTGAATACAACTAG","AAAGGTAGTACGGCACCACC","561307.5.peg.473","1881"
"24570",759,219,540,"CCTGCGCCGGCTAATACGAC","AAAGGTAGTACGGCACCACC","561307.5.peg.473","1881"
"24571",578,219,359,"TGCGTCCAGAATTAGCTACA","AAAGGTAGTACGGCACCACC","561307.5.peg.473","1881"
"24572",839,219,620,"CTAGTAAAGTAGTAACTGTT","AAAGGTAGTACGGCACCACC","561307.5.peg.473","1881"
"24573",479,219,260,"TAGATAGAATATCCGCTTCT","AAAGGTAGTACGGCACCACC","561307.5.peg.473","1881"
"24574",681,219,462,"TCTGTAACAACTTCATAACC","AAAGGTAGTACGGCACCACC","561307.5.peg.473","1881"
"24575",479,229,250,"TAGATAGAATATCCGCTTCT","CGTGTCATATAAAGGTAGTA","561307.5.peg.473","1881"
"24576",578,229,349,"TGCGTCCAGAATTAGCTACA","CGTGTCATATAAAGGTAGTA","561307.5.peg.473","1881"
"24577",839,229,610,"CTAGTAAAGTAGTAACTGTT","CGTGTCATATAAAGGTAGTA","561307.5.peg.473","1881"
"24578",759,229,530,"CCTGCGCCGGCTAATACGAC","CGTGTCATATAAAGGTAGTA","561307.5.peg.473","1881"
"24579",423,229,194,"TGTCCAGTGAATACAACTAG","CGTGTCATATAAAGGTAGTA","561307.5.peg.473","1881"
"24580",681,229,452,"TCTGTAACAACTTCATAACC","CGTGTCATATAAAGGTAGTA","561307.5.peg.473","1881"
"24581",219,423,204,"AAAGGTAGTACGGCACCACC","TGTCCAGTGAATACAACTAG","561307.5.peg.473","1881"
"24582",229,423,194,"CGTGTCATATAAAGGTAGTA","TGTCCAGTGAATACAACTAG","561307.5.peg.473","1881"
"24583",681,423,258,"TCTGTAACAACTTCATAACC","TGTCCAGTGAATACAACTAG","561307.5.peg.473","1881"
"24584",759,423,336,"CCTGCGCCGGCTAATACGAC","TGTCCAGTGAATACAACTAG","561307.5.peg.473","1881"
"24585",578,423,155,"TGCGTCCAGAATTAGCTACA","TGTCCAGTGAATACAACTAG","561307.5.peg.473","1881"
"24586",839,423,416,"CTAGTAAAGTAGTAACTGTT","TGTCCAGTGAATACAACTAG","561307.5.peg.473","1881"
"24587",759,479,280,"CCTGCGCCGGCTAATACGAC","TAGATAGAATATCCGCTTCT","561307.5.peg.473","1881"
"24588",681,479,202,"TCTGTAACAACTTCATAACC","TAGATAGAATATCCGCTTCT","561307.5.peg.473","1881"
"24589",229,479,250,"CGTGTCATATAAAGGTAGTA","TAGATAGAATATCCGCTTCT","561307.5.peg.473","1881"
"24590",839,479,360,"CTAGTAAAGTAGTAACTGTT","TAGATAGAATATCCGCTTCT","561307.5.peg.473","1881"
"24591",219,479,260,"AAAGGTAGTACGGCACCACC","TAGATAGAATATCCGCTTCT","561307.5.peg.473","1881"
"24592",219,578,359,"AAAGGTAGTACGGCACCACC","TGCGTCCAGAATTAGCTACA","561307.5.peg.473","1881"
"24593",839,578,261,"CTAGTAAAGTAGTAACTGTT","TGCGTCCAGAATTAGCTACA","561307.5.peg.473","1881"
"24594",229,578,349,"CGTGTCATATAAAGGTAGTA","TGCGTCCAGAATTAGCTACA","561307.5.peg.473","1881"
"24595",423,578,155,"TGTCCAGTGAATACAACTAG","TGCGTCCAGAATTAGCTACA","561307.5.peg.473","1881"
"24596",681,578,103,"TCTGTAACAACTTCATAACC","TGCGTCCAGAATTAGCTACA","561307.5.peg.473","1881"
"24597",759,578,181,"CCTGCGCCGGCTAATACGAC","TGCGTCCAGAATTAGCTACA","561307.5.peg.473","1881"
"24598",229,681,452,"CGTGTCATATAAAGGTAGTA","TCTGTAACAACTTCATAACC","561307.5.peg.473","1881"
"24599",578,681,103,"TGCGTCCAGAATTAGCTACA","TCTGTAACAACTTCATAACC","561307.5.peg.473","1881"
"24600",479,681,202,"TAGATAGAATATCCGCTTCT","TCTGTAACAACTTCATAACC","561307.5.peg.473","1881"
"24601",839,681,158,"CTAGTAAAGTAGTAACTGTT","TCTGTAACAACTTCATAACC","561307.5.peg.473","1881"
"24602",219,681,462,"AAAGGTAGTACGGCACCACC","TCTGTAACAACTTCATAACC","561307.5.peg.473","1881"
"24603",423,681,258,"TGTCCAGTGAATACAACTAG","TCTGTAACAACTTCATAACC","561307.5.peg.473","1881"
"24604",219,759,540,"AAAGGTAGTACGGCACCACC","CCTGCGCCGGCTAATACGAC","561307.5.peg.473","1881"
"24605",479,759,280,"TAGATAGAATATCCGCTTCT","CCTGCGCCGGCTAATACGAC","561307.5.peg.473","1881"
"24606",578,759,181,"TGCGTCCAGAATTAGCTACA","CCTGCGCCGGCTAATACGAC","561307.5.peg.473","1881"
"24607",229,759,530,"CGTGTCATATAAAGGTAGTA","CCTGCGCCGGCTAATACGAC","561307.5.peg.473","1881"
"24608",423,759,336,"TGTCCAGTGAATACAACTAG","CCTGCGCCGGCTAATACGAC","561307.5.peg.473","1881"
"24609",229,839,610,"CGTGTCATATAAAGGTAGTA","CTAGTAAAGTAGTAACTGTT","561307.5.peg.473","1881"
"24610",219,839,620,"AAAGGTAGTACGGCACCACC","CTAGTAAAGTAGTAACTGTT","561307.5.peg.473","1881"
"24611",578,839,261,"TGCGTCCAGAATTAGCTACA","CTAGTAAAGTAGTAACTGTT","561307.5.peg.473","1881"
"24612",423,839,416,"TGTCCAGTGAATACAACTAG","CTAGTAAAGTAGTAACTGTT","561307.5.peg.473","1881"
"24613",681,839,158,"TCTGTAACAACTTCATAACC","CTAGTAAAGTAGTAACTGTT","561307.5.peg.473","1881"
"24614",479,839,360,"TAGATAGAATATCCGCTTCT","CTAGTAAAGTAGTAACTGTT","561307.5.peg.473","1881"
"24615",495,12,483,"GTACACATTTCACTAAGAA","ATAAGATAGACCTACAATG","561307.5.peg.476","1884"
"24616",523,12,511,"AACTGTAGCTCCAGCGTCAA","ATAAGATAGACCTACAATG","561307.5.peg.476","1884"
"24617",555,12,543,"TAACTGTAGCCGACTGTATC","ATAAGATAGACCTACAATG","561307.5.peg.476","1884"
"24618",607,12,595,"GATGTTACAGATTCTGTTA","ATAAGATAGACCTACAATG","561307.5.peg.476","1884"
"24619",192,12,180,"AAGCTACCTGTACTTGAAGC","ATAAGATAGACCTACAATG","561307.5.peg.476","1884"
"24620",468,12,456,"TCAGTACGCGTTGCATCTTC","ATAAGATAGACCTACAATG","561307.5.peg.476","1884"
"24621",659,12,647,"CAGCCATTCCTAAATCGTCA","ATAAGATAGACCTACAATG","561307.5.peg.476","1884"
"24622",192,28,164,"AAGCTACCTGTACTTGAAGC","TTTAACAACTCCTCATTGT","561307.5.peg.476","1884"
"24623",607,28,579,"GATGTTACAGATTCTGTTA","TTTAACAACTCCTCATTGT","561307.5.peg.476","1884"
"24624",659,28,631,"CAGCCATTCCTAAATCGTCA","TTTAACAACTCCTCATTGT","561307.5.peg.476","1884"
"24625",468,28,440,"TCAGTACGCGTTGCATCTTC","TTTAACAACTCCTCATTGT","561307.5.peg.476","1884"
"24626",523,28,495,"AACTGTAGCTCCAGCGTCAA","TTTAACAACTCCTCATTGT","561307.5.peg.476","1884"
"24627",495,28,467,"GTACACATTTCACTAAGAA","TTTAACAACTCCTCATTGT","561307.5.peg.476","1884"
"24628",555,28,527,"TAACTGTAGCCGACTGTATC","TTTAACAACTCCTCATTGT","561307.5.peg.476","1884"
"24629",495,192,303,"GTACACATTTCACTAAGAA","AAGCTACCTGTACTTGAAGC","561307.5.peg.476","1884"
"24630",28,192,164,"TTTAACAACTCCTCATTGT","AAGCTACCTGTACTTGAAGC","561307.5.peg.476","1884"
"24631",607,192,415,"GATGTTACAGATTCTGTTA","AAGCTACCTGTACTTGAAGC","561307.5.peg.476","1884"
"24632",468,192,276,"TCAGTACGCGTTGCATCTTC","AAGCTACCTGTACTTGAAGC","561307.5.peg.476","1884"
"24633",12,192,180,"ATAAGATAGACCTACAATG","AAGCTACCTGTACTTGAAGC","561307.5.peg.476","1884"
"24634",523,192,331,"AACTGTAGCTCCAGCGTCAA","AAGCTACCTGTACTTGAAGC","561307.5.peg.476","1884"
"24635",555,192,363,"TAACTGTAGCCGACTGTATC","AAGCTACCTGTACTTGAAGC","561307.5.peg.476","1884"
"24636",659,192,467,"CAGCCATTCCTAAATCGTCA","AAGCTACCTGTACTTGAAGC","561307.5.peg.476","1884"
"24637",659,468,191,"CAGCCATTCCTAAATCGTCA","TCAGTACGCGTTGCATCTTC","561307.5.peg.476","1884"
"24638",607,468,139,"GATGTTACAGATTCTGTTA","TCAGTACGCGTTGCATCTTC","561307.5.peg.476","1884"
"24639",192,468,276,"AAGCTACCTGTACTTGAAGC","TCAGTACGCGTTGCATCTTC","561307.5.peg.476","1884"
"24640",12,468,456,"ATAAGATAGACCTACAATG","TCAGTACGCGTTGCATCTTC","561307.5.peg.476","1884"
"24641",28,468,440,"TTTAACAACTCCTCATTGT","TCAGTACGCGTTGCATCTTC","561307.5.peg.476","1884"
"24642",12,495,483,"ATAAGATAGACCTACAATG","GTACACATTTCACTAAGAA","561307.5.peg.476","1884"
"24643",659,495,164,"CAGCCATTCCTAAATCGTCA","GTACACATTTCACTAAGAA","561307.5.peg.476","1884"
"24644",28,495,467,"TTTAACAACTCCTCATTGT","GTACACATTTCACTAAGAA","561307.5.peg.476","1884"
"24645",192,495,303,"AAGCTACCTGTACTTGAAGC","GTACACATTTCACTAAGAA","561307.5.peg.476","1884"
"24646",607,495,112,"GATGTTACAGATTCTGTTA","GTACACATTTCACTAAGAA","561307.5.peg.476","1884"
"24647",12,523,511,"ATAAGATAGACCTACAATG","AACTGTAGCTCCAGCGTCAA","561307.5.peg.476","1884"
"24648",659,523,136,"CAGCCATTCCTAAATCGTCA","AACTGTAGCTCCAGCGTCAA","561307.5.peg.476","1884"
"24649",28,523,495,"TTTAACAACTCCTCATTGT","AACTGTAGCTCCAGCGTCAA","561307.5.peg.476","1884"
"24650",192,523,331,"AAGCTACCTGTACTTGAAGC","AACTGTAGCTCCAGCGTCAA","561307.5.peg.476","1884"
"24651",192,555,363,"AAGCTACCTGTACTTGAAGC","TAACTGTAGCCGACTGTATC","561307.5.peg.476","1884"
"24652",12,555,543,"ATAAGATAGACCTACAATG","TAACTGTAGCCGACTGTATC","561307.5.peg.476","1884"
"24653",659,555,104,"CAGCCATTCCTAAATCGTCA","TAACTGTAGCCGACTGTATC","561307.5.peg.476","1884"
"24654",28,555,527,"TTTAACAACTCCTCATTGT","TAACTGTAGCCGACTGTATC","561307.5.peg.476","1884"
"24655",468,607,139,"TCAGTACGCGTTGCATCTTC","GATGTTACAGATTCTGTTA","561307.5.peg.476","1884"
"24656",495,607,112,"GTACACATTTCACTAAGAA","GATGTTACAGATTCTGTTA","561307.5.peg.476","1884"
"24657",12,607,595,"ATAAGATAGACCTACAATG","GATGTTACAGATTCTGTTA","561307.5.peg.476","1884"
"24658",28,607,579,"TTTAACAACTCCTCATTGT","GATGTTACAGATTCTGTTA","561307.5.peg.476","1884"
"24659",192,607,415,"AAGCTACCTGTACTTGAAGC","GATGTTACAGATTCTGTTA","561307.5.peg.476","1884"
"24660",12,659,647,"ATAAGATAGACCTACAATG","CAGCCATTCCTAAATCGTCA","561307.5.peg.476","1884"
"24661",555,659,104,"TAACTGTAGCCGACTGTATC","CAGCCATTCCTAAATCGTCA","561307.5.peg.476","1884"
"24662",192,659,467,"AAGCTACCTGTACTTGAAGC","CAGCCATTCCTAAATCGTCA","561307.5.peg.476","1884"
"24663",523,659,136,"AACTGTAGCTCCAGCGTCAA","CAGCCATTCCTAAATCGTCA","561307.5.peg.476","1884"
"24664",28,659,631,"TTTAACAACTCCTCATTGT","CAGCCATTCCTAAATCGTCA","561307.5.peg.476","1884"
"24665",468,659,191,"TCAGTACGCGTTGCATCTTC","CAGCCATTCCTAAATCGTCA","561307.5.peg.476","1884"
"24666",495,659,164,"GTACACATTTCACTAAGAA","CAGCCATTCCTAAATCGTCA","561307.5.peg.476","1884"
"24667",370,70,300,"AGAACTAGCGCCTTTGACAA","ACCGATTCCATCACCAGGTA","561307.5.peg.477","1885"
"24668",279,70,209,"TTGTTAGGATCTGTCCATTT","ACCGATTCCATCACCAGGTA","561307.5.peg.477","1885"
"24669",443,70,373,"AAATACCACTTGTCAATTCA","ACCGATTCCATCACCAGGTA","561307.5.peg.477","1885"
"24670",364,70,294,"AGCGCCTTTGACAACGGTAG","ACCGATTCCATCACCAGGTA","561307.5.peg.477","1885"
"24671",362,70,292,"CGCCTTTGACAACGGTAGTG","ACCGATTCCATCACCAGGTA","561307.5.peg.477","1885"
"24672",399,70,329,"TCAACGCGTTCTTCCTTTAA","ACCGATTCCATCACCAGGTA","561307.5.peg.477","1885"
"24673",279,75,204,"TTGTTAGGATCTGTCCATTT","TCTGGACCGATTCCATCACC","561307.5.peg.477","1885"
"24674",399,75,324,"TCAACGCGTTCTTCCTTTAA","TCTGGACCGATTCCATCACC","561307.5.peg.477","1885"
"24675",370,75,295,"AGAACTAGCGCCTTTGACAA","TCTGGACCGATTCCATCACC","561307.5.peg.477","1885"
"24676",362,75,287,"CGCCTTTGACAACGGTAGTG","TCTGGACCGATTCCATCACC","561307.5.peg.477","1885"
"24677",443,75,368,"AAATACCACTTGTCAATTCA","TCTGGACCGATTCCATCACC","561307.5.peg.477","1885"
"24678",364,75,289,"AGCGCCTTTGACAACGGTAG","TCTGGACCGATTCCATCACC","561307.5.peg.477","1885"
"24679",70,279,209,"ACCGATTCCATCACCAGGTA","TTGTTAGGATCTGTCCATTT","561307.5.peg.477","1885"
"24680",443,279,164,"AAATACCACTTGTCAATTCA","TTGTTAGGATCTGTCCATTT","561307.5.peg.477","1885"
"24681",399,279,120,"TCAACGCGTTCTTCCTTTAA","TTGTTAGGATCTGTCCATTT","561307.5.peg.477","1885"
"24682",75,279,204,"TCTGGACCGATTCCATCACC","TTGTTAGGATCTGTCCATTT","561307.5.peg.477","1885"
"24683",70,362,292,"ACCGATTCCATCACCAGGTA","CGCCTTTGACAACGGTAGTG","561307.5.peg.477","1885"
"24684",75,362,287,"TCTGGACCGATTCCATCACC","CGCCTTTGACAACGGTAGTG","561307.5.peg.477","1885"
"24685",75,364,289,"TCTGGACCGATTCCATCACC","AGCGCCTTTGACAACGGTAG","561307.5.peg.477","1885"
"24686",70,364,294,"ACCGATTCCATCACCAGGTA","AGCGCCTTTGACAACGGTAG","561307.5.peg.477","1885"
"24687",70,370,300,"ACCGATTCCATCACCAGGTA","AGAACTAGCGCCTTTGACAA","561307.5.peg.477","1885"
"24688",75,370,295,"TCTGGACCGATTCCATCACC","AGAACTAGCGCCTTTGACAA","561307.5.peg.477","1885"
"24689",70,399,329,"ACCGATTCCATCACCAGGTA","TCAACGCGTTCTTCCTTTAA","561307.5.peg.477","1885"
"24690",75,399,324,"TCTGGACCGATTCCATCACC","TCAACGCGTTCTTCCTTTAA","561307.5.peg.477","1885"
"24691",279,399,120,"TTGTTAGGATCTGTCCATTT","TCAACGCGTTCTTCCTTTAA","561307.5.peg.477","1885"
"24692",70,443,373,"ACCGATTCCATCACCAGGTA","AAATACCACTTGTCAATTCA","561307.5.peg.477","1885"
"24693",75,443,368,"TCTGGACCGATTCCATCACC","AAATACCACTTGTCAATTCA","561307.5.peg.477","1885"
"24694",279,443,164,"TTGTTAGGATCTGTCCATTT","AAATACCACTTGTCAATTCA","561307.5.peg.477","1885"
"24695",570,384,186,"TCCTTAGCATAGACGCCTGT","GGCTGTGTAAGTCCTGTCTC","561307.5.peg.478","1886"
"24696",565,384,181,"AGCATAGACGCCTGTTGGTA","GGCTGTGTAAGTCCTGTCTC","561307.5.peg.478","1886"
"24697",677,384,293,"TCATTCGACCATCCATTGAA","GGCTGTGTAAGTCCTGTCTC","561307.5.peg.478","1886"
"24698",565,405,160,"AGCATAGACGCCTGTTGGTA","CCACAAACGATTGTCTTGCC","561307.5.peg.478","1886"
"24699",677,405,272,"TCATTCGACCATCCATTGAA","CCACAAACGATTGTCTTGCC","561307.5.peg.478","1886"
"24700",570,405,165,"TCCTTAGCATAGACGCCTGT","CCACAAACGATTGTCTTGCC","561307.5.peg.478","1886"
"24701",384,565,181,"GGCTGTGTAAGTCCTGTCTC","AGCATAGACGCCTGTTGGTA","561307.5.peg.478","1886"
"24702",677,565,112,"TCATTCGACCATCCATTGAA","AGCATAGACGCCTGTTGGTA","561307.5.peg.478","1886"
"24703",405,565,160,"CCACAAACGATTGTCTTGCC","AGCATAGACGCCTGTTGGTA","561307.5.peg.478","1886"
"24704",384,570,186,"GGCTGTGTAAGTCCTGTCTC","TCCTTAGCATAGACGCCTGT","561307.5.peg.478","1886"
"24705",677,570,107,"TCATTCGACCATCCATTGAA","TCCTTAGCATAGACGCCTGT","561307.5.peg.478","1886"
"24706",405,570,165,"CCACAAACGATTGTCTTGCC","TCCTTAGCATAGACGCCTGT","561307.5.peg.478","1886"
"24707",384,677,293,"GGCTGTGTAAGTCCTGTCTC","TCATTCGACCATCCATTGAA","561307.5.peg.478","1886"
"24708",405,677,272,"CCACAAACGATTGTCTTGCC","TCATTCGACCATCCATTGAA","561307.5.peg.478","1886"
"24709",565,677,112,"AGCATAGACGCCTGTTGGTA","TCATTCGACCATCCATTGAA","561307.5.peg.478","1886"
"24710",570,677,107,"TCCTTAGCATAGACGCCTGT","TCATTCGACCATCCATTGAA","561307.5.peg.478","1886"
"24711",246,95,151,"ATAGAAGCCCCTTTATATTG","CGATATTGTCGTTGAAGAGA","561307.5.peg.479","1887"
"24712",246,135,111,"ATAGAAGCCCCTTTATATTG","ATACGCTTTAAGTGTACCTT","561307.5.peg.479","1887"
"24713",95,246,151,"CGATATTGTCGTTGAAGAGA","ATAGAAGCCCCTTTATATTG","561307.5.peg.479","1887"
"24714",135,246,111,"ATACGCTTTAAGTGTACCTT","ATAGAAGCCCCTTTATATTG","561307.5.peg.479","1887"
"24715",606,81,525,"GAATGCTAAATGATTGTGT","TAATGAGTGCGAATATTAA","561307.5.peg.48","1888"
"24716",765,81,684,"AGATAAGCACTGACTGGTGT","TAATGAGTGCGAATATTAA","561307.5.peg.48","1888"
"24717",840,81,759,"CCTTGCGATGCTGCGAAGAT","TAATGAGTGCGAATATTAA","561307.5.peg.48","1888"
"24718",771,81,690,"GAATGAAGATAAGCACTGAC","TAATGAGTGCGAATATTAA","561307.5.peg.48","1888"
"24719",771,156,615,"GAATGAAGATAAGCACTGAC","ATAAATATGACGATAGGGAC","561307.5.peg.48","1888"
"24720",765,156,609,"AGATAAGCACTGACTGGTGT","ATAAATATGACGATAGGGAC","561307.5.peg.48","1888"
"24721",606,156,450,"GAATGCTAAATGATTGTGT","ATAAATATGACGATAGGGAC","561307.5.peg.48","1888"
"24722",840,156,684,"CCTTGCGATGCTGCGAAGAT","ATAAATATGACGATAGGGAC","561307.5.peg.48","1888"
"24723",81,606,525,"TAATGAGTGCGAATATTAA","GAATGCTAAATGATTGTGT","561307.5.peg.48","1888"
"24724",765,606,159,"AGATAAGCACTGACTGGTGT","GAATGCTAAATGATTGTGT","561307.5.peg.48","1888"
"24725",840,606,234,"CCTTGCGATGCTGCGAAGAT","GAATGCTAAATGATTGTGT","561307.5.peg.48","1888"
"24726",156,606,450,"ATAAATATGACGATAGGGAC","GAATGCTAAATGATTGTGT","561307.5.peg.48","1888"
"24727",771,606,165,"GAATGAAGATAAGCACTGAC","GAATGCTAAATGATTGTGT","561307.5.peg.48","1888"
"24728",81,765,684,"TAATGAGTGCGAATATTAA","AGATAAGCACTGACTGGTGT","561307.5.peg.48","1888"
"24729",156,765,609,"ATAAATATGACGATAGGGAC","AGATAAGCACTGACTGGTGT","561307.5.peg.48","1888"
"24730",606,765,159,"GAATGCTAAATGATTGTGT","AGATAAGCACTGACTGGTGT","561307.5.peg.48","1888"
"24731",81,771,690,"TAATGAGTGCGAATATTAA","GAATGAAGATAAGCACTGAC","561307.5.peg.48","1888"
"24732",606,771,165,"GAATGCTAAATGATTGTGT","GAATGAAGATAAGCACTGAC","561307.5.peg.48","1888"
"24733",156,771,615,"ATAAATATGACGATAGGGAC","GAATGAAGATAAGCACTGAC","561307.5.peg.48","1888"
"24734",606,840,234,"GAATGCTAAATGATTGTGT","CCTTGCGATGCTGCGAAGAT","561307.5.peg.48","1888"
"24735",156,840,684,"ATAAATATGACGATAGGGAC","CCTTGCGATGCTGCGAAGAT","561307.5.peg.48","1888"
"24736",81,840,759,"TAATGAGTGCGAATATTAA","CCTTGCGATGCTGCGAAGAT","561307.5.peg.48","1888"
"24737",527,118,409,"CTGGAGAACCGAGCTGAGAT","AGCTTTATAAGAACGAGAAG","561307.5.peg.484","1893"
"24738",224,118,106,"TAATTGGACCGTATGCTTGA","AGCTTTATAAGAACGAGAAG","561307.5.peg.484","1893"
"24739",546,118,428,"TCTGGAACACCAGCTGAGTC","AGCTTTATAAGAACGAGAAG","561307.5.peg.484","1893"
"24740",655,118,537,"AATTGGTTCTACTAATACTG","AGCTTTATAAGAACGAGAAG","561307.5.peg.484","1893"
"24741",564,118,446,"ACTTCACGTGCGACGCTTTC","AGCTTTATAAGAACGAGAAG","561307.5.peg.484","1893"
"24742",546,156,390,"TCTGGAACACCAGCTGAGTC","TGTCCTTCTTTCATAACAAC","561307.5.peg.484","1893"
"24743",564,156,408,"ACTTCACGTGCGACGCTTTC","TGTCCTTCTTTCATAACAAC","561307.5.peg.484","1893"
"24744",527,156,371,"CTGGAGAACCGAGCTGAGAT","TGTCCTTCTTTCATAACAAC","561307.5.peg.484","1893"
"24745",655,156,499,"AATTGGTTCTACTAATACTG","TGTCCTTCTTTCATAACAAC","561307.5.peg.484","1893"
"24746",118,224,106,"AGCTTTATAAGAACGAGAAG","TAATTGGACCGTATGCTTGA","561307.5.peg.484","1893"
"24747",564,224,340,"ACTTCACGTGCGACGCTTTC","TAATTGGACCGTATGCTTGA","561307.5.peg.484","1893"
"24748",655,224,431,"AATTGGTTCTACTAATACTG","TAATTGGACCGTATGCTTGA","561307.5.peg.484","1893"
"24749",527,224,303,"CTGGAGAACCGAGCTGAGAT","TAATTGGACCGTATGCTTGA","561307.5.peg.484","1893"
"24750",546,224,322,"TCTGGAACACCAGCTGAGTC","TAATTGGACCGTATGCTTGA","561307.5.peg.484","1893"
"24751",118,527,409,"AGCTTTATAAGAACGAGAAG","CTGGAGAACCGAGCTGAGAT","561307.5.peg.484","1893"
"24752",156,527,371,"TGTCCTTCTTTCATAACAAC","CTGGAGAACCGAGCTGAGAT","561307.5.peg.484","1893"
"24753",655,527,128,"AATTGGTTCTACTAATACTG","CTGGAGAACCGAGCTGAGAT","561307.5.peg.484","1893"
"24754",224,527,303,"TAATTGGACCGTATGCTTGA","CTGGAGAACCGAGCTGAGAT","561307.5.peg.484","1893"
"24755",224,546,322,"TAATTGGACCGTATGCTTGA","TCTGGAACACCAGCTGAGTC","561307.5.peg.484","1893"
"24756",118,546,428,"AGCTTTATAAGAACGAGAAG","TCTGGAACACCAGCTGAGTC","561307.5.peg.484","1893"
"24757",156,546,390,"TGTCCTTCTTTCATAACAAC","TCTGGAACACCAGCTGAGTC","561307.5.peg.484","1893"
"24758",655,546,109,"AATTGGTTCTACTAATACTG","TCTGGAACACCAGCTGAGTC","561307.5.peg.484","1893"
"24759",156,564,408,"TGTCCTTCTTTCATAACAAC","ACTTCACGTGCGACGCTTTC","561307.5.peg.484","1893"
"24760",224,564,340,"TAATTGGACCGTATGCTTGA","ACTTCACGTGCGACGCTTTC","561307.5.peg.484","1893"
"24761",118,564,446,"AGCTTTATAAGAACGAGAAG","ACTTCACGTGCGACGCTTTC","561307.5.peg.484","1893"
"24762",224,655,431,"TAATTGGACCGTATGCTTGA","AATTGGTTCTACTAATACTG","561307.5.peg.484","1893"
"24763",118,655,537,"AGCTTTATAAGAACGAGAAG","AATTGGTTCTACTAATACTG","561307.5.peg.484","1893"
"24764",527,655,128,"CTGGAGAACCGAGCTGAGAT","AATTGGTTCTACTAATACTG","561307.5.peg.484","1893"
"24765",546,655,109,"TCTGGAACACCAGCTGAGTC","AATTGGTTCTACTAATACTG","561307.5.peg.484","1893"
"24766",156,655,499,"TGTCCTTCTTTCATAACAAC","AATTGGTTCTACTAATACTG","561307.5.peg.484","1893"
"24767",292,174,118,"ACCATTGTAACAGATAGTA","GCTTTCAGACCAACATCATC","561307.5.peg.485","1894"
"24768",448,174,274,"GGCGGTAATATAGAAAGAAC","GCTTTCAGACCAACATCATC","561307.5.peg.485","1894"
"24769",352,174,178,"ATAGCAATAAGTACTATGA","GCTTTCAGACCAACATCATC","561307.5.peg.485","1894"
"24770",352,196,156,"ATAGCAATAAGTACTATGA","AACAGCACTGACACCAGCTA","561307.5.peg.485","1894"
"24771",448,196,252,"GGCGGTAATATAGAAAGAAC","AACAGCACTGACACCAGCTA","561307.5.peg.485","1894"
"24772",174,292,118,"GCTTTCAGACCAACATCATC","ACCATTGTAACAGATAGTA","561307.5.peg.485","1894"
"24773",448,292,156,"GGCGGTAATATAGAAAGAAC","ACCATTGTAACAGATAGTA","561307.5.peg.485","1894"
"24774",174,352,178,"GCTTTCAGACCAACATCATC","ATAGCAATAAGTACTATGA","561307.5.peg.485","1894"
"24775",196,352,156,"AACAGCACTGACACCAGCTA","ATAGCAATAAGTACTATGA","561307.5.peg.485","1894"
"24776",174,448,274,"GCTTTCAGACCAACATCATC","GGCGGTAATATAGAAAGAAC","561307.5.peg.485","1894"
"24777",292,448,156,"ACCATTGTAACAGATAGTA","GGCGGTAATATAGAAAGAAC","561307.5.peg.485","1894"
"24778",196,448,252,"AACAGCACTGACACCAGCTA","GGCGGTAATATAGAAAGAAC","561307.5.peg.485","1894"
"24779",191,6,185,"TTTCATCAGTCGTTAGTGCG","GATAGGGCAATAGATTAGGG","561307.5.peg.486","1895"
"24780",273,6,267,"GACGTATAAATTCAATTGG","GATAGGGCAATAGATTAGGG","561307.5.peg.486","1895"
"24781",825,6,819,"CCAACACCGATGACAATAAT","GATAGGGCAATAGATTAGGG","561307.5.peg.486","1895"
"24782",460,6,454,"AACCAAATATTCATTAACC","GATAGGGCAATAGATTAGGG","561307.5.peg.486","1895"
"24783",790,6,784,"AACTGTATTAATTGCGGCAA","GATAGGGCAATAGATTAGGG","561307.5.peg.486","1895"
"24784",749,6,743,"TATGTTTCAACGCACGTGTT","GATAGGGCAATAGATTAGGG","561307.5.peg.486","1895"
"24785",784,6,778,"ATTAATTGCGGCAAAGGAAT","GATAGGGCAATAGATTAGGG","561307.5.peg.486","1895"
"24786",749,8,741,"TATGTTTCAACGCACGTGTT","AGGATAGGGCAATAGATTAG","561307.5.peg.486","1895"
"24787",191,8,183,"TTTCATCAGTCGTTAGTGCG","AGGATAGGGCAATAGATTAG","561307.5.peg.486","1895"
"24788",784,8,776,"ATTAATTGCGGCAAAGGAAT","AGGATAGGGCAATAGATTAG","561307.5.peg.486","1895"
"24789",825,8,817,"CCAACACCGATGACAATAAT","AGGATAGGGCAATAGATTAG","561307.5.peg.486","1895"
"24790",460,8,452,"AACCAAATATTCATTAACC","AGGATAGGGCAATAGATTAG","561307.5.peg.486","1895"
"24791",790,8,782,"AACTGTATTAATTGCGGCAA","AGGATAGGGCAATAGATTAG","561307.5.peg.486","1895"
"24792",273,8,265,"GACGTATAAATTCAATTGG","AGGATAGGGCAATAGATTAG","561307.5.peg.486","1895"
"24793",790,10,780,"AACTGTATTAATTGCGGCAA","ATAGGATAGGGCAATAGATT","561307.5.peg.486","1895"
"24794",460,10,450,"AACCAAATATTCATTAACC","ATAGGATAGGGCAATAGATT","561307.5.peg.486","1895"
"24795",191,10,181,"TTTCATCAGTCGTTAGTGCG","ATAGGATAGGGCAATAGATT","561307.5.peg.486","1895"
"24796",825,10,815,"CCAACACCGATGACAATAAT","ATAGGATAGGGCAATAGATT","561307.5.peg.486","1895"
"24797",784,10,774,"ATTAATTGCGGCAAAGGAAT","ATAGGATAGGGCAATAGATT","561307.5.peg.486","1895"
"24798",749,10,739,"TATGTTTCAACGCACGTGTT","ATAGGATAGGGCAATAGATT","561307.5.peg.486","1895"
"24799",273,10,263,"GACGTATAAATTCAATTGG","ATAGGATAGGGCAATAGATT","561307.5.peg.486","1895"
"24800",273,22,251,"GACGTATAAATTCAATTGG","TATGCTTATGAATAGGATA","561307.5.peg.486","1895"
"24801",790,22,768,"AACTGTATTAATTGCGGCAA","TATGCTTATGAATAGGATA","561307.5.peg.486","1895"
"24802",191,22,169,"TTTCATCAGTCGTTAGTGCG","TATGCTTATGAATAGGATA","561307.5.peg.486","1895"
"24803",460,22,438,"AACCAAATATTCATTAACC","TATGCTTATGAATAGGATA","561307.5.peg.486","1895"
"24804",784,22,762,"ATTAATTGCGGCAAAGGAAT","TATGCTTATGAATAGGATA","561307.5.peg.486","1895"
"24805",749,22,727,"TATGTTTCAACGCACGTGTT","TATGCTTATGAATAGGATA","561307.5.peg.486","1895"
"24806",825,22,803,"CCAACACCGATGACAATAAT","TATGCTTATGAATAGGATA","561307.5.peg.486","1895"
"24807",784,191,593,"ATTAATTGCGGCAAAGGAAT","TTTCATCAGTCGTTAGTGCG","561307.5.peg.486","1895"
"24808",790,191,599,"AACTGTATTAATTGCGGCAA","TTTCATCAGTCGTTAGTGCG","561307.5.peg.486","1895"
"24809",6,191,185,"GATAGGGCAATAGATTAGGG","TTTCATCAGTCGTTAGTGCG","561307.5.peg.486","1895"
"24810",8,191,183,"AGGATAGGGCAATAGATTAG","TTTCATCAGTCGTTAGTGCG","561307.5.peg.486","1895"
"24811",10,191,181,"ATAGGATAGGGCAATAGATT","TTTCATCAGTCGTTAGTGCG","561307.5.peg.486","1895"
"24812",825,191,634,"CCAACACCGATGACAATAAT","TTTCATCAGTCGTTAGTGCG","561307.5.peg.486","1895"
"24813",22,191,169,"TATGCTTATGAATAGGATA","TTTCATCAGTCGTTAGTGCG","561307.5.peg.486","1895"
"24814",460,191,269,"AACCAAATATTCATTAACC","TTTCATCAGTCGTTAGTGCG","561307.5.peg.486","1895"
"24815",749,191,558,"TATGTTTCAACGCACGTGTT","TTTCATCAGTCGTTAGTGCG","561307.5.peg.486","1895"
"24816",6,273,267,"GATAGGGCAATAGATTAGGG","GACGTATAAATTCAATTGG","561307.5.peg.486","1895"
"24817",784,273,511,"ATTAATTGCGGCAAAGGAAT","GACGTATAAATTCAATTGG","561307.5.peg.486","1895"
"24818",22,273,251,"TATGCTTATGAATAGGATA","GACGTATAAATTCAATTGG","561307.5.peg.486","1895"
"24819",10,273,263,"ATAGGATAGGGCAATAGATT","GACGTATAAATTCAATTGG","561307.5.peg.486","1895"
"24820",460,273,187,"AACCAAATATTCATTAACC","GACGTATAAATTCAATTGG","561307.5.peg.486","1895"
"24821",8,273,265,"AGGATAGGGCAATAGATTAG","GACGTATAAATTCAATTGG","561307.5.peg.486","1895"
"24822",790,273,517,"AACTGTATTAATTGCGGCAA","GACGTATAAATTCAATTGG","561307.5.peg.486","1895"
"24823",749,273,476,"TATGTTTCAACGCACGTGTT","GACGTATAAATTCAATTGG","561307.5.peg.486","1895"
"24824",825,273,552,"CCAACACCGATGACAATAAT","GACGTATAAATTCAATTGG","561307.5.peg.486","1895"
"24825",6,460,454,"GATAGGGCAATAGATTAGGG","AACCAAATATTCATTAACC","561307.5.peg.486","1895"
"24826",749,460,289,"TATGTTTCAACGCACGTGTT","AACCAAATATTCATTAACC","561307.5.peg.486","1895"
"24827",10,460,450,"ATAGGATAGGGCAATAGATT","AACCAAATATTCATTAACC","561307.5.peg.486","1895"
"24828",191,460,269,"TTTCATCAGTCGTTAGTGCG","AACCAAATATTCATTAACC","561307.5.peg.486","1895"
"24829",273,460,187,"GACGTATAAATTCAATTGG","AACCAAATATTCATTAACC","561307.5.peg.486","1895"
"24830",825,460,365,"CCAACACCGATGACAATAAT","AACCAAATATTCATTAACC","561307.5.peg.486","1895"
"24831",790,460,330,"AACTGTATTAATTGCGGCAA","AACCAAATATTCATTAACC","561307.5.peg.486","1895"
"24832",22,460,438,"TATGCTTATGAATAGGATA","AACCAAATATTCATTAACC","561307.5.peg.486","1895"
"24833",784,460,324,"ATTAATTGCGGCAAAGGAAT","AACCAAATATTCATTAACC","561307.5.peg.486","1895"
"24834",8,460,452,"AGGATAGGGCAATAGATTAG","AACCAAATATTCATTAACC","561307.5.peg.486","1895"
"24835",460,749,289,"AACCAAATATTCATTAACC","TATGTTTCAACGCACGTGTT","561307.5.peg.486","1895"
"24836",273,749,476,"GACGTATAAATTCAATTGG","TATGTTTCAACGCACGTGTT","561307.5.peg.486","1895"
"24837",6,749,743,"GATAGGGCAATAGATTAGGG","TATGTTTCAACGCACGTGTT","561307.5.peg.486","1895"
"24838",22,749,727,"TATGCTTATGAATAGGATA","TATGTTTCAACGCACGTGTT","561307.5.peg.486","1895"
"24839",8,749,741,"AGGATAGGGCAATAGATTAG","TATGTTTCAACGCACGTGTT","561307.5.peg.486","1895"
"24840",10,749,739,"ATAGGATAGGGCAATAGATT","TATGTTTCAACGCACGTGTT","561307.5.peg.486","1895"
"24841",191,749,558,"TTTCATCAGTCGTTAGTGCG","TATGTTTCAACGCACGTGTT","561307.5.peg.486","1895"
"24842",10,784,774,"ATAGGATAGGGCAATAGATT","ATTAATTGCGGCAAAGGAAT","561307.5.peg.486","1895"
"24843",8,784,776,"AGGATAGGGCAATAGATTAG","ATTAATTGCGGCAAAGGAAT","561307.5.peg.486","1895"
"24844",22,784,762,"TATGCTTATGAATAGGATA","ATTAATTGCGGCAAAGGAAT","561307.5.peg.486","1895"
"24845",6,784,778,"GATAGGGCAATAGATTAGGG","ATTAATTGCGGCAAAGGAAT","561307.5.peg.486","1895"
"24846",191,784,593,"TTTCATCAGTCGTTAGTGCG","ATTAATTGCGGCAAAGGAAT","561307.5.peg.486","1895"
"24847",273,784,511,"GACGTATAAATTCAATTGG","ATTAATTGCGGCAAAGGAAT","561307.5.peg.486","1895"
"24848",460,784,324,"AACCAAATATTCATTAACC","ATTAATTGCGGCAAAGGAAT","561307.5.peg.486","1895"
"24849",10,790,780,"ATAGGATAGGGCAATAGATT","AACTGTATTAATTGCGGCAA","561307.5.peg.486","1895"
"24850",6,790,784,"GATAGGGCAATAGATTAGGG","AACTGTATTAATTGCGGCAA","561307.5.peg.486","1895"
"24851",460,790,330,"AACCAAATATTCATTAACC","AACTGTATTAATTGCGGCAA","561307.5.peg.486","1895"
"24852",22,790,768,"TATGCTTATGAATAGGATA","AACTGTATTAATTGCGGCAA","561307.5.peg.486","1895"
"24853",8,790,782,"AGGATAGGGCAATAGATTAG","AACTGTATTAATTGCGGCAA","561307.5.peg.486","1895"
"24854",191,790,599,"TTTCATCAGTCGTTAGTGCG","AACTGTATTAATTGCGGCAA","561307.5.peg.486","1895"
"24855",273,790,517,"GACGTATAAATTCAATTGG","AACTGTATTAATTGCGGCAA","561307.5.peg.486","1895"
"24856",6,825,819,"GATAGGGCAATAGATTAGGG","CCAACACCGATGACAATAAT","561307.5.peg.486","1895"
"24857",191,825,634,"TTTCATCAGTCGTTAGTGCG","CCAACACCGATGACAATAAT","561307.5.peg.486","1895"
"24858",460,825,365,"AACCAAATATTCATTAACC","CCAACACCGATGACAATAAT","561307.5.peg.486","1895"
"24859",10,825,815,"ATAGGATAGGGCAATAGATT","CCAACACCGATGACAATAAT","561307.5.peg.486","1895"
"24860",22,825,803,"TATGCTTATGAATAGGATA","CCAACACCGATGACAATAAT","561307.5.peg.486","1895"
"24861",8,825,817,"AGGATAGGGCAATAGATTAG","CCAACACCGATGACAATAAT","561307.5.peg.486","1895"
"24862",273,825,552,"GACGTATAAATTCAATTGG","CCAACACCGATGACAATAAT","561307.5.peg.486","1895"
"24863",237,4,233,"GAGTGAAAGTAAACAATTGC","TAAATTAACAGAAGGTGGTG","561307.5.peg.487","1896"
"24864",4,237,233,"TAAATTAACAGAAGGTGGTG","GAGTGAAAGTAAACAATTGC","561307.5.peg.487","1896"
"24865",363,117,246,"TAAATTGATCAGGATCTTT","GGATTGGTCGTTTGTCGCCA","561307.5.peg.488","1897"
"24866",447,117,330,"TTTCCGTCTACAGTTGCTAG","GGATTGGTCGTTTGTCGCCA","561307.5.peg.488","1897"
"24867",363,133,230,"TAAATTGATCAGGATCTTT","AACCAAATATAGTACGGAT","561307.5.peg.488","1897"
"24868",447,133,314,"TTTCCGTCTACAGTTGCTAG","AACCAAATATAGTACGGAT","561307.5.peg.488","1897"
"24869",363,138,225,"TAAATTGATCAGGATCTTT","CACTTAACCAAATATAGTA","561307.5.peg.488","1897"
"24870",447,138,309,"TTTCCGTCTACAGTTGCTAG","CACTTAACCAAATATAGTA","561307.5.peg.488","1897"
"24871",117,363,246,"GGATTGGTCGTTTGTCGCCA","TAAATTGATCAGGATCTTT","561307.5.peg.488","1897"
"24872",133,363,230,"AACCAAATATAGTACGGAT","TAAATTGATCAGGATCTTT","561307.5.peg.488","1897"
"24873",138,363,225,"CACTTAACCAAATATAGTA","TAAATTGATCAGGATCTTT","561307.5.peg.488","1897"
"24874",117,447,330,"GGATTGGTCGTTTGTCGCCA","TTTCCGTCTACAGTTGCTAG","561307.5.peg.488","1897"
"24875",133,447,314,"AACCAAATATAGTACGGAT","TTTCCGTCTACAGTTGCTAG","561307.5.peg.488","1897"
"24876",138,447,309,"CACTTAACCAAATATAGTA","TTTCCGTCTACAGTTGCTAG","561307.5.peg.488","1897"
"24877",310,86,224,"CATCCATACATGAAATGGGT","CTTGAGTTGCAAGTGCTGTA","561307.5.peg.489","1898"
"24878",244,86,158,"CCATAGTATTGTGAAAGGGA","CTTGAGTTGCAAGTGCTGTA","561307.5.peg.489","1898"
"24879",314,86,228,"CCCACATCCATACATGAAAT","CTTGAGTTGCAAGTGCTGTA","561307.5.peg.489","1898"
"24880",405,86,319,"GAATCCATTTGTTTGTGAT","CTTGAGTTGCAAGTGCTGTA","561307.5.peg.489","1898"
"24881",248,86,162,"TTGGCCATAGTATTGTGAAA","CTTGAGTTGCAAGTGCTGTA","561307.5.peg.489","1898"
"24882",510,86,424,"ATAGGAAAGAAGACTGCAAA","CTTGAGTTGCAAGTGCTGTA","561307.5.peg.489","1898"
"24883",244,111,133,"CCATAGTATTGTGAAAGGGA","CCAAACGTAGAAGCCATTGC","561307.5.peg.489","1898"
"24884",248,111,137,"TTGGCCATAGTATTGTGAAA","CCAAACGTAGAAGCCATTGC","561307.5.peg.489","1898"
"24885",405,111,294,"GAATCCATTTGTTTGTGAT","CCAAACGTAGAAGCCATTGC","561307.5.peg.489","1898"
"24886",510,111,399,"ATAGGAAAGAAGACTGCAAA","CCAAACGTAGAAGCCATTGC","561307.5.peg.489","1898"
"24887",310,111,199,"CATCCATACATGAAATGGGT","CCAAACGTAGAAGCCATTGC","561307.5.peg.489","1898"
"24888",314,111,203,"CCCACATCCATACATGAAAT","CCAAACGTAGAAGCCATTGC","561307.5.peg.489","1898"
"24889",510,148,362,"ATAGGAAAGAAGACTGCAAA","ATTAATGAACCAACGATAA","561307.5.peg.489","1898"
"24890",310,148,162,"CATCCATACATGAAATGGGT","ATTAATGAACCAACGATAA","561307.5.peg.489","1898"
"24891",314,148,166,"CCCACATCCATACATGAAAT","ATTAATGAACCAACGATAA","561307.5.peg.489","1898"
"24892",248,148,100,"TTGGCCATAGTATTGTGAAA","ATTAATGAACCAACGATAA","561307.5.peg.489","1898"
"24893",405,148,257,"GAATCCATTTGTTTGTGAT","ATTAATGAACCAACGATAA","561307.5.peg.489","1898"
"24894",405,171,234,"GAATCCATTTGTTTGTGAT","TTAAGAACAGTATCCCCATC","561307.5.peg.489","1898"
"24895",310,171,139,"CATCCATACATGAAATGGGT","TTAAGAACAGTATCCCCATC","561307.5.peg.489","1898"
"24896",510,171,339,"ATAGGAAAGAAGACTGCAAA","TTAAGAACAGTATCCCCATC","561307.5.peg.489","1898"
"24897",314,171,143,"CCCACATCCATACATGAAAT","TTAAGAACAGTATCCCCATC","561307.5.peg.489","1898"
"24898",86,244,158,"CTTGAGTTGCAAGTGCTGTA","CCATAGTATTGTGAAAGGGA","561307.5.peg.489","1898"
"24899",405,244,161,"GAATCCATTTGTTTGTGAT","CCATAGTATTGTGAAAGGGA","561307.5.peg.489","1898"
"24900",111,244,133,"CCAAACGTAGAAGCCATTGC","CCATAGTATTGTGAAAGGGA","561307.5.peg.489","1898"
"24901",510,244,266,"ATAGGAAAGAAGACTGCAAA","CCATAGTATTGTGAAAGGGA","561307.5.peg.489","1898"
"24902",510,248,262,"ATAGGAAAGAAGACTGCAAA","TTGGCCATAGTATTGTGAAA","561307.5.peg.489","1898"
"24903",148,248,100,"ATTAATGAACCAACGATAA","TTGGCCATAGTATTGTGAAA","561307.5.peg.489","1898"
"24904",86,248,162,"CTTGAGTTGCAAGTGCTGTA","TTGGCCATAGTATTGTGAAA","561307.5.peg.489","1898"
"24905",405,248,157,"GAATCCATTTGTTTGTGAT","TTGGCCATAGTATTGTGAAA","561307.5.peg.489","1898"
"24906",111,248,137,"CCAAACGTAGAAGCCATTGC","TTGGCCATAGTATTGTGAAA","561307.5.peg.489","1898"
"24907",86,310,224,"CTTGAGTTGCAAGTGCTGTA","CATCCATACATGAAATGGGT","561307.5.peg.489","1898"
"24908",148,310,162,"ATTAATGAACCAACGATAA","CATCCATACATGAAATGGGT","561307.5.peg.489","1898"
"24909",510,310,200,"ATAGGAAAGAAGACTGCAAA","CATCCATACATGAAATGGGT","561307.5.peg.489","1898"
"24910",171,310,139,"TTAAGAACAGTATCCCCATC","CATCCATACATGAAATGGGT","561307.5.peg.489","1898"
"24911",111,310,199,"CCAAACGTAGAAGCCATTGC","CATCCATACATGAAATGGGT","561307.5.peg.489","1898"
"24912",86,314,228,"CTTGAGTTGCAAGTGCTGTA","CCCACATCCATACATGAAAT","561307.5.peg.489","1898"
"24913",510,314,196,"ATAGGAAAGAAGACTGCAAA","CCCACATCCATACATGAAAT","561307.5.peg.489","1898"
"24914",171,314,143,"TTAAGAACAGTATCCCCATC","CCCACATCCATACATGAAAT","561307.5.peg.489","1898"
"24915",148,314,166,"ATTAATGAACCAACGATAA","CCCACATCCATACATGAAAT","561307.5.peg.489","1898"
"24916",111,314,203,"CCAAACGTAGAAGCCATTGC","CCCACATCCATACATGAAAT","561307.5.peg.489","1898"
"24917",171,405,234,"TTAAGAACAGTATCCCCATC","GAATCCATTTGTTTGTGAT","561307.5.peg.489","1898"
"24918",148,405,257,"ATTAATGAACCAACGATAA","GAATCCATTTGTTTGTGAT","561307.5.peg.489","1898"
"24919",510,405,105,"ATAGGAAAGAAGACTGCAAA","GAATCCATTTGTTTGTGAT","561307.5.peg.489","1898"
"24920",111,405,294,"CCAAACGTAGAAGCCATTGC","GAATCCATTTGTTTGTGAT","561307.5.peg.489","1898"
"24921",244,405,161,"CCATAGTATTGTGAAAGGGA","GAATCCATTTGTTTGTGAT","561307.5.peg.489","1898"
"24922",86,405,319,"CTTGAGTTGCAAGTGCTGTA","GAATCCATTTGTTTGTGAT","561307.5.peg.489","1898"
"24923",248,405,157,"TTGGCCATAGTATTGTGAAA","GAATCCATTTGTTTGTGAT","561307.5.peg.489","1898"
"24924",86,510,424,"CTTGAGTTGCAAGTGCTGTA","ATAGGAAAGAAGACTGCAAA","561307.5.peg.489","1898"
"24925",248,510,262,"TTGGCCATAGTATTGTGAAA","ATAGGAAAGAAGACTGCAAA","561307.5.peg.489","1898"
"24926",171,510,339,"TTAAGAACAGTATCCCCATC","ATAGGAAAGAAGACTGCAAA","561307.5.peg.489","1898"
"24927",244,510,266,"CCATAGTATTGTGAAAGGGA","ATAGGAAAGAAGACTGCAAA","561307.5.peg.489","1898"
"24928",111,510,399,"CCAAACGTAGAAGCCATTGC","ATAGGAAAGAAGACTGCAAA","561307.5.peg.489","1898"
"24929",314,510,196,"CCCACATCCATACATGAAAT","ATAGGAAAGAAGACTGCAAA","561307.5.peg.489","1898"
"24930",148,510,362,"ATTAATGAACCAACGATAA","ATAGGAAAGAAGACTGCAAA","561307.5.peg.489","1898"
"24931",310,510,200,"CATCCATACATGAAATGGGT","ATAGGAAAGAAGACTGCAAA","561307.5.peg.489","1898"
"24932",405,510,105,"GAATCCATTTGTTTGTGAT","ATAGGAAAGAAGACTGCAAA","561307.5.peg.489","1898"
"24933",156,10,146,"CCGCCGACGAAACCGCCACC","GCGTCAAACGCAAGGTAACG","561307.5.peg.49","1899"
"24934",10,156,146,"GCGTCAAACGCAAGGTAACG","CCGCCGACGAAACCGCCACC","561307.5.peg.49","1899"
"24935",343,211,132,"AATAACTACTGGCGTCGCTG","CCATCTCACCTCTTTAACAT","561307.5.peg.490","1900"
"24936",426,211,215,"ATGATGTTTCGAAGTTTAC","CCATCTCACCTCTTTAACAT","561307.5.peg.490","1900"
"24937",211,343,132,"CCATCTCACCTCTTTAACAT","AATAACTACTGGCGTCGCTG","561307.5.peg.490","1900"
"24938",211,426,215,"CCATCTCACCTCTTTAACAT","ATGATGTTTCGAAGTTTAC","561307.5.peg.490","1900"
"24939",461,216,245,"CGTATGCCGCTTTCGAAATA","ACCAACGCTTTGGAAGATTC","561307.5.peg.491","1901"
"24940",453,216,237,"GCTTTCGAAATATGGTTAAC","ACCAACGCTTTGGAAGATTC","561307.5.peg.491","1901"
"24941",561,216,345,"ATCGCACGTTCCATAAATTG","ACCAACGCTTTGGAAGATTC","561307.5.peg.491","1901"
"24942",453,226,227,"GCTTTCGAAATATGGTTAAC","CAATTGACCTACCAACGCTT","561307.5.peg.491","1901"
"24943",561,226,335,"ATCGCACGTTCCATAAATTG","CAATTGACCTACCAACGCTT","561307.5.peg.491","1901"
"24944",461,226,235,"CGTATGCCGCTTTCGAAATA","CAATTGACCTACCAACGCTT","561307.5.peg.491","1901"
"24945",216,453,237,"ACCAACGCTTTGGAAGATTC","GCTTTCGAAATATGGTTAAC","561307.5.peg.491","1901"
"24946",561,453,108,"ATCGCACGTTCCATAAATTG","GCTTTCGAAATATGGTTAAC","561307.5.peg.491","1901"
"24947",226,453,227,"CAATTGACCTACCAACGCTT","GCTTTCGAAATATGGTTAAC","561307.5.peg.491","1901"
"24948",216,461,245,"ACCAACGCTTTGGAAGATTC","CGTATGCCGCTTTCGAAATA","561307.5.peg.491","1901"
"24949",561,461,100,"ATCGCACGTTCCATAAATTG","CGTATGCCGCTTTCGAAATA","561307.5.peg.491","1901"
"24950",226,461,235,"CAATTGACCTACCAACGCTT","CGTATGCCGCTTTCGAAATA","561307.5.peg.491","1901"
"24951",216,561,345,"ACCAACGCTTTGGAAGATTC","ATCGCACGTTCCATAAATTG","561307.5.peg.491","1901"
"24952",226,561,335,"CAATTGACCTACCAACGCTT","ATCGCACGTTCCATAAATTG","561307.5.peg.491","1901"
"24953",453,561,108,"GCTTTCGAAATATGGTTAAC","ATCGCACGTTCCATAAATTG","561307.5.peg.491","1901"
"24954",461,561,100,"CGTATGCCGCTTTCGAAATA","ATCGCACGTTCCATAAATTG","561307.5.peg.491","1901"
"24955",166,24,142,"TCTGTCTACTAAGTAACTTT","CTCAATTTCTTCTGTTCCAT","561307.5.peg.492","1902"
"24956",166,60,106,"TCTGTCTACTAAGTAACTTT","GTATTTCGTGTCTTAATTC","561307.5.peg.492","1902"
"24957",24,166,142,"CTCAATTTCTTCTGTTCCAT","TCTGTCTACTAAGTAACTTT","561307.5.peg.492","1902"
"24958",60,166,106,"GTATTTCGTGTCTTAATTC","TCTGTCTACTAAGTAACTTT","561307.5.peg.492","1902"
"24959",276,110,166,"GTATCTCCACGTAAATGATC","CATTCTCTAATGCCTCTTTA","561307.5.peg.495","1905"
"24960",110,276,166,"CATTCTCTAATGCCTCTTTA","GTATCTCCACGTAAATGATC","561307.5.peg.495","1905"
"24961",276,13,263,"ATAGACATCGTTCGCAGATT","CTTTCTATTTGGTTCATAT","561307.5.peg.497","1907"
"24962",191,13,178,"AAGTATAACCAACTGCACAG","CTTTCTATTTGGTTCATAT","561307.5.peg.497","1907"
"24963",229,13,216,"TAAGTCCATATCTAAAGGCT","CTTTCTATTTGGTTCATAT","561307.5.peg.497","1907"
"24964",227,13,214,"AGTCCATATCTAAAGGCTCG","CTTTCTATTTGGTTCATAT","561307.5.peg.497","1907"
"24965",404,13,391,"AACGATCTTGAGGCAATGTT","CTTTCTATTTGGTTCATAT","561307.5.peg.497","1907"
"24966",191,75,116,"AAGTATAACCAACTGCACAG","GGATCATTGTAAATGCTAAC","561307.5.peg.497","1907"
"24967",276,75,201,"ATAGACATCGTTCGCAGATT","GGATCATTGTAAATGCTAAC","561307.5.peg.497","1907"
"24968",404,75,329,"AACGATCTTGAGGCAATGTT","GGATCATTGTAAATGCTAAC","561307.5.peg.497","1907"
"24969",229,75,154,"TAAGTCCATATCTAAAGGCT","GGATCATTGTAAATGCTAAC","561307.5.peg.497","1907"
"24970",227,75,152,"AGTCCATATCTAAAGGCTCG","GGATCATTGTAAATGCTAAC","561307.5.peg.497","1907"
"24971",229,96,133,"TAAGTCCATATCTAAAGGCT","ACATCGTTATATGCTTCCCA","561307.5.peg.497","1907"
"24972",227,96,131,"AGTCCATATCTAAAGGCTCG","ACATCGTTATATGCTTCCCA","561307.5.peg.497","1907"
"24973",276,96,180,"ATAGACATCGTTCGCAGATT","ACATCGTTATATGCTTCCCA","561307.5.peg.497","1907"
"24974",404,96,308,"AACGATCTTGAGGCAATGTT","ACATCGTTATATGCTTCCCA","561307.5.peg.497","1907"
"24975",13,191,178,"CTTTCTATTTGGTTCATAT","AAGTATAACCAACTGCACAG","561307.5.peg.497","1907"
"24976",75,191,116,"GGATCATTGTAAATGCTAAC","AAGTATAACCAACTGCACAG","561307.5.peg.497","1907"
"24977",404,191,213,"AACGATCTTGAGGCAATGTT","AAGTATAACCAACTGCACAG","561307.5.peg.497","1907"
"24978",13,227,214,"CTTTCTATTTGGTTCATAT","AGTCCATATCTAAAGGCTCG","561307.5.peg.497","1907"
"24979",404,227,177,"AACGATCTTGAGGCAATGTT","AGTCCATATCTAAAGGCTCG","561307.5.peg.497","1907"
"24980",75,227,152,"GGATCATTGTAAATGCTAAC","AGTCCATATCTAAAGGCTCG","561307.5.peg.497","1907"
"24981",96,227,131,"ACATCGTTATATGCTTCCCA","AGTCCATATCTAAAGGCTCG","561307.5.peg.497","1907"
"24982",13,229,216,"CTTTCTATTTGGTTCATAT","TAAGTCCATATCTAAAGGCT","561307.5.peg.497","1907"
"24983",96,229,133,"ACATCGTTATATGCTTCCCA","TAAGTCCATATCTAAAGGCT","561307.5.peg.497","1907"
"24984",75,229,154,"GGATCATTGTAAATGCTAAC","TAAGTCCATATCTAAAGGCT","561307.5.peg.497","1907"
"24985",404,229,175,"AACGATCTTGAGGCAATGTT","TAAGTCCATATCTAAAGGCT","561307.5.peg.497","1907"
"24986",13,276,263,"CTTTCTATTTGGTTCATAT","ATAGACATCGTTCGCAGATT","561307.5.peg.497","1907"
"24987",96,276,180,"ACATCGTTATATGCTTCCCA","ATAGACATCGTTCGCAGATT","561307.5.peg.497","1907"
"24988",75,276,201,"GGATCATTGTAAATGCTAAC","ATAGACATCGTTCGCAGATT","561307.5.peg.497","1907"
"24989",404,276,128,"AACGATCTTGAGGCAATGTT","ATAGACATCGTTCGCAGATT","561307.5.peg.497","1907"
"24990",75,404,329,"GGATCATTGTAAATGCTAAC","AACGATCTTGAGGCAATGTT","561307.5.peg.497","1907"
"24991",13,404,391,"CTTTCTATTTGGTTCATAT","AACGATCTTGAGGCAATGTT","561307.5.peg.497","1907"
"24992",96,404,308,"ACATCGTTATATGCTTCCCA","AACGATCTTGAGGCAATGTT","561307.5.peg.497","1907"
"24993",229,404,175,"TAAGTCCATATCTAAAGGCT","AACGATCTTGAGGCAATGTT","561307.5.peg.497","1907"
"24994",191,404,213,"AAGTATAACCAACTGCACAG","AACGATCTTGAGGCAATGTT","561307.5.peg.497","1907"
"24995",227,404,177,"AGTCCATATCTAAAGGCTCG","AACGATCTTGAGGCAATGTT","561307.5.peg.497","1907"
"24996",276,404,128,"ATAGACATCGTTCGCAGATT","AACGATCTTGAGGCAATGTT","561307.5.peg.497","1907"
"24997",119,11,108,"GATGGTGATTCGTATCTTGA","CGTGATTAAAGTATAGATT","561307.5.peg.498","1908"
"24998",137,11,126,"TACCACCAAACATTGTATGA","CGTGATTAAAGTATAGATT","561307.5.peg.498","1908"
"24999",229,11,218,"ATCTACTGAGTCTGTAGATG","CGTGATTAAAGTATAGATT","561307.5.peg.498","1908"
"25000",11,119,108,"CGTGATTAAAGTATAGATT","GATGGTGATTCGTATCTTGA","561307.5.peg.498","1908"
"25001",229,119,110,"ATCTACTGAGTCTGTAGATG","GATGGTGATTCGTATCTTGA","561307.5.peg.498","1908"
"25002",11,137,126,"CGTGATTAAAGTATAGATT","TACCACCAAACATTGTATGA","561307.5.peg.498","1908"
"25003",11,229,218,"CGTGATTAAAGTATAGATT","ATCTACTGAGTCTGTAGATG","561307.5.peg.498","1908"
"25004",119,229,110,"GATGGTGATTCGTATCTTGA","ATCTACTGAGTCTGTAGATG","561307.5.peg.498","1908"
"25005",498,5,493,"CTCTTCGCCCAAGCTTTAGA","ATTGCGACACGAATAGGAGT","561307.5.peg.499","1909"
"25006",498,11,487,"CTCTTCGCCCAAGCTTTAGA","AGGACAATTGCGACACGAAT","561307.5.peg.499","1909"
"25007",498,31,467,"CTCTTCGCCCAAGCTTTAGA","GCTATTGCTGACGCTTT","561307.5.peg.499","1909"
"25008",5,498,493,"ATTGCGACACGAATAGGAGT","CTCTTCGCCCAAGCTTTAGA","561307.5.peg.499","1909"
"25009",11,498,487,"AGGACAATTGCGACACGAAT","CTCTTCGCCCAAGCTTTAGA","561307.5.peg.499","1909"
"25010",31,498,467,"GCTATTGCTGACGCTTT","CTCTTCGCCCAAGCTTTAGA","561307.5.peg.499","1909"
"25011",223,78,145,"ATAAATCGCTGCTAATTGTC","CCAATAGTAGGAATTCCACT","561307.5.peg.5","1910"
"25012",299,78,221,"ATCCTGCTTGTACGTGTGCA","CCAATAGTAGGAATTCCACT","561307.5.peg.5","1910"
"25013",432,78,354,"ACAATATCAGCTGCCATTAA","CCAATAGTAGGAATTCCACT","561307.5.peg.5","1910"
"25014",429,78,351,"ATATCAGCTGCCATTAAAGG","CCAATAGTAGGAATTCCACT","561307.5.peg.5","1910"
"25015",408,78,330,"GGATATGTTAATAGACCAGC","CCAATAGTAGGAATTCCACT","561307.5.peg.5","1910"
"25016",78,223,145,"CCAATAGTAGGAATTCCACT","ATAAATCGCTGCTAATTGTC","561307.5.peg.5","1910"
"25017",429,223,206,"ATATCAGCTGCCATTAAAGG","ATAAATCGCTGCTAATTGTC","561307.5.peg.5","1910"
"25018",408,223,185,"GGATATGTTAATAGACCAGC","ATAAATCGCTGCTAATTGTC","561307.5.peg.5","1910"
"25019",432,223,209,"ACAATATCAGCTGCCATTAA","ATAAATCGCTGCTAATTGTC","561307.5.peg.5","1910"
"25020",408,299,109,"GGATATGTTAATAGACCAGC","ATCCTGCTTGTACGTGTGCA","561307.5.peg.5","1910"
"25021",78,299,221,"CCAATAGTAGGAATTCCACT","ATCCTGCTTGTACGTGTGCA","561307.5.peg.5","1910"
"25022",429,299,130,"ATATCAGCTGCCATTAAAGG","ATCCTGCTTGTACGTGTGCA","561307.5.peg.5","1910"
"25023",432,299,133,"ACAATATCAGCTGCCATTAA","ATCCTGCTTGTACGTGTGCA","561307.5.peg.5","1910"
"25024",299,408,109,"ATCCTGCTTGTACGTGTGCA","GGATATGTTAATAGACCAGC","561307.5.peg.5","1910"
"25025",223,408,185,"ATAAATCGCTGCTAATTGTC","GGATATGTTAATAGACCAGC","561307.5.peg.5","1910"
"25026",78,408,330,"CCAATAGTAGGAATTCCACT","GGATATGTTAATAGACCAGC","561307.5.peg.5","1910"
"25027",78,429,351,"CCAATAGTAGGAATTCCACT","ATATCAGCTGCCATTAAAGG","561307.5.peg.5","1910"
"25028",299,429,130,"ATCCTGCTTGTACGTGTGCA","ATATCAGCTGCCATTAAAGG","561307.5.peg.5","1910"
"25029",223,429,206,"ATAAATCGCTGCTAATTGTC","ATATCAGCTGCCATTAAAGG","561307.5.peg.5","1910"
"25030",223,432,209,"ATAAATCGCTGCTAATTGTC","ACAATATCAGCTGCCATTAA","561307.5.peg.5","1910"
"25031",78,432,354,"CCAATAGTAGGAATTCCACT","ACAATATCAGCTGCCATTAA","561307.5.peg.5","1910"
"25032",299,432,133,"ATCCTGCTTGTACGTGTGCA","ACAATATCAGCTGCCATTAA","561307.5.peg.5","1910"
"25033",240,11,229,"TCACTAATCATGCCATCAAA","GGGGATATAACTACATAGTT","561307.5.peg.501","1913"
"25034",11,240,229,"GGGGATATAACTACATAGTT","TCACTAATCATGCCATCAAA","561307.5.peg.501","1913"
"25035",438,307,131,"ATTAGAGTAGATGTTTCAGC","CATTTGTGCTGCTAGTCCTG","561307.5.peg.503","1915"
"25036",493,307,186,"GATAGATAATAAGCCACCAC","CATTTGTGCTGCTAGTCCTG","561307.5.peg.503","1915"
"25037",438,335,103,"ATTAGAGTAGATGTTTCAGC","GGAACATAGCAAGTACGAAA","561307.5.peg.503","1915"
"25038",493,335,158,"GATAGATAATAAGCCACCAC","GGAACATAGCAAGTACGAAA","561307.5.peg.503","1915"
"25039",307,438,131,"CATTTGTGCTGCTAGTCCTG","ATTAGAGTAGATGTTTCAGC","561307.5.peg.503","1915"
"25040",335,438,103,"GGAACATAGCAAGTACGAAA","ATTAGAGTAGATGTTTCAGC","561307.5.peg.503","1915"
"25041",307,493,186,"CATTTGTGCTGCTAGTCCTG","GATAGATAATAAGCCACCAC","561307.5.peg.503","1915"
"25042",335,493,158,"GGAACATAGCAAGTACGAAA","GATAGATAATAAGCCACCAC","561307.5.peg.503","1915"
"25043",175,29,146,"TGGCTTCAACTCATGGGCTT","ACGAATCCTCCTTATTTAA","561307.5.peg.504","1916"
"25044",181,29,152,"TAAATCTGGCTTCAACTCAT","ACGAATCCTCCTTATTTAA","561307.5.peg.504","1916"
"25045",175,31,144,"TGGCTTCAACTCATGGGCTT","TTCAGGTACACGTATCG","561307.5.peg.504","1916"
"25046",181,31,150,"TAAATCTGGCTTCAACTCAT","TTCAGGTACACGTATCG","561307.5.peg.504","1916"
"25047",29,175,146,"ACGAATCCTCCTTATTTAA","TGGCTTCAACTCATGGGCTT","561307.5.peg.504","1916"
"25048",31,175,144,"TTCAGGTACACGTATCG","TGGCTTCAACTCATGGGCTT","561307.5.peg.504","1916"
"25049",29,181,152,"ACGAATCCTCCTTATTTAA","TAAATCTGGCTTCAACTCAT","561307.5.peg.504","1916"
"25050",31,181,150,"TTCAGGTACACGTATCG","TAAATCTGGCTTCAACTCAT","561307.5.peg.504","1916"
"25051",374,11,363,"GATTTAAAGGTACGAGTGTA","AACGTTTATCGGAGACGTAG","561307.5.peg.505","1917"
"25052",374,22,352,"GATTTAAAGGTACGAGTGTA","ATCTACGTATCAACGTTTAT","561307.5.peg.505","1917"
"25053",374,56,318,"GATTTAAAGGTACGAGTGTA","ACCAATTGTTCTAATGTAG","561307.5.peg.505","1917"
"25054",11,374,363,"AACGTTTATCGGAGACGTAG","GATTTAAAGGTACGAGTGTA","561307.5.peg.505","1917"
"25055",22,374,352,"ATCTACGTATCAACGTTTAT","GATTTAAAGGTACGAGTGTA","561307.5.peg.505","1917"
"25056",56,374,318,"ACCAATTGTTCTAATGTAG","GATTTAAAGGTACGAGTGTA","561307.5.peg.505","1917"
"25057",285,139,146,"TCACGAATGACACGCTTACT","TTTCGTAGTGATACCTGGTT","561307.5.peg.508","1920"
"25058",285,144,141,"TCACGAATGACACGCTTACT","AGCTCTTTCGTAGTGATACC","561307.5.peg.508","1920"
"25059",139,285,146,"TTTCGTAGTGATACCTGGTT","TCACGAATGACACGCTTACT","561307.5.peg.508","1920"
"25060",144,285,141,"AGCTCTTTCGTAGTGATACC","TCACGAATGACACGCTTACT","561307.5.peg.508","1920"
"25061",483,14,469,"ACGATGACGCCATAAGTTTC","AACTCAGAACACTTTAATG","561307.5.peg.509","1921"
"25062",561,14,547,"ATGTTTGCTGGTTTGCCTAC","AACTCAGAACACTTTAATG","561307.5.peg.509","1921"
"25063",176,14,162,"TCCCTAATAAGTTATCATCA","AACTCAGAACACTTTAATG","561307.5.peg.509","1921"
"25064",213,14,199,"TGAACTAGATATGTGTAGTC","AACTCAGAACACTTTAATG","561307.5.peg.509","1921"
"25065",758,14,744,"CTTCAACTGCTTGTTGAACT","AACTCAGAACACTTTAATG","561307.5.peg.509","1921"
"25066",284,14,270,"GGAAGGGCACACCGCCTATA","AACTCAGAACACTTTAATG","561307.5.peg.509","1921"
"25067",257,14,243,"CGTGACCATGTGTTATAAAT","AACTCAGAACACTTTAATG","561307.5.peg.509","1921"
"25068",707,14,693,"AATACGACCTTTACAATTA","AACTCAGAACACTTTAATG","561307.5.peg.509","1921"
"25069",873,14,859,"GGTTCAATAAATGTTTCAGG","AACTCAGAACACTTTAATG","561307.5.peg.509","1921"
"25070",707,66,641,"AATACGACCTTTACAATTA","GCATATACACCTACTTCATT","561307.5.peg.509","1921"
"25071",176,66,110,"TCCCTAATAAGTTATCATCA","GCATATACACCTACTTCATT","561307.5.peg.509","1921"
"25072",561,66,495,"ATGTTTGCTGGTTTGCCTAC","GCATATACACCTACTTCATT","561307.5.peg.509","1921"
"25073",284,66,218,"GGAAGGGCACACCGCCTATA","GCATATACACCTACTTCATT","561307.5.peg.509","1921"
"25074",483,66,417,"ACGATGACGCCATAAGTTTC","GCATATACACCTACTTCATT","561307.5.peg.509","1921"
"25075",257,66,191,"CGTGACCATGTGTTATAAAT","GCATATACACCTACTTCATT","561307.5.peg.509","1921"
"25076",213,66,147,"TGAACTAGATATGTGTAGTC","GCATATACACCTACTTCATT","561307.5.peg.509","1921"
"25077",873,66,807,"GGTTCAATAAATGTTTCAGG","GCATATACACCTACTTCATT","561307.5.peg.509","1921"
"25078",758,66,692,"CTTCAACTGCTTGTTGAACT","GCATATACACCTACTTCATT","561307.5.peg.509","1921"
"25079",758,176,582,"CTTCAACTGCTTGTTGAACT","TCCCTAATAAGTTATCATCA","561307.5.peg.509","1921"
"25080",483,176,307,"ACGATGACGCCATAAGTTTC","TCCCTAATAAGTTATCATCA","561307.5.peg.509","1921"
"25081",707,176,531,"AATACGACCTTTACAATTA","TCCCTAATAAGTTATCATCA","561307.5.peg.509","1921"
"25082",873,176,697,"GGTTCAATAAATGTTTCAGG","TCCCTAATAAGTTATCATCA","561307.5.peg.509","1921"
"25083",284,176,108,"GGAAGGGCACACCGCCTATA","TCCCTAATAAGTTATCATCA","561307.5.peg.509","1921"
"25084",561,176,385,"ATGTTTGCTGGTTTGCCTAC","TCCCTAATAAGTTATCATCA","561307.5.peg.509","1921"
"25085",66,176,110,"GCATATACACCTACTTCATT","TCCCTAATAAGTTATCATCA","561307.5.peg.509","1921"
"25086",14,176,162,"AACTCAGAACACTTTAATG","TCCCTAATAAGTTATCATCA","561307.5.peg.509","1921"
"25087",14,213,199,"AACTCAGAACACTTTAATG","TGAACTAGATATGTGTAGTC","561307.5.peg.509","1921"
"25088",873,213,660,"GGTTCAATAAATGTTTCAGG","TGAACTAGATATGTGTAGTC","561307.5.peg.509","1921"
"25089",66,213,147,"GCATATACACCTACTTCATT","TGAACTAGATATGTGTAGTC","561307.5.peg.509","1921"
"25090",483,213,270,"ACGATGACGCCATAAGTTTC","TGAACTAGATATGTGTAGTC","561307.5.peg.509","1921"
"25091",707,213,494,"AATACGACCTTTACAATTA","TGAACTAGATATGTGTAGTC","561307.5.peg.509","1921"
"25092",561,213,348,"ATGTTTGCTGGTTTGCCTAC","TGAACTAGATATGTGTAGTC","561307.5.peg.509","1921"
"25093",758,213,545,"CTTCAACTGCTTGTTGAACT","TGAACTAGATATGTGTAGTC","561307.5.peg.509","1921"
"25094",561,257,304,"ATGTTTGCTGGTTTGCCTAC","CGTGACCATGTGTTATAAAT","561307.5.peg.509","1921"
"25095",14,257,243,"AACTCAGAACACTTTAATG","CGTGACCATGTGTTATAAAT","561307.5.peg.509","1921"
"25096",66,257,191,"GCATATACACCTACTTCATT","CGTGACCATGTGTTATAAAT","561307.5.peg.509","1921"
"25097",758,257,501,"CTTCAACTGCTTGTTGAACT","CGTGACCATGTGTTATAAAT","561307.5.peg.509","1921"
"25098",483,257,226,"ACGATGACGCCATAAGTTTC","CGTGACCATGTGTTATAAAT","561307.5.peg.509","1921"
"25099",707,257,450,"AATACGACCTTTACAATTA","CGTGACCATGTGTTATAAAT","561307.5.peg.509","1921"
"25100",873,257,616,"GGTTCAATAAATGTTTCAGG","CGTGACCATGTGTTATAAAT","561307.5.peg.509","1921"
"25101",14,284,270,"AACTCAGAACACTTTAATG","GGAAGGGCACACCGCCTATA","561307.5.peg.509","1921"
"25102",707,284,423,"AATACGACCTTTACAATTA","GGAAGGGCACACCGCCTATA","561307.5.peg.509","1921"
"25103",66,284,218,"GCATATACACCTACTTCATT","GGAAGGGCACACCGCCTATA","561307.5.peg.509","1921"
"25104",561,284,277,"ATGTTTGCTGGTTTGCCTAC","GGAAGGGCACACCGCCTATA","561307.5.peg.509","1921"
"25105",873,284,589,"GGTTCAATAAATGTTTCAGG","GGAAGGGCACACCGCCTATA","561307.5.peg.509","1921"
"25106",176,284,108,"TCCCTAATAAGTTATCATCA","GGAAGGGCACACCGCCTATA","561307.5.peg.509","1921"
"25107",758,284,474,"CTTCAACTGCTTGTTGAACT","GGAAGGGCACACCGCCTATA","561307.5.peg.509","1921"
"25108",483,284,199,"ACGATGACGCCATAAGTTTC","GGAAGGGCACACCGCCTATA","561307.5.peg.509","1921"
"25109",176,483,307,"TCCCTAATAAGTTATCATCA","ACGATGACGCCATAAGTTTC","561307.5.peg.509","1921"
"25110",14,483,469,"AACTCAGAACACTTTAATG","ACGATGACGCCATAAGTTTC","561307.5.peg.509","1921"
"25111",213,483,270,"TGAACTAGATATGTGTAGTC","ACGATGACGCCATAAGTTTC","561307.5.peg.509","1921"
"25112",284,483,199,"GGAAGGGCACACCGCCTATA","ACGATGACGCCATAAGTTTC","561307.5.peg.509","1921"
"25113",257,483,226,"CGTGACCATGTGTTATAAAT","ACGATGACGCCATAAGTTTC","561307.5.peg.509","1921"
"25114",873,483,390,"GGTTCAATAAATGTTTCAGG","ACGATGACGCCATAAGTTTC","561307.5.peg.509","1921"
"25115",66,483,417,"GCATATACACCTACTTCATT","ACGATGACGCCATAAGTTTC","561307.5.peg.509","1921"
"25116",707,483,224,"AATACGACCTTTACAATTA","ACGATGACGCCATAAGTTTC","561307.5.peg.509","1921"
"25117",758,483,275,"CTTCAACTGCTTGTTGAACT","ACGATGACGCCATAAGTTTC","561307.5.peg.509","1921"
"25118",284,561,277,"GGAAGGGCACACCGCCTATA","ATGTTTGCTGGTTTGCCTAC","561307.5.peg.509","1921"
"25119",257,561,304,"CGTGACCATGTGTTATAAAT","ATGTTTGCTGGTTTGCCTAC","561307.5.peg.509","1921"
"25120",66,561,495,"GCATATACACCTACTTCATT","ATGTTTGCTGGTTTGCCTAC","561307.5.peg.509","1921"
"25121",14,561,547,"AACTCAGAACACTTTAATG","ATGTTTGCTGGTTTGCCTAC","561307.5.peg.509","1921"
"25122",176,561,385,"TCCCTAATAAGTTATCATCA","ATGTTTGCTGGTTTGCCTAC","561307.5.peg.509","1921"
"25123",758,561,197,"CTTCAACTGCTTGTTGAACT","ATGTTTGCTGGTTTGCCTAC","561307.5.peg.509","1921"
"25124",873,561,312,"GGTTCAATAAATGTTTCAGG","ATGTTTGCTGGTTTGCCTAC","561307.5.peg.509","1921"
"25125",213,561,348,"TGAACTAGATATGTGTAGTC","ATGTTTGCTGGTTTGCCTAC","561307.5.peg.509","1921"
"25126",707,561,146,"AATACGACCTTTACAATTA","ATGTTTGCTGGTTTGCCTAC","561307.5.peg.509","1921"
"25127",14,707,693,"AACTCAGAACACTTTAATG","AATACGACCTTTACAATTA","561307.5.peg.509","1921"
"25128",176,707,531,"TCCCTAATAAGTTATCATCA","AATACGACCTTTACAATTA","561307.5.peg.509","1921"
"25129",213,707,494,"TGAACTAGATATGTGTAGTC","AATACGACCTTTACAATTA","561307.5.peg.509","1921"
"25130",873,707,166,"GGTTCAATAAATGTTTCAGG","AATACGACCTTTACAATTA","561307.5.peg.509","1921"
"25131",483,707,224,"ACGATGACGCCATAAGTTTC","AATACGACCTTTACAATTA","561307.5.peg.509","1921"
"25132",66,707,641,"GCATATACACCTACTTCATT","AATACGACCTTTACAATTA","561307.5.peg.509","1921"
"25133",284,707,423,"GGAAGGGCACACCGCCTATA","AATACGACCTTTACAATTA","561307.5.peg.509","1921"
"25134",561,707,146,"ATGTTTGCTGGTTTGCCTAC","AATACGACCTTTACAATTA","561307.5.peg.509","1921"
"25135",257,707,450,"CGTGACCATGTGTTATAAAT","AATACGACCTTTACAATTA","561307.5.peg.509","1921"
"25136",14,758,744,"AACTCAGAACACTTTAATG","CTTCAACTGCTTGTTGAACT","561307.5.peg.509","1921"
"25137",561,758,197,"ATGTTTGCTGGTTTGCCTAC","CTTCAACTGCTTGTTGAACT","561307.5.peg.509","1921"
"25138",284,758,474,"GGAAGGGCACACCGCCTATA","CTTCAACTGCTTGTTGAACT","561307.5.peg.509","1921"
"25139",213,758,545,"TGAACTAGATATGTGTAGTC","CTTCAACTGCTTGTTGAACT","561307.5.peg.509","1921"
"25140",483,758,275,"ACGATGACGCCATAAGTTTC","CTTCAACTGCTTGTTGAACT","561307.5.peg.509","1921"
"25141",66,758,692,"GCATATACACCTACTTCATT","CTTCAACTGCTTGTTGAACT","561307.5.peg.509","1921"
"25142",176,758,582,"TCCCTAATAAGTTATCATCA","CTTCAACTGCTTGTTGAACT","561307.5.peg.509","1921"
"25143",257,758,501,"CGTGACCATGTGTTATAAAT","CTTCAACTGCTTGTTGAACT","561307.5.peg.509","1921"
"25144",873,758,115,"GGTTCAATAAATGTTTCAGG","CTTCAACTGCTTGTTGAACT","561307.5.peg.509","1921"
"25145",66,873,807,"GCATATACACCTACTTCATT","GGTTCAATAAATGTTTCAGG","561307.5.peg.509","1921"
"25146",176,873,697,"TCCCTAATAAGTTATCATCA","GGTTCAATAAATGTTTCAGG","561307.5.peg.509","1921"
"25147",707,873,166,"AATACGACCTTTACAATTA","GGTTCAATAAATGTTTCAGG","561307.5.peg.509","1921"
"25148",14,873,859,"AACTCAGAACACTTTAATG","GGTTCAATAAATGTTTCAGG","561307.5.peg.509","1921"
"25149",758,873,115,"CTTCAACTGCTTGTTGAACT","GGTTCAATAAATGTTTCAGG","561307.5.peg.509","1921"
"25150",561,873,312,"ATGTTTGCTGGTTTGCCTAC","GGTTCAATAAATGTTTCAGG","561307.5.peg.509","1921"
"25151",213,873,660,"TGAACTAGATATGTGTAGTC","GGTTCAATAAATGTTTCAGG","561307.5.peg.509","1921"
"25152",284,873,589,"GGAAGGGCACACCGCCTATA","GGTTCAATAAATGTTTCAGG","561307.5.peg.509","1921"
"25153",257,873,616,"CGTGACCATGTGTTATAAAT","GGTTCAATAAATGTTTCAGG","561307.5.peg.509","1921"
"25154",483,873,390,"ACGATGACGCCATAAGTTTC","GGTTCAATAAATGTTTCAGG","561307.5.peg.509","1921"
"25155",650,90,560,"AGCCACTGTCATGCGCTGAA","GTAATATGGCTGTAATTAC","561307.5.peg.51","1922"
"25156",750,90,660,"GGTGGTGCATAGTATGCACT","GTAATATGGCTGTAATTAC","561307.5.peg.51","1922"
"25157",771,90,681,"AGAATGCAATGATTGGAAT","GTAATATGGCTGTAATTAC","561307.5.peg.51","1922"
"25158",731,90,641,"TAGGTAACCAAACAAACATT","GTAATATGGCTGTAATTAC","561307.5.peg.51","1922"
"25159",222,90,132,"GAACCTAGCTCTACGCGTAT","GTAATATGGCTGTAATTAC","561307.5.peg.51","1922"
"25160",568,90,478,"CGCTACACCCATTACGAAGA","GTAATATGGCTGTAATTAC","561307.5.peg.51","1922"
"25161",568,132,436,"CGCTACACCCATTACGAAGA","GCGACATAACGCTTTATAAT","561307.5.peg.51","1922"
"25162",750,132,618,"GGTGGTGCATAGTATGCACT","GCGACATAACGCTTTATAAT","561307.5.peg.51","1922"
"25163",731,132,599,"TAGGTAACCAAACAAACATT","GCGACATAACGCTTTATAAT","561307.5.peg.51","1922"
"25164",771,132,639,"AGAATGCAATGATTGGAAT","GCGACATAACGCTTTATAAT","561307.5.peg.51","1922"
"25165",650,132,518,"AGCCACTGTCATGCGCTGAA","GCGACATAACGCTTTATAAT","561307.5.peg.51","1922"
"25166",650,175,475,"AGCCACTGTCATGCGCTGAA","ATTGATAATTGCCGCGACCA","561307.5.peg.51","1922"
"25167",771,175,596,"AGAATGCAATGATTGGAAT","ATTGATAATTGCCGCGACCA","561307.5.peg.51","1922"
"25168",750,175,575,"GGTGGTGCATAGTATGCACT","ATTGATAATTGCCGCGACCA","561307.5.peg.51","1922"
"25169",731,175,556,"TAGGTAACCAAACAAACATT","ATTGATAATTGCCGCGACCA","561307.5.peg.51","1922"
"25170",568,175,393,"CGCTACACCCATTACGAAGA","ATTGATAATTGCCGCGACCA","561307.5.peg.51","1922"
"25171",90,222,132,"GTAATATGGCTGTAATTAC","GAACCTAGCTCTACGCGTAT","561307.5.peg.51","1922"
"25172",750,222,528,"GGTGGTGCATAGTATGCACT","GAACCTAGCTCTACGCGTAT","561307.5.peg.51","1922"
"25173",568,222,346,"CGCTACACCCATTACGAAGA","GAACCTAGCTCTACGCGTAT","561307.5.peg.51","1922"
"25174",731,222,509,"TAGGTAACCAAACAAACATT","GAACCTAGCTCTACGCGTAT","561307.5.peg.51","1922"
"25175",650,222,428,"AGCCACTGTCATGCGCTGAA","GAACCTAGCTCTACGCGTAT","561307.5.peg.51","1922"
"25176",771,222,549,"AGAATGCAATGATTGGAAT","GAACCTAGCTCTACGCGTAT","561307.5.peg.51","1922"
"25177",750,568,182,"GGTGGTGCATAGTATGCACT","CGCTACACCCATTACGAAGA","561307.5.peg.51","1922"
"25178",731,568,163,"TAGGTAACCAAACAAACATT","CGCTACACCCATTACGAAGA","561307.5.peg.51","1922"
"25179",90,568,478,"GTAATATGGCTGTAATTAC","CGCTACACCCATTACGAAGA","561307.5.peg.51","1922"
"25180",222,568,346,"GAACCTAGCTCTACGCGTAT","CGCTACACCCATTACGAAGA","561307.5.peg.51","1922"
"25181",771,568,203,"AGAATGCAATGATTGGAAT","CGCTACACCCATTACGAAGA","561307.5.peg.51","1922"
"25182",132,568,436,"GCGACATAACGCTTTATAAT","CGCTACACCCATTACGAAGA","561307.5.peg.51","1922"
"25183",175,568,393,"ATTGATAATTGCCGCGACCA","CGCTACACCCATTACGAAGA","561307.5.peg.51","1922"
"25184",90,650,560,"GTAATATGGCTGTAATTAC","AGCCACTGTCATGCGCTGAA","561307.5.peg.51","1922"
"25185",175,650,475,"ATTGATAATTGCCGCGACCA","AGCCACTGTCATGCGCTGAA","561307.5.peg.51","1922"
"25186",771,650,121,"AGAATGCAATGATTGGAAT","AGCCACTGTCATGCGCTGAA","561307.5.peg.51","1922"
"25187",750,650,100,"GGTGGTGCATAGTATGCACT","AGCCACTGTCATGCGCTGAA","561307.5.peg.51","1922"
"25188",222,650,428,"GAACCTAGCTCTACGCGTAT","AGCCACTGTCATGCGCTGAA","561307.5.peg.51","1922"
"25189",132,650,518,"GCGACATAACGCTTTATAAT","AGCCACTGTCATGCGCTGAA","561307.5.peg.51","1922"
"25190",175,731,556,"ATTGATAATTGCCGCGACCA","TAGGTAACCAAACAAACATT","561307.5.peg.51","1922"
"25191",132,731,599,"GCGACATAACGCTTTATAAT","TAGGTAACCAAACAAACATT","561307.5.peg.51","1922"
"25192",568,731,163,"CGCTACACCCATTACGAAGA","TAGGTAACCAAACAAACATT","561307.5.peg.51","1922"
"25193",222,731,509,"GAACCTAGCTCTACGCGTAT","TAGGTAACCAAACAAACATT","561307.5.peg.51","1922"
"25194",90,731,641,"GTAATATGGCTGTAATTAC","TAGGTAACCAAACAAACATT","561307.5.peg.51","1922"
"25195",175,750,575,"ATTGATAATTGCCGCGACCA","GGTGGTGCATAGTATGCACT","561307.5.peg.51","1922"
"25196",222,750,528,"GAACCTAGCTCTACGCGTAT","GGTGGTGCATAGTATGCACT","561307.5.peg.51","1922"
"25197",132,750,618,"GCGACATAACGCTTTATAAT","GGTGGTGCATAGTATGCACT","561307.5.peg.51","1922"
"25198",650,750,100,"AGCCACTGTCATGCGCTGAA","GGTGGTGCATAGTATGCACT","561307.5.peg.51","1922"
"25199",90,750,660,"GTAATATGGCTGTAATTAC","GGTGGTGCATAGTATGCACT","561307.5.peg.51","1922"
"25200",568,750,182,"CGCTACACCCATTACGAAGA","GGTGGTGCATAGTATGCACT","561307.5.peg.51","1922"
"25201",650,771,121,"AGCCACTGTCATGCGCTGAA","AGAATGCAATGATTGGAAT","561307.5.peg.51","1922"
"25202",90,771,681,"GTAATATGGCTGTAATTAC","AGAATGCAATGATTGGAAT","561307.5.peg.51","1922"
"25203",175,771,596,"ATTGATAATTGCCGCGACCA","AGAATGCAATGATTGGAAT","561307.5.peg.51","1922"
"25204",222,771,549,"GAACCTAGCTCTACGCGTAT","AGAATGCAATGATTGGAAT","561307.5.peg.51","1922"
"25205",132,771,639,"GCGACATAACGCTTTATAAT","AGAATGCAATGATTGGAAT","561307.5.peg.51","1922"
"25206",568,771,203,"CGCTACACCCATTACGAAGA","AGAATGCAATGATTGGAAT","561307.5.peg.51","1922"
"25207",171,9,162,"AATTGTTCATCCGTAAGATC","TACAATTATGGGAAAGGTA","561307.5.peg.513","1926"
"25208",230,9,221,"ATGAGATAGAACGTTGATCA","TACAATTATGGGAAAGGTA","561307.5.peg.513","1926"
"25209",354,9,345,"TGAGGAACATCTCTGTATCC","TACAATTATGGGAAAGGTA","561307.5.peg.513","1926"
"25210",449,9,440,"TTAATGCATTAACGCCTTCA","TACAATTATGGGAAAGGTA","561307.5.peg.513","1926"
"25211",354,57,297,"TGAGGAACATCTCTGTATCC","TCGAATTGGGCTTGTAACTT","561307.5.peg.513","1926"
"25212",171,57,114,"AATTGTTCATCCGTAAGATC","TCGAATTGGGCTTGTAACTT","561307.5.peg.513","1926"
"25213",449,57,392,"TTAATGCATTAACGCCTTCA","TCGAATTGGGCTTGTAACTT","561307.5.peg.513","1926"
"25214",230,57,173,"ATGAGATAGAACGTTGATCA","TCGAATTGGGCTTGTAACTT","561307.5.peg.513","1926"
"25215",9,171,162,"TACAATTATGGGAAAGGTA","AATTGTTCATCCGTAAGATC","561307.5.peg.513","1926"
"25216",354,171,183,"TGAGGAACATCTCTGTATCC","AATTGTTCATCCGTAAGATC","561307.5.peg.513","1926"
"25217",57,171,114,"TCGAATTGGGCTTGTAACTT","AATTGTTCATCCGTAAGATC","561307.5.peg.513","1926"
"25218",449,171,278,"TTAATGCATTAACGCCTTCA","AATTGTTCATCCGTAAGATC","561307.5.peg.513","1926"
"25219",9,230,221,"TACAATTATGGGAAAGGTA","ATGAGATAGAACGTTGATCA","561307.5.peg.513","1926"
"25220",354,230,124,"TGAGGAACATCTCTGTATCC","ATGAGATAGAACGTTGATCA","561307.5.peg.513","1926"
"25221",57,230,173,"TCGAATTGGGCTTGTAACTT","ATGAGATAGAACGTTGATCA","561307.5.peg.513","1926"
"25222",449,230,219,"TTAATGCATTAACGCCTTCA","ATGAGATAGAACGTTGATCA","561307.5.peg.513","1926"
"25223",171,354,183,"AATTGTTCATCCGTAAGATC","TGAGGAACATCTCTGTATCC","561307.5.peg.513","1926"
"25224",9,354,345,"TACAATTATGGGAAAGGTA","TGAGGAACATCTCTGTATCC","561307.5.peg.513","1926"
"25225",230,354,124,"ATGAGATAGAACGTTGATCA","TGAGGAACATCTCTGTATCC","561307.5.peg.513","1926"
"25226",57,354,297,"TCGAATTGGGCTTGTAACTT","TGAGGAACATCTCTGTATCC","561307.5.peg.513","1926"
"25227",9,449,440,"TACAATTATGGGAAAGGTA","TTAATGCATTAACGCCTTCA","561307.5.peg.513","1926"
"25228",57,449,392,"TCGAATTGGGCTTGTAACTT","TTAATGCATTAACGCCTTCA","561307.5.peg.513","1926"
"25229",171,449,278,"AATTGTTCATCCGTAAGATC","TTAATGCATTAACGCCTTCA","561307.5.peg.513","1926"
"25230",230,449,219,"ATGAGATAGAACGTTGATCA","TTAATGCATTAACGCCTTCA","561307.5.peg.513","1926"
"25231",275,164,111,"ATTGTACTTCCATAACCGGA","TTTGTAGTCCTTCAGTAACA","561307.5.peg.514","1927"
"25232",401,164,237,"TGTGTACGCCACCACCAAAT","TTTGTAGTCCTTCAGTAACA","561307.5.peg.514","1927"
"25233",471,164,307,"GGAATAACAACCTTTAGACC","TTTGTAGTCCTTCAGTAACA","561307.5.peg.514","1927"
"25234",279,164,115,"AAGAATTGTACTTCCATAAC","TTTGTAGTCCTTCAGTAACA","561307.5.peg.514","1927"
"25235",384,164,220,"AATGGGCTACGAATTGTTAC","TTTGTAGTCCTTCAGTAACA","561307.5.peg.514","1927"
"25236",426,164,262,"AAGTTATCTGCGTGTAATTC","TTTGTAGTCCTTCAGTAACA","561307.5.peg.514","1927"
"25237",492,164,328,"TTCGCATCGTATGGGCCTGA","TTTGTAGTCCTTCAGTAACA","561307.5.peg.514","1927"
"25238",492,275,217,"TTCGCATCGTATGGGCCTGA","ATTGTACTTCCATAACCGGA","561307.5.peg.514","1927"
"25239",384,275,109,"AATGGGCTACGAATTGTTAC","ATTGTACTTCCATAACCGGA","561307.5.peg.514","1927"
"25240",401,275,126,"TGTGTACGCCACCACCAAAT","ATTGTACTTCCATAACCGGA","561307.5.peg.514","1927"
"25241",471,275,196,"GGAATAACAACCTTTAGACC","ATTGTACTTCCATAACCGGA","561307.5.peg.514","1927"
"25242",164,275,111,"TTTGTAGTCCTTCAGTAACA","ATTGTACTTCCATAACCGGA","561307.5.peg.514","1927"
"25243",426,275,151,"AAGTTATCTGCGTGTAATTC","ATTGTACTTCCATAACCGGA","561307.5.peg.514","1927"
"25244",164,279,115,"TTTGTAGTCCTTCAGTAACA","AAGAATTGTACTTCCATAAC","561307.5.peg.514","1927"
"25245",384,279,105,"AATGGGCTACGAATTGTTAC","AAGAATTGTACTTCCATAAC","561307.5.peg.514","1927"
"25246",426,279,147,"AAGTTATCTGCGTGTAATTC","AAGAATTGTACTTCCATAAC","561307.5.peg.514","1927"
"25247",492,279,213,"TTCGCATCGTATGGGCCTGA","AAGAATTGTACTTCCATAAC","561307.5.peg.514","1927"
"25248",471,279,192,"GGAATAACAACCTTTAGACC","AAGAATTGTACTTCCATAAC","561307.5.peg.514","1927"
"25249",401,279,122,"TGTGTACGCCACCACCAAAT","AAGAATTGTACTTCCATAAC","561307.5.peg.514","1927"
"25250",164,384,220,"TTTGTAGTCCTTCAGTAACA","AATGGGCTACGAATTGTTAC","561307.5.peg.514","1927"
"25251",279,384,105,"AAGAATTGTACTTCCATAAC","AATGGGCTACGAATTGTTAC","561307.5.peg.514","1927"
"25252",492,384,108,"TTCGCATCGTATGGGCCTGA","AATGGGCTACGAATTGTTAC","561307.5.peg.514","1927"
"25253",275,384,109,"ATTGTACTTCCATAACCGGA","AATGGGCTACGAATTGTTAC","561307.5.peg.514","1927"
"25254",164,401,237,"TTTGTAGTCCTTCAGTAACA","TGTGTACGCCACCACCAAAT","561307.5.peg.514","1927"
"25255",275,401,126,"ATTGTACTTCCATAACCGGA","TGTGTACGCCACCACCAAAT","561307.5.peg.514","1927"
"25256",279,401,122,"AAGAATTGTACTTCCATAAC","TGTGTACGCCACCACCAAAT","561307.5.peg.514","1927"
"25257",279,426,147,"AAGAATTGTACTTCCATAAC","AAGTTATCTGCGTGTAATTC","561307.5.peg.514","1927"
"25258",164,426,262,"TTTGTAGTCCTTCAGTAACA","AAGTTATCTGCGTGTAATTC","561307.5.peg.514","1927"
"25259",275,426,151,"ATTGTACTTCCATAACCGGA","AAGTTATCTGCGTGTAATTC","561307.5.peg.514","1927"
"25260",164,471,307,"TTTGTAGTCCTTCAGTAACA","GGAATAACAACCTTTAGACC","561307.5.peg.514","1927"
"25261",275,471,196,"ATTGTACTTCCATAACCGGA","GGAATAACAACCTTTAGACC","561307.5.peg.514","1927"
"25262",279,471,192,"AAGAATTGTACTTCCATAAC","GGAATAACAACCTTTAGACC","561307.5.peg.514","1927"
"25263",164,492,328,"TTTGTAGTCCTTCAGTAACA","TTCGCATCGTATGGGCCTGA","561307.5.peg.514","1927"
"25264",384,492,108,"AATGGGCTACGAATTGTTAC","TTCGCATCGTATGGGCCTGA","561307.5.peg.514","1927"
"25265",279,492,213,"AAGAATTGTACTTCCATAAC","TTCGCATCGTATGGGCCTGA","561307.5.peg.514","1927"
"25266",275,492,217,"ATTGTACTTCCATAACCGGA","TTCGCATCGTATGGGCCTGA","561307.5.peg.514","1927"
"25267",615,72,543,"CCTTCTAATGTTACTGCTGC","TGGATACCTTCCCCGATATC","561307.5.peg.515","1928"
"25268",194,72,122,"CAGTACCAGATGCTGGTGAT","TGGATACCTTCCCCGATATC","561307.5.peg.515","1928"
"25269",432,72,360,"CGTGCGTATTTACGTACTGA","TGGATACCTTCCCCGATATC","561307.5.peg.515","1928"
"25270",606,72,534,"GTTACTGCTGCAGGTGCTGC","TGGATACCTTCCCCGATATC","561307.5.peg.515","1928"
"25271",285,72,213,"AATTGCATATCTTCTGCATC","TGGATACCTTCCCCGATATC","561307.5.peg.515","1928"
"25272",201,72,129,"TCTTCTACAGTACCAGATGC","TGGATACCTTCCCCGATATC","561307.5.peg.515","1928"
"25273",665,72,593,"CAATTGCTCTACGCATAGCA","TGGATACCTTCCCCGATATC","561307.5.peg.515","1928"
"25274",378,72,306,"TCTTCAGTTTGAGTAGCTAC","TGGATACCTTCCCCGATATC","561307.5.peg.515","1928"
"25275",72,194,122,"TGGATACCTTCCCCGATATC","CAGTACCAGATGCTGGTGAT","561307.5.peg.515","1928"
"25276",665,194,471,"CAATTGCTCTACGCATAGCA","CAGTACCAGATGCTGGTGAT","561307.5.peg.515","1928"
"25277",615,194,421,"CCTTCTAATGTTACTGCTGC","CAGTACCAGATGCTGGTGAT","561307.5.peg.515","1928"
"25278",432,194,238,"CGTGCGTATTTACGTACTGA","CAGTACCAGATGCTGGTGAT","561307.5.peg.515","1928"
"25279",378,194,184,"TCTTCAGTTTGAGTAGCTAC","CAGTACCAGATGCTGGTGAT","561307.5.peg.515","1928"
"25280",606,194,412,"GTTACTGCTGCAGGTGCTGC","CAGTACCAGATGCTGGTGAT","561307.5.peg.515","1928"
"25281",615,201,414,"CCTTCTAATGTTACTGCTGC","TCTTCTACAGTACCAGATGC","561307.5.peg.515","1928"
"25282",378,201,177,"TCTTCAGTTTGAGTAGCTAC","TCTTCTACAGTACCAGATGC","561307.5.peg.515","1928"
"25283",432,201,231,"CGTGCGTATTTACGTACTGA","TCTTCTACAGTACCAGATGC","561307.5.peg.515","1928"
"25284",72,201,129,"TGGATACCTTCCCCGATATC","TCTTCTACAGTACCAGATGC","561307.5.peg.515","1928"
"25285",606,201,405,"GTTACTGCTGCAGGTGCTGC","TCTTCTACAGTACCAGATGC","561307.5.peg.515","1928"
"25286",665,201,464,"CAATTGCTCTACGCATAGCA","TCTTCTACAGTACCAGATGC","561307.5.peg.515","1928"
"25287",606,285,321,"GTTACTGCTGCAGGTGCTGC","AATTGCATATCTTCTGCATC","561307.5.peg.515","1928"
"25288",615,285,330,"CCTTCTAATGTTACTGCTGC","AATTGCATATCTTCTGCATC","561307.5.peg.515","1928"
"25289",72,285,213,"TGGATACCTTCCCCGATATC","AATTGCATATCTTCTGCATC","561307.5.peg.515","1928"
"25290",665,285,380,"CAATTGCTCTACGCATAGCA","AATTGCATATCTTCTGCATC","561307.5.peg.515","1928"
"25291",432,285,147,"CGTGCGTATTTACGTACTGA","AATTGCATATCTTCTGCATC","561307.5.peg.515","1928"
"25292",72,378,306,"TGGATACCTTCCCCGATATC","TCTTCAGTTTGAGTAGCTAC","561307.5.peg.515","1928"
"25293",194,378,184,"CAGTACCAGATGCTGGTGAT","TCTTCAGTTTGAGTAGCTAC","561307.5.peg.515","1928"
"25294",201,378,177,"TCTTCTACAGTACCAGATGC","TCTTCAGTTTGAGTAGCTAC","561307.5.peg.515","1928"
"25295",606,378,228,"GTTACTGCTGCAGGTGCTGC","TCTTCAGTTTGAGTAGCTAC","561307.5.peg.515","1928"
"25296",615,378,237,"CCTTCTAATGTTACTGCTGC","TCTTCAGTTTGAGTAGCTAC","561307.5.peg.515","1928"
"25297",665,378,287,"CAATTGCTCTACGCATAGCA","TCTTCAGTTTGAGTAGCTAC","561307.5.peg.515","1928"
"25298",201,432,231,"TCTTCTACAGTACCAGATGC","CGTGCGTATTTACGTACTGA","561307.5.peg.515","1928"
"25299",615,432,183,"CCTTCTAATGTTACTGCTGC","CGTGCGTATTTACGTACTGA","561307.5.peg.515","1928"
"25300",194,432,238,"CAGTACCAGATGCTGGTGAT","CGTGCGTATTTACGTACTGA","561307.5.peg.515","1928"
"25301",665,432,233,"CAATTGCTCTACGCATAGCA","CGTGCGTATTTACGTACTGA","561307.5.peg.515","1928"
"25302",72,432,360,"TGGATACCTTCCCCGATATC","CGTGCGTATTTACGTACTGA","561307.5.peg.515","1928"
"25303",606,432,174,"GTTACTGCTGCAGGTGCTGC","CGTGCGTATTTACGTACTGA","561307.5.peg.515","1928"
"25304",285,432,147,"AATTGCATATCTTCTGCATC","CGTGCGTATTTACGTACTGA","561307.5.peg.515","1928"
"25305",285,606,321,"AATTGCATATCTTCTGCATC","GTTACTGCTGCAGGTGCTGC","561307.5.peg.515","1928"
"25306",201,606,405,"TCTTCTACAGTACCAGATGC","GTTACTGCTGCAGGTGCTGC","561307.5.peg.515","1928"
"25307",432,606,174,"CGTGCGTATTTACGTACTGA","GTTACTGCTGCAGGTGCTGC","561307.5.peg.515","1928"
"25308",72,606,534,"TGGATACCTTCCCCGATATC","GTTACTGCTGCAGGTGCTGC","561307.5.peg.515","1928"
"25309",194,606,412,"CAGTACCAGATGCTGGTGAT","GTTACTGCTGCAGGTGCTGC","561307.5.peg.515","1928"
"25310",378,606,228,"TCTTCAGTTTGAGTAGCTAC","GTTACTGCTGCAGGTGCTGC","561307.5.peg.515","1928"
"25311",194,615,421,"CAGTACCAGATGCTGGTGAT","CCTTCTAATGTTACTGCTGC","561307.5.peg.515","1928"
"25312",432,615,183,"CGTGCGTATTTACGTACTGA","CCTTCTAATGTTACTGCTGC","561307.5.peg.515","1928"
"25313",285,615,330,"AATTGCATATCTTCTGCATC","CCTTCTAATGTTACTGCTGC","561307.5.peg.515","1928"
"25314",378,615,237,"TCTTCAGTTTGAGTAGCTAC","CCTTCTAATGTTACTGCTGC","561307.5.peg.515","1928"
"25315",201,615,414,"TCTTCTACAGTACCAGATGC","CCTTCTAATGTTACTGCTGC","561307.5.peg.515","1928"
"25316",72,615,543,"TGGATACCTTCCCCGATATC","CCTTCTAATGTTACTGCTGC","561307.5.peg.515","1928"
"25317",432,665,233,"CGTGCGTATTTACGTACTGA","CAATTGCTCTACGCATAGCA","561307.5.peg.515","1928"
"25318",72,665,593,"TGGATACCTTCCCCGATATC","CAATTGCTCTACGCATAGCA","561307.5.peg.515","1928"
"25319",201,665,464,"TCTTCTACAGTACCAGATGC","CAATTGCTCTACGCATAGCA","561307.5.peg.515","1928"
"25320",378,665,287,"TCTTCAGTTTGAGTAGCTAC","CAATTGCTCTACGCATAGCA","561307.5.peg.515","1928"
"25321",285,665,380,"AATTGCATATCTTCTGCATC","CAATTGCTCTACGCATAGCA","561307.5.peg.515","1928"
"25322",194,665,471,"CAGTACCAGATGCTGGTGAT","CAATTGCTCTACGCATAGCA","561307.5.peg.515","1928"
"25323",216,8,208,"TAAATCACTTCACCACTGTC","ACAGCTTCATATTTATAGGG","561307.5.peg.519","1932"
"25324",538,8,530,"ACGCAATTTCAAATCTAATG","ACAGCTTCATATTTATAGGG","561307.5.peg.519","1932"
"25325",315,8,307,"TATCATAGACGTTTAAGTG","ACAGCTTCATATTTATAGGG","561307.5.peg.519","1932"
"25326",8,216,208,"ACAGCTTCATATTTATAGGG","TAAATCACTTCACCACTGTC","561307.5.peg.519","1932"
"25327",538,216,322,"ACGCAATTTCAAATCTAATG","TAAATCACTTCACCACTGTC","561307.5.peg.519","1932"
"25328",8,315,307,"ACAGCTTCATATTTATAGGG","TATCATAGACGTTTAAGTG","561307.5.peg.519","1932"
"25329",538,315,223,"ACGCAATTTCAAATCTAATG","TATCATAGACGTTTAAGTG","561307.5.peg.519","1932"
"25330",315,538,223,"TATCATAGACGTTTAAGTG","ACGCAATTTCAAATCTAATG","561307.5.peg.519","1932"
"25331",216,538,322,"TAAATCACTTCACCACTGTC","ACGCAATTTCAAATCTAATG","561307.5.peg.519","1932"
"25332",8,538,530,"ACAGCTTCATATTTATAGGG","ACGCAATTTCAAATCTAATG","561307.5.peg.519","1932"
"25333",152,9,143,"GTAAGAGGTAAACAAGAACT","TACGTTAAAGCTGTATTAGG","561307.5.peg.52","1933"
"25334",167,9,158,"CTGGTAACACTCTGTGTAAG","TACGTTAAAGCTGTATTAGG","561307.5.peg.52","1933"
"25335",152,11,141,"GTAAGAGGTAAACAAGAACT","ACAGCTTTAACGTAGGTTGA","561307.5.peg.52","1933"
"25336",167,11,156,"CTGGTAACACTCTGTGTAAG","ACAGCTTTAACGTAGGTTGA","561307.5.peg.52","1933"
"25337",152,12,140,"GTAAGAGGTAAACAAGAACT","ACCTACGTTAAAGCTGTATT","561307.5.peg.52","1933"
"25338",167,12,155,"CTGGTAACACTCTGTGTAAG","ACCTACGTTAAAGCTGTATT","561307.5.peg.52","1933"
"25339",9,152,143,"TACGTTAAAGCTGTATTAGG","GTAAGAGGTAAACAAGAACT","561307.5.peg.52","1933"
"25340",11,152,141,"ACAGCTTTAACGTAGGTTGA","GTAAGAGGTAAACAAGAACT","561307.5.peg.52","1933"
"25341",12,152,140,"ACCTACGTTAAAGCTGTATT","GTAAGAGGTAAACAAGAACT","561307.5.peg.52","1933"
"25342",9,167,158,"TACGTTAAAGCTGTATTAGG","CTGGTAACACTCTGTGTAAG","561307.5.peg.52","1933"
"25343",11,167,156,"ACAGCTTTAACGTAGGTTGA","CTGGTAACACTCTGTGTAAG","561307.5.peg.52","1933"
"25344",12,167,155,"ACCTACGTTAAAGCTGTATT","CTGGTAACACTCTGTGTAAG","561307.5.peg.52","1933"
"25345",259,10,249,"AGCTGGATAACTGATAGTCA","AAACGTATTGAAAGCTATG","561307.5.peg.520","1934"
"25346",276,10,266,"CGAGTAATATAATAGGCAGC","AAACGTATTGAAAGCTATG","561307.5.peg.520","1934"
"25347",259,80,179,"AGCTGGATAACTGATAGTCA","TAACCATCCATAGTAAATAC","561307.5.peg.520","1934"
"25348",276,80,196,"CGAGTAATATAATAGGCAGC","TAACCATCCATAGTAAATAC","561307.5.peg.520","1934"
"25349",10,259,249,"AAACGTATTGAAAGCTATG","AGCTGGATAACTGATAGTCA","561307.5.peg.520","1934"
"25350",80,259,179,"TAACCATCCATAGTAAATAC","AGCTGGATAACTGATAGTCA","561307.5.peg.520","1934"
"25351",10,276,266,"AAACGTATTGAAAGCTATG","CGAGTAATATAATAGGCAGC","561307.5.peg.520","1934"
"25352",80,276,196,"TAACCATCCATAGTAAATAC","CGAGTAATATAATAGGCAGC","561307.5.peg.520","1934"
"25353",216,33,183,"TGATTAAGCATACGATAAC","CCCATTGTTGCACCTAGTAC","561307.5.peg.525","1939"
"25354",33,216,183,"CCCATTGTTGCACCTAGTAC","TGATTAAGCATACGATAAC","561307.5.peg.525","1939"
"25355",165,10,155,"CCAACAGCGACTAATAACCC","TATTGTCCATAAGAAGTAG","561307.5.peg.526","1940"
"25356",198,10,188,"ATTGATGTTATCCAGTTTCC","TATTGTCCATAAGAAGTAG","561307.5.peg.526","1940"
"25357",232,10,222,"TAGCAAAGTATAGCCATATT","TATTGTCCATAAGAAGTAG","561307.5.peg.526","1940"
"25358",165,26,139,"CCAACAGCGACTAATAACCC","TGACTCACCTCTACTTCTTA","561307.5.peg.526","1940"
"25359",198,26,172,"ATTGATGTTATCCAGTTTCC","TGACTCACCTCTACTTCTTA","561307.5.peg.526","1940"
"25360",232,26,206,"TAGCAAAGTATAGCCATATT","TGACTCACCTCTACTTCTTA","561307.5.peg.526","1940"
"25361",10,165,155,"TATTGTCCATAAGAAGTAG","CCAACAGCGACTAATAACCC","561307.5.peg.526","1940"
"25362",26,165,139,"TGACTCACCTCTACTTCTTA","CCAACAGCGACTAATAACCC","561307.5.peg.526","1940"
"25363",10,198,188,"TATTGTCCATAAGAAGTAG","ATTGATGTTATCCAGTTTCC","561307.5.peg.526","1940"
"25364",26,198,172,"TGACTCACCTCTACTTCTTA","ATTGATGTTATCCAGTTTCC","561307.5.peg.526","1940"
"25365",10,232,222,"TATTGTCCATAAGAAGTAG","TAGCAAAGTATAGCCATATT","561307.5.peg.526","1940"
"25366",26,232,206,"TGACTCACCTCTACTTCTTA","TAGCAAAGTATAGCCATATT","561307.5.peg.526","1940"
"25367",222,70,152,"TCACCTAATACTTGATGATT","TGCTTCTTGAATAAGTCCTT","561307.5.peg.528","1942"
"25368",274,70,204,"AACAATCCATACCGTACCTT","TGCTTCTTGAATAAGTCCTT","561307.5.peg.528","1942"
"25369",299,70,229,"AATTCAATGTACCGTCTATT","TGCTTCTTGAATAAGTCCTT","561307.5.peg.528","1942"
"25370",70,222,152,"TGCTTCTTGAATAAGTCCTT","TCACCTAATACTTGATGATT","561307.5.peg.528","1942"
"25371",70,274,204,"TGCTTCTTGAATAAGTCCTT","AACAATCCATACCGTACCTT","561307.5.peg.528","1942"
"25372",70,299,229,"TGCTTCTTGAATAAGTCCTT","AATTCAATGTACCGTCTATT","561307.5.peg.528","1942"
"25373",468,285,183,"ACTTCATCTACAACACCCTC","CCACCAAAGTCTGCATGTCC","561307.5.peg.530","1945"
"25374",456,285,171,"ACACCCTCTGGACGTGCTGA","CCACCAAAGTCTGCATGTCC","561307.5.peg.530","1945"
"25375",539,285,254,"CTGCTGAAGCATAAACAACA","CCACCAAAGTCTGCATGTCC","561307.5.peg.530","1945"
"25376",642,285,357,"TCACTGTTATCAATTGGAGC","CCACCAAAGTCTGCATGTCC","561307.5.peg.530","1945"
"25377",927,285,642,"AATGCTTCTTGATGGTCATG","CCACCAAAGTCTGCATGTCC","561307.5.peg.530","1945"
"25378",669,285,384,"ATGCTACTTGGAATTGTAA","CCACCAAAGTCTGCATGTCC","561307.5.peg.530","1945"
"25379",419,285,134,"TAACAACAACAACAGGTTTC","CCACCAAAGTCTGCATGTCC","561307.5.peg.530","1945"
"25380",680,285,395,"TGTAGTCCAACAATGCTACT","CCACCAAAGTCTGCATGTCC","561307.5.peg.530","1945"
"25381",648,285,363,"GGCTCATCACTGTTATCAAT","CCACCAAAGTCTGCATGTCC","561307.5.peg.530","1945"
"25382",285,419,134,"CCACCAAAGTCTGCATGTCC","TAACAACAACAACAGGTTTC","561307.5.peg.530","1945"
"25383",642,419,223,"TCACTGTTATCAATTGGAGC","TAACAACAACAACAGGTTTC","561307.5.peg.530","1945"
"25384",669,419,250,"ATGCTACTTGGAATTGTAA","TAACAACAACAACAGGTTTC","561307.5.peg.530","1945"
"25385",648,419,229,"GGCTCATCACTGTTATCAAT","TAACAACAACAACAGGTTTC","561307.5.peg.530","1945"
"25386",680,419,261,"TGTAGTCCAACAATGCTACT","TAACAACAACAACAGGTTTC","561307.5.peg.530","1945"
"25387",927,419,508,"AATGCTTCTTGATGGTCATG","TAACAACAACAACAGGTTTC","561307.5.peg.530","1945"
"25388",539,419,120,"CTGCTGAAGCATAAACAACA","TAACAACAACAACAGGTTTC","561307.5.peg.530","1945"
"25389",285,456,171,"CCACCAAAGTCTGCATGTCC","ACACCCTCTGGACGTGCTGA","561307.5.peg.530","1945"
"25390",680,456,224,"TGTAGTCCAACAATGCTACT","ACACCCTCTGGACGTGCTGA","561307.5.peg.530","1945"
"25391",648,456,192,"GGCTCATCACTGTTATCAAT","ACACCCTCTGGACGTGCTGA","561307.5.peg.530","1945"
"25392",669,456,213,"ATGCTACTTGGAATTGTAA","ACACCCTCTGGACGTGCTGA","561307.5.peg.530","1945"
"25393",642,456,186,"TCACTGTTATCAATTGGAGC","ACACCCTCTGGACGTGCTGA","561307.5.peg.530","1945"
"25394",927,456,471,"AATGCTTCTTGATGGTCATG","ACACCCTCTGGACGTGCTGA","561307.5.peg.530","1945"
"25395",669,468,201,"ATGCTACTTGGAATTGTAA","ACTTCATCTACAACACCCTC","561307.5.peg.530","1945"
"25396",927,468,459,"AATGCTTCTTGATGGTCATG","ACTTCATCTACAACACCCTC","561307.5.peg.530","1945"
"25397",680,468,212,"TGTAGTCCAACAATGCTACT","ACTTCATCTACAACACCCTC","561307.5.peg.530","1945"
"25398",285,468,183,"CCACCAAAGTCTGCATGTCC","ACTTCATCTACAACACCCTC","561307.5.peg.530","1945"
"25399",642,468,174,"TCACTGTTATCAATTGGAGC","ACTTCATCTACAACACCCTC","561307.5.peg.530","1945"
"25400",648,468,180,"GGCTCATCACTGTTATCAAT","ACTTCATCTACAACACCCTC","561307.5.peg.530","1945"
"25401",285,539,254,"CCACCAAAGTCTGCATGTCC","CTGCTGAAGCATAAACAACA","561307.5.peg.530","1945"
"25402",648,539,109,"GGCTCATCACTGTTATCAAT","CTGCTGAAGCATAAACAACA","561307.5.peg.530","1945"
"25403",642,539,103,"TCACTGTTATCAATTGGAGC","CTGCTGAAGCATAAACAACA","561307.5.peg.530","1945"
"25404",669,539,130,"ATGCTACTTGGAATTGTAA","CTGCTGAAGCATAAACAACA","561307.5.peg.530","1945"
"25405",927,539,388,"AATGCTTCTTGATGGTCATG","CTGCTGAAGCATAAACAACA","561307.5.peg.530","1945"
"25406",419,539,120,"TAACAACAACAACAGGTTTC","CTGCTGAAGCATAAACAACA","561307.5.peg.530","1945"
"25407",680,539,141,"TGTAGTCCAACAATGCTACT","CTGCTGAAGCATAAACAACA","561307.5.peg.530","1945"
"25408",285,642,357,"CCACCAAAGTCTGCATGTCC","TCACTGTTATCAATTGGAGC","561307.5.peg.530","1945"
"25409",468,642,174,"ACTTCATCTACAACACCCTC","TCACTGTTATCAATTGGAGC","561307.5.peg.530","1945"
"25410",419,642,223,"TAACAACAACAACAGGTTTC","TCACTGTTATCAATTGGAGC","561307.5.peg.530","1945"
"25411",927,642,285,"AATGCTTCTTGATGGTCATG","TCACTGTTATCAATTGGAGC","561307.5.peg.530","1945"
"25412",456,642,186,"ACACCCTCTGGACGTGCTGA","TCACTGTTATCAATTGGAGC","561307.5.peg.530","1945"
"25413",539,642,103,"CTGCTGAAGCATAAACAACA","TCACTGTTATCAATTGGAGC","561307.5.peg.530","1945"
"25414",456,648,192,"ACACCCTCTGGACGTGCTGA","GGCTCATCACTGTTATCAAT","561307.5.peg.530","1945"
"25415",419,648,229,"TAACAACAACAACAGGTTTC","GGCTCATCACTGTTATCAAT","561307.5.peg.530","1945"
"25416",285,648,363,"CCACCAAAGTCTGCATGTCC","GGCTCATCACTGTTATCAAT","561307.5.peg.530","1945"
"25417",927,648,279,"AATGCTTCTTGATGGTCATG","GGCTCATCACTGTTATCAAT","561307.5.peg.530","1945"
"25418",539,648,109,"CTGCTGAAGCATAAACAACA","GGCTCATCACTGTTATCAAT","561307.5.peg.530","1945"
"25419",468,648,180,"ACTTCATCTACAACACCCTC","GGCTCATCACTGTTATCAAT","561307.5.peg.530","1945"
"25420",927,669,258,"AATGCTTCTTGATGGTCATG","ATGCTACTTGGAATTGTAA","561307.5.peg.530","1945"
"25421",456,669,213,"ACACCCTCTGGACGTGCTGA","ATGCTACTTGGAATTGTAA","561307.5.peg.530","1945"
"25422",419,669,250,"TAACAACAACAACAGGTTTC","ATGCTACTTGGAATTGTAA","561307.5.peg.530","1945"
"25423",539,669,130,"CTGCTGAAGCATAAACAACA","ATGCTACTTGGAATTGTAA","561307.5.peg.530","1945"
"25424",468,669,201,"ACTTCATCTACAACACCCTC","ATGCTACTTGGAATTGTAA","561307.5.peg.530","1945"
"25425",285,669,384,"CCACCAAAGTCTGCATGTCC","ATGCTACTTGGAATTGTAA","561307.5.peg.530","1945"
"25426",539,680,141,"CTGCTGAAGCATAAACAACA","TGTAGTCCAACAATGCTACT","561307.5.peg.530","1945"
"25427",285,680,395,"CCACCAAAGTCTGCATGTCC","TGTAGTCCAACAATGCTACT","561307.5.peg.530","1945"
"25428",927,680,247,"AATGCTTCTTGATGGTCATG","TGTAGTCCAACAATGCTACT","561307.5.peg.530","1945"
"25429",419,680,261,"TAACAACAACAACAGGTTTC","TGTAGTCCAACAATGCTACT","561307.5.peg.530","1945"
"25430",456,680,224,"ACACCCTCTGGACGTGCTGA","TGTAGTCCAACAATGCTACT","561307.5.peg.530","1945"
"25431",468,680,212,"ACTTCATCTACAACACCCTC","TGTAGTCCAACAATGCTACT","561307.5.peg.530","1945"
"25432",648,927,279,"GGCTCATCACTGTTATCAAT","AATGCTTCTTGATGGTCATG","561307.5.peg.530","1945"
"25433",680,927,247,"TGTAGTCCAACAATGCTACT","AATGCTTCTTGATGGTCATG","561307.5.peg.530","1945"
"25434",539,927,388,"CTGCTGAAGCATAAACAACA","AATGCTTCTTGATGGTCATG","561307.5.peg.530","1945"
"25435",456,927,471,"ACACCCTCTGGACGTGCTGA","AATGCTTCTTGATGGTCATG","561307.5.peg.530","1945"
"25436",419,927,508,"TAACAACAACAACAGGTTTC","AATGCTTCTTGATGGTCATG","561307.5.peg.530","1945"
"25437",468,927,459,"ACTTCATCTACAACACCCTC","AATGCTTCTTGATGGTCATG","561307.5.peg.530","1945"
"25438",285,927,642,"CCACCAAAGTCTGCATGTCC","AATGCTTCTTGATGGTCATG","561307.5.peg.530","1945"
"25439",669,927,258,"ATGCTACTTGGAATTGTAA","AATGCTTCTTGATGGTCATG","561307.5.peg.530","1945"
"25440",642,927,285,"TCACTGTTATCAATTGGAGC","AATGCTTCTTGATGGTCATG","561307.5.peg.530","1945"
"25441",212,4,208,"GCGGATTAGTTTGTCCTTCT","TATATACATTGATAGGGAGT","561307.5.peg.532","1947"
"25442",231,4,227,"TTTCTGAATTTAAAGTAGG","TATATACATTGATAGGGAGT","561307.5.peg.532","1947"
"25443",4,212,208,"TATATACATTGATAGGGAGT","GCGGATTAGTTTGTCCTTCT","561307.5.peg.532","1947"
"25444",4,231,227,"TATATACATTGATAGGGAGT","TTTCTGAATTTAAAGTAGG","561307.5.peg.532","1947"
"25445",156,9,147,"TCTTCATATAATGGGCATGA","CTTGAGAATTTATATAGAGG","561307.5.peg.533","1948"
"25446",9,156,147,"CTTGAGAATTTATATAGAGG","TCTTCATATAATGGGCATGA","561307.5.peg.533","1948"
"25447",526,153,373,"CGTTTGCCATCCGAAATTTG","TGATATGTTTGACCAACGAG","561307.5.peg.535","1950"
"25448",632,153,479,"CTTTGTAATCGAATGGATGA","TGATATGTTTGACCAACGAG","561307.5.peg.535","1950"
"25449",639,153,486,"GACATACCTTTGTAATCGAA","TGATATGTTTGACCAACGAG","561307.5.peg.535","1950"
"25450",402,153,249,"TTTAACACGCCAACTGTTGA","TGATATGTTTGACCAACGAG","561307.5.peg.535","1950"
"25451",629,153,476,"TGTAATCGAATGGATGACGG","TGATATGTTTGACCAACGAG","561307.5.peg.535","1950"
"25452",526,178,348,"CGTTTGCCATCCGAAATTTG","TAAATTTAACACGGCAGGAG","561307.5.peg.535","1950"
"25453",402,178,224,"TTTAACACGCCAACTGTTGA","TAAATTTAACACGGCAGGAG","561307.5.peg.535","1950"
"25454",639,178,461,"GACATACCTTTGTAATCGAA","TAAATTTAACACGGCAGGAG","561307.5.peg.535","1950"
"25455",629,178,451,"TGTAATCGAATGGATGACGG","TAAATTTAACACGGCAGGAG","561307.5.peg.535","1950"
"25456",632,178,454,"CTTTGTAATCGAATGGATGA","TAAATTTAACACGGCAGGAG","561307.5.peg.535","1950"
"25457",639,183,456,"GACATACCTTTGTAATCGAA","TAGATAAATTTAACACGGC","561307.5.peg.535","1950"
"25458",526,183,343,"CGTTTGCCATCCGAAATTTG","TAGATAAATTTAACACGGC","561307.5.peg.535","1950"
"25459",402,183,219,"TTTAACACGCCAACTGTTGA","TAGATAAATTTAACACGGC","561307.5.peg.535","1950"
"25460",632,183,449,"CTTTGTAATCGAATGGATGA","TAGATAAATTTAACACGGC","561307.5.peg.535","1950"
"25461",629,183,446,"TGTAATCGAATGGATGACGG","TAGATAAATTTAACACGGC","561307.5.peg.535","1950"
"25462",402,217,185,"TTTAACACGCCAACTGTTGA","CATGAAGATACCTGTGGCGA","561307.5.peg.535","1950"
"25463",639,217,422,"GACATACCTTTGTAATCGAA","CATGAAGATACCTGTGGCGA","561307.5.peg.535","1950"
"25464",629,217,412,"TGTAATCGAATGGATGACGG","CATGAAGATACCTGTGGCGA","561307.5.peg.535","1950"
"25465",632,217,415,"CTTTGTAATCGAATGGATGA","CATGAAGATACCTGTGGCGA","561307.5.peg.535","1950"
"25466",526,217,309,"CGTTTGCCATCCGAAATTTG","CATGAAGATACCTGTGGCGA","561307.5.peg.535","1950"
"25467",402,223,179,"TTTAACACGCCAACTGTTGA","AGCCACCATGAAGATACCTG","561307.5.peg.535","1950"
"25468",632,223,409,"CTTTGTAATCGAATGGATGA","AGCCACCATGAAGATACCTG","561307.5.peg.535","1950"
"25469",526,223,303,"CGTTTGCCATCCGAAATTTG","AGCCACCATGAAGATACCTG","561307.5.peg.535","1950"
"25470",639,223,416,"GACATACCTTTGTAATCGAA","AGCCACCATGAAGATACCTG","561307.5.peg.535","1950"
"25471",629,223,406,"TGTAATCGAATGGATGACGG","AGCCACCATGAAGATACCTG","561307.5.peg.535","1950"
"25472",183,402,219,"TAGATAAATTTAACACGGC","TTTAACACGCCAACTGTTGA","561307.5.peg.535","1950"
"25473",632,402,230,"CTTTGTAATCGAATGGATGA","TTTAACACGCCAACTGTTGA","561307.5.peg.535","1950"
"25474",178,402,224,"TAAATTTAACACGGCAGGAG","TTTAACACGCCAACTGTTGA","561307.5.peg.535","1950"
"25475",153,402,249,"TGATATGTTTGACCAACGAG","TTTAACACGCCAACTGTTGA","561307.5.peg.535","1950"
"25476",223,402,179,"AGCCACCATGAAGATACCTG","TTTAACACGCCAACTGTTGA","561307.5.peg.535","1950"
"25477",526,402,124,"CGTTTGCCATCCGAAATTTG","TTTAACACGCCAACTGTTGA","561307.5.peg.535","1950"
"25478",217,402,185,"CATGAAGATACCTGTGGCGA","TTTAACACGCCAACTGTTGA","561307.5.peg.535","1950"
"25479",629,402,227,"TGTAATCGAATGGATGACGG","TTTAACACGCCAACTGTTGA","561307.5.peg.535","1950"
"25480",639,402,237,"GACATACCTTTGTAATCGAA","TTTAACACGCCAACTGTTGA","561307.5.peg.535","1950"
"25481",153,526,373,"TGATATGTTTGACCAACGAG","CGTTTGCCATCCGAAATTTG","561307.5.peg.535","1950"
"25482",183,526,343,"TAGATAAATTTAACACGGC","CGTTTGCCATCCGAAATTTG","561307.5.peg.535","1950"
"25483",402,526,124,"TTTAACACGCCAACTGTTGA","CGTTTGCCATCCGAAATTTG","561307.5.peg.535","1950"
"25484",223,526,303,"AGCCACCATGAAGATACCTG","CGTTTGCCATCCGAAATTTG","561307.5.peg.535","1950"
"25485",629,526,103,"TGTAATCGAATGGATGACGG","CGTTTGCCATCCGAAATTTG","561307.5.peg.535","1950"
"25486",217,526,309,"CATGAAGATACCTGTGGCGA","CGTTTGCCATCCGAAATTTG","561307.5.peg.535","1950"
"25487",178,526,348,"TAAATTTAACACGGCAGGAG","CGTTTGCCATCCGAAATTTG","561307.5.peg.535","1950"
"25488",632,526,106,"CTTTGTAATCGAATGGATGA","CGTTTGCCATCCGAAATTTG","561307.5.peg.535","1950"
"25489",639,526,113,"GACATACCTTTGTAATCGAA","CGTTTGCCATCCGAAATTTG","561307.5.peg.535","1950"
"25490",178,629,451,"TAAATTTAACACGGCAGGAG","TGTAATCGAATGGATGACGG","561307.5.peg.535","1950"
"25491",217,629,412,"CATGAAGATACCTGTGGCGA","TGTAATCGAATGGATGACGG","561307.5.peg.535","1950"
"25492",223,629,406,"AGCCACCATGAAGATACCTG","TGTAATCGAATGGATGACGG","561307.5.peg.535","1950"
"25493",153,629,476,"TGATATGTTTGACCAACGAG","TGTAATCGAATGGATGACGG","561307.5.peg.535","1950"
"25494",183,629,446,"TAGATAAATTTAACACGGC","TGTAATCGAATGGATGACGG","561307.5.peg.535","1950"
"25495",526,629,103,"CGTTTGCCATCCGAAATTTG","TGTAATCGAATGGATGACGG","561307.5.peg.535","1950"
"25496",402,629,227,"TTTAACACGCCAACTGTTGA","TGTAATCGAATGGATGACGG","561307.5.peg.535","1950"
"25497",183,632,449,"TAGATAAATTTAACACGGC","CTTTGTAATCGAATGGATGA","561307.5.peg.535","1950"
"25498",178,632,454,"TAAATTTAACACGGCAGGAG","CTTTGTAATCGAATGGATGA","561307.5.peg.535","1950"
"25499",153,632,479,"TGATATGTTTGACCAACGAG","CTTTGTAATCGAATGGATGA","561307.5.peg.535","1950"
"25500",402,632,230,"TTTAACACGCCAACTGTTGA","CTTTGTAATCGAATGGATGA","561307.5.peg.535","1950"
"25501",526,632,106,"CGTTTGCCATCCGAAATTTG","CTTTGTAATCGAATGGATGA","561307.5.peg.535","1950"
"25502",223,632,409,"AGCCACCATGAAGATACCTG","CTTTGTAATCGAATGGATGA","561307.5.peg.535","1950"
"25503",217,632,415,"CATGAAGATACCTGTGGCGA","CTTTGTAATCGAATGGATGA","561307.5.peg.535","1950"
"25504",217,639,422,"CATGAAGATACCTGTGGCGA","GACATACCTTTGTAATCGAA","561307.5.peg.535","1950"
"25505",178,639,461,"TAAATTTAACACGGCAGGAG","GACATACCTTTGTAATCGAA","561307.5.peg.535","1950"
"25506",183,639,456,"TAGATAAATTTAACACGGC","GACATACCTTTGTAATCGAA","561307.5.peg.535","1950"
"25507",526,639,113,"CGTTTGCCATCCGAAATTTG","GACATACCTTTGTAATCGAA","561307.5.peg.535","1950"
"25508",223,639,416,"AGCCACCATGAAGATACCTG","GACATACCTTTGTAATCGAA","561307.5.peg.535","1950"
"25509",153,639,486,"TGATATGTTTGACCAACGAG","GACATACCTTTGTAATCGAA","561307.5.peg.535","1950"
"25510",402,639,237,"TTTAACACGCCAACTGTTGA","GACATACCTTTGTAATCGAA","561307.5.peg.535","1950"
"25511",293,138,155,"ATCCATATGAACTATAACCT","TAATTTCTAGGCGTCACTGC","561307.5.peg.536","1951"
"25512",274,138,136,"CGGAAATATTGTGTTGAAA","TAATTTCTAGGCGTCACTGC","561307.5.peg.536","1951"
"25513",415,138,277,"TACAGCTACAACATGTATTT","TAATTTCTAGGCGTCACTGC","561307.5.peg.536","1951"
"25514",484,138,346,"GACTGTATGTCCAGTTGCAT","TAATTTCTAGGCGTCACTGC","561307.5.peg.536","1951"
"25515",415,191,224,"TACAGCTACAACATGTATTT","CAATAAAGCCATATTGCGTT","561307.5.peg.536","1951"
"25516",484,191,293,"GACTGTATGTCCAGTTGCAT","CAATAAAGCCATATTGCGTT","561307.5.peg.536","1951"
"25517",293,191,102,"ATCCATATGAACTATAACCT","CAATAAAGCCATATTGCGTT","561307.5.peg.536","1951"
"25518",138,274,136,"TAATTTCTAGGCGTCACTGC","CGGAAATATTGTGTTGAAA","561307.5.peg.536","1951"
"25519",415,274,141,"TACAGCTACAACATGTATTT","CGGAAATATTGTGTTGAAA","561307.5.peg.536","1951"
"25520",484,274,210,"GACTGTATGTCCAGTTGCAT","CGGAAATATTGTGTTGAAA","561307.5.peg.536","1951"
"25521",138,293,155,"TAATTTCTAGGCGTCACTGC","ATCCATATGAACTATAACCT","561307.5.peg.536","1951"
"25522",415,293,122,"TACAGCTACAACATGTATTT","ATCCATATGAACTATAACCT","561307.5.peg.536","1951"
"25523",484,293,191,"GACTGTATGTCCAGTTGCAT","ATCCATATGAACTATAACCT","561307.5.peg.536","1951"
"25524",191,293,102,"CAATAAAGCCATATTGCGTT","ATCCATATGAACTATAACCT","561307.5.peg.536","1951"
"25525",138,415,277,"TAATTTCTAGGCGTCACTGC","TACAGCTACAACATGTATTT","561307.5.peg.536","1951"
"25526",293,415,122,"ATCCATATGAACTATAACCT","TACAGCTACAACATGTATTT","561307.5.peg.536","1951"
"25527",191,415,224,"CAATAAAGCCATATTGCGTT","TACAGCTACAACATGTATTT","561307.5.peg.536","1951"
"25528",274,415,141,"CGGAAATATTGTGTTGAAA","TACAGCTACAACATGTATTT","561307.5.peg.536","1951"
"25529",191,484,293,"CAATAAAGCCATATTGCGTT","GACTGTATGTCCAGTTGCAT","561307.5.peg.536","1951"
"25530",138,484,346,"TAATTTCTAGGCGTCACTGC","GACTGTATGTCCAGTTGCAT","561307.5.peg.536","1951"
"25531",274,484,210,"CGGAAATATTGTGTTGAAA","GACTGTATGTCCAGTTGCAT","561307.5.peg.536","1951"
"25532",293,484,191,"ATCCATATGAACTATAACCT","GACTGTATGTCCAGTTGCAT","561307.5.peg.536","1951"
"25533",381,142,239,"TTGTTATCTCCTGCTGTTGC","CATTTGTGTATGTGCTTGTT","561307.5.peg.537","1952"
"25534",352,142,210,"ATATGTTTGGCCGCTTCCAT","CATTTGTGTATGTGCTTGTT","561307.5.peg.537","1952"
"25535",365,142,223,"TTGCTGGATTCACATATGTT","CATTTGTGTATGTGCTTGTT","561307.5.peg.537","1952"
"25536",468,142,326,"TGTGAATAATAGCTCGCGTC","CATTTGTGTATGTGCTTGTT","561307.5.peg.537","1952"
"25537",352,237,115,"ATATGTTTGGCCGCTTCCAT","GCTTGATTCCAGTTACCATC","561307.5.peg.537","1952"
"25538",365,237,128,"TTGCTGGATTCACATATGTT","GCTTGATTCCAGTTACCATC","561307.5.peg.537","1952"
"25539",468,237,231,"TGTGAATAATAGCTCGCGTC","GCTTGATTCCAGTTACCATC","561307.5.peg.537","1952"
"25540",381,237,144,"TTGTTATCTCCTGCTGTTGC","GCTTGATTCCAGTTACCATC","561307.5.peg.537","1952"
"25541",142,352,210,"CATTTGTGTATGTGCTTGTT","ATATGTTTGGCCGCTTCCAT","561307.5.peg.537","1952"
"25542",468,352,116,"TGTGAATAATAGCTCGCGTC","ATATGTTTGGCCGCTTCCAT","561307.5.peg.537","1952"
"25543",237,352,115,"GCTTGATTCCAGTTACCATC","ATATGTTTGGCCGCTTCCAT","561307.5.peg.537","1952"
"25544",142,365,223,"CATTTGTGTATGTGCTTGTT","TTGCTGGATTCACATATGTT","561307.5.peg.537","1952"
"25545",237,365,128,"GCTTGATTCCAGTTACCATC","TTGCTGGATTCACATATGTT","561307.5.peg.537","1952"
"25546",468,365,103,"TGTGAATAATAGCTCGCGTC","TTGCTGGATTCACATATGTT","561307.5.peg.537","1952"
"25547",142,381,239,"CATTTGTGTATGTGCTTGTT","TTGTTATCTCCTGCTGTTGC","561307.5.peg.537","1952"
"25548",237,381,144,"GCTTGATTCCAGTTACCATC","TTGTTATCTCCTGCTGTTGC","561307.5.peg.537","1952"
"25549",142,468,326,"CATTTGTGTATGTGCTTGTT","TGTGAATAATAGCTCGCGTC","561307.5.peg.537","1952"
"25550",237,468,231,"GCTTGATTCCAGTTACCATC","TGTGAATAATAGCTCGCGTC","561307.5.peg.537","1952"
"25551",352,468,116,"ATATGTTTGGCCGCTTCCAT","TGTGAATAATAGCTCGCGTC","561307.5.peg.537","1952"
"25552",365,468,103,"TTGCTGGATTCACATATGTT","TGTGAATAATAGCTCGCGTC","561307.5.peg.537","1952"
"25553",115,9,106,"AAGTACGAGTGCGATGACAA","ATTTAGCTGTATTGGTTTGG","561307.5.peg.539","1954"
"25554",152,9,143,"TGAAGTTGTCATGTGCTACA","ATTTAGCTGTATTGGTTTGG","561307.5.peg.539","1954"
"25555",180,9,171,"CTAAATCTTGAATGGTAAT","ATTTAGCTGTATTGGTTTGG","561307.5.peg.539","1954"
"25556",9,115,106,"ATTTAGCTGTATTGGTTTGG","AAGTACGAGTGCGATGACAA","561307.5.peg.539","1954"
"25557",9,152,143,"ATTTAGCTGTATTGGTTTGG","TGAAGTTGTCATGTGCTACA","561307.5.peg.539","1954"
"25558",9,180,171,"ATTTAGCTGTATTGGTTTGG","CTAAATCTTGAATGGTAAT","561307.5.peg.539","1954"
"25559",590,5,585,"CTAAGTTAAATGCACCTGAA","CAATCTTATCATTGGAGGAG","561307.5.peg.540","1956"
"25560",476,5,471,"CCATTGATCGCATAAGACGT","CAATCTTATCATTGGAGGAG","561307.5.peg.540","1956"
"25561",164,5,159,"TGTCATCTTCTGTTACATGT","CAATCTTATCATTGGAGGAG","561307.5.peg.540","1956"
"25562",528,5,523,"CTGTCAGAATGTGATGCTTT","CAATCTTATCATTGGAGGAG","561307.5.peg.540","1956"
"25563",476,10,466,"CCATTGATCGCATAAGACGT","CCTTTCAATCTTATCATTGG","561307.5.peg.540","1956"
"25564",164,10,154,"TGTCATCTTCTGTTACATGT","CCTTTCAATCTTATCATTGG","561307.5.peg.540","1956"
"25565",528,10,518,"CTGTCAGAATGTGATGCTTT","CCTTTCAATCTTATCATTGG","561307.5.peg.540","1956"
"25566",590,10,580,"CTAAGTTAAATGCACCTGAA","CCTTTCAATCTTATCATTGG","561307.5.peg.540","1956"
"25567",5,164,159,"CAATCTTATCATTGGAGGAG","TGTCATCTTCTGTTACATGT","561307.5.peg.540","1956"
"25568",476,164,312,"CCATTGATCGCATAAGACGT","TGTCATCTTCTGTTACATGT","561307.5.peg.540","1956"
"25569",10,164,154,"CCTTTCAATCTTATCATTGG","TGTCATCTTCTGTTACATGT","561307.5.peg.540","1956"
"25570",528,164,364,"CTGTCAGAATGTGATGCTTT","TGTCATCTTCTGTTACATGT","561307.5.peg.540","1956"
"25571",590,164,426,"CTAAGTTAAATGCACCTGAA","TGTCATCTTCTGTTACATGT","561307.5.peg.540","1956"
"25572",5,476,471,"CAATCTTATCATTGGAGGAG","CCATTGATCGCATAAGACGT","561307.5.peg.540","1956"
"25573",10,476,466,"CCTTTCAATCTTATCATTGG","CCATTGATCGCATAAGACGT","561307.5.peg.540","1956"
"25574",164,476,312,"TGTCATCTTCTGTTACATGT","CCATTGATCGCATAAGACGT","561307.5.peg.540","1956"
"25575",590,476,114,"CTAAGTTAAATGCACCTGAA","CCATTGATCGCATAAGACGT","561307.5.peg.540","1956"
"25576",10,528,518,"CCTTTCAATCTTATCATTGG","CTGTCAGAATGTGATGCTTT","561307.5.peg.540","1956"
"25577",164,528,364,"TGTCATCTTCTGTTACATGT","CTGTCAGAATGTGATGCTTT","561307.5.peg.540","1956"
"25578",5,528,523,"CAATCTTATCATTGGAGGAG","CTGTCAGAATGTGATGCTTT","561307.5.peg.540","1956"
"25579",10,590,580,"CCTTTCAATCTTATCATTGG","CTAAGTTAAATGCACCTGAA","561307.5.peg.540","1956"
"25580",164,590,426,"TGTCATCTTCTGTTACATGT","CTAAGTTAAATGCACCTGAA","561307.5.peg.540","1956"
"25581",5,590,585,"CAATCTTATCATTGGAGGAG","CTAAGTTAAATGCACCTGAA","561307.5.peg.540","1956"
"25582",476,590,114,"CCATTGATCGCATAAGACGT","CTAAGTTAAATGCACCTGAA","561307.5.peg.540","1956"
"25583",667,408,259,"AATTTGTCGACAATAAGTT","AATGCAGAGTCTGCGATTGT","561307.5.peg.541","1957"
"25584",408,667,259,"AATGCAGAGTCTGCGATTGT","AATTTGTCGACAATAAGTT","561307.5.peg.541","1957"
"25585",381,105,276,"GGATTGCTTGGTGACGTTTG","GTATATGCTTGAGCCGAGTT","561307.5.peg.544","1960"
"25586",257,105,152,"GATTGTCGTTTGTACGTGAC","GTATATGCTTGAGCCGAGTT","561307.5.peg.544","1960"
"25587",420,105,315,"TCGTCATTGTCTTCGACATT","GTATATGCTTGAGCCGAGTT","561307.5.peg.544","1960"
"25588",320,105,215,"ACTGACCACTTAATGAAGAA","GTATATGCTTGAGCCGAGTT","561307.5.peg.544","1960"
"25589",378,105,273,"TTGCTTGGTGACGTTTGAGG","GTATATGCTTGAGCCGAGTT","561307.5.peg.544","1960"
"25590",393,105,288,"GCTGGTGTCAAAGGATTGCT","GTATATGCTTGAGCCGAGTT","561307.5.peg.544","1960"
"25591",411,105,306,"TCTTCGACATTCGGTATTGC","GTATATGCTTGAGCCGAGTT","561307.5.peg.544","1960"
"25592",402,105,297,"TTCGGTATTGCTGGTGTCAA","GTATATGCTTGAGCCGAGTT","561307.5.peg.544","1960"
"25593",393,167,226,"GCTGGTGTCAAAGGATTGCT","TCACTTTGAACTGTGCGTTT","561307.5.peg.544","1960"
"25594",402,167,235,"TTCGGTATTGCTGGTGTCAA","TCACTTTGAACTGTGCGTTT","561307.5.peg.544","1960"
"25595",411,167,244,"TCTTCGACATTCGGTATTGC","TCACTTTGAACTGTGCGTTT","561307.5.peg.544","1960"
"25596",378,167,211,"TTGCTTGGTGACGTTTGAGG","TCACTTTGAACTGTGCGTTT","561307.5.peg.544","1960"
"25597",381,167,214,"GGATTGCTTGGTGACGTTTG","TCACTTTGAACTGTGCGTTT","561307.5.peg.544","1960"
"25598",320,167,153,"ACTGACCACTTAATGAAGAA","TCACTTTGAACTGTGCGTTT","561307.5.peg.544","1960"
"25599",420,167,253,"TCGTCATTGTCTTCGACATT","TCACTTTGAACTGTGCGTTT","561307.5.peg.544","1960"
"25600",411,199,212,"TCTTCGACATTCGGTATTGC","ATATGTATAAGTATACGCGC","561307.5.peg.544","1960"
"25601",378,199,179,"TTGCTTGGTGACGTTTGAGG","ATATGTATAAGTATACGCGC","561307.5.peg.544","1960"
"25602",381,199,182,"GGATTGCTTGGTGACGTTTG","ATATGTATAAGTATACGCGC","561307.5.peg.544","1960"
"25603",420,199,221,"TCGTCATTGTCTTCGACATT","ATATGTATAAGTATACGCGC","561307.5.peg.544","1960"
"25604",402,199,203,"TTCGGTATTGCTGGTGTCAA","ATATGTATAAGTATACGCGC","561307.5.peg.544","1960"
"25605",320,199,121,"ACTGACCACTTAATGAAGAA","ATATGTATAAGTATACGCGC","561307.5.peg.544","1960"
"25606",393,199,194,"GCTGGTGTCAAAGGATTGCT","ATATGTATAAGTATACGCGC","561307.5.peg.544","1960"
"25607",378,257,121,"TTGCTTGGTGACGTTTGAGG","GATTGTCGTTTGTACGTGAC","561307.5.peg.544","1960"
"25608",402,257,145,"TTCGGTATTGCTGGTGTCAA","GATTGTCGTTTGTACGTGAC","561307.5.peg.544","1960"
"25609",420,257,163,"TCGTCATTGTCTTCGACATT","GATTGTCGTTTGTACGTGAC","561307.5.peg.544","1960"
"25610",381,257,124,"GGATTGCTTGGTGACGTTTG","GATTGTCGTTTGTACGTGAC","561307.5.peg.544","1960"
"25611",411,257,154,"TCTTCGACATTCGGTATTGC","GATTGTCGTTTGTACGTGAC","561307.5.peg.544","1960"
"25612",105,257,152,"GTATATGCTTGAGCCGAGTT","GATTGTCGTTTGTACGTGAC","561307.5.peg.544","1960"
"25613",393,257,136,"GCTGGTGTCAAAGGATTGCT","GATTGTCGTTTGTACGTGAC","561307.5.peg.544","1960"
"25614",105,320,215,"GTATATGCTTGAGCCGAGTT","ACTGACCACTTAATGAAGAA","561307.5.peg.544","1960"
"25615",167,320,153,"TCACTTTGAACTGTGCGTTT","ACTGACCACTTAATGAAGAA","561307.5.peg.544","1960"
"25616",420,320,100,"TCGTCATTGTCTTCGACATT","ACTGACCACTTAATGAAGAA","561307.5.peg.544","1960"
"25617",199,320,121,"ATATGTATAAGTATACGCGC","ACTGACCACTTAATGAAGAA","561307.5.peg.544","1960"
"25618",105,378,273,"GTATATGCTTGAGCCGAGTT","TTGCTTGGTGACGTTTGAGG","561307.5.peg.544","1960"
"25619",167,378,211,"TCACTTTGAACTGTGCGTTT","TTGCTTGGTGACGTTTGAGG","561307.5.peg.544","1960"
"25620",199,378,179,"ATATGTATAAGTATACGCGC","TTGCTTGGTGACGTTTGAGG","561307.5.peg.544","1960"
"25621",257,378,121,"GATTGTCGTTTGTACGTGAC","TTGCTTGGTGACGTTTGAGG","561307.5.peg.544","1960"
"25622",105,381,276,"GTATATGCTTGAGCCGAGTT","GGATTGCTTGGTGACGTTTG","561307.5.peg.544","1960"
"25623",257,381,124,"GATTGTCGTTTGTACGTGAC","GGATTGCTTGGTGACGTTTG","561307.5.peg.544","1960"
"25624",199,381,182,"ATATGTATAAGTATACGCGC","GGATTGCTTGGTGACGTTTG","561307.5.peg.544","1960"
"25625",167,381,214,"TCACTTTGAACTGTGCGTTT","GGATTGCTTGGTGACGTTTG","561307.5.peg.544","1960"
"25626",199,393,194,"ATATGTATAAGTATACGCGC","GCTGGTGTCAAAGGATTGCT","561307.5.peg.544","1960"
"25627",167,393,226,"TCACTTTGAACTGTGCGTTT","GCTGGTGTCAAAGGATTGCT","561307.5.peg.544","1960"
"25628",257,393,136,"GATTGTCGTTTGTACGTGAC","GCTGGTGTCAAAGGATTGCT","561307.5.peg.544","1960"
"25629",105,393,288,"GTATATGCTTGAGCCGAGTT","GCTGGTGTCAAAGGATTGCT","561307.5.peg.544","1960"
"25630",257,402,145,"GATTGTCGTTTGTACGTGAC","TTCGGTATTGCTGGTGTCAA","561307.5.peg.544","1960"
"25631",105,402,297,"GTATATGCTTGAGCCGAGTT","TTCGGTATTGCTGGTGTCAA","561307.5.peg.544","1960"
"25632",199,402,203,"ATATGTATAAGTATACGCGC","TTCGGTATTGCTGGTGTCAA","561307.5.peg.544","1960"
"25633",167,402,235,"TCACTTTGAACTGTGCGTTT","TTCGGTATTGCTGGTGTCAA","561307.5.peg.544","1960"
"25634",257,411,154,"GATTGTCGTTTGTACGTGAC","TCTTCGACATTCGGTATTGC","561307.5.peg.544","1960"
"25635",105,411,306,"GTATATGCTTGAGCCGAGTT","TCTTCGACATTCGGTATTGC","561307.5.peg.544","1960"
"25636",167,411,244,"TCACTTTGAACTGTGCGTTT","TCTTCGACATTCGGTATTGC","561307.5.peg.544","1960"
"25637",199,411,212,"ATATGTATAAGTATACGCGC","TCTTCGACATTCGGTATTGC","561307.5.peg.544","1960"
"25638",199,420,221,"ATATGTATAAGTATACGCGC","TCGTCATTGTCTTCGACATT","561307.5.peg.544","1960"
"25639",105,420,315,"GTATATGCTTGAGCCGAGTT","TCGTCATTGTCTTCGACATT","561307.5.peg.544","1960"
"25640",167,420,253,"TCACTTTGAACTGTGCGTTT","TCGTCATTGTCTTCGACATT","561307.5.peg.544","1960"
"25641",320,420,100,"ACTGACCACTTAATGAAGAA","TCGTCATTGTCTTCGACATT","561307.5.peg.544","1960"
"25642",257,420,163,"GATTGTCGTTTGTACGTGAC","TCGTCATTGTCTTCGACATT","561307.5.peg.544","1960"
"25643",662,356,306,"GCGTATCTGTAAATAATTCC","CTGGGATAACAATCATGACT","561307.5.peg.546","1962"
"25644",1356,356,1000,"AATTAATGTGTTCTGCTAA","CTGGGATAACAATCATGACT","561307.5.peg.546","1962"
"25645",648,356,292,"AATTCCGGGAAGTCGTTAAT","CTGGGATAACAATCATGACT","561307.5.peg.546","1962"
"25646",1394,356,1038,"TACTTGTGTCTTGCGCAACT","CTGGGATAACAATCATGACT","561307.5.peg.546","1962"
"25647",356,648,292,"CTGGGATAACAATCATGACT","AATTCCGGGAAGTCGTTAAT","561307.5.peg.546","1962"
"25648",1356,648,708,"AATTAATGTGTTCTGCTAA","AATTCCGGGAAGTCGTTAAT","561307.5.peg.546","1962"
"25649",1394,648,746,"TACTTGTGTCTTGCGCAACT","AATTCCGGGAAGTCGTTAAT","561307.5.peg.546","1962"
"25650",356,662,306,"CTGGGATAACAATCATGACT","GCGTATCTGTAAATAATTCC","561307.5.peg.546","1962"
"25651",1356,662,694,"AATTAATGTGTTCTGCTAA","GCGTATCTGTAAATAATTCC","561307.5.peg.546","1962"
"25652",1394,662,732,"TACTTGTGTCTTGCGCAACT","GCGTATCTGTAAATAATTCC","561307.5.peg.546","1962"
"25653",662,1356,694,"GCGTATCTGTAAATAATTCC","AATTAATGTGTTCTGCTAA","561307.5.peg.546","1962"
"25654",356,1356,1000,"CTGGGATAACAATCATGACT","AATTAATGTGTTCTGCTAA","561307.5.peg.546","1962"
"25655",648,1356,708,"AATTCCGGGAAGTCGTTAAT","AATTAATGTGTTCTGCTAA","561307.5.peg.546","1962"
"25656",356,1394,1038,"CTGGGATAACAATCATGACT","TACTTGTGTCTTGCGCAACT","561307.5.peg.546","1962"
"25657",648,1394,746,"AATTCCGGGAAGTCGTTAAT","TACTTGTGTCTTGCGCAACT","561307.5.peg.546","1962"
"25658",662,1394,732,"GCGTATCTGTAAATAATTCC","TACTTGTGTCTTGCGCAACT","561307.5.peg.546","1962"
"25659",303,131,172,"GTCAATTCAGGTCGTTGATA","GTGGGTCAATGATTGTTAAT","561307.5.peg.55","1966"
"25660",586,131,455,"GCCGCTACCAACGATATGAT","GTGGGTCAATGATTGTTAAT","561307.5.peg.55","1966"
"25661",586,204,382,"GCCGCTACCAACGATATGAT","CAATCGGTGATCTTAAATA","561307.5.peg.55","1966"
"25662",131,303,172,"GTGGGTCAATGATTGTTAAT","GTCAATTCAGGTCGTTGATA","561307.5.peg.55","1966"
"25663",586,303,283,"GCCGCTACCAACGATATGAT","GTCAATTCAGGTCGTTGATA","561307.5.peg.55","1966"
"25664",131,586,455,"GTGGGTCAATGATTGTTAAT","GCCGCTACCAACGATATGAT","561307.5.peg.55","1966"
"25665",204,586,382,"CAATCGGTGATCTTAAATA","GCCGCTACCAACGATATGAT","561307.5.peg.55","1966"
"25666",303,586,283,"GTCAATTCAGGTCGTTGATA","GCCGCTACCAACGATATGAT","561307.5.peg.55","1966"
"25667",1531,438,1093,"CGAGACTTGATATCAATAA","TAATCATCTGCCTGTGCATG","561307.5.peg.551","1968"
"25668",1515,438,1077,"ATAATGGTATCTACATGCTC","TAATCATCTGCCTGTGCATG","561307.5.peg.551","1968"
"25669",571,438,133,"CATTACTAATGGCGGTATAA","TAATCATCTGCCTGTGCATG","561307.5.peg.551","1968"
"25670",831,438,393,"TCTTTAATTTCAGCAACCGT","TAATCATCTGCCTGTGCATG","561307.5.peg.551","1968"
"25671",579,438,141,"AAAGCAATCATTACTAATGG","TAATCATCTGCCTGTGCATG","561307.5.peg.551","1968"
"25672",1386,438,948,"GTAATGACAAACACTAATTG","TAATCATCTGCCTGTGCATG","561307.5.peg.551","1968"
"25673",983,438,545,"CGAATAGTTCATCACGACGT","TAATCATCTGCCTGTGCATG","561307.5.peg.551","1968"
"25674",1337,438,899,"TGCTGCGTTCACGCACAGCT","TAATCATCTGCCTGTGCATG","561307.5.peg.551","1968"
"25675",1863,438,1425,"GTACCAGCAACTAAACCATG","TAATCATCTGCCTGTGCATG","561307.5.peg.551","1968"
"25676",1885,438,1447,"CTCAGATTTCCCTGAACCAG","TAATCATCTGCCTGTGCATG","561307.5.peg.551","1968"
"25677",2021,438,1583,"TGTAATCGTACCAACTAAA","TAATCATCTGCCTGTGCATG","561307.5.peg.551","1968"
"25678",1233,438,795,"TGCCCTCTCAATGTCATATG","TAATCATCTGCCTGTGCATG","561307.5.peg.551","1968"
"25679",824,438,386,"TTTCAGCAACCGTTGGATAA","TAATCATCTGCCTGTGCATG","561307.5.peg.551","1968"
"25680",1800,438,1362,"TCTTTACCTCTTACACCTAA","TAATCATCTGCCTGTGCATG","561307.5.peg.551","1968"
"25681",1949,438,1511,"ATAGGAATGCAACTTCATGA","TAATCATCTGCCTGTGCATG","561307.5.peg.551","1968"
"25682",1531,470,1061,"CGAGACTTGATATCAATAA","GAATAATCCTTGGCGAACGA","561307.5.peg.551","1968"
"25683",1800,470,1330,"TCTTTACCTCTTACACCTAA","GAATAATCCTTGGCGAACGA","561307.5.peg.551","1968"
"25684",831,470,361,"TCTTTAATTTCAGCAACCGT","GAATAATCCTTGGCGAACGA","561307.5.peg.551","1968"
"25685",1233,470,763,"TGCCCTCTCAATGTCATATG","GAATAATCCTTGGCGAACGA","561307.5.peg.551","1968"
"25686",579,470,109,"AAAGCAATCATTACTAATGG","GAATAATCCTTGGCGAACGA","561307.5.peg.551","1968"
"25687",824,470,354,"TTTCAGCAACCGTTGGATAA","GAATAATCCTTGGCGAACGA","561307.5.peg.551","1968"
"25688",983,470,513,"CGAATAGTTCATCACGACGT","GAATAATCCTTGGCGAACGA","561307.5.peg.551","1968"
"25689",1949,470,1479,"ATAGGAATGCAACTTCATGA","GAATAATCCTTGGCGAACGA","561307.5.peg.551","1968"
"25690",1863,470,1393,"GTACCAGCAACTAAACCATG","GAATAATCCTTGGCGAACGA","561307.5.peg.551","1968"
"25691",2021,470,1551,"TGTAATCGTACCAACTAAA","GAATAATCCTTGGCGAACGA","561307.5.peg.551","1968"
"25692",1386,470,916,"GTAATGACAAACACTAATTG","GAATAATCCTTGGCGAACGA","561307.5.peg.551","1968"
"25693",571,470,101,"CATTACTAATGGCGGTATAA","GAATAATCCTTGGCGAACGA","561307.5.peg.551","1968"
"25694",1515,470,1045,"ATAATGGTATCTACATGCTC","GAATAATCCTTGGCGAACGA","561307.5.peg.551","1968"
"25695",1885,470,1415,"CTCAGATTTCCCTGAACCAG","GAATAATCCTTGGCGAACGA","561307.5.peg.551","1968"
"25696",1337,470,867,"TGCTGCGTTCACGCACAGCT","GAATAATCCTTGGCGAACGA","561307.5.peg.551","1968"
"25697",1233,480,753,"TGCCCTCTCAATGTCATATG","GGTTCACGGTGAATAATCCT","561307.5.peg.551","1968"
"25698",1515,480,1035,"ATAATGGTATCTACATGCTC","GGTTCACGGTGAATAATCCT","561307.5.peg.551","1968"
"25699",1863,480,1383,"GTACCAGCAACTAAACCATG","GGTTCACGGTGAATAATCCT","561307.5.peg.551","1968"
"25700",1531,480,1051,"CGAGACTTGATATCAATAA","GGTTCACGGTGAATAATCCT","561307.5.peg.551","1968"
"25701",1949,480,1469,"ATAGGAATGCAACTTCATGA","GGTTCACGGTGAATAATCCT","561307.5.peg.551","1968"
"25702",983,480,503,"CGAATAGTTCATCACGACGT","GGTTCACGGTGAATAATCCT","561307.5.peg.551","1968"
"25703",2021,480,1541,"TGTAATCGTACCAACTAAA","GGTTCACGGTGAATAATCCT","561307.5.peg.551","1968"
"25704",1386,480,906,"GTAATGACAAACACTAATTG","GGTTCACGGTGAATAATCCT","561307.5.peg.551","1968"
"25705",1885,480,1405,"CTCAGATTTCCCTGAACCAG","GGTTCACGGTGAATAATCCT","561307.5.peg.551","1968"
"25706",1337,480,857,"TGCTGCGTTCACGCACAGCT","GGTTCACGGTGAATAATCCT","561307.5.peg.551","1968"
"25707",831,480,351,"TCTTTAATTTCAGCAACCGT","GGTTCACGGTGAATAATCCT","561307.5.peg.551","1968"
"25708",824,480,344,"TTTCAGCAACCGTTGGATAA","GGTTCACGGTGAATAATCCT","561307.5.peg.551","1968"
"25709",1800,480,1320,"TCTTTACCTCTTACACCTAA","GGTTCACGGTGAATAATCCT","561307.5.peg.551","1968"
"25710",1863,494,1369,"GTACCAGCAACTAAACCATG","TAATATCATCCGTCGGTTCA","561307.5.peg.551","1968"
"25711",831,494,337,"TCTTTAATTTCAGCAACCGT","TAATATCATCCGTCGGTTCA","561307.5.peg.551","1968"
"25712",1531,494,1037,"CGAGACTTGATATCAATAA","TAATATCATCCGTCGGTTCA","561307.5.peg.551","1968"
"25713",1386,494,892,"GTAATGACAAACACTAATTG","TAATATCATCCGTCGGTTCA","561307.5.peg.551","1968"
"25714",2021,494,1527,"TGTAATCGTACCAACTAAA","TAATATCATCCGTCGGTTCA","561307.5.peg.551","1968"
"25715",983,494,489,"CGAATAGTTCATCACGACGT","TAATATCATCCGTCGGTTCA","561307.5.peg.551","1968"
"25716",1233,494,739,"TGCCCTCTCAATGTCATATG","TAATATCATCCGTCGGTTCA","561307.5.peg.551","1968"
"25717",1337,494,843,"TGCTGCGTTCACGCACAGCT","TAATATCATCCGTCGGTTCA","561307.5.peg.551","1968"
"25718",1949,494,1455,"ATAGGAATGCAACTTCATGA","TAATATCATCCGTCGGTTCA","561307.5.peg.551","1968"
"25719",1800,494,1306,"TCTTTACCTCTTACACCTAA","TAATATCATCCGTCGGTTCA","561307.5.peg.551","1968"
"25720",1515,494,1021,"ATAATGGTATCTACATGCTC","TAATATCATCCGTCGGTTCA","561307.5.peg.551","1968"
"25721",824,494,330,"TTTCAGCAACCGTTGGATAA","TAATATCATCCGTCGGTTCA","561307.5.peg.551","1968"
"25722",1885,494,1391,"CTCAGATTTCCCTGAACCAG","TAATATCATCCGTCGGTTCA","561307.5.peg.551","1968"
"25723",1949,501,1448,"ATAGGAATGCAACTTCATGA","TCAATCTTAATATCATCCGT","561307.5.peg.551","1968"
"25724",1885,501,1384,"CTCAGATTTCCCTGAACCAG","TCAATCTTAATATCATCCGT","561307.5.peg.551","1968"
"25725",1386,501,885,"GTAATGACAAACACTAATTG","TCAATCTTAATATCATCCGT","561307.5.peg.551","1968"
"25726",983,501,482,"CGAATAGTTCATCACGACGT","TCAATCTTAATATCATCCGT","561307.5.peg.551","1968"
"25727",1800,501,1299,"TCTTTACCTCTTACACCTAA","TCAATCTTAATATCATCCGT","561307.5.peg.551","1968"
"25728",1233,501,732,"TGCCCTCTCAATGTCATATG","TCAATCTTAATATCATCCGT","561307.5.peg.551","1968"
"25729",1337,501,836,"TGCTGCGTTCACGCACAGCT","TCAATCTTAATATCATCCGT","561307.5.peg.551","1968"
"25730",1863,501,1362,"GTACCAGCAACTAAACCATG","TCAATCTTAATATCATCCGT","561307.5.peg.551","1968"
"25731",1531,501,1030,"CGAGACTTGATATCAATAA","TCAATCTTAATATCATCCGT","561307.5.peg.551","1968"
"25732",824,501,323,"TTTCAGCAACCGTTGGATAA","TCAATCTTAATATCATCCGT","561307.5.peg.551","1968"
"25733",2021,501,1520,"TGTAATCGTACCAACTAAA","TCAATCTTAATATCATCCGT","561307.5.peg.551","1968"
"25734",831,501,330,"TCTTTAATTTCAGCAACCGT","TCAATCTTAATATCATCCGT","561307.5.peg.551","1968"
"25735",1515,501,1014,"ATAATGGTATCTACATGCTC","TCAATCTTAATATCATCCGT","561307.5.peg.551","1968"
"25736",1885,528,1357,"CTCAGATTTCCCTGAACCAG","TTCTTCTGTATTGGCTGTGG","561307.5.peg.551","1968"
"25737",1863,528,1335,"GTACCAGCAACTAAACCATG","TTCTTCTGTATTGGCTGTGG","561307.5.peg.551","1968"
"25738",1949,528,1421,"ATAGGAATGCAACTTCATGA","TTCTTCTGTATTGGCTGTGG","561307.5.peg.551","1968"
"25739",1800,528,1272,"TCTTTACCTCTTACACCTAA","TTCTTCTGTATTGGCTGTGG","561307.5.peg.551","1968"
"25740",831,528,303,"TCTTTAATTTCAGCAACCGT","TTCTTCTGTATTGGCTGTGG","561307.5.peg.551","1968"
"25741",824,528,296,"TTTCAGCAACCGTTGGATAA","TTCTTCTGTATTGGCTGTGG","561307.5.peg.551","1968"
"25742",1337,528,809,"TGCTGCGTTCACGCACAGCT","TTCTTCTGTATTGGCTGTGG","561307.5.peg.551","1968"
"25743",983,528,455,"CGAATAGTTCATCACGACGT","TTCTTCTGTATTGGCTGTGG","561307.5.peg.551","1968"
"25744",1386,528,858,"GTAATGACAAACACTAATTG","TTCTTCTGTATTGGCTGTGG","561307.5.peg.551","1968"
"25745",1233,528,705,"TGCCCTCTCAATGTCATATG","TTCTTCTGTATTGGCTGTGG","561307.5.peg.551","1968"
"25746",1515,528,987,"ATAATGGTATCTACATGCTC","TTCTTCTGTATTGGCTGTGG","561307.5.peg.551","1968"
"25747",2021,528,1493,"TGTAATCGTACCAACTAAA","TTCTTCTGTATTGGCTGTGG","561307.5.peg.551","1968"
"25748",1531,528,1003,"CGAGACTTGATATCAATAA","TTCTTCTGTATTGGCTGTGG","561307.5.peg.551","1968"
"25749",1386,531,855,"GTAATGACAAACACTAATTG","TTGTTCTTCTGTATTGGCTG","561307.5.peg.551","1968"
"25750",1515,531,984,"ATAATGGTATCTACATGCTC","TTGTTCTTCTGTATTGGCTG","561307.5.peg.551","1968"
"25751",1885,531,1354,"CTCAGATTTCCCTGAACCAG","TTGTTCTTCTGTATTGGCTG","561307.5.peg.551","1968"
"25752",824,531,293,"TTTCAGCAACCGTTGGATAA","TTGTTCTTCTGTATTGGCTG","561307.5.peg.551","1968"
"25753",1800,531,1269,"TCTTTACCTCTTACACCTAA","TTGTTCTTCTGTATTGGCTG","561307.5.peg.551","1968"
"25754",1233,531,702,"TGCCCTCTCAATGTCATATG","TTGTTCTTCTGTATTGGCTG","561307.5.peg.551","1968"
"25755",1949,531,1418,"ATAGGAATGCAACTTCATGA","TTGTTCTTCTGTATTGGCTG","561307.5.peg.551","1968"
"25756",1531,531,1000,"CGAGACTTGATATCAATAA","TTGTTCTTCTGTATTGGCTG","561307.5.peg.551","1968"
"25757",2021,531,1490,"TGTAATCGTACCAACTAAA","TTGTTCTTCTGTATTGGCTG","561307.5.peg.551","1968"
"25758",1863,531,1332,"GTACCAGCAACTAAACCATG","TTGTTCTTCTGTATTGGCTG","561307.5.peg.551","1968"
"25759",983,531,452,"CGAATAGTTCATCACGACGT","TTGTTCTTCTGTATTGGCTG","561307.5.peg.551","1968"
"25760",831,531,300,"TCTTTAATTTCAGCAACCGT","TTGTTCTTCTGTATTGGCTG","561307.5.peg.551","1968"
"25761",1337,531,806,"TGCTGCGTTCACGCACAGCT","TTGTTCTTCTGTATTGGCTG","561307.5.peg.551","1968"
"25762",1949,537,1412,"ATAGGAATGCAACTTCATGA","CTGTATTGTTCTTCTGTAT","561307.5.peg.551","1968"
"25763",1531,537,994,"CGAGACTTGATATCAATAA","CTGTATTGTTCTTCTGTAT","561307.5.peg.551","1968"
"25764",1233,537,696,"TGCCCTCTCAATGTCATATG","CTGTATTGTTCTTCTGTAT","561307.5.peg.551","1968"
"25765",1863,537,1326,"GTACCAGCAACTAAACCATG","CTGTATTGTTCTTCTGTAT","561307.5.peg.551","1968"
"25766",2021,537,1484,"TGTAATCGTACCAACTAAA","CTGTATTGTTCTTCTGTAT","561307.5.peg.551","1968"
"25767",831,537,294,"TCTTTAATTTCAGCAACCGT","CTGTATTGTTCTTCTGTAT","561307.5.peg.551","1968"
"25768",824,537,287,"TTTCAGCAACCGTTGGATAA","CTGTATTGTTCTTCTGTAT","561307.5.peg.551","1968"
"25769",983,537,446,"CGAATAGTTCATCACGACGT","CTGTATTGTTCTTCTGTAT","561307.5.peg.551","1968"
"25770",1386,537,849,"GTAATGACAAACACTAATTG","CTGTATTGTTCTTCTGTAT","561307.5.peg.551","1968"
"25771",1515,537,978,"ATAATGGTATCTACATGCTC","CTGTATTGTTCTTCTGTAT","561307.5.peg.551","1968"
"25772",1885,537,1348,"CTCAGATTTCCCTGAACCAG","CTGTATTGTTCTTCTGTAT","561307.5.peg.551","1968"
"25773",1337,537,800,"TGCTGCGTTCACGCACAGCT","CTGTATTGTTCTTCTGTAT","561307.5.peg.551","1968"
"25774",1800,537,1263,"TCTTTACCTCTTACACCTAA","CTGTATTGTTCTTCTGTAT","561307.5.peg.551","1968"
"25775",983,571,412,"CGAATAGTTCATCACGACGT","CATTACTAATGGCGGTATAA","561307.5.peg.551","1968"
"25776",831,571,260,"TCTTTAATTTCAGCAACCGT","CATTACTAATGGCGGTATAA","561307.5.peg.551","1968"
"25777",1386,571,815,"GTAATGACAAACACTAATTG","CATTACTAATGGCGGTATAA","561307.5.peg.551","1968"
"25778",1885,571,1314,"CTCAGATTTCCCTGAACCAG","CATTACTAATGGCGGTATAA","561307.5.peg.551","1968"
"25779",1233,571,662,"TGCCCTCTCAATGTCATATG","CATTACTAATGGCGGTATAA","561307.5.peg.551","1968"
"25780",824,571,253,"TTTCAGCAACCGTTGGATAA","CATTACTAATGGCGGTATAA","561307.5.peg.551","1968"
"25781",1515,571,944,"ATAATGGTATCTACATGCTC","CATTACTAATGGCGGTATAA","561307.5.peg.551","1968"
"25782",1949,571,1378,"ATAGGAATGCAACTTCATGA","CATTACTAATGGCGGTATAA","561307.5.peg.551","1968"
"25783",470,571,101,"GAATAATCCTTGGCGAACGA","CATTACTAATGGCGGTATAA","561307.5.peg.551","1968"
"25784",2021,571,1450,"TGTAATCGTACCAACTAAA","CATTACTAATGGCGGTATAA","561307.5.peg.551","1968"
"25785",1800,571,1229,"TCTTTACCTCTTACACCTAA","CATTACTAATGGCGGTATAA","561307.5.peg.551","1968"
"25786",1531,571,960,"CGAGACTTGATATCAATAA","CATTACTAATGGCGGTATAA","561307.5.peg.551","1968"
"25787",438,571,133,"TAATCATCTGCCTGTGCATG","CATTACTAATGGCGGTATAA","561307.5.peg.551","1968"
"25788",1337,571,766,"TGCTGCGTTCACGCACAGCT","CATTACTAATGGCGGTATAA","561307.5.peg.551","1968"
"25789",1863,571,1292,"GTACCAGCAACTAAACCATG","CATTACTAATGGCGGTATAA","561307.5.peg.551","1968"
"25790",1386,579,807,"GTAATGACAAACACTAATTG","AAAGCAATCATTACTAATGG","561307.5.peg.551","1968"
"25791",470,579,109,"GAATAATCCTTGGCGAACGA","AAAGCAATCATTACTAATGG","561307.5.peg.551","1968"
"25792",983,579,404,"CGAATAGTTCATCACGACGT","AAAGCAATCATTACTAATGG","561307.5.peg.551","1968"
"25793",1531,579,952,"CGAGACTTGATATCAATAA","AAAGCAATCATTACTAATGG","561307.5.peg.551","1968"
"25794",438,579,141,"TAATCATCTGCCTGTGCATG","AAAGCAATCATTACTAATGG","561307.5.peg.551","1968"
"25795",2021,579,1442,"TGTAATCGTACCAACTAAA","AAAGCAATCATTACTAATGG","561307.5.peg.551","1968"
"25796",831,579,252,"TCTTTAATTTCAGCAACCGT","AAAGCAATCATTACTAATGG","561307.5.peg.551","1968"
"25797",1515,579,936,"ATAATGGTATCTACATGCTC","AAAGCAATCATTACTAATGG","561307.5.peg.551","1968"
"25798",824,579,245,"TTTCAGCAACCGTTGGATAA","AAAGCAATCATTACTAATGG","561307.5.peg.551","1968"
"25799",1863,579,1284,"GTACCAGCAACTAAACCATG","AAAGCAATCATTACTAATGG","561307.5.peg.551","1968"
"25800",1949,579,1370,"ATAGGAATGCAACTTCATGA","AAAGCAATCATTACTAATGG","561307.5.peg.551","1968"
"25801",1233,579,654,"TGCCCTCTCAATGTCATATG","AAAGCAATCATTACTAATGG","561307.5.peg.551","1968"
"25802",1885,579,1306,"CTCAGATTTCCCTGAACCAG","AAAGCAATCATTACTAATGG","561307.5.peg.551","1968"
"25803",1800,579,1221,"TCTTTACCTCTTACACCTAA","AAAGCAATCATTACTAATGG","561307.5.peg.551","1968"
"25804",1337,579,758,"TGCTGCGTTCACGCACAGCT","AAAGCAATCATTACTAATGG","561307.5.peg.551","1968"
"25805",537,824,287,"CTGTATTGTTCTTCTGTAT","TTTCAGCAACCGTTGGATAA","561307.5.peg.551","1968"
"25806",528,824,296,"TTCTTCTGTATTGGCTGTGG","TTTCAGCAACCGTTGGATAA","561307.5.peg.551","1968"
"25807",1531,824,707,"CGAGACTTGATATCAATAA","TTTCAGCAACCGTTGGATAA","561307.5.peg.551","1968"
"25808",1949,824,1125,"ATAGGAATGCAACTTCATGA","TTTCAGCAACCGTTGGATAA","561307.5.peg.551","1968"
"25809",579,824,245,"AAAGCAATCATTACTAATGG","TTTCAGCAACCGTTGGATAA","561307.5.peg.551","1968"
"25810",571,824,253,"CATTACTAATGGCGGTATAA","TTTCAGCAACCGTTGGATAA","561307.5.peg.551","1968"
"25811",1800,824,976,"TCTTTACCTCTTACACCTAA","TTTCAGCAACCGTTGGATAA","561307.5.peg.551","1968"
"25812",1885,824,1061,"CTCAGATTTCCCTGAACCAG","TTTCAGCAACCGTTGGATAA","561307.5.peg.551","1968"
"25813",480,824,344,"GGTTCACGGTGAATAATCCT","TTTCAGCAACCGTTGGATAA","561307.5.peg.551","1968"
"25814",1863,824,1039,"GTACCAGCAACTAAACCATG","TTTCAGCAACCGTTGGATAA","561307.5.peg.551","1968"
"25815",983,824,159,"CGAATAGTTCATCACGACGT","TTTCAGCAACCGTTGGATAA","561307.5.peg.551","1968"
"25816",470,824,354,"GAATAATCCTTGGCGAACGA","TTTCAGCAACCGTTGGATAA","561307.5.peg.551","1968"
"25817",1386,824,562,"GTAATGACAAACACTAATTG","TTTCAGCAACCGTTGGATAA","561307.5.peg.551","1968"
"25818",1337,824,513,"TGCTGCGTTCACGCACAGCT","TTTCAGCAACCGTTGGATAA","561307.5.peg.551","1968"
"25819",531,824,293,"TTGTTCTTCTGTATTGGCTG","TTTCAGCAACCGTTGGATAA","561307.5.peg.551","1968"
"25820",2021,824,1197,"TGTAATCGTACCAACTAAA","TTTCAGCAACCGTTGGATAA","561307.5.peg.551","1968"
"25821",494,824,330,"TAATATCATCCGTCGGTTCA","TTTCAGCAACCGTTGGATAA","561307.5.peg.551","1968"
"25822",501,824,323,"TCAATCTTAATATCATCCGT","TTTCAGCAACCGTTGGATAA","561307.5.peg.551","1968"
"25823",1233,824,409,"TGCCCTCTCAATGTCATATG","TTTCAGCAACCGTTGGATAA","561307.5.peg.551","1968"
"25824",1515,824,691,"ATAATGGTATCTACATGCTC","TTTCAGCAACCGTTGGATAA","561307.5.peg.551","1968"
"25825",438,824,386,"TAATCATCTGCCTGTGCATG","TTTCAGCAACCGTTGGATAA","561307.5.peg.551","1968"
"25826",1337,831,506,"TGCTGCGTTCACGCACAGCT","TCTTTAATTTCAGCAACCGT","561307.5.peg.551","1968"
"25827",1885,831,1054,"CTCAGATTTCCCTGAACCAG","TCTTTAATTTCAGCAACCGT","561307.5.peg.551","1968"
"25828",1386,831,555,"GTAATGACAAACACTAATTG","TCTTTAATTTCAGCAACCGT","561307.5.peg.551","1968"
"25829",438,831,393,"TAATCATCTGCCTGTGCATG","TCTTTAATTTCAGCAACCGT","561307.5.peg.551","1968"
"25830",480,831,351,"GGTTCACGGTGAATAATCCT","TCTTTAATTTCAGCAACCGT","561307.5.peg.551","1968"
"25831",571,831,260,"CATTACTAATGGCGGTATAA","TCTTTAATTTCAGCAACCGT","561307.5.peg.551","1968"
"25832",579,831,252,"AAAGCAATCATTACTAATGG","TCTTTAATTTCAGCAACCGT","561307.5.peg.551","1968"
"25833",1515,831,684,"ATAATGGTATCTACATGCTC","TCTTTAATTTCAGCAACCGT","561307.5.peg.551","1968"
"25834",531,831,300,"TTGTTCTTCTGTATTGGCTG","TCTTTAATTTCAGCAACCGT","561307.5.peg.551","1968"
"25835",470,831,361,"GAATAATCCTTGGCGAACGA","TCTTTAATTTCAGCAACCGT","561307.5.peg.551","1968"
"25836",537,831,294,"CTGTATTGTTCTTCTGTAT","TCTTTAATTTCAGCAACCGT","561307.5.peg.551","1968"
"25837",494,831,337,"TAATATCATCCGTCGGTTCA","TCTTTAATTTCAGCAACCGT","561307.5.peg.551","1968"
"25838",1800,831,969,"TCTTTACCTCTTACACCTAA","TCTTTAATTTCAGCAACCGT","561307.5.peg.551","1968"
"25839",501,831,330,"TCAATCTTAATATCATCCGT","TCTTTAATTTCAGCAACCGT","561307.5.peg.551","1968"
"25840",1233,831,402,"TGCCCTCTCAATGTCATATG","TCTTTAATTTCAGCAACCGT","561307.5.peg.551","1968"
"25841",528,831,303,"TTCTTCTGTATTGGCTGTGG","TCTTTAATTTCAGCAACCGT","561307.5.peg.551","1968"
"25842",983,831,152,"CGAATAGTTCATCACGACGT","TCTTTAATTTCAGCAACCGT","561307.5.peg.551","1968"
"25843",1863,831,1032,"GTACCAGCAACTAAACCATG","TCTTTAATTTCAGCAACCGT","561307.5.peg.551","1968"
"25844",1531,831,700,"CGAGACTTGATATCAATAA","TCTTTAATTTCAGCAACCGT","561307.5.peg.551","1968"
"25845",1949,831,1118,"ATAGGAATGCAACTTCATGA","TCTTTAATTTCAGCAACCGT","561307.5.peg.551","1968"
"25846",2021,831,1190,"TGTAATCGTACCAACTAAA","TCTTTAATTTCAGCAACCGT","561307.5.peg.551","1968"
"25847",438,983,545,"TAATCATCTGCCTGTGCATG","CGAATAGTTCATCACGACGT","561307.5.peg.551","1968"
"25848",537,983,446,"CTGTATTGTTCTTCTGTAT","CGAATAGTTCATCACGACGT","561307.5.peg.551","1968"
"25849",1531,983,548,"CGAGACTTGATATCAATAA","CGAATAGTTCATCACGACGT","561307.5.peg.551","1968"
"25850",2021,983,1038,"TGTAATCGTACCAACTAAA","CGAATAGTTCATCACGACGT","561307.5.peg.551","1968"
"25851",1337,983,354,"TGCTGCGTTCACGCACAGCT","CGAATAGTTCATCACGACGT","561307.5.peg.551","1968"
"25852",1949,983,966,"ATAGGAATGCAACTTCATGA","CGAATAGTTCATCACGACGT","561307.5.peg.551","1968"
"25853",1386,983,403,"GTAATGACAAACACTAATTG","CGAATAGTTCATCACGACGT","561307.5.peg.551","1968"
"25854",824,983,159,"TTTCAGCAACCGTTGGATAA","CGAATAGTTCATCACGACGT","561307.5.peg.551","1968"
"25855",1233,983,250,"TGCCCTCTCAATGTCATATG","CGAATAGTTCATCACGACGT","561307.5.peg.551","1968"
"25856",579,983,404,"AAAGCAATCATTACTAATGG","CGAATAGTTCATCACGACGT","561307.5.peg.551","1968"
"25857",531,983,452,"TTGTTCTTCTGTATTGGCTG","CGAATAGTTCATCACGACGT","561307.5.peg.551","1968"
"25858",831,983,152,"TCTTTAATTTCAGCAACCGT","CGAATAGTTCATCACGACGT","561307.5.peg.551","1968"
"25859",470,983,513,"GAATAATCCTTGGCGAACGA","CGAATAGTTCATCACGACGT","561307.5.peg.551","1968"
"25860",1515,983,532,"ATAATGGTATCTACATGCTC","CGAATAGTTCATCACGACGT","561307.5.peg.551","1968"
"25861",528,983,455,"TTCTTCTGTATTGGCTGTGG","CGAATAGTTCATCACGACGT","561307.5.peg.551","1968"
"25862",1885,983,902,"CTCAGATTTCCCTGAACCAG","CGAATAGTTCATCACGACGT","561307.5.peg.551","1968"
"25863",480,983,503,"GGTTCACGGTGAATAATCCT","CGAATAGTTCATCACGACGT","561307.5.peg.551","1968"
"25864",1863,983,880,"GTACCAGCAACTAAACCATG","CGAATAGTTCATCACGACGT","561307.5.peg.551","1968"
"25865",1800,983,817,"TCTTTACCTCTTACACCTAA","CGAATAGTTCATCACGACGT","561307.5.peg.551","1968"
"25866",571,983,412,"CATTACTAATGGCGGTATAA","CGAATAGTTCATCACGACGT","561307.5.peg.551","1968"
"25867",501,983,482,"TCAATCTTAATATCATCCGT","CGAATAGTTCATCACGACGT","561307.5.peg.551","1968"
"25868",494,983,489,"TAATATCATCCGTCGGTTCA","CGAATAGTTCATCACGACGT","561307.5.peg.551","1968"
"25869",1949,1233,716,"ATAGGAATGCAACTTCATGA","TGCCCTCTCAATGTCATATG","561307.5.peg.551","1968"
"25870",1386,1233,153,"GTAATGACAAACACTAATTG","TGCCCTCTCAATGTCATATG","561307.5.peg.551","1968"
"25871",537,1233,696,"CTGTATTGTTCTTCTGTAT","TGCCCTCTCAATGTCATATG","561307.5.peg.551","1968"
"25872",1531,1233,298,"CGAGACTTGATATCAATAA","TGCCCTCTCAATGTCATATG","561307.5.peg.551","1968"
"25873",470,1233,763,"GAATAATCCTTGGCGAACGA","TGCCCTCTCAATGTCATATG","561307.5.peg.551","1968"
"25874",2021,1233,788,"TGTAATCGTACCAACTAAA","TGCCCTCTCAATGTCATATG","561307.5.peg.551","1968"
"25875",831,1233,402,"TCTTTAATTTCAGCAACCGT","TGCCCTCTCAATGTCATATG","561307.5.peg.551","1968"
"25876",1337,1233,104,"TGCTGCGTTCACGCACAGCT","TGCCCTCTCAATGTCATATG","561307.5.peg.551","1968"
"25877",480,1233,753,"GGTTCACGGTGAATAATCCT","TGCCCTCTCAATGTCATATG","561307.5.peg.551","1968"
"25878",494,1233,739,"TAATATCATCCGTCGGTTCA","TGCCCTCTCAATGTCATATG","561307.5.peg.551","1968"
"25879",501,1233,732,"TCAATCTTAATATCATCCGT","TGCCCTCTCAATGTCATATG","561307.5.peg.551","1968"
"25880",983,1233,250,"CGAATAGTTCATCACGACGT","TGCCCTCTCAATGTCATATG","561307.5.peg.551","1968"
"25881",571,1233,662,"CATTACTAATGGCGGTATAA","TGCCCTCTCAATGTCATATG","561307.5.peg.551","1968"
"25882",1863,1233,630,"GTACCAGCAACTAAACCATG","TGCCCTCTCAATGTCATATG","561307.5.peg.551","1968"
"25883",438,1233,795,"TAATCATCTGCCTGTGCATG","TGCCCTCTCAATGTCATATG","561307.5.peg.551","1968"
"25884",528,1233,705,"TTCTTCTGTATTGGCTGTGG","TGCCCTCTCAATGTCATATG","561307.5.peg.551","1968"
"25885",531,1233,702,"TTGTTCTTCTGTATTGGCTG","TGCCCTCTCAATGTCATATG","561307.5.peg.551","1968"
"25886",1515,1233,282,"ATAATGGTATCTACATGCTC","TGCCCTCTCAATGTCATATG","561307.5.peg.551","1968"
"25887",824,1233,409,"TTTCAGCAACCGTTGGATAA","TGCCCTCTCAATGTCATATG","561307.5.peg.551","1968"
"25888",579,1233,654,"AAAGCAATCATTACTAATGG","TGCCCTCTCAATGTCATATG","561307.5.peg.551","1968"
"25889",1800,1233,567,"TCTTTACCTCTTACACCTAA","TGCCCTCTCAATGTCATATG","561307.5.peg.551","1968"
"25890",1885,1233,652,"CTCAGATTTCCCTGAACCAG","TGCCCTCTCAATGTCATATG","561307.5.peg.551","1968"
"25891",579,1337,758,"AAAGCAATCATTACTAATGG","TGCTGCGTTCACGCACAGCT","561307.5.peg.551","1968"
"25892",831,1337,506,"TCTTTAATTTCAGCAACCGT","TGCTGCGTTCACGCACAGCT","561307.5.peg.551","1968"
"25893",470,1337,867,"GAATAATCCTTGGCGAACGA","TGCTGCGTTCACGCACAGCT","561307.5.peg.551","1968"
"25894",1949,1337,612,"ATAGGAATGCAACTTCATGA","TGCTGCGTTCACGCACAGCT","561307.5.peg.551","1968"
"25895",1233,1337,104,"TGCCCTCTCAATGTCATATG","TGCTGCGTTCACGCACAGCT","561307.5.peg.551","1968"
"25896",501,1337,836,"TCAATCTTAATATCATCCGT","TGCTGCGTTCACGCACAGCT","561307.5.peg.551","1968"
"25897",1885,1337,548,"CTCAGATTTCCCTGAACCAG","TGCTGCGTTCACGCACAGCT","561307.5.peg.551","1968"
"25898",1515,1337,178,"ATAATGGTATCTACATGCTC","TGCTGCGTTCACGCACAGCT","561307.5.peg.551","1968"
"25899",824,1337,513,"TTTCAGCAACCGTTGGATAA","TGCTGCGTTCACGCACAGCT","561307.5.peg.551","1968"
"25900",480,1337,857,"GGTTCACGGTGAATAATCCT","TGCTGCGTTCACGCACAGCT","561307.5.peg.551","1968"
"25901",2021,1337,684,"TGTAATCGTACCAACTAAA","TGCTGCGTTCACGCACAGCT","561307.5.peg.551","1968"
"25902",537,1337,800,"CTGTATTGTTCTTCTGTAT","TGCTGCGTTCACGCACAGCT","561307.5.peg.551","1968"
"25903",1863,1337,526,"GTACCAGCAACTAAACCATG","TGCTGCGTTCACGCACAGCT","561307.5.peg.551","1968"
"25904",494,1337,843,"TAATATCATCCGTCGGTTCA","TGCTGCGTTCACGCACAGCT","561307.5.peg.551","1968"
"25905",983,1337,354,"CGAATAGTTCATCACGACGT","TGCTGCGTTCACGCACAGCT","561307.5.peg.551","1968"
"25906",1800,1337,463,"TCTTTACCTCTTACACCTAA","TGCTGCGTTCACGCACAGCT","561307.5.peg.551","1968"
"25907",571,1337,766,"CATTACTAATGGCGGTATAA","TGCTGCGTTCACGCACAGCT","561307.5.peg.551","1968"
"25908",438,1337,899,"TAATCATCTGCCTGTGCATG","TGCTGCGTTCACGCACAGCT","561307.5.peg.551","1968"
"25909",1531,1337,194,"CGAGACTTGATATCAATAA","TGCTGCGTTCACGCACAGCT","561307.5.peg.551","1968"
"25910",531,1337,806,"TTGTTCTTCTGTATTGGCTG","TGCTGCGTTCACGCACAGCT","561307.5.peg.551","1968"
"25911",528,1337,809,"TTCTTCTGTATTGGCTGTGG","TGCTGCGTTCACGCACAGCT","561307.5.peg.551","1968"
"25912",824,1386,562,"TTTCAGCAACCGTTGGATAA","GTAATGACAAACACTAATTG","561307.5.peg.551","1968"
"25913",1949,1386,563,"ATAGGAATGCAACTTCATGA","GTAATGACAAACACTAATTG","561307.5.peg.551","1968"
"25914",501,1386,885,"TCAATCTTAATATCATCCGT","GTAATGACAAACACTAATTG","561307.5.peg.551","1968"
"25915",1233,1386,153,"TGCCCTCTCAATGTCATATG","GTAATGACAAACACTAATTG","561307.5.peg.551","1968"
"25916",579,1386,807,"AAAGCAATCATTACTAATGG","GTAATGACAAACACTAATTG","561307.5.peg.551","1968"
"25917",1515,1386,129,"ATAATGGTATCTACATGCTC","GTAATGACAAACACTAATTG","561307.5.peg.551","1968"
"25918",571,1386,815,"CATTACTAATGGCGGTATAA","GTAATGACAAACACTAATTG","561307.5.peg.551","1968"
"25919",537,1386,849,"CTGTATTGTTCTTCTGTAT","GTAATGACAAACACTAATTG","561307.5.peg.551","1968"
"25920",528,1386,858,"TTCTTCTGTATTGGCTGTGG","GTAATGACAAACACTAATTG","561307.5.peg.551","1968"
"25921",1800,1386,414,"TCTTTACCTCTTACACCTAA","GTAATGACAAACACTAATTG","561307.5.peg.551","1968"
"25922",438,1386,948,"TAATCATCTGCCTGTGCATG","GTAATGACAAACACTAATTG","561307.5.peg.551","1968"
"25923",1863,1386,477,"GTACCAGCAACTAAACCATG","GTAATGACAAACACTAATTG","561307.5.peg.551","1968"
"25924",480,1386,906,"GGTTCACGGTGAATAATCCT","GTAATGACAAACACTAATTG","561307.5.peg.551","1968"
"25925",2021,1386,635,"TGTAATCGTACCAACTAAA","GTAATGACAAACACTAATTG","561307.5.peg.551","1968"
"25926",831,1386,555,"TCTTTAATTTCAGCAACCGT","GTAATGACAAACACTAATTG","561307.5.peg.551","1968"
"25927",983,1386,403,"CGAATAGTTCATCACGACGT","GTAATGACAAACACTAATTG","561307.5.peg.551","1968"
"25928",1531,1386,145,"CGAGACTTGATATCAATAA","GTAATGACAAACACTAATTG","561307.5.peg.551","1968"
"25929",470,1386,916,"GAATAATCCTTGGCGAACGA","GTAATGACAAACACTAATTG","561307.5.peg.551","1968"
"25930",494,1386,892,"TAATATCATCCGTCGGTTCA","GTAATGACAAACACTAATTG","561307.5.peg.551","1968"
"25931",531,1386,855,"TTGTTCTTCTGTATTGGCTG","GTAATGACAAACACTAATTG","561307.5.peg.551","1968"
"25932",1885,1386,499,"CTCAGATTTCCCTGAACCAG","GTAATGACAAACACTAATTG","561307.5.peg.551","1968"
"25933",831,1515,684,"TCTTTAATTTCAGCAACCGT","ATAATGGTATCTACATGCTC","561307.5.peg.551","1968"
"25934",438,1515,1077,"TAATCATCTGCCTGTGCATG","ATAATGGTATCTACATGCTC","561307.5.peg.551","1968"
"25935",1863,1515,348,"GTACCAGCAACTAAACCATG","ATAATGGTATCTACATGCTC","561307.5.peg.551","1968"
"25936",2021,1515,506,"TGTAATCGTACCAACTAAA","ATAATGGTATCTACATGCTC","561307.5.peg.551","1968"
"25937",824,1515,691,"TTTCAGCAACCGTTGGATAA","ATAATGGTATCTACATGCTC","561307.5.peg.551","1968"
"25938",579,1515,936,"AAAGCAATCATTACTAATGG","ATAATGGTATCTACATGCTC","561307.5.peg.551","1968"
"25939",470,1515,1045,"GAATAATCCTTGGCGAACGA","ATAATGGTATCTACATGCTC","561307.5.peg.551","1968"
"25940",494,1515,1021,"TAATATCATCCGTCGGTTCA","ATAATGGTATCTACATGCTC","561307.5.peg.551","1968"
"25941",1337,1515,178,"TGCTGCGTTCACGCACAGCT","ATAATGGTATCTACATGCTC","561307.5.peg.551","1968"
"25942",537,1515,978,"CTGTATTGTTCTTCTGTAT","ATAATGGTATCTACATGCTC","561307.5.peg.551","1968"
"25943",528,1515,987,"TTCTTCTGTATTGGCTGTGG","ATAATGGTATCTACATGCTC","561307.5.peg.551","1968"
"25944",480,1515,1035,"GGTTCACGGTGAATAATCCT","ATAATGGTATCTACATGCTC","561307.5.peg.551","1968"
"25945",571,1515,944,"CATTACTAATGGCGGTATAA","ATAATGGTATCTACATGCTC","561307.5.peg.551","1968"
"25946",983,1515,532,"CGAATAGTTCATCACGACGT","ATAATGGTATCTACATGCTC","561307.5.peg.551","1968"
"25947",1233,1515,282,"TGCCCTCTCAATGTCATATG","ATAATGGTATCTACATGCTC","561307.5.peg.551","1968"
"25948",501,1515,1014,"TCAATCTTAATATCATCCGT","ATAATGGTATCTACATGCTC","561307.5.peg.551","1968"
"25949",1800,1515,285,"TCTTTACCTCTTACACCTAA","ATAATGGTATCTACATGCTC","561307.5.peg.551","1968"
"25950",531,1515,984,"TTGTTCTTCTGTATTGGCTG","ATAATGGTATCTACATGCTC","561307.5.peg.551","1968"
"25951",1885,1515,370,"CTCAGATTTCCCTGAACCAG","ATAATGGTATCTACATGCTC","561307.5.peg.551","1968"
"25952",1949,1515,434,"ATAGGAATGCAACTTCATGA","ATAATGGTATCTACATGCTC","561307.5.peg.551","1968"
"25953",1386,1515,129,"GTAATGACAAACACTAATTG","ATAATGGTATCTACATGCTC","561307.5.peg.551","1968"
"25954",824,1531,707,"TTTCAGCAACCGTTGGATAA","CGAGACTTGATATCAATAA","561307.5.peg.551","1968"
"25955",470,1531,1061,"GAATAATCCTTGGCGAACGA","CGAGACTTGATATCAATAA","561307.5.peg.551","1968"
"25956",1233,1531,298,"TGCCCTCTCAATGTCATATG","CGAGACTTGATATCAATAA","561307.5.peg.551","1968"
"25957",1863,1531,332,"GTACCAGCAACTAAACCATG","CGAGACTTGATATCAATAA","561307.5.peg.551","1968"
"25958",528,1531,1003,"TTCTTCTGTATTGGCTGTGG","CGAGACTTGATATCAATAA","561307.5.peg.551","1968"
"25959",494,1531,1037,"TAATATCATCCGTCGGTTCA","CGAGACTTGATATCAATAA","561307.5.peg.551","1968"
"25960",579,1531,952,"AAAGCAATCATTACTAATGG","CGAGACTTGATATCAATAA","561307.5.peg.551","1968"
"25961",1337,1531,194,"TGCTGCGTTCACGCACAGCT","CGAGACTTGATATCAATAA","561307.5.peg.551","1968"
"25962",2021,1531,490,"TGTAATCGTACCAACTAAA","CGAGACTTGATATCAATAA","561307.5.peg.551","1968"
"25963",831,1531,700,"TCTTTAATTTCAGCAACCGT","CGAGACTTGATATCAATAA","561307.5.peg.551","1968"
"25964",537,1531,994,"CTGTATTGTTCTTCTGTAT","CGAGACTTGATATCAATAA","561307.5.peg.551","1968"
"25965",1800,1531,269,"TCTTTACCTCTTACACCTAA","CGAGACTTGATATCAATAA","561307.5.peg.551","1968"
"25966",531,1531,1000,"TTGTTCTTCTGTATTGGCTG","CGAGACTTGATATCAATAA","561307.5.peg.551","1968"
"25967",501,1531,1030,"TCAATCTTAATATCATCCGT","CGAGACTTGATATCAATAA","561307.5.peg.551","1968"
"25968",480,1531,1051,"GGTTCACGGTGAATAATCCT","CGAGACTTGATATCAATAA","561307.5.peg.551","1968"
"25969",983,1531,548,"CGAATAGTTCATCACGACGT","CGAGACTTGATATCAATAA","561307.5.peg.551","1968"
"25970",1386,1531,145,"GTAATGACAAACACTAATTG","CGAGACTTGATATCAATAA","561307.5.peg.551","1968"
"25971",1885,1531,354,"CTCAGATTTCCCTGAACCAG","CGAGACTTGATATCAATAA","561307.5.peg.551","1968"
"25972",438,1531,1093,"TAATCATCTGCCTGTGCATG","CGAGACTTGATATCAATAA","561307.5.peg.551","1968"
"25973",571,1531,960,"CATTACTAATGGCGGTATAA","CGAGACTTGATATCAATAA","561307.5.peg.551","1968"
"25974",1949,1531,418,"ATAGGAATGCAACTTCATGA","CGAGACTTGATATCAATAA","561307.5.peg.551","1968"
"25975",494,1800,1306,"TAATATCATCCGTCGGTTCA","TCTTTACCTCTTACACCTAA","561307.5.peg.551","1968"
"25976",824,1800,976,"TTTCAGCAACCGTTGGATAA","TCTTTACCTCTTACACCTAA","561307.5.peg.551","1968"
"25977",1233,1800,567,"TGCCCTCTCAATGTCATATG","TCTTTACCTCTTACACCTAA","561307.5.peg.551","1968"
"25978",528,1800,1272,"TTCTTCTGTATTGGCTGTGG","TCTTTACCTCTTACACCTAA","561307.5.peg.551","1968"
"25979",571,1800,1229,"CATTACTAATGGCGGTATAA","TCTTTACCTCTTACACCTAA","561307.5.peg.551","1968"
"25980",831,1800,969,"TCTTTAATTTCAGCAACCGT","TCTTTACCTCTTACACCTAA","561307.5.peg.551","1968"
"25981",501,1800,1299,"TCAATCTTAATATCATCCGT","TCTTTACCTCTTACACCTAA","561307.5.peg.551","1968"
"25982",531,1800,1269,"TTGTTCTTCTGTATTGGCTG","TCTTTACCTCTTACACCTAA","561307.5.peg.551","1968"
"25983",579,1800,1221,"AAAGCAATCATTACTAATGG","TCTTTACCTCTTACACCTAA","561307.5.peg.551","1968"
"25984",537,1800,1263,"CTGTATTGTTCTTCTGTAT","TCTTTACCTCTTACACCTAA","561307.5.peg.551","1968"
"25985",480,1800,1320,"GGTTCACGGTGAATAATCCT","TCTTTACCTCTTACACCTAA","561307.5.peg.551","1968"
"25986",470,1800,1330,"GAATAATCCTTGGCGAACGA","TCTTTACCTCTTACACCTAA","561307.5.peg.551","1968"
"25987",1949,1800,149,"ATAGGAATGCAACTTCATGA","TCTTTACCTCTTACACCTAA","561307.5.peg.551","1968"
"25988",1531,1800,269,"CGAGACTTGATATCAATAA","TCTTTACCTCTTACACCTAA","561307.5.peg.551","1968"
"25989",438,1800,1362,"TAATCATCTGCCTGTGCATG","TCTTTACCTCTTACACCTAA","561307.5.peg.551","1968"
"25990",983,1800,817,"CGAATAGTTCATCACGACGT","TCTTTACCTCTTACACCTAA","561307.5.peg.551","1968"
"25991",1337,1800,463,"TGCTGCGTTCACGCACAGCT","TCTTTACCTCTTACACCTAA","561307.5.peg.551","1968"
"25992",2021,1800,221,"TGTAATCGTACCAACTAAA","TCTTTACCTCTTACACCTAA","561307.5.peg.551","1968"
"25993",1386,1800,414,"GTAATGACAAACACTAATTG","TCTTTACCTCTTACACCTAA","561307.5.peg.551","1968"
"25994",1515,1800,285,"ATAATGGTATCTACATGCTC","TCTTTACCTCTTACACCTAA","561307.5.peg.551","1968"
"25995",1337,1863,526,"TGCTGCGTTCACGCACAGCT","GTACCAGCAACTAAACCATG","561307.5.peg.551","1968"
"25996",983,1863,880,"CGAATAGTTCATCACGACGT","GTACCAGCAACTAAACCATG","561307.5.peg.551","1968"
"25997",1386,1863,477,"GTAATGACAAACACTAATTG","GTACCAGCAACTAAACCATG","561307.5.peg.551","1968"
"25998",579,1863,1284,"AAAGCAATCATTACTAATGG","GTACCAGCAACTAAACCATG","561307.5.peg.551","1968"
"25999",494,1863,1369,"TAATATCATCCGTCGGTTCA","GTACCAGCAACTAAACCATG","561307.5.peg.551","1968"
"26000",480,1863,1383,"GGTTCACGGTGAATAATCCT","GTACCAGCAACTAAACCATG","561307.5.peg.551","1968"
"26001",571,1863,1292,"CATTACTAATGGCGGTATAA","GTACCAGCAACTAAACCATG","561307.5.peg.551","1968"
"26002",438,1863,1425,"TAATCATCTGCCTGTGCATG","GTACCAGCAACTAAACCATG","561307.5.peg.551","1968"
"26003",1531,1863,332,"CGAGACTTGATATCAATAA","GTACCAGCAACTAAACCATG","561307.5.peg.551","1968"
"26004",470,1863,1393,"GAATAATCCTTGGCGAACGA","GTACCAGCAACTAAACCATG","561307.5.peg.551","1968"
"26005",824,1863,1039,"TTTCAGCAACCGTTGGATAA","GTACCAGCAACTAAACCATG","561307.5.peg.551","1968"
"26006",2021,1863,158,"TGTAATCGTACCAACTAAA","GTACCAGCAACTAAACCATG","561307.5.peg.551","1968"
"26007",501,1863,1362,"TCAATCTTAATATCATCCGT","GTACCAGCAACTAAACCATG","561307.5.peg.551","1968"
"26008",531,1863,1332,"TTGTTCTTCTGTATTGGCTG","GTACCAGCAACTAAACCATG","561307.5.peg.551","1968"
"26009",1515,1863,348,"ATAATGGTATCTACATGCTC","GTACCAGCAACTAAACCATG","561307.5.peg.551","1968"
"26010",1233,1863,630,"TGCCCTCTCAATGTCATATG","GTACCAGCAACTAAACCATG","561307.5.peg.551","1968"
"26011",831,1863,1032,"TCTTTAATTTCAGCAACCGT","GTACCAGCAACTAAACCATG","561307.5.peg.551","1968"
"26012",537,1863,1326,"CTGTATTGTTCTTCTGTAT","GTACCAGCAACTAAACCATG","561307.5.peg.551","1968"
"26013",528,1863,1335,"TTCTTCTGTATTGGCTGTGG","GTACCAGCAACTAAACCATG","561307.5.peg.551","1968"
"26014",438,1885,1447,"TAATCATCTGCCTGTGCATG","CTCAGATTTCCCTGAACCAG","561307.5.peg.551","1968"
"26015",2021,1885,136,"TGTAATCGTACCAACTAAA","CTCAGATTTCCCTGAACCAG","561307.5.peg.551","1968"
"26016",537,1885,1348,"CTGTATTGTTCTTCTGTAT","CTCAGATTTCCCTGAACCAG","561307.5.peg.551","1968"
"26017",470,1885,1415,"GAATAATCCTTGGCGAACGA","CTCAGATTTCCCTGAACCAG","561307.5.peg.551","1968"
"26018",1233,1885,652,"TGCCCTCTCAATGTCATATG","CTCAGATTTCCCTGAACCAG","561307.5.peg.551","1968"
"26019",831,1885,1054,"TCTTTAATTTCAGCAACCGT","CTCAGATTTCCCTGAACCAG","561307.5.peg.551","1968"
"26020",531,1885,1354,"TTGTTCTTCTGTATTGGCTG","CTCAGATTTCCCTGAACCAG","561307.5.peg.551","1968"
"26021",480,1885,1405,"GGTTCACGGTGAATAATCCT","CTCAGATTTCCCTGAACCAG","561307.5.peg.551","1968"
"26022",494,1885,1391,"TAATATCATCCGTCGGTTCA","CTCAGATTTCCCTGAACCAG","561307.5.peg.551","1968"
"26023",1531,1885,354,"CGAGACTTGATATCAATAA","CTCAGATTTCCCTGAACCAG","561307.5.peg.551","1968"
"26024",1515,1885,370,"ATAATGGTATCTACATGCTC","CTCAGATTTCCCTGAACCAG","561307.5.peg.551","1968"
"26025",1337,1885,548,"TGCTGCGTTCACGCACAGCT","CTCAGATTTCCCTGAACCAG","561307.5.peg.551","1968"
"26026",579,1885,1306,"AAAGCAATCATTACTAATGG","CTCAGATTTCCCTGAACCAG","561307.5.peg.551","1968"
"26027",1386,1885,499,"GTAATGACAAACACTAATTG","CTCAGATTTCCCTGAACCAG","561307.5.peg.551","1968"
"26028",501,1885,1384,"TCAATCTTAATATCATCCGT","CTCAGATTTCCCTGAACCAG","561307.5.peg.551","1968"
"26029",983,1885,902,"CGAATAGTTCATCACGACGT","CTCAGATTTCCCTGAACCAG","561307.5.peg.551","1968"
"26030",571,1885,1314,"CATTACTAATGGCGGTATAA","CTCAGATTTCCCTGAACCAG","561307.5.peg.551","1968"
"26031",824,1885,1061,"TTTCAGCAACCGTTGGATAA","CTCAGATTTCCCTGAACCAG","561307.5.peg.551","1968"
"26032",528,1885,1357,"TTCTTCTGTATTGGCTGTGG","CTCAGATTTCCCTGAACCAG","561307.5.peg.551","1968"
"26033",831,1949,1118,"TCTTTAATTTCAGCAACCGT","ATAGGAATGCAACTTCATGA","561307.5.peg.551","1968"
"26034",480,1949,1469,"GGTTCACGGTGAATAATCCT","ATAGGAATGCAACTTCATGA","561307.5.peg.551","1968"
"26035",494,1949,1455,"TAATATCATCCGTCGGTTCA","ATAGGAATGCAACTTCATGA","561307.5.peg.551","1968"
"26036",571,1949,1378,"CATTACTAATGGCGGTATAA","ATAGGAATGCAACTTCATGA","561307.5.peg.551","1968"
"26037",1337,1949,612,"TGCTGCGTTCACGCACAGCT","ATAGGAATGCAACTTCATGA","561307.5.peg.551","1968"
"26038",528,1949,1421,"TTCTTCTGTATTGGCTGTGG","ATAGGAATGCAACTTCATGA","561307.5.peg.551","1968"
"26039",470,1949,1479,"GAATAATCCTTGGCGAACGA","ATAGGAATGCAACTTCATGA","561307.5.peg.551","1968"
"26040",501,1949,1448,"TCAATCTTAATATCATCCGT","ATAGGAATGCAACTTCATGA","561307.5.peg.551","1968"
"26041",1531,1949,418,"CGAGACTTGATATCAATAA","ATAGGAATGCAACTTCATGA","561307.5.peg.551","1968"
"26042",537,1949,1412,"CTGTATTGTTCTTCTGTAT","ATAGGAATGCAACTTCATGA","561307.5.peg.551","1968"
"26043",824,1949,1125,"TTTCAGCAACCGTTGGATAA","ATAGGAATGCAACTTCATGA","561307.5.peg.551","1968"
"26044",531,1949,1418,"TTGTTCTTCTGTATTGGCTG","ATAGGAATGCAACTTCATGA","561307.5.peg.551","1968"
"26045",1515,1949,434,"ATAATGGTATCTACATGCTC","ATAGGAATGCAACTTCATGA","561307.5.peg.551","1968"
"26046",983,1949,966,"CGAATAGTTCATCACGACGT","ATAGGAATGCAACTTCATGA","561307.5.peg.551","1968"
"26047",1800,1949,149,"TCTTTACCTCTTACACCTAA","ATAGGAATGCAACTTCATGA","561307.5.peg.551","1968"
"26048",579,1949,1370,"AAAGCAATCATTACTAATGG","ATAGGAATGCAACTTCATGA","561307.5.peg.551","1968"
"26049",438,1949,1511,"TAATCATCTGCCTGTGCATG","ATAGGAATGCAACTTCATGA","561307.5.peg.551","1968"
"26050",1233,1949,716,"TGCCCTCTCAATGTCATATG","ATAGGAATGCAACTTCATGA","561307.5.peg.551","1968"
"26051",1386,1949,563,"GTAATGACAAACACTAATTG","ATAGGAATGCAACTTCATGA","561307.5.peg.551","1968"
"26052",494,2021,1527,"TAATATCATCCGTCGGTTCA","TGTAATCGTACCAACTAAA","561307.5.peg.551","1968"
"26053",1515,2021,506,"ATAATGGTATCTACATGCTC","TGTAATCGTACCAACTAAA","561307.5.peg.551","1968"
"26054",480,2021,1541,"GGTTCACGGTGAATAATCCT","TGTAATCGTACCAACTAAA","561307.5.peg.551","1968"
"26055",531,2021,1490,"TTGTTCTTCTGTATTGGCTG","TGTAATCGTACCAACTAAA","561307.5.peg.551","1968"
"26056",1800,2021,221,"TCTTTACCTCTTACACCTAA","TGTAATCGTACCAACTAAA","561307.5.peg.551","1968"
"26057",824,2021,1197,"TTTCAGCAACCGTTGGATAA","TGTAATCGTACCAACTAAA","561307.5.peg.551","1968"
"26058",501,2021,1520,"TCAATCTTAATATCATCCGT","TGTAATCGTACCAACTAAA","561307.5.peg.551","1968"
"26059",1531,2021,490,"CGAGACTTGATATCAATAA","TGTAATCGTACCAACTAAA","561307.5.peg.551","1968"
"26060",528,2021,1493,"TTCTTCTGTATTGGCTGTGG","TGTAATCGTACCAACTAAA","561307.5.peg.551","1968"
"26061",983,2021,1038,"CGAATAGTTCATCACGACGT","TGTAATCGTACCAACTAAA","561307.5.peg.551","1968"
"26062",470,2021,1551,"GAATAATCCTTGGCGAACGA","TGTAATCGTACCAACTAAA","561307.5.peg.551","1968"
"26063",579,2021,1442,"AAAGCAATCATTACTAATGG","TGTAATCGTACCAACTAAA","561307.5.peg.551","1968"
"26064",1863,2021,158,"GTACCAGCAACTAAACCATG","TGTAATCGTACCAACTAAA","561307.5.peg.551","1968"
"26065",831,2021,1190,"TCTTTAATTTCAGCAACCGT","TGTAATCGTACCAACTAAA","561307.5.peg.551","1968"
"26066",1386,2021,635,"GTAATGACAAACACTAATTG","TGTAATCGTACCAACTAAA","561307.5.peg.551","1968"
"26067",438,2021,1583,"TAATCATCTGCCTGTGCATG","TGTAATCGTACCAACTAAA","561307.5.peg.551","1968"
"26068",1337,2021,684,"TGCTGCGTTCACGCACAGCT","TGTAATCGTACCAACTAAA","561307.5.peg.551","1968"
"26069",571,2021,1450,"CATTACTAATGGCGGTATAA","TGTAATCGTACCAACTAAA","561307.5.peg.551","1968"
"26070",1885,2021,136,"CTCAGATTTCCCTGAACCAG","TGTAATCGTACCAACTAAA","561307.5.peg.551","1968"
"26071",537,2021,1484,"CTGTATTGTTCTTCTGTAT","TGTAATCGTACCAACTAAA","561307.5.peg.551","1968"
"26072",1233,2021,788,"TGCCCTCTCAATGTCATATG","TGTAATCGTACCAACTAAA","561307.5.peg.551","1968"
"26073",766,237,529,"TGCATTTGCTGCTGAATAAG","CCCATTAATTTAGATCCTTG","561307.5.peg.556","1973"
"26074",870,237,633,"CCTTTGAGGAAGCCCATACC","CCCATTAATTTAGATCCTTG","561307.5.peg.556","1973"
"26075",732,237,495,"ATAGCTACTGCTCCAGCAAC","CCCATTAATTTAGATCCTTG","561307.5.peg.556","1973"
"26076",864,237,627,"AGGAAGCCCATACCTGGCAA","CCCATTAATTTAGATCCTTG","561307.5.peg.556","1973"
"26077",870,732,138,"CCTTTGAGGAAGCCCATACC","ATAGCTACTGCTCCAGCAAC","561307.5.peg.556","1973"
"26078",237,732,495,"CCCATTAATTTAGATCCTTG","ATAGCTACTGCTCCAGCAAC","561307.5.peg.556","1973"
"26079",864,732,132,"AGGAAGCCCATACCTGGCAA","ATAGCTACTGCTCCAGCAAC","561307.5.peg.556","1973"
"26080",237,766,529,"CCCATTAATTTAGATCCTTG","TGCATTTGCTGCTGAATAAG","561307.5.peg.556","1973"
"26081",870,766,104,"CCTTTGAGGAAGCCCATACC","TGCATTTGCTGCTGAATAAG","561307.5.peg.556","1973"
"26082",237,864,627,"CCCATTAATTTAGATCCTTG","AGGAAGCCCATACCTGGCAA","561307.5.peg.556","1973"
"26083",732,864,132,"ATAGCTACTGCTCCAGCAAC","AGGAAGCCCATACCTGGCAA","561307.5.peg.556","1973"
"26084",237,870,633,"CCCATTAATTTAGATCCTTG","CCTTTGAGGAAGCCCATACC","561307.5.peg.556","1973"
"26085",732,870,138,"ATAGCTACTGCTCCAGCAAC","CCTTTGAGGAAGCCCATACC","561307.5.peg.556","1973"
"26086",766,870,104,"TGCATTTGCTGCTGAATAAG","CCTTTGAGGAAGCCCATACC","561307.5.peg.556","1973"
"26087",1198,7,1191,"TTCATCTTCTGTATGGATAA","TTCACAAAGTATAAAGGAG","561307.5.peg.557","1974"
"26088",420,7,413,"GTCGACGTAGGATTTGTTGT","TTCACAAAGTATAAAGGAG","561307.5.peg.557","1974"
"26089",726,7,719,"ATGTAAGACGGCACGTTACC","TTCACAAAGTATAAAGGAG","561307.5.peg.557","1974"
"26090",708,7,701,"CCTGGTCCCACACCTAATGC","TTCACAAAGTATAAAGGAG","561307.5.peg.557","1974"
"26091",1054,7,1047,"TGAACCTACACCGCTAATTT","TTCACAAAGTATAAAGGAG","561307.5.peg.557","1974"
"26092",1278,7,1271,"CCAATACCTCCAACCGCTGA","TTCACAAAGTATAAAGGAG","561307.5.peg.557","1974"
"26093",1198,420,778,"TTCATCTTCTGTATGGATAA","GTCGACGTAGGATTTGTTGT","561307.5.peg.557","1974"
"26094",7,420,413,"TTCACAAAGTATAAAGGAG","GTCGACGTAGGATTTGTTGT","561307.5.peg.557","1974"
"26095",1054,420,634,"TGAACCTACACCGCTAATTT","GTCGACGTAGGATTTGTTGT","561307.5.peg.557","1974"
"26096",1278,420,858,"CCAATACCTCCAACCGCTGA","GTCGACGTAGGATTTGTTGT","561307.5.peg.557","1974"
"26097",708,420,288,"CCTGGTCCCACACCTAATGC","GTCGACGTAGGATTTGTTGT","561307.5.peg.557","1974"
"26098",726,420,306,"ATGTAAGACGGCACGTTACC","GTCGACGTAGGATTTGTTGT","561307.5.peg.557","1974"
"26099",1198,708,490,"TTCATCTTCTGTATGGATAA","CCTGGTCCCACACCTAATGC","561307.5.peg.557","1974"
"26100",1278,708,570,"CCAATACCTCCAACCGCTGA","CCTGGTCCCACACCTAATGC","561307.5.peg.557","1974"
"26101",1054,708,346,"TGAACCTACACCGCTAATTT","CCTGGTCCCACACCTAATGC","561307.5.peg.557","1974"
"26102",420,708,288,"GTCGACGTAGGATTTGTTGT","CCTGGTCCCACACCTAATGC","561307.5.peg.557","1974"
"26103",7,708,701,"TTCACAAAGTATAAAGGAG","CCTGGTCCCACACCTAATGC","561307.5.peg.557","1974"
"26104",7,726,719,"TTCACAAAGTATAAAGGAG","ATGTAAGACGGCACGTTACC","561307.5.peg.557","1974"
"26105",1278,726,552,"CCAATACCTCCAACCGCTGA","ATGTAAGACGGCACGTTACC","561307.5.peg.557","1974"
"26106",1054,726,328,"TGAACCTACACCGCTAATTT","ATGTAAGACGGCACGTTACC","561307.5.peg.557","1974"
"26107",1198,726,472,"TTCATCTTCTGTATGGATAA","ATGTAAGACGGCACGTTACC","561307.5.peg.557","1974"
"26108",420,726,306,"GTCGACGTAGGATTTGTTGT","ATGTAAGACGGCACGTTACC","561307.5.peg.557","1974"
"26109",726,1054,328,"ATGTAAGACGGCACGTTACC","TGAACCTACACCGCTAATTT","561307.5.peg.557","1974"
"26110",708,1054,346,"CCTGGTCCCACACCTAATGC","TGAACCTACACCGCTAATTT","561307.5.peg.557","1974"
"26111",1278,1054,224,"CCAATACCTCCAACCGCTGA","TGAACCTACACCGCTAATTT","561307.5.peg.557","1974"
"26112",1198,1054,144,"TTCATCTTCTGTATGGATAA","TGAACCTACACCGCTAATTT","561307.5.peg.557","1974"
"26113",420,1054,634,"GTCGACGTAGGATTTGTTGT","TGAACCTACACCGCTAATTT","561307.5.peg.557","1974"
"26114",7,1054,1047,"TTCACAAAGTATAAAGGAG","TGAACCTACACCGCTAATTT","561307.5.peg.557","1974"
"26115",7,1198,1191,"TTCACAAAGTATAAAGGAG","TTCATCTTCTGTATGGATAA","561307.5.peg.557","1974"
"26116",726,1198,472,"ATGTAAGACGGCACGTTACC","TTCATCTTCTGTATGGATAA","561307.5.peg.557","1974"
"26117",1054,1198,144,"TGAACCTACACCGCTAATTT","TTCATCTTCTGTATGGATAA","561307.5.peg.557","1974"
"26118",420,1198,778,"GTCGACGTAGGATTTGTTGT","TTCATCTTCTGTATGGATAA","561307.5.peg.557","1974"
"26119",708,1198,490,"CCTGGTCCCACACCTAATGC","TTCATCTTCTGTATGGATAA","561307.5.peg.557","1974"
"26120",420,1278,858,"GTCGACGTAGGATTTGTTGT","CCAATACCTCCAACCGCTGA","561307.5.peg.557","1974"
"26121",708,1278,570,"CCTGGTCCCACACCTAATGC","CCAATACCTCCAACCGCTGA","561307.5.peg.557","1974"
"26122",1054,1278,224,"TGAACCTACACCGCTAATTT","CCAATACCTCCAACCGCTGA","561307.5.peg.557","1974"
"26123",7,1278,1271,"TTCACAAAGTATAAAGGAG","CCAATACCTCCAACCGCTGA","561307.5.peg.557","1974"
"26124",726,1278,552,"ATGTAAGACGGCACGTTACC","CCAATACCTCCAACCGCTGA","561307.5.peg.557","1974"
"26125",348,228,120,"ACATACTCGACAATTTAGA","ACCTCTTGCGCCATAAACTG","561307.5.peg.558","1975"
"26126",228,348,120,"ACCTCTTGCGCCATAAACTG","ACATACTCGACAATTTAGA","561307.5.peg.558","1975"
"26127",690,5,685,"AAACGCTCTTGACCAATAGT","GGTTATAAACAGCAAATGAG","561307.5.peg.561","1979"
"26128",642,5,637,"TATATTTCCTCACTAGTTC","GGTTATAAACAGCAAATGAG","561307.5.peg.561","1979"
"26129",446,5,441,"ATTAAATGACTTACCTCCA","GGTTATAAACAGCAAATGAG","561307.5.peg.561","1979"
"26130",555,5,550,"TCATCATCGACTGCTAATAC","GGTTATAAACAGCAAATGAG","561307.5.peg.561","1979"
"26131",734,5,729,"ATAACTCAACGCCATCCATA","GGTTATAAACAGCAAATGAG","561307.5.peg.561","1979"
"26132",765,5,760,"GACATGACGTCTTCTATATT","GGTTATAAACAGCAAATGAG","561307.5.peg.561","1979"
"26133",5,446,441,"GGTTATAAACAGCAAATGAG","ATTAAATGACTTACCTCCA","561307.5.peg.561","1979"
"26134",555,446,109,"TCATCATCGACTGCTAATAC","ATTAAATGACTTACCTCCA","561307.5.peg.561","1979"
"26135",642,446,196,"TATATTTCCTCACTAGTTC","ATTAAATGACTTACCTCCA","561307.5.peg.561","1979"
"26136",734,446,288,"ATAACTCAACGCCATCCATA","ATTAAATGACTTACCTCCA","561307.5.peg.561","1979"
"26137",690,446,244,"AAACGCTCTTGACCAATAGT","ATTAAATGACTTACCTCCA","561307.5.peg.561","1979"
"26138",765,446,319,"GACATGACGTCTTCTATATT","ATTAAATGACTTACCTCCA","561307.5.peg.561","1979"
"26139",446,555,109,"ATTAAATGACTTACCTCCA","TCATCATCGACTGCTAATAC","561307.5.peg.561","1979"
"26140",734,555,179,"ATAACTCAACGCCATCCATA","TCATCATCGACTGCTAATAC","561307.5.peg.561","1979"
"26141",5,555,550,"GGTTATAAACAGCAAATGAG","TCATCATCGACTGCTAATAC","561307.5.peg.561","1979"
"26142",765,555,210,"GACATGACGTCTTCTATATT","TCATCATCGACTGCTAATAC","561307.5.peg.561","1979"
"26143",690,555,135,"AAACGCTCTTGACCAATAGT","TCATCATCGACTGCTAATAC","561307.5.peg.561","1979"
"26144",446,642,196,"ATTAAATGACTTACCTCCA","TATATTTCCTCACTAGTTC","561307.5.peg.561","1979"
"26145",765,642,123,"GACATGACGTCTTCTATATT","TATATTTCCTCACTAGTTC","561307.5.peg.561","1979"
"26146",5,642,637,"GGTTATAAACAGCAAATGAG","TATATTTCCTCACTAGTTC","561307.5.peg.561","1979"
"26147",5,690,685,"GGTTATAAACAGCAAATGAG","AAACGCTCTTGACCAATAGT","561307.5.peg.561","1979"
"26148",555,690,135,"TCATCATCGACTGCTAATAC","AAACGCTCTTGACCAATAGT","561307.5.peg.561","1979"
"26149",446,690,244,"ATTAAATGACTTACCTCCA","AAACGCTCTTGACCAATAGT","561307.5.peg.561","1979"
"26150",555,734,179,"TCATCATCGACTGCTAATAC","ATAACTCAACGCCATCCATA","561307.5.peg.561","1979"
"26151",5,734,729,"GGTTATAAACAGCAAATGAG","ATAACTCAACGCCATCCATA","561307.5.peg.561","1979"
"26152",446,734,288,"ATTAAATGACTTACCTCCA","ATAACTCAACGCCATCCATA","561307.5.peg.561","1979"
"26153",5,765,760,"GGTTATAAACAGCAAATGAG","GACATGACGTCTTCTATATT","561307.5.peg.561","1979"
"26154",642,765,123,"TATATTTCCTCACTAGTTC","GACATGACGTCTTCTATATT","561307.5.peg.561","1979"
"26155",446,765,319,"ATTAAATGACTTACCTCCA","GACATGACGTCTTCTATATT","561307.5.peg.561","1979"
"26156",555,765,210,"TCATCATCGACTGCTAATAC","GACATGACGTCTTCTATATT","561307.5.peg.561","1979"
"26157",438,309,129,"GAAATACCCCTAGCATTAAT","ACTGGAAAGAATTCACATGA","561307.5.peg.562","1980"
"26158",438,327,111,"GAAATACCCCTAGCATTAAT","TTTGTCTTCACTGCCTCAAC","561307.5.peg.562","1980"
"26159",309,438,129,"ACTGGAAAGAATTCACATGA","GAAATACCCCTAGCATTAAT","561307.5.peg.562","1980"
"26160",327,438,111,"TTTGTCTTCACTGCCTCAAC","GAAATACCCCTAGCATTAAT","561307.5.peg.562","1980"
"26161",441,309,132,"CACCACTTGCCGAATAAATT","GAAGACGATAATAATATCGC","561307.5.peg.563","1981"
"26162",468,309,159,"GCTATCACTGAGTTATAATT","GAAGACGATAATAATATCGC","561307.5.peg.563","1981"
"26163",468,354,114,"GCTATCACTGAGTTATAATT","TGCAACTTACTCTCACCATA","561307.5.peg.563","1981"
"26164",309,441,132,"GAAGACGATAATAATATCGC","CACCACTTGCCGAATAAATT","561307.5.peg.563","1981"
"26165",309,468,159,"GAAGACGATAATAATATCGC","GCTATCACTGAGTTATAATT","561307.5.peg.563","1981"
"26166",354,468,114,"TGCAACTTACTCTCACCATA","GCTATCACTGAGTTATAATT","561307.5.peg.563","1981"
"26167",486,9,477,"CGTCTGCTATGTTCCGTATA","GCCAGATACGTATTTCTTGG","561307.5.peg.564","1982"
"26168",395,9,386,"ATCTATTACCCGCTTCCATG","GCCAGATACGTATTTCTTGG","561307.5.peg.564","1982"
"26169",222,9,213,"ACTGCCTCTAAGTAGTGGTC","GCCAGATACGTATTTCTTGG","561307.5.peg.564","1982"
"26170",561,9,552,"GCTTCTATCACTTCTGTCAT","GCCAGATACGTATTTCTTGG","561307.5.peg.564","1982"
"26171",227,9,218,"TTCCAACTGCCTCTAAGTAG","GCCAGATACGTATTTCTTGG","561307.5.peg.564","1982"
"26172",387,9,378,"CCCGCTTCCATGTGGAACAC","GCCAGATACGTATTTCTTGG","561307.5.peg.564","1982"
"26173",464,9,455,"GTAGATTCACATCACTGACA","GCCAGATACGTATTTCTTGG","561307.5.peg.564","1982"
"26174",486,12,474,"CGTCTGCTATGTTCCGTATA","AAATACGTATCTGGCTGATT","561307.5.peg.564","1982"
"26175",395,12,383,"ATCTATTACCCGCTTCCATG","AAATACGTATCTGGCTGATT","561307.5.peg.564","1982"
"26176",227,12,215,"TTCCAACTGCCTCTAAGTAG","AAATACGTATCTGGCTGATT","561307.5.peg.564","1982"
"26177",222,12,210,"ACTGCCTCTAAGTAGTGGTC","AAATACGTATCTGGCTGATT","561307.5.peg.564","1982"
"26178",561,12,549,"GCTTCTATCACTTCTGTCAT","AAATACGTATCTGGCTGATT","561307.5.peg.564","1982"
"26179",387,12,375,"CCCGCTTCCATGTGGAACAC","AAATACGTATCTGGCTGATT","561307.5.peg.564","1982"
"26180",464,12,452,"GTAGATTCACATCACTGACA","AAATACGTATCTGGCTGATT","561307.5.peg.564","1982"
"26181",227,21,206,"TTCCAACTGCCTCTAAGTAG","ACCTCCAAGAAATACGTATC","561307.5.peg.564","1982"
"26182",486,21,465,"CGTCTGCTATGTTCCGTATA","ACCTCCAAGAAATACGTATC","561307.5.peg.564","1982"
"26183",561,21,540,"GCTTCTATCACTTCTGTCAT","ACCTCCAAGAAATACGTATC","561307.5.peg.564","1982"
"26184",395,21,374,"ATCTATTACCCGCTTCCATG","ACCTCCAAGAAATACGTATC","561307.5.peg.564","1982"
"26185",222,21,201,"ACTGCCTCTAAGTAGTGGTC","ACCTCCAAGAAATACGTATC","561307.5.peg.564","1982"
"26186",464,21,443,"GTAGATTCACATCACTGACA","ACCTCCAAGAAATACGTATC","561307.5.peg.564","1982"
"26187",387,21,366,"CCCGCTTCCATGTGGAACAC","ACCTCCAAGAAATACGTATC","561307.5.peg.564","1982"
"26188",9,222,213,"GCCAGATACGTATTTCTTGG","ACTGCCTCTAAGTAGTGGTC","561307.5.peg.564","1982"
"26189",486,222,264,"CGTCTGCTATGTTCCGTATA","ACTGCCTCTAAGTAGTGGTC","561307.5.peg.564","1982"
"26190",21,222,201,"ACCTCCAAGAAATACGTATC","ACTGCCTCTAAGTAGTGGTC","561307.5.peg.564","1982"
"26191",387,222,165,"CCCGCTTCCATGTGGAACAC","ACTGCCTCTAAGTAGTGGTC","561307.5.peg.564","1982"
"26192",12,222,210,"AAATACGTATCTGGCTGATT","ACTGCCTCTAAGTAGTGGTC","561307.5.peg.564","1982"
"26193",395,222,173,"ATCTATTACCCGCTTCCATG","ACTGCCTCTAAGTAGTGGTC","561307.5.peg.564","1982"
"26194",464,222,242,"GTAGATTCACATCACTGACA","ACTGCCTCTAAGTAGTGGTC","561307.5.peg.564","1982"
"26195",561,222,339,"GCTTCTATCACTTCTGTCAT","ACTGCCTCTAAGTAGTGGTC","561307.5.peg.564","1982"
"26196",464,227,237,"GTAGATTCACATCACTGACA","TTCCAACTGCCTCTAAGTAG","561307.5.peg.564","1982"
"26197",9,227,218,"GCCAGATACGTATTTCTTGG","TTCCAACTGCCTCTAAGTAG","561307.5.peg.564","1982"
"26198",387,227,160,"CCCGCTTCCATGTGGAACAC","TTCCAACTGCCTCTAAGTAG","561307.5.peg.564","1982"
"26199",395,227,168,"ATCTATTACCCGCTTCCATG","TTCCAACTGCCTCTAAGTAG","561307.5.peg.564","1982"
"26200",561,227,334,"GCTTCTATCACTTCTGTCAT","TTCCAACTGCCTCTAAGTAG","561307.5.peg.564","1982"
"26201",21,227,206,"ACCTCCAAGAAATACGTATC","TTCCAACTGCCTCTAAGTAG","561307.5.peg.564","1982"
"26202",12,227,215,"AAATACGTATCTGGCTGATT","TTCCAACTGCCTCTAAGTAG","561307.5.peg.564","1982"
"26203",486,227,259,"CGTCTGCTATGTTCCGTATA","TTCCAACTGCCTCTAAGTAG","561307.5.peg.564","1982"
"26204",12,387,375,"AAATACGTATCTGGCTGATT","CCCGCTTCCATGTGGAACAC","561307.5.peg.564","1982"
"26205",21,387,366,"ACCTCCAAGAAATACGTATC","CCCGCTTCCATGTGGAACAC","561307.5.peg.564","1982"
"26206",9,387,378,"GCCAGATACGTATTTCTTGG","CCCGCTTCCATGTGGAACAC","561307.5.peg.564","1982"
"26207",227,387,160,"TTCCAACTGCCTCTAAGTAG","CCCGCTTCCATGTGGAACAC","561307.5.peg.564","1982"
"26208",561,387,174,"GCTTCTATCACTTCTGTCAT","CCCGCTTCCATGTGGAACAC","561307.5.peg.564","1982"
"26209",222,387,165,"ACTGCCTCTAAGTAGTGGTC","CCCGCTTCCATGTGGAACAC","561307.5.peg.564","1982"
"26210",9,395,386,"GCCAGATACGTATTTCTTGG","ATCTATTACCCGCTTCCATG","561307.5.peg.564","1982"
"26211",561,395,166,"GCTTCTATCACTTCTGTCAT","ATCTATTACCCGCTTCCATG","561307.5.peg.564","1982"
"26212",21,395,374,"ACCTCCAAGAAATACGTATC","ATCTATTACCCGCTTCCATG","561307.5.peg.564","1982"
"26213",12,395,383,"AAATACGTATCTGGCTGATT","ATCTATTACCCGCTTCCATG","561307.5.peg.564","1982"
"26214",227,395,168,"TTCCAACTGCCTCTAAGTAG","ATCTATTACCCGCTTCCATG","561307.5.peg.564","1982"
"26215",222,395,173,"ACTGCCTCTAAGTAGTGGTC","ATCTATTACCCGCTTCCATG","561307.5.peg.564","1982"
"26216",9,464,455,"GCCAGATACGTATTTCTTGG","GTAGATTCACATCACTGACA","561307.5.peg.564","1982"
"26217",12,464,452,"AAATACGTATCTGGCTGATT","GTAGATTCACATCACTGACA","561307.5.peg.564","1982"
"26218",227,464,237,"TTCCAACTGCCTCTAAGTAG","GTAGATTCACATCACTGACA","561307.5.peg.564","1982"
"26219",222,464,242,"ACTGCCTCTAAGTAGTGGTC","GTAGATTCACATCACTGACA","561307.5.peg.564","1982"
"26220",21,464,443,"ACCTCCAAGAAATACGTATC","GTAGATTCACATCACTGACA","561307.5.peg.564","1982"
"26221",227,486,259,"TTCCAACTGCCTCTAAGTAG","CGTCTGCTATGTTCCGTATA","561307.5.peg.564","1982"
"26222",222,486,264,"ACTGCCTCTAAGTAGTGGTC","CGTCTGCTATGTTCCGTATA","561307.5.peg.564","1982"
"26223",12,486,474,"AAATACGTATCTGGCTGATT","CGTCTGCTATGTTCCGTATA","561307.5.peg.564","1982"
"26224",21,486,465,"ACCTCCAAGAAATACGTATC","CGTCTGCTATGTTCCGTATA","561307.5.peg.564","1982"
"26225",9,486,477,"GCCAGATACGTATTTCTTGG","CGTCTGCTATGTTCCGTATA","561307.5.peg.564","1982"
"26226",21,561,540,"ACCTCCAAGAAATACGTATC","GCTTCTATCACTTCTGTCAT","561307.5.peg.564","1982"
"26227",227,561,334,"TTCCAACTGCCTCTAAGTAG","GCTTCTATCACTTCTGTCAT","561307.5.peg.564","1982"
"26228",9,561,552,"GCCAGATACGTATTTCTTGG","GCTTCTATCACTTCTGTCAT","561307.5.peg.564","1982"
"26229",12,561,549,"AAATACGTATCTGGCTGATT","GCTTCTATCACTTCTGTCAT","561307.5.peg.564","1982"
"26230",222,561,339,"ACTGCCTCTAAGTAGTGGTC","GCTTCTATCACTTCTGTCAT","561307.5.peg.564","1982"
"26231",395,561,166,"ATCTATTACCCGCTTCCATG","GCTTCTATCACTTCTGTCAT","561307.5.peg.564","1982"
"26232",387,561,174,"CCCGCTTCCATGTGGAACAC","GCTTCTATCACTTCTGTCAT","561307.5.peg.564","1982"
"26233",312,92,220,"TCATTTGCATGAATCACGTC","CTATTTGTTTAAGTACCCTT","561307.5.peg.566","1984"
"26234",92,312,220,"CTATTTGTTTAAGTACCCTT","TCATTTGCATGAATCACGTC","561307.5.peg.566","1984"
"26235",351,134,217,"TAAATACCACTAATTGCCGC","AGTAATACACCGGCTCTATA","561307.5.peg.567","1985"
"26236",291,134,157,"GCTAGTTTCTCTTCCTTATC","AGTAATACACCGGCTCTATA","561307.5.peg.567","1985"
"26237",550,134,416,"ATGAAATAAATGCCTAATC","AGTAATACACCGGCTCTATA","561307.5.peg.567","1985"
"26238",351,144,207,"TAAATACCACTAATTGCCGC","ACCATGGTTGAGTAATACAC","561307.5.peg.567","1985"
"26239",291,144,147,"GCTAGTTTCTCTTCCTTATC","ACCATGGTTGAGTAATACAC","561307.5.peg.567","1985"
"26240",550,144,406,"ATGAAATAAATGCCTAATC","ACCATGGTTGAGTAATACAC","561307.5.peg.567","1985"
"26241",550,217,333,"ATGAAATAAATGCCTAATC","TAACCCTCGCGGAATTTCTT","561307.5.peg.567","1985"
"26242",351,217,134,"TAAATACCACTAATTGCCGC","TAACCCTCGCGGAATTTCTT","561307.5.peg.567","1985"
"26243",351,228,123,"TAAATACCACTAATTGCCGC","TTAATAATATTAACCCTCG","561307.5.peg.567","1985"
"26244",550,228,322,"ATGAAATAAATGCCTAATC","TTAATAATATTAACCCTCG","561307.5.peg.567","1985"
"26245",134,291,157,"AGTAATACACCGGCTCTATA","GCTAGTTTCTCTTCCTTATC","561307.5.peg.567","1985"
"26246",550,291,259,"ATGAAATAAATGCCTAATC","GCTAGTTTCTCTTCCTTATC","561307.5.peg.567","1985"
"26247",144,291,147,"ACCATGGTTGAGTAATACAC","GCTAGTTTCTCTTCCTTATC","561307.5.peg.567","1985"
"26248",134,351,217,"AGTAATACACCGGCTCTATA","TAAATACCACTAATTGCCGC","561307.5.peg.567","1985"
"26249",228,351,123,"TTAATAATATTAACCCTCG","TAAATACCACTAATTGCCGC","561307.5.peg.567","1985"
"26250",144,351,207,"ACCATGGTTGAGTAATACAC","TAAATACCACTAATTGCCGC","561307.5.peg.567","1985"
"26251",217,351,134,"TAACCCTCGCGGAATTTCTT","TAAATACCACTAATTGCCGC","561307.5.peg.567","1985"
"26252",550,351,199,"ATGAAATAAATGCCTAATC","TAAATACCACTAATTGCCGC","561307.5.peg.567","1985"
"26253",134,550,416,"AGTAATACACCGGCTCTATA","ATGAAATAAATGCCTAATC","561307.5.peg.567","1985"
"26254",144,550,406,"ACCATGGTTGAGTAATACAC","ATGAAATAAATGCCTAATC","561307.5.peg.567","1985"
"26255",228,550,322,"TTAATAATATTAACCCTCG","ATGAAATAAATGCCTAATC","561307.5.peg.567","1985"
"26256",217,550,333,"TAACCCTCGCGGAATTTCTT","ATGAAATAAATGCCTAATC","561307.5.peg.567","1985"
"26257",351,550,199,"TAAATACCACTAATTGCCGC","ATGAAATAAATGCCTAATC","561307.5.peg.567","1985"
"26258",291,550,259,"GCTAGTTTCTCTTCCTTATC","ATGAAATAAATGCCTAATC","561307.5.peg.567","1985"
"26259",236,66,170,"CATACCAGTTAGGAATCACA","CCTGTCTTAATCGCATTATC","561307.5.peg.569","1987"
"26260",246,66,180,"TGACGCATGTCATACCAGTT","CCTGTCTTAATCGCATTATC","561307.5.peg.569","1987"
"26261",236,99,137,"CATACCAGTTAGGAATCACA","AGCTTATCAATCATGCTACC","561307.5.peg.569","1987"
"26262",246,99,147,"TGACGCATGTCATACCAGTT","AGCTTATCAATCATGCTACC","561307.5.peg.569","1987"
"26263",66,236,170,"CCTGTCTTAATCGCATTATC","CATACCAGTTAGGAATCACA","561307.5.peg.569","1987"
"26264",99,236,137,"AGCTTATCAATCATGCTACC","CATACCAGTTAGGAATCACA","561307.5.peg.569","1987"
"26265",66,246,180,"CCTGTCTTAATCGCATTATC","TGACGCATGTCATACCAGTT","561307.5.peg.569","1987"
"26266",99,246,147,"AGCTTATCAATCATGCTACC","TGACGCATGTCATACCAGTT","561307.5.peg.569","1987"
"26267",563,8,555,"AGCCACTTTGAATAATTTGC","TTCGATAGAGTGATAAAGGA","561307.5.peg.57","1988"
"26268",524,8,516,"CATATGGTAATAACACATAC","TTCGATAGAGTGATAAAGGA","561307.5.peg.57","1988"
"26269",443,8,435,"TAAACAGACTTAACAATGGT","TTCGATAGAGTGATAAAGGA","561307.5.peg.57","1988"
"26270",411,8,403,"GGAATGAATGCAATATGTAC","TTCGATAGAGTGATAAAGGA","561307.5.peg.57","1988"
"26271",642,8,634,"CCAACAATATACCCCATTGA","TTCGATAGAGTGATAAAGGA","561307.5.peg.57","1988"
"26272",432,8,424,"AACAATGGTGGGATGACAAT","TTCGATAGAGTGATAAAGGA","561307.5.peg.57","1988"
"26273",432,12,420,"AACAATGGTGGGATGACAAT","TAGTTCGATAGAGTGATAA","561307.5.peg.57","1988"
"26274",524,12,512,"CATATGGTAATAACACATAC","TAGTTCGATAGAGTGATAA","561307.5.peg.57","1988"
"26275",443,12,431,"TAAACAGACTTAACAATGGT","TAGTTCGATAGAGTGATAA","561307.5.peg.57","1988"
"26276",563,12,551,"AGCCACTTTGAATAATTTGC","TAGTTCGATAGAGTGATAA","561307.5.peg.57","1988"
"26277",642,12,630,"CCAACAATATACCCCATTGA","TAGTTCGATAGAGTGATAA","561307.5.peg.57","1988"
"26278",411,12,399,"GGAATGAATGCAATATGTAC","TAGTTCGATAGAGTGATAA","561307.5.peg.57","1988"
"26279",642,411,231,"CCAACAATATACCCCATTGA","GGAATGAATGCAATATGTAC","561307.5.peg.57","1988"
"26280",8,411,403,"TTCGATAGAGTGATAAAGGA","GGAATGAATGCAATATGTAC","561307.5.peg.57","1988"
"26281",12,411,399,"TAGTTCGATAGAGTGATAA","GGAATGAATGCAATATGTAC","561307.5.peg.57","1988"
"26282",563,411,152,"AGCCACTTTGAATAATTTGC","GGAATGAATGCAATATGTAC","561307.5.peg.57","1988"
"26283",524,411,113,"CATATGGTAATAACACATAC","GGAATGAATGCAATATGTAC","561307.5.peg.57","1988"
"26284",563,432,131,"AGCCACTTTGAATAATTTGC","AACAATGGTGGGATGACAAT","561307.5.peg.57","1988"
"26285",12,432,420,"TAGTTCGATAGAGTGATAA","AACAATGGTGGGATGACAAT","561307.5.peg.57","1988"
"26286",642,432,210,"CCAACAATATACCCCATTGA","AACAATGGTGGGATGACAAT","561307.5.peg.57","1988"
"26287",8,432,424,"TTCGATAGAGTGATAAAGGA","AACAATGGTGGGATGACAAT","561307.5.peg.57","1988"
"26288",8,443,435,"TTCGATAGAGTGATAAAGGA","TAAACAGACTTAACAATGGT","561307.5.peg.57","1988"
"26289",12,443,431,"TAGTTCGATAGAGTGATAA","TAAACAGACTTAACAATGGT","561307.5.peg.57","1988"
"26290",642,443,199,"CCAACAATATACCCCATTGA","TAAACAGACTTAACAATGGT","561307.5.peg.57","1988"
"26291",563,443,120,"AGCCACTTTGAATAATTTGC","TAAACAGACTTAACAATGGT","561307.5.peg.57","1988"
"26292",8,524,516,"TTCGATAGAGTGATAAAGGA","CATATGGTAATAACACATAC","561307.5.peg.57","1988"
"26293",411,524,113,"GGAATGAATGCAATATGTAC","CATATGGTAATAACACATAC","561307.5.peg.57","1988"
"26294",12,524,512,"TAGTTCGATAGAGTGATAA","CATATGGTAATAACACATAC","561307.5.peg.57","1988"
"26295",642,524,118,"CCAACAATATACCCCATTGA","CATATGGTAATAACACATAC","561307.5.peg.57","1988"
"26296",432,563,131,"AACAATGGTGGGATGACAAT","AGCCACTTTGAATAATTTGC","561307.5.peg.57","1988"
"26297",411,563,152,"GGAATGAATGCAATATGTAC","AGCCACTTTGAATAATTTGC","561307.5.peg.57","1988"
"26298",12,563,551,"TAGTTCGATAGAGTGATAA","AGCCACTTTGAATAATTTGC","561307.5.peg.57","1988"
"26299",443,563,120,"TAAACAGACTTAACAATGGT","AGCCACTTTGAATAATTTGC","561307.5.peg.57","1988"
"26300",8,563,555,"TTCGATAGAGTGATAAAGGA","AGCCACTTTGAATAATTTGC","561307.5.peg.57","1988"
"26301",8,642,634,"TTCGATAGAGTGATAAAGGA","CCAACAATATACCCCATTGA","561307.5.peg.57","1988"
"26302",432,642,210,"AACAATGGTGGGATGACAAT","CCAACAATATACCCCATTGA","561307.5.peg.57","1988"
"26303",443,642,199,"TAAACAGACTTAACAATGGT","CCAACAATATACCCCATTGA","561307.5.peg.57","1988"
"26304",411,642,231,"GGAATGAATGCAATATGTAC","CCAACAATATACCCCATTGA","561307.5.peg.57","1988"
"26305",12,642,630,"TAGTTCGATAGAGTGATAA","CCAACAATATACCCCATTGA","561307.5.peg.57","1988"
"26306",524,642,118,"CATATGGTAATAACACATAC","CCAACAATATACCCCATTGA","561307.5.peg.57","1988"
"26307",402,175,227,"TAGTTGGTCGTAGGGTTCAT","ACATCATAATCTTTGAACG","561307.5.peg.571","1990"
"26308",410,175,235,"AAATACCATAGTTGGTCGTA","ACATCATAATCTTTGAACG","561307.5.peg.571","1990"
"26309",402,234,168,"TAGTTGGTCGTAGGGTTCAT","TAATCAGATAGCCTTGCTTG","561307.5.peg.571","1990"
"26310",410,234,176,"AAATACCATAGTTGGTCGTA","TAATCAGATAGCCTTGCTTG","561307.5.peg.571","1990"
"26311",175,402,227,"ACATCATAATCTTTGAACG","TAGTTGGTCGTAGGGTTCAT","561307.5.peg.571","1990"
"26312",234,402,168,"TAATCAGATAGCCTTGCTTG","TAGTTGGTCGTAGGGTTCAT","561307.5.peg.571","1990"
"26313",175,410,235,"ACATCATAATCTTTGAACG","AAATACCATAGTTGGTCGTA","561307.5.peg.571","1990"
"26314",234,410,176,"TAATCAGATAGCCTTGCTTG","AAATACCATAGTTGGTCGTA","561307.5.peg.571","1990"
"26315",388,286,102,"ATTGTCGACTCTACAATAA","ATCATTATTCGGCGTCGGAA","561307.5.peg.572","1991"
"26316",498,286,212,"TTTCCTGGCAGTACACGTTC","ATCATTATTCGGCGTCGGAA","561307.5.peg.572","1991"
"26317",498,291,207,"TTTCCTGGCAGTACACGTTC","TGATCATCATTATTCGGCGT","561307.5.peg.572","1991"
"26318",498,317,181,"TTTCCTGGCAGTACACGTTC","CTAGCGAAATGTCACATGAC","561307.5.peg.572","1991"
"26319",286,388,102,"ATCATTATTCGGCGTCGGAA","ATTGTCGACTCTACAATAA","561307.5.peg.572","1991"
"26320",498,388,110,"TTTCCTGGCAGTACACGTTC","ATTGTCGACTCTACAATAA","561307.5.peg.572","1991"
"26321",291,498,207,"TGATCATCATTATTCGGCGT","TTTCCTGGCAGTACACGTTC","561307.5.peg.572","1991"
"26322",317,498,181,"CTAGCGAAATGTCACATGAC","TTTCCTGGCAGTACACGTTC","561307.5.peg.572","1991"
"26323",286,498,212,"ATCATTATTCGGCGTCGGAA","TTTCCTGGCAGTACACGTTC","561307.5.peg.572","1991"
"26324",388,498,110,"ATTGTCGACTCTACAATAA","TTTCCTGGCAGTACACGTTC","561307.5.peg.572","1991"
"26325",260,9,251,"TAGCAAGTGCATTCGCCGTA","CATGTGTTTGAACTTCAGAG","561307.5.peg.573","1992"
"26326",387,9,378,"CCAGCTTCTACATGTCCGAC","CATGTGTTTGAACTTCAGAG","561307.5.peg.573","1992"
"26327",435,9,426,"CGATTTAACTCTTCAGGAAA","CATGTGTTTGAACTTCAGAG","561307.5.peg.573","1992"
"26328",387,260,127,"CCAGCTTCTACATGTCCGAC","TAGCAAGTGCATTCGCCGTA","561307.5.peg.573","1992"
"26329",9,260,251,"CATGTGTTTGAACTTCAGAG","TAGCAAGTGCATTCGCCGTA","561307.5.peg.573","1992"
"26330",435,260,175,"CGATTTAACTCTTCAGGAAA","TAGCAAGTGCATTCGCCGTA","561307.5.peg.573","1992"
"26331",9,387,378,"CATGTGTTTGAACTTCAGAG","CCAGCTTCTACATGTCCGAC","561307.5.peg.573","1992"
"26332",260,387,127,"TAGCAAGTGCATTCGCCGTA","CCAGCTTCTACATGTCCGAC","561307.5.peg.573","1992"
"26333",260,435,175,"TAGCAAGTGCATTCGCCGTA","CGATTTAACTCTTCAGGAAA","561307.5.peg.573","1992"
"26334",9,435,426,"CATGTGTTTGAACTTCAGAG","CGATTTAACTCTTCAGGAAA","561307.5.peg.573","1992"
"26335",117,11,106,"AAAGGGGTCGTTGGCAGTAA","CATGCGCATTAGTACTAGAA","561307.5.peg.575","1994"
"26336",11,117,106,"CATGCGCATTAGTACTAGAA","AAAGGGGTCGTTGGCAGTAA","561307.5.peg.575","1994"
"26337",387,153,234,"TGGAAATGTCTTGCAGCAAA","GATAGTGTTTCTCCAGTTGC","561307.5.peg.576","1995"
"26338",530,153,377,"TCCATGCAGCTAATAGCATT","GATAGTGTTTCTCCAGTTGC","561307.5.peg.576","1995"
"26339",597,153,444,"CTTAATGGTGTTGAAGACGA","GATAGTGTTTCTCCAGTTGC","561307.5.peg.576","1995"
"26340",561,153,408,"GTATTACCTGCAGCAATGGC","GATAGTGTTTCTCCAGTTGC","561307.5.peg.576","1995"
"26341",644,153,491,"CACCTTTAGGTAATACCTCT","GATAGTGTTTCTCCAGTTGC","561307.5.peg.576","1995"
"26342",357,153,204,"ATTGCTGTTGTCTCACGAAT","GATAGTGTTTCTCCAGTTGC","561307.5.peg.576","1995"
"26343",565,153,412,"AATTGTATTACCTGCAGCAA","GATAGTGTTTCTCCAGTTGC","561307.5.peg.576","1995"
"26344",657,153,504,"GTATATTGACAACACCTTT","GATAGTGTTTCTCCAGTTGC","561307.5.peg.576","1995"
"26345",492,153,339,"ACAGCACCTACGACGCCAAT","GATAGTGTTTCTCCAGTTGC","561307.5.peg.576","1995"
"26346",153,357,204,"GATAGTGTTTCTCCAGTTGC","ATTGCTGTTGTCTCACGAAT","561307.5.peg.576","1995"
"26347",597,357,240,"CTTAATGGTGTTGAAGACGA","ATTGCTGTTGTCTCACGAAT","561307.5.peg.576","1995"
"26348",565,357,208,"AATTGTATTACCTGCAGCAA","ATTGCTGTTGTCTCACGAAT","561307.5.peg.576","1995"
"26349",530,357,173,"TCCATGCAGCTAATAGCATT","ATTGCTGTTGTCTCACGAAT","561307.5.peg.576","1995"
"26350",644,357,287,"CACCTTTAGGTAATACCTCT","ATTGCTGTTGTCTCACGAAT","561307.5.peg.576","1995"
"26351",657,357,300,"GTATATTGACAACACCTTT","ATTGCTGTTGTCTCACGAAT","561307.5.peg.576","1995"
"26352",492,357,135,"ACAGCACCTACGACGCCAAT","ATTGCTGTTGTCTCACGAAT","561307.5.peg.576","1995"
"26353",561,357,204,"GTATTACCTGCAGCAATGGC","ATTGCTGTTGTCTCACGAAT","561307.5.peg.576","1995"
"26354",644,387,257,"CACCTTTAGGTAATACCTCT","TGGAAATGTCTTGCAGCAAA","561307.5.peg.576","1995"
"26355",153,387,234,"GATAGTGTTTCTCCAGTTGC","TGGAAATGTCTTGCAGCAAA","561307.5.peg.576","1995"
"26356",565,387,178,"AATTGTATTACCTGCAGCAA","TGGAAATGTCTTGCAGCAAA","561307.5.peg.576","1995"
"26357",561,387,174,"GTATTACCTGCAGCAATGGC","TGGAAATGTCTTGCAGCAAA","561307.5.peg.576","1995"
"26358",530,387,143,"TCCATGCAGCTAATAGCATT","TGGAAATGTCTTGCAGCAAA","561307.5.peg.576","1995"
"26359",492,387,105,"ACAGCACCTACGACGCCAAT","TGGAAATGTCTTGCAGCAAA","561307.5.peg.576","1995"
"26360",597,387,210,"CTTAATGGTGTTGAAGACGA","TGGAAATGTCTTGCAGCAAA","561307.5.peg.576","1995"
"26361",657,387,270,"GTATATTGACAACACCTTT","TGGAAATGTCTTGCAGCAAA","561307.5.peg.576","1995"
"26362",597,492,105,"CTTAATGGTGTTGAAGACGA","ACAGCACCTACGACGCCAAT","561307.5.peg.576","1995"
"26363",644,492,152,"CACCTTTAGGTAATACCTCT","ACAGCACCTACGACGCCAAT","561307.5.peg.576","1995"
"26364",357,492,135,"ATTGCTGTTGTCTCACGAAT","ACAGCACCTACGACGCCAAT","561307.5.peg.576","1995"
"26365",387,492,105,"TGGAAATGTCTTGCAGCAAA","ACAGCACCTACGACGCCAAT","561307.5.peg.576","1995"
"26366",657,492,165,"GTATATTGACAACACCTTT","ACAGCACCTACGACGCCAAT","561307.5.peg.576","1995"
"26367",153,492,339,"GATAGTGTTTCTCCAGTTGC","ACAGCACCTACGACGCCAAT","561307.5.peg.576","1995"
"26368",153,530,377,"GATAGTGTTTCTCCAGTTGC","TCCATGCAGCTAATAGCATT","561307.5.peg.576","1995"
"26369",657,530,127,"GTATATTGACAACACCTTT","TCCATGCAGCTAATAGCATT","561307.5.peg.576","1995"
"26370",644,530,114,"CACCTTTAGGTAATACCTCT","TCCATGCAGCTAATAGCATT","561307.5.peg.576","1995"
"26371",387,530,143,"TGGAAATGTCTTGCAGCAAA","TCCATGCAGCTAATAGCATT","561307.5.peg.576","1995"
"26372",357,530,173,"ATTGCTGTTGTCTCACGAAT","TCCATGCAGCTAATAGCATT","561307.5.peg.576","1995"
"26373",387,561,174,"TGGAAATGTCTTGCAGCAAA","GTATTACCTGCAGCAATGGC","561307.5.peg.576","1995"
"26374",357,561,204,"ATTGCTGTTGTCTCACGAAT","GTATTACCTGCAGCAATGGC","561307.5.peg.576","1995"
"26375",153,561,408,"GATAGTGTTTCTCCAGTTGC","GTATTACCTGCAGCAATGGC","561307.5.peg.576","1995"
"26376",357,565,208,"ATTGCTGTTGTCTCACGAAT","AATTGTATTACCTGCAGCAA","561307.5.peg.576","1995"
"26377",387,565,178,"TGGAAATGTCTTGCAGCAAA","AATTGTATTACCTGCAGCAA","561307.5.peg.576","1995"
"26378",153,565,412,"GATAGTGTTTCTCCAGTTGC","AATTGTATTACCTGCAGCAA","561307.5.peg.576","1995"
"26379",492,597,105,"ACAGCACCTACGACGCCAAT","CTTAATGGTGTTGAAGACGA","561307.5.peg.576","1995"
"26380",357,597,240,"ATTGCTGTTGTCTCACGAAT","CTTAATGGTGTTGAAGACGA","561307.5.peg.576","1995"
"26381",387,597,210,"TGGAAATGTCTTGCAGCAAA","CTTAATGGTGTTGAAGACGA","561307.5.peg.576","1995"
"26382",153,597,444,"GATAGTGTTTCTCCAGTTGC","CTTAATGGTGTTGAAGACGA","561307.5.peg.576","1995"
"26383",387,644,257,"TGGAAATGTCTTGCAGCAAA","CACCTTTAGGTAATACCTCT","561307.5.peg.576","1995"
"26384",492,644,152,"ACAGCACCTACGACGCCAAT","CACCTTTAGGTAATACCTCT","561307.5.peg.576","1995"
"26385",530,644,114,"TCCATGCAGCTAATAGCATT","CACCTTTAGGTAATACCTCT","561307.5.peg.576","1995"
"26386",357,644,287,"ATTGCTGTTGTCTCACGAAT","CACCTTTAGGTAATACCTCT","561307.5.peg.576","1995"
"26387",153,644,491,"GATAGTGTTTCTCCAGTTGC","CACCTTTAGGTAATACCTCT","561307.5.peg.576","1995"
"26388",530,657,127,"TCCATGCAGCTAATAGCATT","GTATATTGACAACACCTTT","561307.5.peg.576","1995"
"26389",357,657,300,"ATTGCTGTTGTCTCACGAAT","GTATATTGACAACACCTTT","561307.5.peg.576","1995"
"26390",387,657,270,"TGGAAATGTCTTGCAGCAAA","GTATATTGACAACACCTTT","561307.5.peg.576","1995"
"26391",153,657,504,"GATAGTGTTTCTCCAGTTGC","GTATATTGACAACACCTTT","561307.5.peg.576","1995"
"26392",492,657,165,"ACAGCACCTACGACGCCAAT","GTATATTGACAACACCTTT","561307.5.peg.576","1995"
"26393",426,303,123,"ATGCCACTTTCAATTGGTTG","CCAAATGTGTATCGTGCAGT","561307.5.peg.577","1996"
"26394",432,303,129,"ACATAATGCCACTTTCAAT","CCAAATGTGTATCGTGCAGT","561307.5.peg.577","1996"
"26395",303,426,123,"CCAAATGTGTATCGTGCAGT","ATGCCACTTTCAATTGGTTG","561307.5.peg.577","1996"
"26396",303,432,129,"CCAAATGTGTATCGTGCAGT","ACATAATGCCACTTTCAAT","561307.5.peg.577","1996"
"26397",606,335,271,"TGTGGTGTTAATACATTCGG","GTGTTCTGACTTTATGTAT","561307.5.peg.58","1999"
"26398",492,335,157,"GGTTTAAATTCGTCTTAAA","GTGTTCTGACTTTATGTAT","561307.5.peg.58","1999"
"26399",759,335,424,"TATGTGATGGTTACTAATCT","GTGTTCTGACTTTATGTAT","561307.5.peg.58","1999"
"26400",624,335,289,"TATCTTCTGCAAATGTTTG","GTGTTCTGACTTTATGTAT","561307.5.peg.58","1999"
"26401",569,335,234,"CTCTTGCCAAATTAATGGAT","GTGTTCTGACTTTATGTAT","561307.5.peg.58","1999"
"26402",335,492,157,"GTGTTCTGACTTTATGTAT","GGTTTAAATTCGTCTTAAA","561307.5.peg.58","1999"
"26403",606,492,114,"TGTGGTGTTAATACATTCGG","GGTTTAAATTCGTCTTAAA","561307.5.peg.58","1999"
"26404",624,492,132,"TATCTTCTGCAAATGTTTG","GGTTTAAATTCGTCTTAAA","561307.5.peg.58","1999"
"26405",759,492,267,"TATGTGATGGTTACTAATCT","GGTTTAAATTCGTCTTAAA","561307.5.peg.58","1999"
"26406",759,569,190,"TATGTGATGGTTACTAATCT","CTCTTGCCAAATTAATGGAT","561307.5.peg.58","1999"
"26407",335,569,234,"GTGTTCTGACTTTATGTAT","CTCTTGCCAAATTAATGGAT","561307.5.peg.58","1999"
"26408",335,606,271,"GTGTTCTGACTTTATGTAT","TGTGGTGTTAATACATTCGG","561307.5.peg.58","1999"
"26409",492,606,114,"GGTTTAAATTCGTCTTAAA","TGTGGTGTTAATACATTCGG","561307.5.peg.58","1999"
"26410",759,606,153,"TATGTGATGGTTACTAATCT","TGTGGTGTTAATACATTCGG","561307.5.peg.58","1999"
"26411",335,624,289,"GTGTTCTGACTTTATGTAT","TATCTTCTGCAAATGTTTG","561307.5.peg.58","1999"
"26412",492,624,132,"GGTTTAAATTCGTCTTAAA","TATCTTCTGCAAATGTTTG","561307.5.peg.58","1999"
"26413",759,624,135,"TATGTGATGGTTACTAATCT","TATCTTCTGCAAATGTTTG","561307.5.peg.58","1999"
"26414",492,759,267,"GGTTTAAATTCGTCTTAAA","TATGTGATGGTTACTAATCT","561307.5.peg.58","1999"
"26415",569,759,190,"CTCTTGCCAAATTAATGGAT","TATGTGATGGTTACTAATCT","561307.5.peg.58","1999"
"26416",624,759,135,"TATCTTCTGCAAATGTTTG","TATGTGATGGTTACTAATCT","561307.5.peg.58","1999"
"26417",335,759,424,"GTGTTCTGACTTTATGTAT","TATGTGATGGTTACTAATCT","561307.5.peg.58","1999"
"26418",606,759,153,"TGTGGTGTTAATACATTCGG","TATGTGATGGTTACTAATCT","561307.5.peg.58","1999"
"26419",477,177,300,"AATGTGTTGAATAACGATG","AATTAGCTGAATGTGTAAT","561307.5.peg.581","2001"
"26420",477,276,201,"AATGTGTTGAATAACGATG","TTAATGCGTCCATTAAATC","561307.5.peg.581","2001"
"26421",177,477,300,"AATTAGCTGAATGTGTAAT","AATGTGTTGAATAACGATG","561307.5.peg.581","2001"
"26422",276,477,201,"TTAATGCGTCCATTAAATC","AATGTGTTGAATAACGATG","561307.5.peg.581","2001"
"26423",288,11,277,"CTTCCAAGCAAGAAGCCCAA","TGAACCGTCATTGTATAAGG","561307.5.peg.582","2002"
"26424",146,11,135,"GACCCGGTAACAATACAGGT","TGAACCGTCATTGTATAAGG","561307.5.peg.582","2002"
"26425",162,11,151,"TTTCCTACAAGAGCAGGACC","TGAACCGTCATTGTATAAGG","561307.5.peg.582","2002"
"26426",369,11,358,"ACAAATGGTGCCCATGCTAT","TGAACCGTCATTGTATAAGG","561307.5.peg.582","2002"
"26427",360,11,349,"GCCCATGCTATCGGAGATAT","TGAACCGTCATTGTATAAGG","561307.5.peg.582","2002"
"26428",360,14,346,"GCCCATGCTATCGGAGATAT","TGTTGAACCGTCATTGTATA","561307.5.peg.582","2002"
"26429",162,14,148,"TTTCCTACAAGAGCAGGACC","TGTTGAACCGTCATTGTATA","561307.5.peg.582","2002"
"26430",369,14,355,"ACAAATGGTGCCCATGCTAT","TGTTGAACCGTCATTGTATA","561307.5.peg.582","2002"
"26431",146,14,132,"GACCCGGTAACAATACAGGT","TGTTGAACCGTCATTGTATA","561307.5.peg.582","2002"
"26432",288,14,274,"CTTCCAAGCAAGAAGCCCAA","TGTTGAACCGTCATTGTATA","561307.5.peg.582","2002"
"26433",369,22,347,"ACAAATGGTGCCCATGCTAT","GATGCCTCCTTATACAATGA","561307.5.peg.582","2002"
"26434",146,22,124,"GACCCGGTAACAATACAGGT","GATGCCTCCTTATACAATGA","561307.5.peg.582","2002"
"26435",360,22,338,"GCCCATGCTATCGGAGATAT","GATGCCTCCTTATACAATGA","561307.5.peg.582","2002"
"26436",288,22,266,"CTTCCAAGCAAGAAGCCCAA","GATGCCTCCTTATACAATGA","561307.5.peg.582","2002"
"26437",162,22,140,"TTTCCTACAAGAGCAGGACC","GATGCCTCCTTATACAATGA","561307.5.peg.582","2002"
"26438",11,146,135,"TGAACCGTCATTGTATAAGG","GACCCGGTAACAATACAGGT","561307.5.peg.582","2002"
"26439",288,146,142,"CTTCCAAGCAAGAAGCCCAA","GACCCGGTAACAATACAGGT","561307.5.peg.582","2002"
"26440",22,146,124,"GATGCCTCCTTATACAATGA","GACCCGGTAACAATACAGGT","561307.5.peg.582","2002"
"26441",369,146,223,"ACAAATGGTGCCCATGCTAT","GACCCGGTAACAATACAGGT","561307.5.peg.582","2002"
"26442",14,146,132,"TGTTGAACCGTCATTGTATA","GACCCGGTAACAATACAGGT","561307.5.peg.582","2002"
"26443",360,146,214,"GCCCATGCTATCGGAGATAT","GACCCGGTAACAATACAGGT","561307.5.peg.582","2002"
"26444",11,162,151,"TGAACCGTCATTGTATAAGG","TTTCCTACAAGAGCAGGACC","561307.5.peg.582","2002"
"26445",369,162,207,"ACAAATGGTGCCCATGCTAT","TTTCCTACAAGAGCAGGACC","561307.5.peg.582","2002"
"26446",22,162,140,"GATGCCTCCTTATACAATGA","TTTCCTACAAGAGCAGGACC","561307.5.peg.582","2002"
"26447",288,162,126,"CTTCCAAGCAAGAAGCCCAA","TTTCCTACAAGAGCAGGACC","561307.5.peg.582","2002"
"26448",360,162,198,"GCCCATGCTATCGGAGATAT","TTTCCTACAAGAGCAGGACC","561307.5.peg.582","2002"
"26449",14,162,148,"TGTTGAACCGTCATTGTATA","TTTCCTACAAGAGCAGGACC","561307.5.peg.582","2002"
"26450",22,288,266,"GATGCCTCCTTATACAATGA","CTTCCAAGCAAGAAGCCCAA","561307.5.peg.582","2002"
"26451",14,288,274,"TGTTGAACCGTCATTGTATA","CTTCCAAGCAAGAAGCCCAA","561307.5.peg.582","2002"
"26452",146,288,142,"GACCCGGTAACAATACAGGT","CTTCCAAGCAAGAAGCCCAA","561307.5.peg.582","2002"
"26453",162,288,126,"TTTCCTACAAGAGCAGGACC","CTTCCAAGCAAGAAGCCCAA","561307.5.peg.582","2002"
"26454",11,288,277,"TGAACCGTCATTGTATAAGG","CTTCCAAGCAAGAAGCCCAA","561307.5.peg.582","2002"
"26455",146,360,214,"GACCCGGTAACAATACAGGT","GCCCATGCTATCGGAGATAT","561307.5.peg.582","2002"
"26456",11,360,349,"TGAACCGTCATTGTATAAGG","GCCCATGCTATCGGAGATAT","561307.5.peg.582","2002"
"26457",22,360,338,"GATGCCTCCTTATACAATGA","GCCCATGCTATCGGAGATAT","561307.5.peg.582","2002"
"26458",14,360,346,"TGTTGAACCGTCATTGTATA","GCCCATGCTATCGGAGATAT","561307.5.peg.582","2002"
"26459",162,360,198,"TTTCCTACAAGAGCAGGACC","GCCCATGCTATCGGAGATAT","561307.5.peg.582","2002"
"26460",162,369,207,"TTTCCTACAAGAGCAGGACC","ACAAATGGTGCCCATGCTAT","561307.5.peg.582","2002"
"26461",14,369,355,"TGTTGAACCGTCATTGTATA","ACAAATGGTGCCCATGCTAT","561307.5.peg.582","2002"
"26462",22,369,347,"GATGCCTCCTTATACAATGA","ACAAATGGTGCCCATGCTAT","561307.5.peg.582","2002"
"26463",146,369,223,"GACCCGGTAACAATACAGGT","ACAAATGGTGCCCATGCTAT","561307.5.peg.582","2002"
"26464",11,369,358,"TGAACCGTCATTGTATAAGG","ACAAATGGTGCCCATGCTAT","561307.5.peg.582","2002"
"26465",283,90,193,"ATTATTTAAATGTGGCTGCG","CATCAACTTCTACTAAATG","561307.5.peg.583","2003"
"26466",398,90,308,"CATCAACATAAGTGTGTTCA","CATCAACTTCTACTAAATG","561307.5.peg.583","2003"
"26467",349,90,259,"CTTCATCGGATTAGACAATC","CATCAACTTCTACTAAATG","561307.5.peg.583","2003"
"26468",447,90,357,"CTTGAATATTACTTACAGC","CATCAACTTCTACTAAATG","561307.5.peg.583","2003"
"26469",538,90,448,"AAGAGTGATACCATCTTGAT","CATCAACTTCTACTAAATG","561307.5.peg.583","2003"
"26470",283,126,157,"ATTATTTAAATGTGGCTGCG","ATTGCTGAATAAATGTTCT","561307.5.peg.583","2003"
"26471",349,126,223,"CTTCATCGGATTAGACAATC","ATTGCTGAATAAATGTTCT","561307.5.peg.583","2003"
"26472",538,126,412,"AAGAGTGATACCATCTTGAT","ATTGCTGAATAAATGTTCT","561307.5.peg.583","2003"
"26473",398,126,272,"CATCAACATAAGTGTGTTCA","ATTGCTGAATAAATGTTCT","561307.5.peg.583","2003"
"26474",447,126,321,"CTTGAATATTACTTACAGC","ATTGCTGAATAAATGTTCT","561307.5.peg.583","2003"
"26475",90,283,193,"CATCAACTTCTACTAAATG","ATTATTTAAATGTGGCTGCG","561307.5.peg.583","2003"
"26476",126,283,157,"ATTGCTGAATAAATGTTCT","ATTATTTAAATGTGGCTGCG","561307.5.peg.583","2003"
"26477",447,283,164,"CTTGAATATTACTTACAGC","ATTATTTAAATGTGGCTGCG","561307.5.peg.583","2003"
"26478",398,283,115,"CATCAACATAAGTGTGTTCA","ATTATTTAAATGTGGCTGCG","561307.5.peg.583","2003"
"26479",538,283,255,"AAGAGTGATACCATCTTGAT","ATTATTTAAATGTGGCTGCG","561307.5.peg.583","2003"
"26480",538,349,189,"AAGAGTGATACCATCTTGAT","CTTCATCGGATTAGACAATC","561307.5.peg.583","2003"
"26481",90,349,259,"CATCAACTTCTACTAAATG","CTTCATCGGATTAGACAATC","561307.5.peg.583","2003"
"26482",126,349,223,"ATTGCTGAATAAATGTTCT","CTTCATCGGATTAGACAATC","561307.5.peg.583","2003"
"26483",90,398,308,"CATCAACTTCTACTAAATG","CATCAACATAAGTGTGTTCA","561307.5.peg.583","2003"
"26484",126,398,272,"ATTGCTGAATAAATGTTCT","CATCAACATAAGTGTGTTCA","561307.5.peg.583","2003"
"26485",283,398,115,"ATTATTTAAATGTGGCTGCG","CATCAACATAAGTGTGTTCA","561307.5.peg.583","2003"
"26486",538,398,140,"AAGAGTGATACCATCTTGAT","CATCAACATAAGTGTGTTCA","561307.5.peg.583","2003"
"26487",126,447,321,"ATTGCTGAATAAATGTTCT","CTTGAATATTACTTACAGC","561307.5.peg.583","2003"
"26488",283,447,164,"ATTATTTAAATGTGGCTGCG","CTTGAATATTACTTACAGC","561307.5.peg.583","2003"
"26489",90,447,357,"CATCAACTTCTACTAAATG","CTTGAATATTACTTACAGC","561307.5.peg.583","2003"
"26490",90,538,448,"CATCAACTTCTACTAAATG","AAGAGTGATACCATCTTGAT","561307.5.peg.583","2003"
"26491",283,538,255,"ATTATTTAAATGTGGCTGCG","AAGAGTGATACCATCTTGAT","561307.5.peg.583","2003"
"26492",126,538,412,"ATTGCTGAATAAATGTTCT","AAGAGTGATACCATCTTGAT","561307.5.peg.583","2003"
"26493",398,538,140,"CATCAACATAAGTGTGTTCA","AAGAGTGATACCATCTTGAT","561307.5.peg.583","2003"
"26494",349,538,189,"CTTCATCGGATTAGACAATC","AAGAGTGATACCATCTTGAT","561307.5.peg.583","2003"
"26495",243,72,171,"CGTTCACGAGTCATATATGC","TCTTGACCTTCTACTGCTTC","561307.5.peg.585","2005"
"26496",320,72,248,"TTGCTGCCGCTAAATCTACA","TCTTGACCTTCTACTGCTTC","561307.5.peg.585","2005"
"26497",72,243,171,"TCTTGACCTTCTACTGCTTC","CGTTCACGAGTCATATATGC","561307.5.peg.585","2005"
"26498",72,320,248,"TCTTGACCTTCTACTGCTTC","TTGCTGCCGCTAAATCTACA","561307.5.peg.585","2005"
"26499",367,12,355,"TCCCCAAACGATTGTAAATA","GTGTGTATATATGTGGAAAG","561307.5.peg.586","2006"
"26500",213,12,201,"AACCAGATATAATGGACAA","GTGTGTATATATGTGGAAAG","561307.5.peg.586","2006"
"26501",433,12,421,"AATATAATGTTCCACGTCTT","GTGTGTATATATGTGGAAAG","561307.5.peg.586","2006"
"26502",603,12,591,"TTTACTTGATTTCGGTCTTG","GTGTGTATATATGTGGAAAG","561307.5.peg.586","2006"
"26503",611,12,599,"CACTTTGCTTTACTTGATTT","GTGTGTATATATGTGGAAAG","561307.5.peg.586","2006"
"26504",367,14,353,"TCCCCAAACGATTGTAAATA","AGTGTGTATATATGTGGAA","561307.5.peg.586","2006"
"26505",213,14,199,"AACCAGATATAATGGACAA","AGTGTGTATATATGTGGAA","561307.5.peg.586","2006"
"26506",603,14,589,"TTTACTTGATTTCGGTCTTG","AGTGTGTATATATGTGGAA","561307.5.peg.586","2006"
"26507",611,14,597,"CACTTTGCTTTACTTGATTT","AGTGTGTATATATGTGGAA","561307.5.peg.586","2006"
"26508",433,14,419,"AATATAATGTTCCACGTCTT","AGTGTGTATATATGTGGAA","561307.5.peg.586","2006"
"26509",367,19,348,"TCCCCAAACGATTGTAAATA","ATGGTAGTGTGTATATATG","561307.5.peg.586","2006"
"26510",611,19,592,"CACTTTGCTTTACTTGATTT","ATGGTAGTGTGTATATATG","561307.5.peg.586","2006"
"26511",213,19,194,"AACCAGATATAATGGACAA","ATGGTAGTGTGTATATATG","561307.5.peg.586","2006"
"26512",603,19,584,"TTTACTTGATTTCGGTCTTG","ATGGTAGTGTGTATATATG","561307.5.peg.586","2006"
"26513",433,19,414,"AATATAATGTTCCACGTCTT","ATGGTAGTGTGTATATATG","561307.5.peg.586","2006"
"26514",19,213,194,"ATGGTAGTGTGTATATATG","AACCAGATATAATGGACAA","561307.5.peg.586","2006"
"26515",12,213,201,"GTGTGTATATATGTGGAAAG","AACCAGATATAATGGACAA","561307.5.peg.586","2006"
"26516",367,213,154,"TCCCCAAACGATTGTAAATA","AACCAGATATAATGGACAA","561307.5.peg.586","2006"
"26517",603,213,390,"TTTACTTGATTTCGGTCTTG","AACCAGATATAATGGACAA","561307.5.peg.586","2006"
"26518",433,213,220,"AATATAATGTTCCACGTCTT","AACCAGATATAATGGACAA","561307.5.peg.586","2006"
"26519",611,213,398,"CACTTTGCTTTACTTGATTT","AACCAGATATAATGGACAA","561307.5.peg.586","2006"
"26520",14,213,199,"AGTGTGTATATATGTGGAA","AACCAGATATAATGGACAA","561307.5.peg.586","2006"
"26521",12,367,355,"GTGTGTATATATGTGGAAAG","TCCCCAAACGATTGTAAATA","561307.5.peg.586","2006"
"26522",19,367,348,"ATGGTAGTGTGTATATATG","TCCCCAAACGATTGTAAATA","561307.5.peg.586","2006"
"26523",603,367,236,"TTTACTTGATTTCGGTCTTG","TCCCCAAACGATTGTAAATA","561307.5.peg.586","2006"
"26524",611,367,244,"CACTTTGCTTTACTTGATTT","TCCCCAAACGATTGTAAATA","561307.5.peg.586","2006"
"26525",14,367,353,"AGTGTGTATATATGTGGAA","TCCCCAAACGATTGTAAATA","561307.5.peg.586","2006"
"26526",213,367,154,"AACCAGATATAATGGACAA","TCCCCAAACGATTGTAAATA","561307.5.peg.586","2006"
"26527",19,433,414,"ATGGTAGTGTGTATATATG","AATATAATGTTCCACGTCTT","561307.5.peg.586","2006"
"26528",12,433,421,"GTGTGTATATATGTGGAAAG","AATATAATGTTCCACGTCTT","561307.5.peg.586","2006"
"26529",213,433,220,"AACCAGATATAATGGACAA","AATATAATGTTCCACGTCTT","561307.5.peg.586","2006"
"26530",14,433,419,"AGTGTGTATATATGTGGAA","AATATAATGTTCCACGTCTT","561307.5.peg.586","2006"
"26531",611,433,178,"CACTTTGCTTTACTTGATTT","AATATAATGTTCCACGTCTT","561307.5.peg.586","2006"
"26532",603,433,170,"TTTACTTGATTTCGGTCTTG","AATATAATGTTCCACGTCTT","561307.5.peg.586","2006"
"26533",433,603,170,"AATATAATGTTCCACGTCTT","TTTACTTGATTTCGGTCTTG","561307.5.peg.586","2006"
"26534",14,603,589,"AGTGTGTATATATGTGGAA","TTTACTTGATTTCGGTCTTG","561307.5.peg.586","2006"
"26535",12,603,591,"GTGTGTATATATGTGGAAAG","TTTACTTGATTTCGGTCTTG","561307.5.peg.586","2006"
"26536",367,603,236,"TCCCCAAACGATTGTAAATA","TTTACTTGATTTCGGTCTTG","561307.5.peg.586","2006"
"26537",19,603,584,"ATGGTAGTGTGTATATATG","TTTACTTGATTTCGGTCTTG","561307.5.peg.586","2006"
"26538",213,603,390,"AACCAGATATAATGGACAA","TTTACTTGATTTCGGTCTTG","561307.5.peg.586","2006"
"26539",14,611,597,"AGTGTGTATATATGTGGAA","CACTTTGCTTTACTTGATTT","561307.5.peg.586","2006"
"26540",12,611,599,"GTGTGTATATATGTGGAAAG","CACTTTGCTTTACTTGATTT","561307.5.peg.586","2006"
"26541",433,611,178,"AATATAATGTTCCACGTCTT","CACTTTGCTTTACTTGATTT","561307.5.peg.586","2006"
"26542",367,611,244,"TCCCCAAACGATTGTAAATA","CACTTTGCTTTACTTGATTT","561307.5.peg.586","2006"
"26543",19,611,592,"ATGGTAGTGTGTATATATG","CACTTTGCTTTACTTGATTT","561307.5.peg.586","2006"
"26544",213,611,398,"AACCAGATATAATGGACAA","CACTTTGCTTTACTTGATTT","561307.5.peg.586","2006"
"26545",669,143,526,"GTTCAAATGGATGCTTAAT","GTTTAACCCAATACGCATTA","561307.5.peg.587","2007"
"26546",2659,143,2516,"TGGTATCATGTACTCCGGTA","GTTTAACCCAATACGCATTA","561307.5.peg.587","2007"
"26547",2664,143,2521,"TTAACTGGTATCATGTACTC","GTTTAACCCAATACGCATTA","561307.5.peg.587","2007"
"26548",3107,143,2964,"CGTTATACACCGTATCTTTA","GTTTAACCCAATACGCATTA","561307.5.peg.587","2007"
"26549",2202,143,2059,"TACGATTTGGAACTTTGTT","GTTTAACCCAATACGCATTA","561307.5.peg.587","2007"
"26550",1782,143,1639,"AAGCGAACAATACCTCGGTG","GTTTAACCCAATACGCATTA","561307.5.peg.587","2007"
"26551",3396,143,3253,"ATAAAGAGGTATGCATGTAA","GTTTAACCCAATACGCATTA","561307.5.peg.587","2007"
"26552",1315,143,1172,"TCAACTTGTTGCTCAAATA","GTTTAACCCAATACGCATTA","561307.5.peg.587","2007"
"26553",2436,143,2293,"AAATAATCTATGTTGCCATC","GTTTAACCCAATACGCATTA","561307.5.peg.587","2007"
"26554",1763,143,1620,"GCGGAATTAGTGTCCCTTTA","GTTTAACCCAATACGCATTA","561307.5.peg.587","2007"
"26555",2800,143,2657,"AATTTGGCATAGCAAGTGTT","GTTTAACCCAATACGCATTA","561307.5.peg.587","2007"
"26556",3410,143,3267,"ATGATGCGTATCTATAAAG","GTTTAACCCAATACGCATTA","561307.5.peg.587","2007"
"26557",2787,143,2644,"AAGTGTTCGGTATCTGTACT","GTTTAACCCAATACGCATTA","561307.5.peg.587","2007"
"26558",1956,143,1813,"TTAATTGTTCTACCGCTAT","GTTTAACCCAATACGCATTA","561307.5.peg.587","2007"
"26559",2298,143,2155,"CCACTTGTACATAATTCTCC","GTTTAACCCAATACGCATTA","561307.5.peg.587","2007"
"26560",2238,143,2095,"TAAACATGAGTACCCAGAAT","GTTTAACCCAATACGCATTA","561307.5.peg.587","2007"
"26561",1787,143,1644,"GGACCAAGCGAACAATACCT","GTTTAACCCAATACGCATTA","561307.5.peg.587","2007"
"26562",2130,143,1987,"TAATAATTTGAGGATGCTT","GTTTAACCCAATACGCATTA","561307.5.peg.587","2007"
"26563",2214,143,2071,"TACCAATAGGAATACGATT","GTTTAACCCAATACGCATTA","561307.5.peg.587","2007"
"26564",1452,143,1309,"ATGACAGCGACACGATCATT","GTTTAACCCAATACGCATTA","561307.5.peg.587","2007"
"26565",1284,143,1141,"GTTTGCGCATCATCTATCTC","GTTTAACCCAATACGCATTA","561307.5.peg.587","2007"
"26566",1599,143,1456,"GGTACGTTATTACAACTTT","GTTTAACCCAATACGCATTA","561307.5.peg.587","2007"
"26567",2748,143,2605,"GTATCGACATAGTCCATGAT","GTTTAACCCAATACGCATTA","561307.5.peg.587","2007"
"26568",2352,143,2209,"ATTTATCTGCTGTCAATTC","GTTTAACCCAATACGCATTA","561307.5.peg.587","2007"
"26569",331,143,188,"AGCTTCTAAATCATAGTTTG","GTTTAACCCAATACGCATTA","561307.5.peg.587","2007"
"26570",3621,143,3478,"TTTGGTCTAACATAGTCTGT","GTTTAACCCAATACGCATTA","561307.5.peg.587","2007"
"26571",321,143,178,"TCATAGTTTGCGGAAGAAGA","GTTTAACCCAATACGCATTA","561307.5.peg.587","2007"
"26572",858,143,715,"GCATCGATTGTTAACGTTAA","GTTTAACCCAATACGCATTA","561307.5.peg.587","2007"
"26573",3363,143,3220,"ATCTCACTCTAATTTGACT","GTTTAACCCAATACGCATTA","561307.5.peg.587","2007"
"26574",2226,143,2083,"CCCAGAATCGGTTTACCAAT","GTTTAACCCAATACGCATTA","561307.5.peg.587","2007"
"26575",1551,143,1408,"TGACGATCACTTGGATAGTT","GTTTAACCCAATACGCATTA","561307.5.peg.587","2007"
"26576",1542,143,1399,"CTTGGATAGTTCGGATCAAT","GTTTAACCCAATACGCATTA","561307.5.peg.587","2007"
"26577",1344,143,1201,"AATTGCACAGCGACATGATT","GTTTAACCCAATACGCATTA","561307.5.peg.587","2007"
"26578",1560,143,1417,"ATGTACTCCTGACGATCACT","GTTTAACCCAATACGCATTA","561307.5.peg.587","2007"
"26579",2776,143,2633,"ATCTGTACTCGGTGCTACAT","GTTTAACCCAATACGCATTA","561307.5.peg.587","2007"
"26580",1452,321,1131,"ATGACAGCGACACGATCATT","TCATAGTTTGCGGAAGAAGA","561307.5.peg.587","2007"
"26581",2664,321,2343,"TTAACTGGTATCATGTACTC","TCATAGTTTGCGGAAGAAGA","561307.5.peg.587","2007"
"26582",858,321,537,"GCATCGATTGTTAACGTTAA","TCATAGTTTGCGGAAGAAGA","561307.5.peg.587","2007"
"26583",1956,321,1635,"TTAATTGTTCTACCGCTAT","TCATAGTTTGCGGAAGAAGA","561307.5.peg.587","2007"
"26584",3410,321,3089,"ATGATGCGTATCTATAAAG","TCATAGTTTGCGGAAGAAGA","561307.5.peg.587","2007"
"26585",1560,321,1239,"ATGTACTCCTGACGATCACT","TCATAGTTTGCGGAAGAAGA","561307.5.peg.587","2007"
"26586",1542,321,1221,"CTTGGATAGTTCGGATCAAT","TCATAGTTTGCGGAAGAAGA","561307.5.peg.587","2007"
"26587",2298,321,1977,"CCACTTGTACATAATTCTCC","TCATAGTTTGCGGAAGAAGA","561307.5.peg.587","2007"
"26588",1315,321,994,"TCAACTTGTTGCTCAAATA","TCATAGTTTGCGGAAGAAGA","561307.5.peg.587","2007"
"26589",2776,321,2455,"ATCTGTACTCGGTGCTACAT","TCATAGTTTGCGGAAGAAGA","561307.5.peg.587","2007"
"26590",3363,321,3042,"ATCTCACTCTAATTTGACT","TCATAGTTTGCGGAAGAAGA","561307.5.peg.587","2007"
"26591",1763,321,1442,"GCGGAATTAGTGTCCCTTTA","TCATAGTTTGCGGAAGAAGA","561307.5.peg.587","2007"
"26592",2352,321,2031,"ATTTATCTGCTGTCAATTC","TCATAGTTTGCGGAAGAAGA","561307.5.peg.587","2007"
"26593",2130,321,1809,"TAATAATTTGAGGATGCTT","TCATAGTTTGCGGAAGAAGA","561307.5.peg.587","2007"
"26594",1344,321,1023,"AATTGCACAGCGACATGATT","TCATAGTTTGCGGAAGAAGA","561307.5.peg.587","2007"
"26595",2214,321,1893,"TACCAATAGGAATACGATT","TCATAGTTTGCGGAAGAAGA","561307.5.peg.587","2007"
"26596",2436,321,2115,"AAATAATCTATGTTGCCATC","TCATAGTTTGCGGAAGAAGA","561307.5.peg.587","2007"
"26597",2202,321,1881,"TACGATTTGGAACTTTGTT","TCATAGTTTGCGGAAGAAGA","561307.5.peg.587","2007"
"26598",3621,321,3300,"TTTGGTCTAACATAGTCTGT","TCATAGTTTGCGGAAGAAGA","561307.5.peg.587","2007"
"26599",1551,321,1230,"TGACGATCACTTGGATAGTT","TCATAGTTTGCGGAAGAAGA","561307.5.peg.587","2007"
"26600",2659,321,2338,"TGGTATCATGTACTCCGGTA","TCATAGTTTGCGGAAGAAGA","561307.5.peg.587","2007"
"26601",2800,321,2479,"AATTTGGCATAGCAAGTGTT","TCATAGTTTGCGGAAGAAGA","561307.5.peg.587","2007"
"26602",2748,321,2427,"GTATCGACATAGTCCATGAT","TCATAGTTTGCGGAAGAAGA","561307.5.peg.587","2007"
"26603",1284,321,963,"GTTTGCGCATCATCTATCTC","TCATAGTTTGCGGAAGAAGA","561307.5.peg.587","2007"
"26604",1782,321,1461,"AAGCGAACAATACCTCGGTG","TCATAGTTTGCGGAAGAAGA","561307.5.peg.587","2007"
"26605",3107,321,2786,"CGTTATACACCGTATCTTTA","TCATAGTTTGCGGAAGAAGA","561307.5.peg.587","2007"
"26606",2238,321,1917,"TAAACATGAGTACCCAGAAT","TCATAGTTTGCGGAAGAAGA","561307.5.peg.587","2007"
"26607",2226,321,1905,"CCCAGAATCGGTTTACCAAT","TCATAGTTTGCGGAAGAAGA","561307.5.peg.587","2007"
"26608",1599,321,1278,"GGTACGTTATTACAACTTT","TCATAGTTTGCGGAAGAAGA","561307.5.peg.587","2007"
"26609",1787,321,1466,"GGACCAAGCGAACAATACCT","TCATAGTTTGCGGAAGAAGA","561307.5.peg.587","2007"
"26610",669,321,348,"GTTCAAATGGATGCTTAAT","TCATAGTTTGCGGAAGAAGA","561307.5.peg.587","2007"
"26611",3396,321,3075,"ATAAAGAGGTATGCATGTAA","TCATAGTTTGCGGAAGAAGA","561307.5.peg.587","2007"
"26612",2787,321,2466,"AAGTGTTCGGTATCTGTACT","TCATAGTTTGCGGAAGAAGA","561307.5.peg.587","2007"
"26613",143,321,178,"GTTTAACCCAATACGCATTA","TCATAGTTTGCGGAAGAAGA","561307.5.peg.587","2007"
"26614",2352,331,2021,"ATTTATCTGCTGTCAATTC","AGCTTCTAAATCATAGTTTG","561307.5.peg.587","2007"
"26615",2298,331,1967,"CCACTTGTACATAATTCTCC","AGCTTCTAAATCATAGTTTG","561307.5.peg.587","2007"
"26616",1551,331,1220,"TGACGATCACTTGGATAGTT","AGCTTCTAAATCATAGTTTG","561307.5.peg.587","2007"
"26617",3363,331,3032,"ATCTCACTCTAATTTGACT","AGCTTCTAAATCATAGTTTG","561307.5.peg.587","2007"
"26618",1782,331,1451,"AAGCGAACAATACCTCGGTG","AGCTTCTAAATCATAGTTTG","561307.5.peg.587","2007"
"26619",2238,331,1907,"TAAACATGAGTACCCAGAAT","AGCTTCTAAATCATAGTTTG","561307.5.peg.587","2007"
"26620",1452,331,1121,"ATGACAGCGACACGATCATT","AGCTTCTAAATCATAGTTTG","561307.5.peg.587","2007"
"26621",143,331,188,"GTTTAACCCAATACGCATTA","AGCTTCTAAATCATAGTTTG","561307.5.peg.587","2007"
"26622",3396,331,3065,"ATAAAGAGGTATGCATGTAA","AGCTTCTAAATCATAGTTTG","561307.5.peg.587","2007"
"26623",1542,331,1211,"CTTGGATAGTTCGGATCAAT","AGCTTCTAAATCATAGTTTG","561307.5.peg.587","2007"
"26624",1315,331,984,"TCAACTTGTTGCTCAAATA","AGCTTCTAAATCATAGTTTG","561307.5.peg.587","2007"
"26625",1560,331,1229,"ATGTACTCCTGACGATCACT","AGCTTCTAAATCATAGTTTG","561307.5.peg.587","2007"
"26626",2202,331,1871,"TACGATTTGGAACTTTGTT","AGCTTCTAAATCATAGTTTG","561307.5.peg.587","2007"
"26627",1599,331,1268,"GGTACGTTATTACAACTTT","AGCTTCTAAATCATAGTTTG","561307.5.peg.587","2007"
"26628",2748,331,2417,"GTATCGACATAGTCCATGAT","AGCTTCTAAATCATAGTTTG","561307.5.peg.587","2007"
"26629",2436,331,2105,"AAATAATCTATGTTGCCATC","AGCTTCTAAATCATAGTTTG","561307.5.peg.587","2007"
"26630",2787,331,2456,"AAGTGTTCGGTATCTGTACT","AGCTTCTAAATCATAGTTTG","561307.5.peg.587","2007"
"26631",2659,331,2328,"TGGTATCATGTACTCCGGTA","AGCTTCTAAATCATAGTTTG","561307.5.peg.587","2007"
"26632",2776,331,2445,"ATCTGTACTCGGTGCTACAT","AGCTTCTAAATCATAGTTTG","561307.5.peg.587","2007"
"26633",1344,331,1013,"AATTGCACAGCGACATGATT","AGCTTCTAAATCATAGTTTG","561307.5.peg.587","2007"
"26634",2664,331,2333,"TTAACTGGTATCATGTACTC","AGCTTCTAAATCATAGTTTG","561307.5.peg.587","2007"
"26635",3107,331,2776,"CGTTATACACCGTATCTTTA","AGCTTCTAAATCATAGTTTG","561307.5.peg.587","2007"
"26636",3621,331,3290,"TTTGGTCTAACATAGTCTGT","AGCTTCTAAATCATAGTTTG","561307.5.peg.587","2007"
"26637",1763,331,1432,"GCGGAATTAGTGTCCCTTTA","AGCTTCTAAATCATAGTTTG","561307.5.peg.587","2007"
"26638",1787,331,1456,"GGACCAAGCGAACAATACCT","AGCTTCTAAATCATAGTTTG","561307.5.peg.587","2007"
"26639",2800,331,2469,"AATTTGGCATAGCAAGTGTT","AGCTTCTAAATCATAGTTTG","561307.5.peg.587","2007"
"26640",1284,331,953,"GTTTGCGCATCATCTATCTC","AGCTTCTAAATCATAGTTTG","561307.5.peg.587","2007"
"26641",2214,331,1883,"TACCAATAGGAATACGATT","AGCTTCTAAATCATAGTTTG","561307.5.peg.587","2007"
"26642",1956,331,1625,"TTAATTGTTCTACCGCTAT","AGCTTCTAAATCATAGTTTG","561307.5.peg.587","2007"
"26643",2226,331,1895,"CCCAGAATCGGTTTACCAAT","AGCTTCTAAATCATAGTTTG","561307.5.peg.587","2007"
"26644",3410,331,3079,"ATGATGCGTATCTATAAAG","AGCTTCTAAATCATAGTTTG","561307.5.peg.587","2007"
"26645",858,331,527,"GCATCGATTGTTAACGTTAA","AGCTTCTAAATCATAGTTTG","561307.5.peg.587","2007"
"26646",2130,331,1799,"TAATAATTTGAGGATGCTT","AGCTTCTAAATCATAGTTTG","561307.5.peg.587","2007"
"26647",669,331,338,"GTTCAAATGGATGCTTAAT","AGCTTCTAAATCATAGTTTG","561307.5.peg.587","2007"
"26648",2226,669,1557,"CCCAGAATCGGTTTACCAAT","GTTCAAATGGATGCTTAAT","561307.5.peg.587","2007"
"26649",2298,669,1629,"CCACTTGTACATAATTCTCC","GTTCAAATGGATGCTTAAT","561307.5.peg.587","2007"
"26650",1763,669,1094,"GCGGAATTAGTGTCCCTTTA","GTTCAAATGGATGCTTAAT","561307.5.peg.587","2007"
"26651",1284,669,615,"GTTTGCGCATCATCTATCTC","GTTCAAATGGATGCTTAAT","561307.5.peg.587","2007"
"26652",143,669,526,"GTTTAACCCAATACGCATTA","GTTCAAATGGATGCTTAAT","561307.5.peg.587","2007"
"26653",3410,669,2741,"ATGATGCGTATCTATAAAG","GTTCAAATGGATGCTTAAT","561307.5.peg.587","2007"
"26654",2202,669,1533,"TACGATTTGGAACTTTGTT","GTTCAAATGGATGCTTAAT","561307.5.peg.587","2007"
"26655",858,669,189,"GCATCGATTGTTAACGTTAA","GTTCAAATGGATGCTTAAT","561307.5.peg.587","2007"
"26656",321,669,348,"TCATAGTTTGCGGAAGAAGA","GTTCAAATGGATGCTTAAT","561307.5.peg.587","2007"
"26657",1787,669,1118,"GGACCAAGCGAACAATACCT","GTTCAAATGGATGCTTAAT","561307.5.peg.587","2007"
"26658",3621,669,2952,"TTTGGTCTAACATAGTCTGT","GTTCAAATGGATGCTTAAT","561307.5.peg.587","2007"
"26659",3396,669,2727,"ATAAAGAGGTATGCATGTAA","GTTCAAATGGATGCTTAAT","561307.5.peg.587","2007"
"26660",2238,669,1569,"TAAACATGAGTACCCAGAAT","GTTCAAATGGATGCTTAAT","561307.5.peg.587","2007"
"26661",2130,669,1461,"TAATAATTTGAGGATGCTT","GTTCAAATGGATGCTTAAT","561307.5.peg.587","2007"
"26662",1782,669,1113,"AAGCGAACAATACCTCGGTG","GTTCAAATGGATGCTTAAT","561307.5.peg.587","2007"
"26663",1315,669,646,"TCAACTTGTTGCTCAAATA","GTTCAAATGGATGCTTAAT","561307.5.peg.587","2007"
"26664",2659,669,1990,"TGGTATCATGTACTCCGGTA","GTTCAAATGGATGCTTAAT","561307.5.peg.587","2007"
"26665",331,669,338,"AGCTTCTAAATCATAGTTTG","GTTCAAATGGATGCTTAAT","561307.5.peg.587","2007"
"26666",2787,669,2118,"AAGTGTTCGGTATCTGTACT","GTTCAAATGGATGCTTAAT","561307.5.peg.587","2007"
"26667",1599,669,930,"GGTACGTTATTACAACTTT","GTTCAAATGGATGCTTAAT","561307.5.peg.587","2007"
"26668",1452,669,783,"ATGACAGCGACACGATCATT","GTTCAAATGGATGCTTAAT","561307.5.peg.587","2007"
"26669",2748,669,2079,"GTATCGACATAGTCCATGAT","GTTCAAATGGATGCTTAAT","561307.5.peg.587","2007"
"26670",1542,669,873,"CTTGGATAGTTCGGATCAAT","GTTCAAATGGATGCTTAAT","561307.5.peg.587","2007"
"26671",3363,669,2694,"ATCTCACTCTAATTTGACT","GTTCAAATGGATGCTTAAT","561307.5.peg.587","2007"
"26672",1560,669,891,"ATGTACTCCTGACGATCACT","GTTCAAATGGATGCTTAAT","561307.5.peg.587","2007"
"26673",2352,669,1683,"ATTTATCTGCTGTCAATTC","GTTCAAATGGATGCTTAAT","561307.5.peg.587","2007"
"26674",1344,669,675,"AATTGCACAGCGACATGATT","GTTCAAATGGATGCTTAAT","561307.5.peg.587","2007"
"26675",2776,669,2107,"ATCTGTACTCGGTGCTACAT","GTTCAAATGGATGCTTAAT","561307.5.peg.587","2007"
"26676",1956,669,1287,"TTAATTGTTCTACCGCTAT","GTTCAAATGGATGCTTAAT","561307.5.peg.587","2007"
"26677",2800,669,2131,"AATTTGGCATAGCAAGTGTT","GTTCAAATGGATGCTTAAT","561307.5.peg.587","2007"
"26678",3107,669,2438,"CGTTATACACCGTATCTTTA","GTTCAAATGGATGCTTAAT","561307.5.peg.587","2007"
"26679",2214,669,1545,"TACCAATAGGAATACGATT","GTTCAAATGGATGCTTAAT","561307.5.peg.587","2007"
"26680",2436,669,1767,"AAATAATCTATGTTGCCATC","GTTCAAATGGATGCTTAAT","561307.5.peg.587","2007"
"26681",2664,669,1995,"TTAACTGGTATCATGTACTC","GTTCAAATGGATGCTTAAT","561307.5.peg.587","2007"
"26682",1551,669,882,"TGACGATCACTTGGATAGTT","GTTCAAATGGATGCTTAAT","561307.5.peg.587","2007"
"26683",1315,858,457,"TCAACTTGTTGCTCAAATA","GCATCGATTGTTAACGTTAA","561307.5.peg.587","2007"
"26684",2298,858,1440,"CCACTTGTACATAATTCTCC","GCATCGATTGTTAACGTTAA","561307.5.peg.587","2007"
"26685",2776,858,1918,"ATCTGTACTCGGTGCTACAT","GCATCGATTGTTAACGTTAA","561307.5.peg.587","2007"
"26686",143,858,715,"GTTTAACCCAATACGCATTA","GCATCGATTGTTAACGTTAA","561307.5.peg.587","2007"
"26687",3621,858,2763,"TTTGGTCTAACATAGTCTGT","GCATCGATTGTTAACGTTAA","561307.5.peg.587","2007"
"26688",2226,858,1368,"CCCAGAATCGGTTTACCAAT","GCATCGATTGTTAACGTTAA","561307.5.peg.587","2007"
"26689",331,858,527,"AGCTTCTAAATCATAGTTTG","GCATCGATTGTTAACGTTAA","561307.5.peg.587","2007"
"26690",1560,858,702,"ATGTACTCCTGACGATCACT","GCATCGATTGTTAACGTTAA","561307.5.peg.587","2007"
"26691",1956,858,1098,"TTAATTGTTCTACCGCTAT","GCATCGATTGTTAACGTTAA","561307.5.peg.587","2007"
"26692",2659,858,1801,"TGGTATCATGTACTCCGGTA","GCATCGATTGTTAACGTTAA","561307.5.peg.587","2007"
"26693",2787,858,1929,"AAGTGTTCGGTATCTGTACT","GCATCGATTGTTAACGTTAA","561307.5.peg.587","2007"
"26694",2238,858,1380,"TAAACATGAGTACCCAGAAT","GCATCGATTGTTAACGTTAA","561307.5.peg.587","2007"
"26695",2748,858,1890,"GTATCGACATAGTCCATGAT","GCATCGATTGTTAACGTTAA","561307.5.peg.587","2007"
"26696",1763,858,905,"GCGGAATTAGTGTCCCTTTA","GCATCGATTGTTAACGTTAA","561307.5.peg.587","2007"
"26697",1284,858,426,"GTTTGCGCATCATCTATCTC","GCATCGATTGTTAACGTTAA","561307.5.peg.587","2007"
"26698",2214,858,1356,"TACCAATAGGAATACGATT","GCATCGATTGTTAACGTTAA","561307.5.peg.587","2007"
"26699",1551,858,693,"TGACGATCACTTGGATAGTT","GCATCGATTGTTAACGTTAA","561307.5.peg.587","2007"
"26700",1599,858,741,"GGTACGTTATTACAACTTT","GCATCGATTGTTAACGTTAA","561307.5.peg.587","2007"
"26701",3410,858,2552,"ATGATGCGTATCTATAAAG","GCATCGATTGTTAACGTTAA","561307.5.peg.587","2007"
"26702",1782,858,924,"AAGCGAACAATACCTCGGTG","GCATCGATTGTTAACGTTAA","561307.5.peg.587","2007"
"26703",3363,858,2505,"ATCTCACTCTAATTTGACT","GCATCGATTGTTAACGTTAA","561307.5.peg.587","2007"
"26704",3107,858,2249,"CGTTATACACCGTATCTTTA","GCATCGATTGTTAACGTTAA","561307.5.peg.587","2007"
"26705",2800,858,1942,"AATTTGGCATAGCAAGTGTT","GCATCGATTGTTAACGTTAA","561307.5.peg.587","2007"
"26706",321,858,537,"TCATAGTTTGCGGAAGAAGA","GCATCGATTGTTAACGTTAA","561307.5.peg.587","2007"
"26707",2352,858,1494,"ATTTATCTGCTGTCAATTC","GCATCGATTGTTAACGTTAA","561307.5.peg.587","2007"
"26708",1344,858,486,"AATTGCACAGCGACATGATT","GCATCGATTGTTAACGTTAA","561307.5.peg.587","2007"
"26709",1787,858,929,"GGACCAAGCGAACAATACCT","GCATCGATTGTTAACGTTAA","561307.5.peg.587","2007"
"26710",2130,858,1272,"TAATAATTTGAGGATGCTT","GCATCGATTGTTAACGTTAA","561307.5.peg.587","2007"
"26711",3396,858,2538,"ATAAAGAGGTATGCATGTAA","GCATCGATTGTTAACGTTAA","561307.5.peg.587","2007"
"26712",2664,858,1806,"TTAACTGGTATCATGTACTC","GCATCGATTGTTAACGTTAA","561307.5.peg.587","2007"
"26713",2436,858,1578,"AAATAATCTATGTTGCCATC","GCATCGATTGTTAACGTTAA","561307.5.peg.587","2007"
"26714",1452,858,594,"ATGACAGCGACACGATCATT","GCATCGATTGTTAACGTTAA","561307.5.peg.587","2007"
"26715",1542,858,684,"CTTGGATAGTTCGGATCAAT","GCATCGATTGTTAACGTTAA","561307.5.peg.587","2007"
"26716",2202,858,1344,"TACGATTTGGAACTTTGTT","GCATCGATTGTTAACGTTAA","561307.5.peg.587","2007"
"26717",669,858,189,"GTTCAAATGGATGCTTAAT","GCATCGATTGTTAACGTTAA","561307.5.peg.587","2007"
"26718",2214,1284,930,"TACCAATAGGAATACGATT","GTTTGCGCATCATCTATCTC","561307.5.peg.587","2007"
"26719",2776,1284,1492,"ATCTGTACTCGGTGCTACAT","GTTTGCGCATCATCTATCTC","561307.5.peg.587","2007"
"26720",3396,1284,2112,"ATAAAGAGGTATGCATGTAA","GTTTGCGCATCATCTATCTC","561307.5.peg.587","2007"
"26721",1560,1284,276,"ATGTACTCCTGACGATCACT","GTTTGCGCATCATCTATCTC","561307.5.peg.587","2007"
"26722",1763,1284,479,"GCGGAATTAGTGTCCCTTTA","GTTTGCGCATCATCTATCTC","561307.5.peg.587","2007"
"26723",2202,1284,918,"TACGATTTGGAACTTTGTT","GTTTGCGCATCATCTATCTC","561307.5.peg.587","2007"
"26724",2787,1284,1503,"AAGTGTTCGGTATCTGTACT","GTTTGCGCATCATCTATCTC","561307.5.peg.587","2007"
"26725",1551,1284,267,"TGACGATCACTTGGATAGTT","GTTTGCGCATCATCTATCTC","561307.5.peg.587","2007"
"26726",2238,1284,954,"TAAACATGAGTACCCAGAAT","GTTTGCGCATCATCTATCTC","561307.5.peg.587","2007"
"26727",1599,1284,315,"GGTACGTTATTACAACTTT","GTTTGCGCATCATCTATCTC","561307.5.peg.587","2007"
"26728",3410,1284,2126,"ATGATGCGTATCTATAAAG","GTTTGCGCATCATCTATCTC","561307.5.peg.587","2007"
"26729",2436,1284,1152,"AAATAATCTATGTTGCCATC","GTTTGCGCATCATCTATCTC","561307.5.peg.587","2007"
"26730",3363,1284,2079,"ATCTCACTCTAATTTGACT","GTTTGCGCATCATCTATCTC","561307.5.peg.587","2007"
"26731",1787,1284,503,"GGACCAAGCGAACAATACCT","GTTTGCGCATCATCTATCTC","561307.5.peg.587","2007"
"26732",3107,1284,1823,"CGTTATACACCGTATCTTTA","GTTTGCGCATCATCTATCTC","561307.5.peg.587","2007"
"26733",1956,1284,672,"TTAATTGTTCTACCGCTAT","GTTTGCGCATCATCTATCTC","561307.5.peg.587","2007"
"26734",2748,1284,1464,"GTATCGACATAGTCCATGAT","GTTTGCGCATCATCTATCTC","561307.5.peg.587","2007"
"26735",2664,1284,1380,"TTAACTGGTATCATGTACTC","GTTTGCGCATCATCTATCTC","561307.5.peg.587","2007"
"26736",2130,1284,846,"TAATAATTTGAGGATGCTT","GTTTGCGCATCATCTATCTC","561307.5.peg.587","2007"
"26737",1452,1284,168,"ATGACAGCGACACGATCATT","GTTTGCGCATCATCTATCTC","561307.5.peg.587","2007"
"26738",858,1284,426,"GCATCGATTGTTAACGTTAA","GTTTGCGCATCATCTATCTC","561307.5.peg.587","2007"
"26739",669,1284,615,"GTTCAAATGGATGCTTAAT","GTTTGCGCATCATCTATCTC","561307.5.peg.587","2007"
"26740",143,1284,1141,"GTTTAACCCAATACGCATTA","GTTTGCGCATCATCTATCTC","561307.5.peg.587","2007"
"26741",331,1284,953,"AGCTTCTAAATCATAGTTTG","GTTTGCGCATCATCTATCTC","561307.5.peg.587","2007"
"26742",2298,1284,1014,"CCACTTGTACATAATTCTCC","GTTTGCGCATCATCTATCTC","561307.5.peg.587","2007"
"26743",3621,1284,2337,"TTTGGTCTAACATAGTCTGT","GTTTGCGCATCATCTATCTC","561307.5.peg.587","2007"
"26744",321,1284,963,"TCATAGTTTGCGGAAGAAGA","GTTTGCGCATCATCTATCTC","561307.5.peg.587","2007"
"26745",2226,1284,942,"CCCAGAATCGGTTTACCAAT","GTTTGCGCATCATCTATCTC","561307.5.peg.587","2007"
"26746",2800,1284,1516,"AATTTGGCATAGCAAGTGTT","GTTTGCGCATCATCTATCTC","561307.5.peg.587","2007"
"26747",2352,1284,1068,"ATTTATCTGCTGTCAATTC","GTTTGCGCATCATCTATCTC","561307.5.peg.587","2007"
"26748",2659,1284,1375,"TGGTATCATGTACTCCGGTA","GTTTGCGCATCATCTATCTC","561307.5.peg.587","2007"
"26749",1542,1284,258,"CTTGGATAGTTCGGATCAAT","GTTTGCGCATCATCTATCTC","561307.5.peg.587","2007"
"26750",1782,1284,498,"AAGCGAACAATACCTCGGTG","GTTTGCGCATCATCTATCTC","561307.5.peg.587","2007"
"26751",2748,1315,1433,"GTATCGACATAGTCCATGAT","TCAACTTGTTGCTCAAATA","561307.5.peg.587","2007"
"26752",858,1315,457,"GCATCGATTGTTAACGTTAA","TCAACTTGTTGCTCAAATA","561307.5.peg.587","2007"
"26753",3410,1315,2095,"ATGATGCGTATCTATAAAG","TCAACTTGTTGCTCAAATA","561307.5.peg.587","2007"
"26754",331,1315,984,"AGCTTCTAAATCATAGTTTG","TCAACTTGTTGCTCAAATA","561307.5.peg.587","2007"
"26755",2436,1315,1121,"AAATAATCTATGTTGCCATC","TCAACTTGTTGCTCAAATA","561307.5.peg.587","2007"
"26756",3107,1315,1792,"CGTTATACACCGTATCTTTA","TCAACTTGTTGCTCAAATA","561307.5.peg.587","2007"
"26757",2130,1315,815,"TAATAATTTGAGGATGCTT","TCAACTTGTTGCTCAAATA","561307.5.peg.587","2007"
"26758",1452,1315,137,"ATGACAGCGACACGATCATT","TCAACTTGTTGCTCAAATA","561307.5.peg.587","2007"
"26759",2226,1315,911,"CCCAGAATCGGTTTACCAAT","TCAACTTGTTGCTCAAATA","561307.5.peg.587","2007"
"26760",2659,1315,1344,"TGGTATCATGTACTCCGGTA","TCAACTTGTTGCTCAAATA","561307.5.peg.587","2007"
"26761",2238,1315,923,"TAAACATGAGTACCCAGAAT","TCAACTTGTTGCTCAAATA","561307.5.peg.587","2007"
"26762",2298,1315,983,"CCACTTGTACATAATTCTCC","TCAACTTGTTGCTCAAATA","561307.5.peg.587","2007"
"26763",1782,1315,467,"AAGCGAACAATACCTCGGTG","TCAACTTGTTGCTCAAATA","561307.5.peg.587","2007"
"26764",1599,1315,284,"GGTACGTTATTACAACTTT","TCAACTTGTTGCTCAAATA","561307.5.peg.587","2007"
"26765",2664,1315,1349,"TTAACTGGTATCATGTACTC","TCAACTTGTTGCTCAAATA","561307.5.peg.587","2007"
"26766",2352,1315,1037,"ATTTATCTGCTGTCAATTC","TCAACTTGTTGCTCAAATA","561307.5.peg.587","2007"
"26767",1542,1315,227,"CTTGGATAGTTCGGATCAAT","TCAACTTGTTGCTCAAATA","561307.5.peg.587","2007"
"26768",2787,1315,1472,"AAGTGTTCGGTATCTGTACT","TCAACTTGTTGCTCAAATA","561307.5.peg.587","2007"
"26769",1763,1315,448,"GCGGAATTAGTGTCCCTTTA","TCAACTTGTTGCTCAAATA","561307.5.peg.587","2007"
"26770",2800,1315,1485,"AATTTGGCATAGCAAGTGTT","TCAACTTGTTGCTCAAATA","561307.5.peg.587","2007"
"26771",2776,1315,1461,"ATCTGTACTCGGTGCTACAT","TCAACTTGTTGCTCAAATA","561307.5.peg.587","2007"
"26772",1956,1315,641,"TTAATTGTTCTACCGCTAT","TCAACTTGTTGCTCAAATA","561307.5.peg.587","2007"
"26773",3621,1315,2306,"TTTGGTCTAACATAGTCTGT","TCAACTTGTTGCTCAAATA","561307.5.peg.587","2007"
"26774",1560,1315,245,"ATGTACTCCTGACGATCACT","TCAACTTGTTGCTCAAATA","561307.5.peg.587","2007"
"26775",3396,1315,2081,"ATAAAGAGGTATGCATGTAA","TCAACTTGTTGCTCAAATA","561307.5.peg.587","2007"
"26776",1787,1315,472,"GGACCAAGCGAACAATACCT","TCAACTTGTTGCTCAAATA","561307.5.peg.587","2007"
"26777",321,1315,994,"TCATAGTTTGCGGAAGAAGA","TCAACTTGTTGCTCAAATA","561307.5.peg.587","2007"
"26778",143,1315,1172,"GTTTAACCCAATACGCATTA","TCAACTTGTTGCTCAAATA","561307.5.peg.587","2007"
"26779",669,1315,646,"GTTCAAATGGATGCTTAAT","TCAACTTGTTGCTCAAATA","561307.5.peg.587","2007"
"26780",2202,1315,887,"TACGATTTGGAACTTTGTT","TCAACTTGTTGCTCAAATA","561307.5.peg.587","2007"
"26781",2214,1315,899,"TACCAATAGGAATACGATT","TCAACTTGTTGCTCAAATA","561307.5.peg.587","2007"
"26782",1551,1315,236,"TGACGATCACTTGGATAGTT","TCAACTTGTTGCTCAAATA","561307.5.peg.587","2007"
"26783",3363,1315,2048,"ATCTCACTCTAATTTGACT","TCAACTTGTTGCTCAAATA","561307.5.peg.587","2007"
"26784",1599,1344,255,"GGTACGTTATTACAACTTT","AATTGCACAGCGACATGATT","561307.5.peg.587","2007"
"26785",1452,1344,108,"ATGACAGCGACACGATCATT","AATTGCACAGCGACATGATT","561307.5.peg.587","2007"
"26786",1956,1344,612,"TTAATTGTTCTACCGCTAT","AATTGCACAGCGACATGATT","561307.5.peg.587","2007"
"26787",2130,1344,786,"TAATAATTTGAGGATGCTT","AATTGCACAGCGACATGATT","561307.5.peg.587","2007"
"26788",1763,1344,419,"GCGGAATTAGTGTCCCTTTA","AATTGCACAGCGACATGATT","561307.5.peg.587","2007"
"26789",669,1344,675,"GTTCAAATGGATGCTTAAT","AATTGCACAGCGACATGATT","561307.5.peg.587","2007"
"26790",2664,1344,1320,"TTAACTGGTATCATGTACTC","AATTGCACAGCGACATGATT","561307.5.peg.587","2007"
"26791",858,1344,486,"GCATCGATTGTTAACGTTAA","AATTGCACAGCGACATGATT","561307.5.peg.587","2007"
"26792",1542,1344,198,"CTTGGATAGTTCGGATCAAT","AATTGCACAGCGACATGATT","561307.5.peg.587","2007"
"26793",2659,1344,1315,"TGGTATCATGTACTCCGGTA","AATTGCACAGCGACATGATT","561307.5.peg.587","2007"
"26794",2800,1344,1456,"AATTTGGCATAGCAAGTGTT","AATTGCACAGCGACATGATT","561307.5.peg.587","2007"
"26795",2238,1344,894,"TAAACATGAGTACCCAGAAT","AATTGCACAGCGACATGATT","561307.5.peg.587","2007"
"26796",3410,1344,2066,"ATGATGCGTATCTATAAAG","AATTGCACAGCGACATGATT","561307.5.peg.587","2007"
"26797",2202,1344,858,"TACGATTTGGAACTTTGTT","AATTGCACAGCGACATGATT","561307.5.peg.587","2007"
"26798",1551,1344,207,"TGACGATCACTTGGATAGTT","AATTGCACAGCGACATGATT","561307.5.peg.587","2007"
"26799",2748,1344,1404,"GTATCGACATAGTCCATGAT","AATTGCACAGCGACATGATT","561307.5.peg.587","2007"
"26800",3107,1344,1763,"CGTTATACACCGTATCTTTA","AATTGCACAGCGACATGATT","561307.5.peg.587","2007"
"26801",321,1344,1023,"TCATAGTTTGCGGAAGAAGA","AATTGCACAGCGACATGATT","561307.5.peg.587","2007"
"26802",3363,1344,2019,"ATCTCACTCTAATTTGACT","AATTGCACAGCGACATGATT","561307.5.peg.587","2007"
"26803",3396,1344,2052,"ATAAAGAGGTATGCATGTAA","AATTGCACAGCGACATGATT","561307.5.peg.587","2007"
"26804",1782,1344,438,"AAGCGAACAATACCTCGGTG","AATTGCACAGCGACATGATT","561307.5.peg.587","2007"
"26805",2787,1344,1443,"AAGTGTTCGGTATCTGTACT","AATTGCACAGCGACATGATT","561307.5.peg.587","2007"
"26806",1560,1344,216,"ATGTACTCCTGACGATCACT","AATTGCACAGCGACATGATT","561307.5.peg.587","2007"
"26807",2226,1344,882,"CCCAGAATCGGTTTACCAAT","AATTGCACAGCGACATGATT","561307.5.peg.587","2007"
"26808",2214,1344,870,"TACCAATAGGAATACGATT","AATTGCACAGCGACATGATT","561307.5.peg.587","2007"
"26809",2436,1344,1092,"AAATAATCTATGTTGCCATC","AATTGCACAGCGACATGATT","561307.5.peg.587","2007"
"26810",2298,1344,954,"CCACTTGTACATAATTCTCC","AATTGCACAGCGACATGATT","561307.5.peg.587","2007"
"26811",2776,1344,1432,"ATCTGTACTCGGTGCTACAT","AATTGCACAGCGACATGATT","561307.5.peg.587","2007"
"26812",331,1344,1013,"AGCTTCTAAATCATAGTTTG","AATTGCACAGCGACATGATT","561307.5.peg.587","2007"
"26813",2352,1344,1008,"ATTTATCTGCTGTCAATTC","AATTGCACAGCGACATGATT","561307.5.peg.587","2007"
"26814",3621,1344,2277,"TTTGGTCTAACATAGTCTGT","AATTGCACAGCGACATGATT","561307.5.peg.587","2007"
"26815",1787,1344,443,"GGACCAAGCGAACAATACCT","AATTGCACAGCGACATGATT","561307.5.peg.587","2007"
"26816",143,1344,1201,"GTTTAACCCAATACGCATTA","AATTGCACAGCGACATGATT","561307.5.peg.587","2007"
"26817",2436,1452,984,"AAATAATCTATGTTGCCATC","ATGACAGCGACACGATCATT","561307.5.peg.587","2007"
"26818",143,1452,1309,"GTTTAACCCAATACGCATTA","ATGACAGCGACACGATCATT","561307.5.peg.587","2007"
"26819",1787,1452,335,"GGACCAAGCGAACAATACCT","ATGACAGCGACACGATCATT","561307.5.peg.587","2007"
"26820",2787,1452,1335,"AAGTGTTCGGTATCTGTACT","ATGACAGCGACACGATCATT","561307.5.peg.587","2007"
"26821",331,1452,1121,"AGCTTCTAAATCATAGTTTG","ATGACAGCGACACGATCATT","561307.5.peg.587","2007"
"26822",2214,1452,762,"TACCAATAGGAATACGATT","ATGACAGCGACACGATCATT","561307.5.peg.587","2007"
"26823",2748,1452,1296,"GTATCGACATAGTCCATGAT","ATGACAGCGACACGATCATT","561307.5.peg.587","2007"
"26824",1344,1452,108,"AATTGCACAGCGACATGATT","ATGACAGCGACACGATCATT","561307.5.peg.587","2007"
"26825",2800,1452,1348,"AATTTGGCATAGCAAGTGTT","ATGACAGCGACACGATCATT","561307.5.peg.587","2007"
"26826",3363,1452,1911,"ATCTCACTCTAATTTGACT","ATGACAGCGACACGATCATT","561307.5.peg.587","2007"
"26827",2226,1452,774,"CCCAGAATCGGTTTACCAAT","ATGACAGCGACACGATCATT","561307.5.peg.587","2007"
"26828",2659,1452,1207,"TGGTATCATGTACTCCGGTA","ATGACAGCGACACGATCATT","561307.5.peg.587","2007"
"26829",858,1452,594,"GCATCGATTGTTAACGTTAA","ATGACAGCGACACGATCATT","561307.5.peg.587","2007"
"26830",3107,1452,1655,"CGTTATACACCGTATCTTTA","ATGACAGCGACACGATCATT","561307.5.peg.587","2007"
"26831",1763,1452,311,"GCGGAATTAGTGTCCCTTTA","ATGACAGCGACACGATCATT","561307.5.peg.587","2007"
"26832",2298,1452,846,"CCACTTGTACATAATTCTCC","ATGACAGCGACACGATCATT","561307.5.peg.587","2007"
"26833",669,1452,783,"GTTCAAATGGATGCTTAAT","ATGACAGCGACACGATCATT","561307.5.peg.587","2007"
"26834",2238,1452,786,"TAAACATGAGTACCCAGAAT","ATGACAGCGACACGATCATT","561307.5.peg.587","2007"
"26835",3410,1452,1958,"ATGATGCGTATCTATAAAG","ATGACAGCGACACGATCATT","561307.5.peg.587","2007"
"26836",1284,1452,168,"GTTTGCGCATCATCTATCTC","ATGACAGCGACACGATCATT","561307.5.peg.587","2007"
"26837",1315,1452,137,"TCAACTTGTTGCTCAAATA","ATGACAGCGACACGATCATT","561307.5.peg.587","2007"
"26838",2352,1452,900,"ATTTATCTGCTGTCAATTC","ATGACAGCGACACGATCATT","561307.5.peg.587","2007"
"26839",2776,1452,1324,"ATCTGTACTCGGTGCTACAT","ATGACAGCGACACGATCATT","561307.5.peg.587","2007"
"26840",2130,1452,678,"TAATAATTTGAGGATGCTT","ATGACAGCGACACGATCATT","561307.5.peg.587","2007"
"26841",1956,1452,504,"TTAATTGTTCTACCGCTAT","ATGACAGCGACACGATCATT","561307.5.peg.587","2007"
"26842",3621,1452,2169,"TTTGGTCTAACATAGTCTGT","ATGACAGCGACACGATCATT","561307.5.peg.587","2007"
"26843",2202,1452,750,"TACGATTTGGAACTTTGTT","ATGACAGCGACACGATCATT","561307.5.peg.587","2007"
"26844",1599,1452,147,"GGTACGTTATTACAACTTT","ATGACAGCGACACGATCATT","561307.5.peg.587","2007"
"26845",3396,1452,1944,"ATAAAGAGGTATGCATGTAA","ATGACAGCGACACGATCATT","561307.5.peg.587","2007"
"26846",2664,1452,1212,"TTAACTGGTATCATGTACTC","ATGACAGCGACACGATCATT","561307.5.peg.587","2007"
"26847",1560,1452,108,"ATGTACTCCTGACGATCACT","ATGACAGCGACACGATCATT","561307.5.peg.587","2007"
"26848",321,1452,1131,"TCATAGTTTGCGGAAGAAGA","ATGACAGCGACACGATCATT","561307.5.peg.587","2007"
"26849",1782,1452,330,"AAGCGAACAATACCTCGGTG","ATGACAGCGACACGATCATT","561307.5.peg.587","2007"
"26850",2130,1542,588,"TAATAATTTGAGGATGCTT","CTTGGATAGTTCGGATCAAT","561307.5.peg.587","2007"
"26851",3107,1542,1565,"CGTTATACACCGTATCTTTA","CTTGGATAGTTCGGATCAAT","561307.5.peg.587","2007"
"26852",2436,1542,894,"AAATAATCTATGTTGCCATC","CTTGGATAGTTCGGATCAAT","561307.5.peg.587","2007"
"26853",2214,1542,672,"TACCAATAGGAATACGATT","CTTGGATAGTTCGGATCAAT","561307.5.peg.587","2007"
"26854",3410,1542,1868,"ATGATGCGTATCTATAAAG","CTTGGATAGTTCGGATCAAT","561307.5.peg.587","2007"
"26855",2659,1542,1117,"TGGTATCATGTACTCCGGTA","CTTGGATAGTTCGGATCAAT","561307.5.peg.587","2007"
"26856",2800,1542,1258,"AATTTGGCATAGCAAGTGTT","CTTGGATAGTTCGGATCAAT","561307.5.peg.587","2007"
"26857",1956,1542,414,"TTAATTGTTCTACCGCTAT","CTTGGATAGTTCGGATCAAT","561307.5.peg.587","2007"
"26858",1787,1542,245,"GGACCAAGCGAACAATACCT","CTTGGATAGTTCGGATCAAT","561307.5.peg.587","2007"
"26859",858,1542,684,"GCATCGATTGTTAACGTTAA","CTTGGATAGTTCGGATCAAT","561307.5.peg.587","2007"
"26860",2298,1542,756,"CCACTTGTACATAATTCTCC","CTTGGATAGTTCGGATCAAT","561307.5.peg.587","2007"
"26861",143,1542,1399,"GTTTAACCCAATACGCATTA","CTTGGATAGTTCGGATCAAT","561307.5.peg.587","2007"
"26862",669,1542,873,"GTTCAAATGGATGCTTAAT","CTTGGATAGTTCGGATCAAT","561307.5.peg.587","2007"
"26863",2787,1542,1245,"AAGTGTTCGGTATCTGTACT","CTTGGATAGTTCGGATCAAT","561307.5.peg.587","2007"
"26864",321,1542,1221,"TCATAGTTTGCGGAAGAAGA","CTTGGATAGTTCGGATCAAT","561307.5.peg.587","2007"
"26865",2748,1542,1206,"GTATCGACATAGTCCATGAT","CTTGGATAGTTCGGATCAAT","561307.5.peg.587","2007"
"26866",1284,1542,258,"GTTTGCGCATCATCTATCTC","CTTGGATAGTTCGGATCAAT","561307.5.peg.587","2007"
"26867",3621,1542,2079,"TTTGGTCTAACATAGTCTGT","CTTGGATAGTTCGGATCAAT","561307.5.peg.587","2007"
"26868",2664,1542,1122,"TTAACTGGTATCATGTACTC","CTTGGATAGTTCGGATCAAT","561307.5.peg.587","2007"
"26869",1315,1542,227,"TCAACTTGTTGCTCAAATA","CTTGGATAGTTCGGATCAAT","561307.5.peg.587","2007"
"26870",2238,1542,696,"TAAACATGAGTACCCAGAAT","CTTGGATAGTTCGGATCAAT","561307.5.peg.587","2007"
"26871",1763,1542,221,"GCGGAATTAGTGTCCCTTTA","CTTGGATAGTTCGGATCAAT","561307.5.peg.587","2007"
"26872",3396,1542,1854,"ATAAAGAGGTATGCATGTAA","CTTGGATAGTTCGGATCAAT","561307.5.peg.587","2007"
"26873",331,1542,1211,"AGCTTCTAAATCATAGTTTG","CTTGGATAGTTCGGATCAAT","561307.5.peg.587","2007"
"26874",2352,1542,810,"ATTTATCTGCTGTCAATTC","CTTGGATAGTTCGGATCAAT","561307.5.peg.587","2007"
"26875",2776,1542,1234,"ATCTGTACTCGGTGCTACAT","CTTGGATAGTTCGGATCAAT","561307.5.peg.587","2007"
"26876",1344,1542,198,"AATTGCACAGCGACATGATT","CTTGGATAGTTCGGATCAAT","561307.5.peg.587","2007"
"26877",2226,1542,684,"CCCAGAATCGGTTTACCAAT","CTTGGATAGTTCGGATCAAT","561307.5.peg.587","2007"
"26878",1782,1542,240,"AAGCGAACAATACCTCGGTG","CTTGGATAGTTCGGATCAAT","561307.5.peg.587","2007"
"26879",3363,1542,1821,"ATCTCACTCTAATTTGACT","CTTGGATAGTTCGGATCAAT","561307.5.peg.587","2007"
"26880",2202,1542,660,"TACGATTTGGAACTTTGTT","CTTGGATAGTTCGGATCAAT","561307.5.peg.587","2007"
"26881",669,1551,882,"GTTCAAATGGATGCTTAAT","TGACGATCACTTGGATAGTT","561307.5.peg.587","2007"
"26882",1956,1551,405,"TTAATTGTTCTACCGCTAT","TGACGATCACTTGGATAGTT","561307.5.peg.587","2007"
"26883",2238,1551,687,"TAAACATGAGTACCCAGAAT","TGACGATCACTTGGATAGTT","561307.5.peg.587","2007"
"26884",2787,1551,1236,"AAGTGTTCGGTATCTGTACT","TGACGATCACTTGGATAGTT","561307.5.peg.587","2007"
"26885",2436,1551,885,"AAATAATCTATGTTGCCATC","TGACGATCACTTGGATAGTT","561307.5.peg.587","2007"
"26886",1782,1551,231,"AAGCGAACAATACCTCGGTG","TGACGATCACTTGGATAGTT","561307.5.peg.587","2007"
"26887",1763,1551,212,"GCGGAATTAGTGTCCCTTTA","TGACGATCACTTGGATAGTT","561307.5.peg.587","2007"
"26888",2800,1551,1249,"AATTTGGCATAGCAAGTGTT","TGACGATCACTTGGATAGTT","561307.5.peg.587","2007"
"26889",143,1551,1408,"GTTTAACCCAATACGCATTA","TGACGATCACTTGGATAGTT","561307.5.peg.587","2007"
"26890",3363,1551,1812,"ATCTCACTCTAATTTGACT","TGACGATCACTTGGATAGTT","561307.5.peg.587","2007"
"26891",858,1551,693,"GCATCGATTGTTAACGTTAA","TGACGATCACTTGGATAGTT","561307.5.peg.587","2007"
"26892",2202,1551,651,"TACGATTTGGAACTTTGTT","TGACGATCACTTGGATAGTT","561307.5.peg.587","2007"
"26893",2352,1551,801,"ATTTATCTGCTGTCAATTC","TGACGATCACTTGGATAGTT","561307.5.peg.587","2007"
"26894",2776,1551,1225,"ATCTGTACTCGGTGCTACAT","TGACGATCACTTGGATAGTT","561307.5.peg.587","2007"
"26895",3107,1551,1556,"CGTTATACACCGTATCTTTA","TGACGATCACTTGGATAGTT","561307.5.peg.587","2007"
"26896",321,1551,1230,"TCATAGTTTGCGGAAGAAGA","TGACGATCACTTGGATAGTT","561307.5.peg.587","2007"
"26897",1315,1551,236,"TCAACTTGTTGCTCAAATA","TGACGATCACTTGGATAGTT","561307.5.peg.587","2007"
"26898",331,1551,1220,"AGCTTCTAAATCATAGTTTG","TGACGATCACTTGGATAGTT","561307.5.peg.587","2007"
"26899",2664,1551,1113,"TTAACTGGTATCATGTACTC","TGACGATCACTTGGATAGTT","561307.5.peg.587","2007"
"26900",2659,1551,1108,"TGGTATCATGTACTCCGGTA","TGACGATCACTTGGATAGTT","561307.5.peg.587","2007"
"26901",1284,1551,267,"GTTTGCGCATCATCTATCTC","TGACGATCACTTGGATAGTT","561307.5.peg.587","2007"
"26902",1787,1551,236,"GGACCAAGCGAACAATACCT","TGACGATCACTTGGATAGTT","561307.5.peg.587","2007"
"26903",3396,1551,1845,"ATAAAGAGGTATGCATGTAA","TGACGATCACTTGGATAGTT","561307.5.peg.587","2007"
"26904",2748,1551,1197,"GTATCGACATAGTCCATGAT","TGACGATCACTTGGATAGTT","561307.5.peg.587","2007"
"26905",2130,1551,579,"TAATAATTTGAGGATGCTT","TGACGATCACTTGGATAGTT","561307.5.peg.587","2007"
"26906",3621,1551,2070,"TTTGGTCTAACATAGTCTGT","TGACGATCACTTGGATAGTT","561307.5.peg.587","2007"
"26907",2226,1551,675,"CCCAGAATCGGTTTACCAAT","TGACGATCACTTGGATAGTT","561307.5.peg.587","2007"
"26908",1344,1551,207,"AATTGCACAGCGACATGATT","TGACGATCACTTGGATAGTT","561307.5.peg.587","2007"
"26909",3410,1551,1859,"ATGATGCGTATCTATAAAG","TGACGATCACTTGGATAGTT","561307.5.peg.587","2007"
"26910",2298,1551,747,"CCACTTGTACATAATTCTCC","TGACGATCACTTGGATAGTT","561307.5.peg.587","2007"
"26911",2214,1551,663,"TACCAATAGGAATACGATT","TGACGATCACTTGGATAGTT","561307.5.peg.587","2007"
"26912",2659,1560,1099,"TGGTATCATGTACTCCGGTA","ATGTACTCCTGACGATCACT","561307.5.peg.587","2007"
"26913",331,1560,1229,"AGCTTCTAAATCATAGTTTG","ATGTACTCCTGACGATCACT","561307.5.peg.587","2007"
"26914",1284,1560,276,"GTTTGCGCATCATCTATCTC","ATGTACTCCTGACGATCACT","561307.5.peg.587","2007"
"26915",2130,1560,570,"TAATAATTTGAGGATGCTT","ATGTACTCCTGACGATCACT","561307.5.peg.587","2007"
"26916",3107,1560,1547,"CGTTATACACCGTATCTTTA","ATGTACTCCTGACGATCACT","561307.5.peg.587","2007"
"26917",143,1560,1417,"GTTTAACCCAATACGCATTA","ATGTACTCCTGACGATCACT","561307.5.peg.587","2007"
"26918",2298,1560,738,"CCACTTGTACATAATTCTCC","ATGTACTCCTGACGATCACT","561307.5.peg.587","2007"
"26919",1315,1560,245,"TCAACTTGTTGCTCAAATA","ATGTACTCCTGACGATCACT","561307.5.peg.587","2007"
"26920",2787,1560,1227,"AAGTGTTCGGTATCTGTACT","ATGTACTCCTGACGATCACT","561307.5.peg.587","2007"
"26921",2800,1560,1240,"AATTTGGCATAGCAAGTGTT","ATGTACTCCTGACGATCACT","561307.5.peg.587","2007"
"26922",1956,1560,396,"TTAATTGTTCTACCGCTAT","ATGTACTCCTGACGATCACT","561307.5.peg.587","2007"
"26923",2226,1560,666,"CCCAGAATCGGTTTACCAAT","ATGTACTCCTGACGATCACT","561307.5.peg.587","2007"
"26924",858,1560,702,"GCATCGATTGTTAACGTTAA","ATGTACTCCTGACGATCACT","561307.5.peg.587","2007"
"26925",1452,1560,108,"ATGACAGCGACACGATCATT","ATGTACTCCTGACGATCACT","561307.5.peg.587","2007"
"26926",1344,1560,216,"AATTGCACAGCGACATGATT","ATGTACTCCTGACGATCACT","561307.5.peg.587","2007"
"26927",2748,1560,1188,"GTATCGACATAGTCCATGAT","ATGTACTCCTGACGATCACT","561307.5.peg.587","2007"
"26928",1763,1560,203,"GCGGAATTAGTGTCCCTTTA","ATGTACTCCTGACGATCACT","561307.5.peg.587","2007"
"26929",2776,1560,1216,"ATCTGTACTCGGTGCTACAT","ATGTACTCCTGACGATCACT","561307.5.peg.587","2007"
"26930",2238,1560,678,"TAAACATGAGTACCCAGAAT","ATGTACTCCTGACGATCACT","561307.5.peg.587","2007"
"26931",3410,1560,1850,"ATGATGCGTATCTATAAAG","ATGTACTCCTGACGATCACT","561307.5.peg.587","2007"
"26932",2202,1560,642,"TACGATTTGGAACTTTGTT","ATGTACTCCTGACGATCACT","561307.5.peg.587","2007"
"26933",3396,1560,1836,"ATAAAGAGGTATGCATGTAA","ATGTACTCCTGACGATCACT","561307.5.peg.587","2007"
"26934",669,1560,891,"GTTCAAATGGATGCTTAAT","ATGTACTCCTGACGATCACT","561307.5.peg.587","2007"
"26935",1787,1560,227,"GGACCAAGCGAACAATACCT","ATGTACTCCTGACGATCACT","561307.5.peg.587","2007"
"26936",2664,1560,1104,"TTAACTGGTATCATGTACTC","ATGTACTCCTGACGATCACT","561307.5.peg.587","2007"
"26937",2214,1560,654,"TACCAATAGGAATACGATT","ATGTACTCCTGACGATCACT","561307.5.peg.587","2007"
"26938",2352,1560,792,"ATTTATCTGCTGTCAATTC","ATGTACTCCTGACGATCACT","561307.5.peg.587","2007"
"26939",3621,1560,2061,"TTTGGTCTAACATAGTCTGT","ATGTACTCCTGACGATCACT","561307.5.peg.587","2007"
"26940",1782,1560,222,"AAGCGAACAATACCTCGGTG","ATGTACTCCTGACGATCACT","561307.5.peg.587","2007"
"26941",3363,1560,1803,"ATCTCACTCTAATTTGACT","ATGTACTCCTGACGATCACT","561307.5.peg.587","2007"
"26942",321,1560,1239,"TCATAGTTTGCGGAAGAAGA","ATGTACTCCTGACGATCACT","561307.5.peg.587","2007"
"26943",2436,1560,876,"AAATAATCTATGTTGCCATC","ATGTACTCCTGACGATCACT","561307.5.peg.587","2007"
"26944",2748,1599,1149,"GTATCGACATAGTCCATGAT","GGTACGTTATTACAACTTT","561307.5.peg.587","2007"
"26945",2787,1599,1188,"AAGTGTTCGGTATCTGTACT","GGTACGTTATTACAACTTT","561307.5.peg.587","2007"
"26946",2226,1599,627,"CCCAGAATCGGTTTACCAAT","GGTACGTTATTACAACTTT","561307.5.peg.587","2007"
"26947",858,1599,741,"GCATCGATTGTTAACGTTAA","GGTACGTTATTACAACTTT","561307.5.peg.587","2007"
"26948",2659,1599,1060,"TGGTATCATGTACTCCGGTA","GGTACGTTATTACAACTTT","561307.5.peg.587","2007"
"26949",2214,1599,615,"TACCAATAGGAATACGATT","GGTACGTTATTACAACTTT","561307.5.peg.587","2007"
"26950",3363,1599,1764,"ATCTCACTCTAATTTGACT","GGTACGTTATTACAACTTT","561307.5.peg.587","2007"
"26951",331,1599,1268,"AGCTTCTAAATCATAGTTTG","GGTACGTTATTACAACTTT","561307.5.peg.587","2007"
"26952",1956,1599,357,"TTAATTGTTCTACCGCTAT","GGTACGTTATTACAACTTT","561307.5.peg.587","2007"
"26953",2130,1599,531,"TAATAATTTGAGGATGCTT","GGTACGTTATTACAACTTT","561307.5.peg.587","2007"
"26954",2352,1599,753,"ATTTATCTGCTGTCAATTC","GGTACGTTATTACAACTTT","561307.5.peg.587","2007"
"26955",321,1599,1278,"TCATAGTTTGCGGAAGAAGA","GGTACGTTATTACAACTTT","561307.5.peg.587","2007"
"26956",1763,1599,164,"GCGGAATTAGTGTCCCTTTA","GGTACGTTATTACAACTTT","561307.5.peg.587","2007"
"26957",1315,1599,284,"TCAACTTGTTGCTCAAATA","GGTACGTTATTACAACTTT","561307.5.peg.587","2007"
"26958",2664,1599,1065,"TTAACTGGTATCATGTACTC","GGTACGTTATTACAACTTT","561307.5.peg.587","2007"
"26959",1782,1599,183,"AAGCGAACAATACCTCGGTG","GGTACGTTATTACAACTTT","561307.5.peg.587","2007"
"26960",1787,1599,188,"GGACCAAGCGAACAATACCT","GGTACGTTATTACAACTTT","561307.5.peg.587","2007"
"26961",1284,1599,315,"GTTTGCGCATCATCTATCTC","GGTACGTTATTACAACTTT","561307.5.peg.587","2007"
"26962",2298,1599,699,"CCACTTGTACATAATTCTCC","GGTACGTTATTACAACTTT","561307.5.peg.587","2007"
"26963",2776,1599,1177,"ATCTGTACTCGGTGCTACAT","GGTACGTTATTACAACTTT","561307.5.peg.587","2007"
"26964",3621,1599,2022,"TTTGGTCTAACATAGTCTGT","GGTACGTTATTACAACTTT","561307.5.peg.587","2007"
"26965",3396,1599,1797,"ATAAAGAGGTATGCATGTAA","GGTACGTTATTACAACTTT","561307.5.peg.587","2007"
"26966",2238,1599,639,"TAAACATGAGTACCCAGAAT","GGTACGTTATTACAACTTT","561307.5.peg.587","2007"
"26967",1452,1599,147,"ATGACAGCGACACGATCATT","GGTACGTTATTACAACTTT","561307.5.peg.587","2007"
"26968",2202,1599,603,"TACGATTTGGAACTTTGTT","GGTACGTTATTACAACTTT","561307.5.peg.587","2007"
"26969",143,1599,1456,"GTTTAACCCAATACGCATTA","GGTACGTTATTACAACTTT","561307.5.peg.587","2007"
"26970",3410,1599,1811,"ATGATGCGTATCTATAAAG","GGTACGTTATTACAACTTT","561307.5.peg.587","2007"
"26971",2436,1599,837,"AAATAATCTATGTTGCCATC","GGTACGTTATTACAACTTT","561307.5.peg.587","2007"
"26972",2800,1599,1201,"AATTTGGCATAGCAAGTGTT","GGTACGTTATTACAACTTT","561307.5.peg.587","2007"
"26973",1344,1599,255,"AATTGCACAGCGACATGATT","GGTACGTTATTACAACTTT","561307.5.peg.587","2007"
"26974",3107,1599,1508,"CGTTATACACCGTATCTTTA","GGTACGTTATTACAACTTT","561307.5.peg.587","2007"
"26975",669,1599,930,"GTTCAAATGGATGCTTAAT","GGTACGTTATTACAACTTT","561307.5.peg.587","2007"
"26976",669,1763,1094,"GTTCAAATGGATGCTTAAT","GCGGAATTAGTGTCCCTTTA","561307.5.peg.587","2007"
"26977",2436,1763,673,"AAATAATCTATGTTGCCATC","GCGGAATTAGTGTCCCTTTA","561307.5.peg.587","2007"
"26978",1315,1763,448,"TCAACTTGTTGCTCAAATA","GCGGAATTAGTGTCCCTTTA","561307.5.peg.587","2007"
"26979",143,1763,1620,"GTTTAACCCAATACGCATTA","GCGGAATTAGTGTCCCTTTA","561307.5.peg.587","2007"
"26980",2214,1763,451,"TACCAATAGGAATACGATT","GCGGAATTAGTGTCCCTTTA","561307.5.peg.587","2007"
"26981",3410,1763,1647,"ATGATGCGTATCTATAAAG","GCGGAATTAGTGTCCCTTTA","561307.5.peg.587","2007"
"26982",2130,1763,367,"TAATAATTTGAGGATGCTT","GCGGAATTAGTGTCCCTTTA","561307.5.peg.587","2007"
"26983",3396,1763,1633,"ATAAAGAGGTATGCATGTAA","GCGGAATTAGTGTCCCTTTA","561307.5.peg.587","2007"
"26984",858,1763,905,"GCATCGATTGTTAACGTTAA","GCGGAATTAGTGTCCCTTTA","561307.5.peg.587","2007"
"26985",1560,1763,203,"ATGTACTCCTGACGATCACT","GCGGAATTAGTGTCCCTTTA","561307.5.peg.587","2007"
"26986",1542,1763,221,"CTTGGATAGTTCGGATCAAT","GCGGAATTAGTGTCCCTTTA","561307.5.peg.587","2007"
"26987",2202,1763,439,"TACGATTTGGAACTTTGTT","GCGGAATTAGTGTCCCTTTA","561307.5.peg.587","2007"
"26988",2238,1763,475,"TAAACATGAGTACCCAGAAT","GCGGAATTAGTGTCCCTTTA","561307.5.peg.587","2007"
"26989",2748,1763,985,"GTATCGACATAGTCCATGAT","GCGGAATTAGTGTCCCTTTA","561307.5.peg.587","2007"
"26990",1956,1763,193,"TTAATTGTTCTACCGCTAT","GCGGAATTAGTGTCCCTTTA","561307.5.peg.587","2007"
"26991",321,1763,1442,"TCATAGTTTGCGGAAGAAGA","GCGGAATTAGTGTCCCTTTA","561307.5.peg.587","2007"
"26992",2298,1763,535,"CCACTTGTACATAATTCTCC","GCGGAATTAGTGTCCCTTTA","561307.5.peg.587","2007"
"26993",2664,1763,901,"TTAACTGGTATCATGTACTC","GCGGAATTAGTGTCCCTTTA","561307.5.peg.587","2007"
"26994",3621,1763,1858,"TTTGGTCTAACATAGTCTGT","GCGGAATTAGTGTCCCTTTA","561307.5.peg.587","2007"
"26995",1452,1763,311,"ATGACAGCGACACGATCATT","GCGGAATTAGTGTCCCTTTA","561307.5.peg.587","2007"
"26996",331,1763,1432,"AGCTTCTAAATCATAGTTTG","GCGGAATTAGTGTCCCTTTA","561307.5.peg.587","2007"
"26997",2659,1763,896,"TGGTATCATGTACTCCGGTA","GCGGAATTAGTGTCCCTTTA","561307.5.peg.587","2007"
"26998",2800,1763,1037,"AATTTGGCATAGCAAGTGTT","GCGGAATTAGTGTCCCTTTA","561307.5.peg.587","2007"
"26999",1551,1763,212,"TGACGATCACTTGGATAGTT","GCGGAATTAGTGTCCCTTTA","561307.5.peg.587","2007"
"27000",2776,1763,1013,"ATCTGTACTCGGTGCTACAT","GCGGAATTAGTGTCCCTTTA","561307.5.peg.587","2007"
"27001",3363,1763,1600,"ATCTCACTCTAATTTGACT","GCGGAATTAGTGTCCCTTTA","561307.5.peg.587","2007"
"27002",2352,1763,589,"ATTTATCTGCTGTCAATTC","GCGGAATTAGTGTCCCTTTA","561307.5.peg.587","2007"
"27003",2787,1763,1024,"AAGTGTTCGGTATCTGTACT","GCGGAATTAGTGTCCCTTTA","561307.5.peg.587","2007"
"27004",3107,1763,1344,"CGTTATACACCGTATCTTTA","GCGGAATTAGTGTCCCTTTA","561307.5.peg.587","2007"
"27005",1284,1763,479,"GTTTGCGCATCATCTATCTC","GCGGAATTAGTGTCCCTTTA","561307.5.peg.587","2007"
"27006",2226,1763,463,"CCCAGAATCGGTTTACCAAT","GCGGAATTAGTGTCCCTTTA","561307.5.peg.587","2007"
"27007",1599,1763,164,"GGTACGTTATTACAACTTT","GCGGAATTAGTGTCCCTTTA","561307.5.peg.587","2007"
"27008",1344,1763,419,"AATTGCACAGCGACATGATT","GCGGAATTAGTGTCCCTTTA","561307.5.peg.587","2007"
"27009",2202,1782,420,"TACGATTTGGAACTTTGTT","AAGCGAACAATACCTCGGTG","561307.5.peg.587","2007"
"27010",858,1782,924,"GCATCGATTGTTAACGTTAA","AAGCGAACAATACCTCGGTG","561307.5.peg.587","2007"
"27011",2659,1782,877,"TGGTATCATGTACTCCGGTA","AAGCGAACAATACCTCGGTG","561307.5.peg.587","2007"
"27012",2226,1782,444,"CCCAGAATCGGTTTACCAAT","AAGCGAACAATACCTCGGTG","561307.5.peg.587","2007"
"27013",2776,1782,994,"ATCTGTACTCGGTGCTACAT","AAGCGAACAATACCTCGGTG","561307.5.peg.587","2007"
"27014",1560,1782,222,"ATGTACTCCTGACGATCACT","AAGCGAACAATACCTCGGTG","561307.5.peg.587","2007"
"27015",2130,1782,348,"TAATAATTTGAGGATGCTT","AAGCGAACAATACCTCGGTG","561307.5.peg.587","2007"
"27016",3621,1782,1839,"TTTGGTCTAACATAGTCTGT","AAGCGAACAATACCTCGGTG","561307.5.peg.587","2007"
"27017",1452,1782,330,"ATGACAGCGACACGATCATT","AAGCGAACAATACCTCGGTG","561307.5.peg.587","2007"
"27018",1542,1782,240,"CTTGGATAGTTCGGATCAAT","AAGCGAACAATACCTCGGTG","561307.5.peg.587","2007"
"27019",3410,1782,1628,"ATGATGCGTATCTATAAAG","AAGCGAACAATACCTCGGTG","561307.5.peg.587","2007"
"27020",321,1782,1461,"TCATAGTTTGCGGAAGAAGA","AAGCGAACAATACCTCGGTG","561307.5.peg.587","2007"
"27021",1284,1782,498,"GTTTGCGCATCATCTATCTC","AAGCGAACAATACCTCGGTG","561307.5.peg.587","2007"
"27022",143,1782,1639,"GTTTAACCCAATACGCATTA","AAGCGAACAATACCTCGGTG","561307.5.peg.587","2007"
"27023",2436,1782,654,"AAATAATCTATGTTGCCATC","AAGCGAACAATACCTCGGTG","561307.5.peg.587","2007"
"27024",669,1782,1113,"GTTCAAATGGATGCTTAAT","AAGCGAACAATACCTCGGTG","561307.5.peg.587","2007"
"27025",2352,1782,570,"ATTTATCTGCTGTCAATTC","AAGCGAACAATACCTCGGTG","561307.5.peg.587","2007"
"27026",2748,1782,966,"GTATCGACATAGTCCATGAT","AAGCGAACAATACCTCGGTG","561307.5.peg.587","2007"
"27027",2214,1782,432,"TACCAATAGGAATACGATT","AAGCGAACAATACCTCGGTG","561307.5.peg.587","2007"
"27028",3363,1782,1581,"ATCTCACTCTAATTTGACT","AAGCGAACAATACCTCGGTG","561307.5.peg.587","2007"
"27029",2298,1782,516,"CCACTTGTACATAATTCTCC","AAGCGAACAATACCTCGGTG","561307.5.peg.587","2007"
"27030",2800,1782,1018,"AATTTGGCATAGCAAGTGTT","AAGCGAACAATACCTCGGTG","561307.5.peg.587","2007"
"27031",3396,1782,1614,"ATAAAGAGGTATGCATGTAA","AAGCGAACAATACCTCGGTG","561307.5.peg.587","2007"
"27032",2787,1782,1005,"AAGTGTTCGGTATCTGTACT","AAGCGAACAATACCTCGGTG","561307.5.peg.587","2007"
"27033",1344,1782,438,"AATTGCACAGCGACATGATT","AAGCGAACAATACCTCGGTG","561307.5.peg.587","2007"
"27034",1599,1782,183,"GGTACGTTATTACAACTTT","AAGCGAACAATACCTCGGTG","561307.5.peg.587","2007"
"27035",1551,1782,231,"TGACGATCACTTGGATAGTT","AAGCGAACAATACCTCGGTG","561307.5.peg.587","2007"
"27036",3107,1782,1325,"CGTTATACACCGTATCTTTA","AAGCGAACAATACCTCGGTG","561307.5.peg.587","2007"
"27037",1315,1782,467,"TCAACTTGTTGCTCAAATA","AAGCGAACAATACCTCGGTG","561307.5.peg.587","2007"
"27038",331,1782,1451,"AGCTTCTAAATCATAGTTTG","AAGCGAACAATACCTCGGTG","561307.5.peg.587","2007"
"27039",2664,1782,882,"TTAACTGGTATCATGTACTC","AAGCGAACAATACCTCGGTG","561307.5.peg.587","2007"
"27040",2238,1782,456,"TAAACATGAGTACCCAGAAT","AAGCGAACAATACCTCGGTG","561307.5.peg.587","2007"
"27041",1956,1782,174,"TTAATTGTTCTACCGCTAT","AAGCGAACAATACCTCGGTG","561307.5.peg.587","2007"
"27042",143,1787,1644,"GTTTAACCCAATACGCATTA","GGACCAAGCGAACAATACCT","561307.5.peg.587","2007"
"27043",2298,1787,511,"CCACTTGTACATAATTCTCC","GGACCAAGCGAACAATACCT","561307.5.peg.587","2007"
"27044",669,1787,1118,"GTTCAAATGGATGCTTAAT","GGACCAAGCGAACAATACCT","561307.5.peg.587","2007"
"27045",2202,1787,415,"TACGATTTGGAACTTTGTT","GGACCAAGCGAACAATACCT","561307.5.peg.587","2007"
"27046",2664,1787,877,"TTAACTGGTATCATGTACTC","GGACCAAGCGAACAATACCT","561307.5.peg.587","2007"
"27047",3107,1787,1320,"CGTTATACACCGTATCTTTA","GGACCAAGCGAACAATACCT","561307.5.peg.587","2007"
"27048",2776,1787,989,"ATCTGTACTCGGTGCTACAT","GGACCAAGCGAACAATACCT","561307.5.peg.587","2007"
"27049",1542,1787,245,"CTTGGATAGTTCGGATCAAT","GGACCAAGCGAACAATACCT","561307.5.peg.587","2007"
"27050",321,1787,1466,"TCATAGTTTGCGGAAGAAGA","GGACCAAGCGAACAATACCT","561307.5.peg.587","2007"
"27051",331,1787,1456,"AGCTTCTAAATCATAGTTTG","GGACCAAGCGAACAATACCT","561307.5.peg.587","2007"
"27052",3621,1787,1834,"TTTGGTCTAACATAGTCTGT","GGACCAAGCGAACAATACCT","561307.5.peg.587","2007"
"27053",2130,1787,343,"TAATAATTTGAGGATGCTT","GGACCAAGCGAACAATACCT","561307.5.peg.587","2007"
"27054",2226,1787,439,"CCCAGAATCGGTTTACCAAT","GGACCAAGCGAACAATACCT","561307.5.peg.587","2007"
"27055",2748,1787,961,"GTATCGACATAGTCCATGAT","GGACCAAGCGAACAATACCT","561307.5.peg.587","2007"
"27056",1344,1787,443,"AATTGCACAGCGACATGATT","GGACCAAGCGAACAATACCT","561307.5.peg.587","2007"
"27057",1560,1787,227,"ATGTACTCCTGACGATCACT","GGACCAAGCGAACAATACCT","561307.5.peg.587","2007"
"27058",2659,1787,872,"TGGTATCATGTACTCCGGTA","GGACCAAGCGAACAATACCT","561307.5.peg.587","2007"
"27059",1452,1787,335,"ATGACAGCGACACGATCATT","GGACCAAGCGAACAATACCT","561307.5.peg.587","2007"
"27060",2800,1787,1013,"AATTTGGCATAGCAAGTGTT","GGACCAAGCGAACAATACCT","561307.5.peg.587","2007"
"27061",2238,1787,451,"TAAACATGAGTACCCAGAAT","GGACCAAGCGAACAATACCT","561307.5.peg.587","2007"
"27062",2352,1787,565,"ATTTATCTGCTGTCAATTC","GGACCAAGCGAACAATACCT","561307.5.peg.587","2007"
"27063",2214,1787,427,"TACCAATAGGAATACGATT","GGACCAAGCGAACAATACCT","561307.5.peg.587","2007"
"27064",1599,1787,188,"GGTACGTTATTACAACTTT","GGACCAAGCGAACAATACCT","561307.5.peg.587","2007"
"27065",3410,1787,1623,"ATGATGCGTATCTATAAAG","GGACCAAGCGAACAATACCT","561307.5.peg.587","2007"
"27066",2787,1787,1000,"AAGTGTTCGGTATCTGTACT","GGACCAAGCGAACAATACCT","561307.5.peg.587","2007"
"27067",1315,1787,472,"TCAACTTGTTGCTCAAATA","GGACCAAGCGAACAATACCT","561307.5.peg.587","2007"
"27068",1956,1787,169,"TTAATTGTTCTACCGCTAT","GGACCAAGCGAACAATACCT","561307.5.peg.587","2007"
"27069",1284,1787,503,"GTTTGCGCATCATCTATCTC","GGACCAAGCGAACAATACCT","561307.5.peg.587","2007"
"27070",858,1787,929,"GCATCGATTGTTAACGTTAA","GGACCAAGCGAACAATACCT","561307.5.peg.587","2007"
"27071",3396,1787,1609,"ATAAAGAGGTATGCATGTAA","GGACCAAGCGAACAATACCT","561307.5.peg.587","2007"
"27072",3363,1787,1576,"ATCTCACTCTAATTTGACT","GGACCAAGCGAACAATACCT","561307.5.peg.587","2007"
"27073",2436,1787,649,"AAATAATCTATGTTGCCATC","GGACCAAGCGAACAATACCT","561307.5.peg.587","2007"
"27074",1551,1787,236,"TGACGATCACTTGGATAGTT","GGACCAAGCGAACAATACCT","561307.5.peg.587","2007"
"27075",2352,1956,396,"ATTTATCTGCTGTCAATTC","TTAATTGTTCTACCGCTAT","561307.5.peg.587","2007"
"27076",2659,1956,703,"TGGTATCATGTACTCCGGTA","TTAATTGTTCTACCGCTAT","561307.5.peg.587","2007"
"27077",1551,1956,405,"TGACGATCACTTGGATAGTT","TTAATTGTTCTACCGCTAT","561307.5.peg.587","2007"
"27078",2800,1956,844,"AATTTGGCATAGCAAGTGTT","TTAATTGTTCTACCGCTAT","561307.5.peg.587","2007"
"27079",2214,1956,258,"TACCAATAGGAATACGATT","TTAATTGTTCTACCGCTAT","561307.5.peg.587","2007"
"27080",3363,1956,1407,"ATCTCACTCTAATTTGACT","TTAATTGTTCTACCGCTAT","561307.5.peg.587","2007"
"27081",1787,1956,169,"GGACCAAGCGAACAATACCT","TTAATTGTTCTACCGCTAT","561307.5.peg.587","2007"
"27082",669,1956,1287,"GTTCAAATGGATGCTTAAT","TTAATTGTTCTACCGCTAT","561307.5.peg.587","2007"
"27083",1284,1956,672,"GTTTGCGCATCATCTATCTC","TTAATTGTTCTACCGCTAT","561307.5.peg.587","2007"
"27084",2748,1956,792,"GTATCGACATAGTCCATGAT","TTAATTGTTCTACCGCTAT","561307.5.peg.587","2007"
"27085",1452,1956,504,"ATGACAGCGACACGATCATT","TTAATTGTTCTACCGCTAT","561307.5.peg.587","2007"
"27086",321,1956,1635,"TCATAGTTTGCGGAAGAAGA","TTAATTGTTCTACCGCTAT","561307.5.peg.587","2007"
"27087",2130,1956,174,"TAATAATTTGAGGATGCTT","TTAATTGTTCTACCGCTAT","561307.5.peg.587","2007"
"27088",1542,1956,414,"CTTGGATAGTTCGGATCAAT","TTAATTGTTCTACCGCTAT","561307.5.peg.587","2007"
"27089",2436,1956,480,"AAATAATCTATGTTGCCATC","TTAATTGTTCTACCGCTAT","561307.5.peg.587","2007"
"27090",2202,1956,246,"TACGATTTGGAACTTTGTT","TTAATTGTTCTACCGCTAT","561307.5.peg.587","2007"
"27091",2776,1956,820,"ATCTGTACTCGGTGCTACAT","TTAATTGTTCTACCGCTAT","561307.5.peg.587","2007"
"27092",3396,1956,1440,"ATAAAGAGGTATGCATGTAA","TTAATTGTTCTACCGCTAT","561307.5.peg.587","2007"
"27093",1315,1956,641,"TCAACTTGTTGCTCAAATA","TTAATTGTTCTACCGCTAT","561307.5.peg.587","2007"
"27094",1599,1956,357,"GGTACGTTATTACAACTTT","TTAATTGTTCTACCGCTAT","561307.5.peg.587","2007"
"27095",2226,1956,270,"CCCAGAATCGGTTTACCAAT","TTAATTGTTCTACCGCTAT","561307.5.peg.587","2007"
"27096",2787,1956,831,"AAGTGTTCGGTATCTGTACT","TTAATTGTTCTACCGCTAT","561307.5.peg.587","2007"
"27097",1560,1956,396,"ATGTACTCCTGACGATCACT","TTAATTGTTCTACCGCTAT","561307.5.peg.587","2007"
"27098",2298,1956,342,"CCACTTGTACATAATTCTCC","TTAATTGTTCTACCGCTAT","561307.5.peg.587","2007"
"27099",331,1956,1625,"AGCTTCTAAATCATAGTTTG","TTAATTGTTCTACCGCTAT","561307.5.peg.587","2007"
"27100",2238,1956,282,"TAAACATGAGTACCCAGAAT","TTAATTGTTCTACCGCTAT","561307.5.peg.587","2007"
"27101",1344,1956,612,"AATTGCACAGCGACATGATT","TTAATTGTTCTACCGCTAT","561307.5.peg.587","2007"
"27102",3621,1956,1665,"TTTGGTCTAACATAGTCTGT","TTAATTGTTCTACCGCTAT","561307.5.peg.587","2007"
"27103",3410,1956,1454,"ATGATGCGTATCTATAAAG","TTAATTGTTCTACCGCTAT","561307.5.peg.587","2007"
"27104",1763,1956,193,"GCGGAATTAGTGTCCCTTTA","TTAATTGTTCTACCGCTAT","561307.5.peg.587","2007"
"27105",143,1956,1813,"GTTTAACCCAATACGCATTA","TTAATTGTTCTACCGCTAT","561307.5.peg.587","2007"
"27106",1782,1956,174,"AAGCGAACAATACCTCGGTG","TTAATTGTTCTACCGCTAT","561307.5.peg.587","2007"
"27107",858,1956,1098,"GCATCGATTGTTAACGTTAA","TTAATTGTTCTACCGCTAT","561307.5.peg.587","2007"
"27108",2664,1956,708,"TTAACTGGTATCATGTACTC","TTAATTGTTCTACCGCTAT","561307.5.peg.587","2007"
"27109",3107,1956,1151,"CGTTATACACCGTATCTTTA","TTAATTGTTCTACCGCTAT","561307.5.peg.587","2007"
"27110",1599,2130,531,"GGTACGTTATTACAACTTT","TAATAATTTGAGGATGCTT","561307.5.peg.587","2007"
"27111",1344,2130,786,"AATTGCACAGCGACATGATT","TAATAATTTGAGGATGCTT","561307.5.peg.587","2007"
"27112",1452,2130,678,"ATGACAGCGACACGATCATT","TAATAATTTGAGGATGCTT","561307.5.peg.587","2007"
"27113",1782,2130,348,"AAGCGAACAATACCTCGGTG","TAATAATTTGAGGATGCTT","561307.5.peg.587","2007"
"27114",2664,2130,534,"TTAACTGGTATCATGTACTC","TAATAATTTGAGGATGCTT","561307.5.peg.587","2007"
"27115",1763,2130,367,"GCGGAATTAGTGTCCCTTTA","TAATAATTTGAGGATGCTT","561307.5.peg.587","2007"
"27116",2800,2130,670,"AATTTGGCATAGCAAGTGTT","TAATAATTTGAGGATGCTT","561307.5.peg.587","2007"
"27117",2776,2130,646,"ATCTGTACTCGGTGCTACAT","TAATAATTTGAGGATGCTT","561307.5.peg.587","2007"
"27118",2298,2130,168,"CCACTTGTACATAATTCTCC","TAATAATTTGAGGATGCTT","561307.5.peg.587","2007"
"27119",2748,2130,618,"GTATCGACATAGTCCATGAT","TAATAATTTGAGGATGCTT","561307.5.peg.587","2007"
"27120",331,2130,1799,"AGCTTCTAAATCATAGTTTG","TAATAATTTGAGGATGCTT","561307.5.peg.587","2007"
"27121",2787,2130,657,"AAGTGTTCGGTATCTGTACT","TAATAATTTGAGGATGCTT","561307.5.peg.587","2007"
"27122",1315,2130,815,"TCAACTTGTTGCTCAAATA","TAATAATTTGAGGATGCTT","561307.5.peg.587","2007"
"27123",858,2130,1272,"GCATCGATTGTTAACGTTAA","TAATAATTTGAGGATGCTT","561307.5.peg.587","2007"
"27124",669,2130,1461,"GTTCAAATGGATGCTTAAT","TAATAATTTGAGGATGCTT","561307.5.peg.587","2007"
"27125",1560,2130,570,"ATGTACTCCTGACGATCACT","TAATAATTTGAGGATGCTT","561307.5.peg.587","2007"
"27126",2436,2130,306,"AAATAATCTATGTTGCCATC","TAATAATTTGAGGATGCTT","561307.5.peg.587","2007"
"27127",3363,2130,1233,"ATCTCACTCTAATTTGACT","TAATAATTTGAGGATGCTT","561307.5.peg.587","2007"
"27128",1956,2130,174,"TTAATTGTTCTACCGCTAT","TAATAATTTGAGGATGCTT","561307.5.peg.587","2007"
"27129",1551,2130,579,"TGACGATCACTTGGATAGTT","TAATAATTTGAGGATGCTT","561307.5.peg.587","2007"
"27130",3621,2130,1491,"TTTGGTCTAACATAGTCTGT","TAATAATTTGAGGATGCTT","561307.5.peg.587","2007"
"27131",143,2130,1987,"GTTTAACCCAATACGCATTA","TAATAATTTGAGGATGCTT","561307.5.peg.587","2007"
"27132",2659,2130,529,"TGGTATCATGTACTCCGGTA","TAATAATTTGAGGATGCTT","561307.5.peg.587","2007"
"27133",1542,2130,588,"CTTGGATAGTTCGGATCAAT","TAATAATTTGAGGATGCTT","561307.5.peg.587","2007"
"27134",3107,2130,977,"CGTTATACACCGTATCTTTA","TAATAATTTGAGGATGCTT","561307.5.peg.587","2007"
"27135",3410,2130,1280,"ATGATGCGTATCTATAAAG","TAATAATTTGAGGATGCTT","561307.5.peg.587","2007"
"27136",2238,2130,108,"TAAACATGAGTACCCAGAAT","TAATAATTTGAGGATGCTT","561307.5.peg.587","2007"
"27137",321,2130,1809,"TCATAGTTTGCGGAAGAAGA","TAATAATTTGAGGATGCTT","561307.5.peg.587","2007"
"27138",1284,2130,846,"GTTTGCGCATCATCTATCTC","TAATAATTTGAGGATGCTT","561307.5.peg.587","2007"
"27139",2352,2130,222,"ATTTATCTGCTGTCAATTC","TAATAATTTGAGGATGCTT","561307.5.peg.587","2007"
"27140",3396,2130,1266,"ATAAAGAGGTATGCATGTAA","TAATAATTTGAGGATGCTT","561307.5.peg.587","2007"
"27141",1787,2130,343,"GGACCAAGCGAACAATACCT","TAATAATTTGAGGATGCTT","561307.5.peg.587","2007"
"27142",2436,2202,234,"AAATAATCTATGTTGCCATC","TACGATTTGGAACTTTGTT","561307.5.peg.587","2007"
"27143",2776,2202,574,"ATCTGTACTCGGTGCTACAT","TACGATTTGGAACTTTGTT","561307.5.peg.587","2007"
"27144",1782,2202,420,"AAGCGAACAATACCTCGGTG","TACGATTTGGAACTTTGTT","561307.5.peg.587","2007"
"27145",2664,2202,462,"TTAACTGGTATCATGTACTC","TACGATTTGGAACTTTGTT","561307.5.peg.587","2007"
"27146",1599,2202,603,"GGTACGTTATTACAACTTT","TACGATTTGGAACTTTGTT","561307.5.peg.587","2007"
"27147",2352,2202,150,"ATTTATCTGCTGTCAATTC","TACGATTTGGAACTTTGTT","561307.5.peg.587","2007"
"27148",3107,2202,905,"CGTTATACACCGTATCTTTA","TACGATTTGGAACTTTGTT","561307.5.peg.587","2007"
"27149",1452,2202,750,"ATGACAGCGACACGATCATT","TACGATTTGGAACTTTGTT","561307.5.peg.587","2007"
"27150",1542,2202,660,"CTTGGATAGTTCGGATCAAT","TACGATTTGGAACTTTGTT","561307.5.peg.587","2007"
"27151",1344,2202,858,"AATTGCACAGCGACATGATT","TACGATTTGGAACTTTGTT","561307.5.peg.587","2007"
"27152",331,2202,1871,"AGCTTCTAAATCATAGTTTG","TACGATTTGGAACTTTGTT","561307.5.peg.587","2007"
"27153",2659,2202,457,"TGGTATCATGTACTCCGGTA","TACGATTTGGAACTTTGTT","561307.5.peg.587","2007"
"27154",3621,2202,1419,"TTTGGTCTAACATAGTCTGT","TACGATTTGGAACTTTGTT","561307.5.peg.587","2007"
"27155",2800,2202,598,"AATTTGGCATAGCAAGTGTT","TACGATTTGGAACTTTGTT","561307.5.peg.587","2007"
"27156",1787,2202,415,"GGACCAAGCGAACAATACCT","TACGATTTGGAACTTTGTT","561307.5.peg.587","2007"
"27157",3363,2202,1161,"ATCTCACTCTAATTTGACT","TACGATTTGGAACTTTGTT","561307.5.peg.587","2007"
"27158",2787,2202,585,"AAGTGTTCGGTATCTGTACT","TACGATTTGGAACTTTGTT","561307.5.peg.587","2007"
"27159",669,2202,1533,"GTTCAAATGGATGCTTAAT","TACGATTTGGAACTTTGTT","561307.5.peg.587","2007"
"27160",2748,2202,546,"GTATCGACATAGTCCATGAT","TACGATTTGGAACTTTGTT","561307.5.peg.587","2007"
"27161",1284,2202,918,"GTTTGCGCATCATCTATCTC","TACGATTTGGAACTTTGTT","561307.5.peg.587","2007"
"27162",1763,2202,439,"GCGGAATTAGTGTCCCTTTA","TACGATTTGGAACTTTGTT","561307.5.peg.587","2007"
"27163",1956,2202,246,"TTAATTGTTCTACCGCTAT","TACGATTTGGAACTTTGTT","561307.5.peg.587","2007"
"27164",1560,2202,642,"ATGTACTCCTGACGATCACT","TACGATTTGGAACTTTGTT","561307.5.peg.587","2007"
"27165",3410,2202,1208,"ATGATGCGTATCTATAAAG","TACGATTTGGAACTTTGTT","561307.5.peg.587","2007"
"27166",858,2202,1344,"GCATCGATTGTTAACGTTAA","TACGATTTGGAACTTTGTT","561307.5.peg.587","2007"
"27167",321,2202,1881,"TCATAGTTTGCGGAAGAAGA","TACGATTTGGAACTTTGTT","561307.5.peg.587","2007"
"27168",1551,2202,651,"TGACGATCACTTGGATAGTT","TACGATTTGGAACTTTGTT","561307.5.peg.587","2007"
"27169",3396,2202,1194,"ATAAAGAGGTATGCATGTAA","TACGATTTGGAACTTTGTT","561307.5.peg.587","2007"
"27170",1315,2202,887,"TCAACTTGTTGCTCAAATA","TACGATTTGGAACTTTGTT","561307.5.peg.587","2007"
"27171",143,2202,2059,"GTTTAACCCAATACGCATTA","TACGATTTGGAACTTTGTT","561307.5.peg.587","2007"
"27172",1782,2214,432,"AAGCGAACAATACCTCGGTG","TACCAATAGGAATACGATT","561307.5.peg.587","2007"
"27173",143,2214,2071,"GTTTAACCCAATACGCATTA","TACCAATAGGAATACGATT","561307.5.peg.587","2007"
"27174",2659,2214,445,"TGGTATCATGTACTCCGGTA","TACCAATAGGAATACGATT","561307.5.peg.587","2007"
"27175",1560,2214,654,"ATGTACTCCTGACGATCACT","TACCAATAGGAATACGATT","561307.5.peg.587","2007"
"27176",3107,2214,893,"CGTTATACACCGTATCTTTA","TACCAATAGGAATACGATT","561307.5.peg.587","2007"
"27177",2352,2214,138,"ATTTATCTGCTGTCAATTC","TACCAATAGGAATACGATT","561307.5.peg.587","2007"
"27178",1551,2214,663,"TGACGATCACTTGGATAGTT","TACCAATAGGAATACGATT","561307.5.peg.587","2007"
"27179",2776,2214,562,"ATCTGTACTCGGTGCTACAT","TACCAATAGGAATACGATT","561307.5.peg.587","2007"
"27180",3396,2214,1182,"ATAAAGAGGTATGCATGTAA","TACCAATAGGAATACGATT","561307.5.peg.587","2007"
"27181",2800,2214,586,"AATTTGGCATAGCAAGTGTT","TACCAATAGGAATACGATT","561307.5.peg.587","2007"
"27182",1315,2214,899,"TCAACTTGTTGCTCAAATA","TACCAATAGGAATACGATT","561307.5.peg.587","2007"
"27183",321,2214,1893,"TCATAGTTTGCGGAAGAAGA","TACCAATAGGAATACGATT","561307.5.peg.587","2007"
"27184",669,2214,1545,"GTTCAAATGGATGCTTAAT","TACCAATAGGAATACGATT","561307.5.peg.587","2007"
"27185",2436,2214,222,"AAATAATCTATGTTGCCATC","TACCAATAGGAATACGATT","561307.5.peg.587","2007"
"27186",1344,2214,870,"AATTGCACAGCGACATGATT","TACCAATAGGAATACGATT","561307.5.peg.587","2007"
"27187",3410,2214,1196,"ATGATGCGTATCTATAAAG","TACCAATAGGAATACGATT","561307.5.peg.587","2007"
"27188",3621,2214,1407,"TTTGGTCTAACATAGTCTGT","TACCAATAGGAATACGATT","561307.5.peg.587","2007"
"27189",2787,2214,573,"AAGTGTTCGGTATCTGTACT","TACCAATAGGAATACGATT","561307.5.peg.587","2007"
"27190",1956,2214,258,"TTAATTGTTCTACCGCTAT","TACCAATAGGAATACGATT","561307.5.peg.587","2007"
"27191",1599,2214,615,"GGTACGTTATTACAACTTT","TACCAATAGGAATACGATT","561307.5.peg.587","2007"
"27192",2664,2214,450,"TTAACTGGTATCATGTACTC","TACCAATAGGAATACGATT","561307.5.peg.587","2007"
"27193",3363,2214,1149,"ATCTCACTCTAATTTGACT","TACCAATAGGAATACGATT","561307.5.peg.587","2007"
"27194",1452,2214,762,"ATGACAGCGACACGATCATT","TACCAATAGGAATACGATT","561307.5.peg.587","2007"
"27195",858,2214,1356,"GCATCGATTGTTAACGTTAA","TACCAATAGGAATACGATT","561307.5.peg.587","2007"
"27196",1284,2214,930,"GTTTGCGCATCATCTATCTC","TACCAATAGGAATACGATT","561307.5.peg.587","2007"
"27197",2748,2214,534,"GTATCGACATAGTCCATGAT","TACCAATAGGAATACGATT","561307.5.peg.587","2007"
"27198",1763,2214,451,"GCGGAATTAGTGTCCCTTTA","TACCAATAGGAATACGATT","561307.5.peg.587","2007"
"27199",1542,2214,672,"CTTGGATAGTTCGGATCAAT","TACCAATAGGAATACGATT","561307.5.peg.587","2007"
"27200",331,2214,1883,"AGCTTCTAAATCATAGTTTG","TACCAATAGGAATACGATT","561307.5.peg.587","2007"
"27201",1787,2214,427,"GGACCAAGCGAACAATACCT","TACCAATAGGAATACGATT","561307.5.peg.587","2007"
"27202",3621,2226,1395,"TTTGGTCTAACATAGTCTGT","CCCAGAATCGGTTTACCAAT","561307.5.peg.587","2007"
"27203",2352,2226,126,"ATTTATCTGCTGTCAATTC","CCCAGAATCGGTTTACCAAT","561307.5.peg.587","2007"
"27204",1560,2226,666,"ATGTACTCCTGACGATCACT","CCCAGAATCGGTTTACCAAT","561307.5.peg.587","2007"
"27205",669,2226,1557,"GTTCAAATGGATGCTTAAT","CCCAGAATCGGTTTACCAAT","561307.5.peg.587","2007"
"27206",3410,2226,1184,"ATGATGCGTATCTATAAAG","CCCAGAATCGGTTTACCAAT","561307.5.peg.587","2007"
"27207",3363,2226,1137,"ATCTCACTCTAATTTGACT","CCCAGAATCGGTTTACCAAT","561307.5.peg.587","2007"
"27208",1782,2226,444,"AAGCGAACAATACCTCGGTG","CCCAGAATCGGTTTACCAAT","561307.5.peg.587","2007"
"27209",2664,2226,438,"TTAACTGGTATCATGTACTC","CCCAGAATCGGTTTACCAAT","561307.5.peg.587","2007"
"27210",2776,2226,550,"ATCTGTACTCGGTGCTACAT","CCCAGAATCGGTTTACCAAT","561307.5.peg.587","2007"
"27211",3396,2226,1170,"ATAAAGAGGTATGCATGTAA","CCCAGAATCGGTTTACCAAT","561307.5.peg.587","2007"
"27212",2659,2226,433,"TGGTATCATGTACTCCGGTA","CCCAGAATCGGTTTACCAAT","561307.5.peg.587","2007"
"27213",1344,2226,882,"AATTGCACAGCGACATGATT","CCCAGAATCGGTTTACCAAT","561307.5.peg.587","2007"
"27214",143,2226,2083,"GTTTAACCCAATACGCATTA","CCCAGAATCGGTTTACCAAT","561307.5.peg.587","2007"
"27215",321,2226,1905,"TCATAGTTTGCGGAAGAAGA","CCCAGAATCGGTTTACCAAT","561307.5.peg.587","2007"
"27216",331,2226,1895,"AGCTTCTAAATCATAGTTTG","CCCAGAATCGGTTTACCAAT","561307.5.peg.587","2007"
"27217",858,2226,1368,"GCATCGATTGTTAACGTTAA","CCCAGAATCGGTTTACCAAT","561307.5.peg.587","2007"
"27218",1542,2226,684,"CTTGGATAGTTCGGATCAAT","CCCAGAATCGGTTTACCAAT","561307.5.peg.587","2007"
"27219",2748,2226,522,"GTATCGACATAGTCCATGAT","CCCAGAATCGGTTTACCAAT","561307.5.peg.587","2007"
"27220",2800,2226,574,"AATTTGGCATAGCAAGTGTT","CCCAGAATCGGTTTACCAAT","561307.5.peg.587","2007"
"27221",1599,2226,627,"GGTACGTTATTACAACTTT","CCCAGAATCGGTTTACCAAT","561307.5.peg.587","2007"
"27222",3107,2226,881,"CGTTATACACCGTATCTTTA","CCCAGAATCGGTTTACCAAT","561307.5.peg.587","2007"
"27223",1284,2226,942,"GTTTGCGCATCATCTATCTC","CCCAGAATCGGTTTACCAAT","561307.5.peg.587","2007"
"27224",1956,2226,270,"TTAATTGTTCTACCGCTAT","CCCAGAATCGGTTTACCAAT","561307.5.peg.587","2007"
"27225",1551,2226,675,"TGACGATCACTTGGATAGTT","CCCAGAATCGGTTTACCAAT","561307.5.peg.587","2007"
"27226",1763,2226,463,"GCGGAATTAGTGTCCCTTTA","CCCAGAATCGGTTTACCAAT","561307.5.peg.587","2007"
"27227",1787,2226,439,"GGACCAAGCGAACAATACCT","CCCAGAATCGGTTTACCAAT","561307.5.peg.587","2007"
"27228",1452,2226,774,"ATGACAGCGACACGATCATT","CCCAGAATCGGTTTACCAAT","561307.5.peg.587","2007"
"27229",2787,2226,561,"AAGTGTTCGGTATCTGTACT","CCCAGAATCGGTTTACCAAT","561307.5.peg.587","2007"
"27230",2436,2226,210,"AAATAATCTATGTTGCCATC","CCCAGAATCGGTTTACCAAT","561307.5.peg.587","2007"
"27231",1315,2226,911,"TCAACTTGTTGCTCAAATA","CCCAGAATCGGTTTACCAAT","561307.5.peg.587","2007"
"27232",143,2238,2095,"GTTTAACCCAATACGCATTA","TAAACATGAGTACCCAGAAT","561307.5.peg.587","2007"
"27233",1599,2238,639,"GGTACGTTATTACAACTTT","TAAACATGAGTACCCAGAAT","561307.5.peg.587","2007"
"27234",2800,2238,562,"AATTTGGCATAGCAAGTGTT","TAAACATGAGTACCCAGAAT","561307.5.peg.587","2007"
"27235",1763,2238,475,"GCGGAATTAGTGTCCCTTTA","TAAACATGAGTACCCAGAAT","561307.5.peg.587","2007"
"27236",2436,2238,198,"AAATAATCTATGTTGCCATC","TAAACATGAGTACCCAGAAT","561307.5.peg.587","2007"
"27237",331,2238,1907,"AGCTTCTAAATCATAGTTTG","TAAACATGAGTACCCAGAAT","561307.5.peg.587","2007"
"27238",321,2238,1917,"TCATAGTTTGCGGAAGAAGA","TAAACATGAGTACCCAGAAT","561307.5.peg.587","2007"
"27239",1560,2238,678,"ATGTACTCCTGACGATCACT","TAAACATGAGTACCCAGAAT","561307.5.peg.587","2007"
"27240",3621,2238,1383,"TTTGGTCTAACATAGTCTGT","TAAACATGAGTACCCAGAAT","561307.5.peg.587","2007"
"27241",1787,2238,451,"GGACCAAGCGAACAATACCT","TAAACATGAGTACCCAGAAT","561307.5.peg.587","2007"
"27242",2659,2238,421,"TGGTATCATGTACTCCGGTA","TAAACATGAGTACCCAGAAT","561307.5.peg.587","2007"
"27243",2776,2238,538,"ATCTGTACTCGGTGCTACAT","TAAACATGAGTACCCAGAAT","561307.5.peg.587","2007"
"27244",858,2238,1380,"GCATCGATTGTTAACGTTAA","TAAACATGAGTACCCAGAAT","561307.5.peg.587","2007"
"27245",3363,2238,1125,"ATCTCACTCTAATTTGACT","TAAACATGAGTACCCAGAAT","561307.5.peg.587","2007"
"27246",1542,2238,696,"CTTGGATAGTTCGGATCAAT","TAAACATGAGTACCCAGAAT","561307.5.peg.587","2007"
"27247",1344,2238,894,"AATTGCACAGCGACATGATT","TAAACATGAGTACCCAGAAT","561307.5.peg.587","2007"
"27248",1551,2238,687,"TGACGATCACTTGGATAGTT","TAAACATGAGTACCCAGAAT","561307.5.peg.587","2007"
"27249",1284,2238,954,"GTTTGCGCATCATCTATCTC","TAAACATGAGTACCCAGAAT","561307.5.peg.587","2007"
"27250",2664,2238,426,"TTAACTGGTATCATGTACTC","TAAACATGAGTACCCAGAAT","561307.5.peg.587","2007"
"27251",3396,2238,1158,"ATAAAGAGGTATGCATGTAA","TAAACATGAGTACCCAGAAT","561307.5.peg.587","2007"
"27252",1782,2238,456,"AAGCGAACAATACCTCGGTG","TAAACATGAGTACCCAGAAT","561307.5.peg.587","2007"
"27253",3107,2238,869,"CGTTATACACCGTATCTTTA","TAAACATGAGTACCCAGAAT","561307.5.peg.587","2007"
"27254",2130,2238,108,"TAATAATTTGAGGATGCTT","TAAACATGAGTACCCAGAAT","561307.5.peg.587","2007"
"27255",1452,2238,786,"ATGACAGCGACACGATCATT","TAAACATGAGTACCCAGAAT","561307.5.peg.587","2007"
"27256",1315,2238,923,"TCAACTTGTTGCTCAAATA","TAAACATGAGTACCCAGAAT","561307.5.peg.587","2007"
"27257",3410,2238,1172,"ATGATGCGTATCTATAAAG","TAAACATGAGTACCCAGAAT","561307.5.peg.587","2007"
"27258",1956,2238,282,"TTAATTGTTCTACCGCTAT","TAAACATGAGTACCCAGAAT","561307.5.peg.587","2007"
"27259",2787,2238,549,"AAGTGTTCGGTATCTGTACT","TAAACATGAGTACCCAGAAT","561307.5.peg.587","2007"
"27260",2748,2238,510,"GTATCGACATAGTCCATGAT","TAAACATGAGTACCCAGAAT","561307.5.peg.587","2007"
"27261",669,2238,1569,"GTTCAAATGGATGCTTAAT","TAAACATGAGTACCCAGAAT","561307.5.peg.587","2007"
"27262",2352,2238,114,"ATTTATCTGCTGTCAATTC","TAAACATGAGTACCCAGAAT","561307.5.peg.587","2007"
"27263",858,2298,1440,"GCATCGATTGTTAACGTTAA","CCACTTGTACATAATTCTCC","561307.5.peg.587","2007"
"27264",3410,2298,1112,"ATGATGCGTATCTATAAAG","CCACTTGTACATAATTCTCC","561307.5.peg.587","2007"
"27265",2800,2298,502,"AATTTGGCATAGCAAGTGTT","CCACTTGTACATAATTCTCC","561307.5.peg.587","2007"
"27266",2659,2298,361,"TGGTATCATGTACTCCGGTA","CCACTTGTACATAATTCTCC","561307.5.peg.587","2007"
"27267",1315,2298,983,"TCAACTTGTTGCTCAAATA","CCACTTGTACATAATTCTCC","561307.5.peg.587","2007"
"27268",669,2298,1629,"GTTCAAATGGATGCTTAAT","CCACTTGTACATAATTCTCC","561307.5.peg.587","2007"
"27269",1551,2298,747,"TGACGATCACTTGGATAGTT","CCACTTGTACATAATTCTCC","561307.5.peg.587","2007"
"27270",1542,2298,756,"CTTGGATAGTTCGGATCAAT","CCACTTGTACATAATTCTCC","561307.5.peg.587","2007"
"27271",3396,2298,1098,"ATAAAGAGGTATGCATGTAA","CCACTTGTACATAATTCTCC","561307.5.peg.587","2007"
"27272",143,2298,2155,"GTTTAACCCAATACGCATTA","CCACTTGTACATAATTCTCC","561307.5.peg.587","2007"
"27273",3107,2298,809,"CGTTATACACCGTATCTTTA","CCACTTGTACATAATTCTCC","561307.5.peg.587","2007"
"27274",1560,2298,738,"ATGTACTCCTGACGATCACT","CCACTTGTACATAATTCTCC","561307.5.peg.587","2007"
"27275",1599,2298,699,"GGTACGTTATTACAACTTT","CCACTTGTACATAATTCTCC","561307.5.peg.587","2007"
"27276",2748,2298,450,"GTATCGACATAGTCCATGAT","CCACTTGTACATAATTCTCC","561307.5.peg.587","2007"
"27277",331,2298,1967,"AGCTTCTAAATCATAGTTTG","CCACTTGTACATAATTCTCC","561307.5.peg.587","2007"
"27278",1344,2298,954,"AATTGCACAGCGACATGATT","CCACTTGTACATAATTCTCC","561307.5.peg.587","2007"
"27279",2436,2298,138,"AAATAATCTATGTTGCCATC","CCACTTGTACATAATTCTCC","561307.5.peg.587","2007"
"27280",2787,2298,489,"AAGTGTTCGGTATCTGTACT","CCACTTGTACATAATTCTCC","561307.5.peg.587","2007"
"27281",1956,2298,342,"TTAATTGTTCTACCGCTAT","CCACTTGTACATAATTCTCC","561307.5.peg.587","2007"
"27282",2130,2298,168,"TAATAATTTGAGGATGCTT","CCACTTGTACATAATTCTCC","561307.5.peg.587","2007"
"27283",2776,2298,478,"ATCTGTACTCGGTGCTACAT","CCACTTGTACATAATTCTCC","561307.5.peg.587","2007"
"27284",3621,2298,1323,"TTTGGTCTAACATAGTCTGT","CCACTTGTACATAATTCTCC","561307.5.peg.587","2007"
"27285",1452,2298,846,"ATGACAGCGACACGATCATT","CCACTTGTACATAATTCTCC","561307.5.peg.587","2007"
"27286",321,2298,1977,"TCATAGTTTGCGGAAGAAGA","CCACTTGTACATAATTCTCC","561307.5.peg.587","2007"
"27287",3363,2298,1065,"ATCTCACTCTAATTTGACT","CCACTTGTACATAATTCTCC","561307.5.peg.587","2007"
"27288",1763,2298,535,"GCGGAATTAGTGTCCCTTTA","CCACTTGTACATAATTCTCC","561307.5.peg.587","2007"
"27289",1782,2298,516,"AAGCGAACAATACCTCGGTG","CCACTTGTACATAATTCTCC","561307.5.peg.587","2007"
"27290",1284,2298,1014,"GTTTGCGCATCATCTATCTC","CCACTTGTACATAATTCTCC","561307.5.peg.587","2007"
"27291",2664,2298,366,"TTAACTGGTATCATGTACTC","CCACTTGTACATAATTCTCC","561307.5.peg.587","2007"
"27292",1787,2298,511,"GGACCAAGCGAACAATACCT","CCACTTGTACATAATTCTCC","561307.5.peg.587","2007"
"27293",1560,2352,792,"ATGTACTCCTGACGATCACT","ATTTATCTGCTGTCAATTC","561307.5.peg.587","2007"
"27294",1787,2352,565,"GGACCAAGCGAACAATACCT","ATTTATCTGCTGTCAATTC","561307.5.peg.587","2007"
"27295",2659,2352,307,"TGGTATCATGTACTCCGGTA","ATTTATCTGCTGTCAATTC","561307.5.peg.587","2007"
"27296",2202,2352,150,"TACGATTTGGAACTTTGTT","ATTTATCTGCTGTCAATTC","561307.5.peg.587","2007"
"27297",2800,2352,448,"AATTTGGCATAGCAAGTGTT","ATTTATCTGCTGTCAATTC","561307.5.peg.587","2007"
"27298",2130,2352,222,"TAATAATTTGAGGATGCTT","ATTTATCTGCTGTCAATTC","561307.5.peg.587","2007"
"27299",2226,2352,126,"CCCAGAATCGGTTTACCAAT","ATTTATCTGCTGTCAATTC","561307.5.peg.587","2007"
"27300",321,2352,2031,"TCATAGTTTGCGGAAGAAGA","ATTTATCTGCTGTCAATTC","561307.5.peg.587","2007"
"27301",858,2352,1494,"GCATCGATTGTTAACGTTAA","ATTTATCTGCTGTCAATTC","561307.5.peg.587","2007"
"27302",2238,2352,114,"TAAACATGAGTACCCAGAAT","ATTTATCTGCTGTCAATTC","561307.5.peg.587","2007"
"27303",1452,2352,900,"ATGACAGCGACACGATCATT","ATTTATCTGCTGTCAATTC","561307.5.peg.587","2007"
"27304",1763,2352,589,"GCGGAATTAGTGTCCCTTTA","ATTTATCTGCTGTCAATTC","561307.5.peg.587","2007"
"27305",3107,2352,755,"CGTTATACACCGTATCTTTA","ATTTATCTGCTGTCAATTC","561307.5.peg.587","2007"
"27306",1344,2352,1008,"AATTGCACAGCGACATGATT","ATTTATCTGCTGTCAATTC","561307.5.peg.587","2007"
"27307",3621,2352,1269,"TTTGGTCTAACATAGTCTGT","ATTTATCTGCTGTCAATTC","561307.5.peg.587","2007"
"27308",3410,2352,1058,"ATGATGCGTATCTATAAAG","ATTTATCTGCTGTCAATTC","561307.5.peg.587","2007"
"27309",2664,2352,312,"TTAACTGGTATCATGTACTC","ATTTATCTGCTGTCAATTC","561307.5.peg.587","2007"
"27310",2214,2352,138,"TACCAATAGGAATACGATT","ATTTATCTGCTGTCAATTC","561307.5.peg.587","2007"
"27311",143,2352,2209,"GTTTAACCCAATACGCATTA","ATTTATCTGCTGTCAATTC","561307.5.peg.587","2007"
"27312",1599,2352,753,"GGTACGTTATTACAACTTT","ATTTATCTGCTGTCAATTC","561307.5.peg.587","2007"
"27313",1284,2352,1068,"GTTTGCGCATCATCTATCTC","ATTTATCTGCTGTCAATTC","561307.5.peg.587","2007"
"27314",1551,2352,801,"TGACGATCACTTGGATAGTT","ATTTATCTGCTGTCAATTC","561307.5.peg.587","2007"
"27315",3363,2352,1011,"ATCTCACTCTAATTTGACT","ATTTATCTGCTGTCAATTC","561307.5.peg.587","2007"
"27316",3396,2352,1044,"ATAAAGAGGTATGCATGTAA","ATTTATCTGCTGTCAATTC","561307.5.peg.587","2007"
"27317",669,2352,1683,"GTTCAAATGGATGCTTAAT","ATTTATCTGCTGTCAATTC","561307.5.peg.587","2007"
"27318",2748,2352,396,"GTATCGACATAGTCCATGAT","ATTTATCTGCTGTCAATTC","561307.5.peg.587","2007"
"27319",331,2352,2021,"AGCTTCTAAATCATAGTTTG","ATTTATCTGCTGTCAATTC","561307.5.peg.587","2007"
"27320",2776,2352,424,"ATCTGTACTCGGTGCTACAT","ATTTATCTGCTGTCAATTC","561307.5.peg.587","2007"
"27321",1956,2352,396,"TTAATTGTTCTACCGCTAT","ATTTATCTGCTGTCAATTC","561307.5.peg.587","2007"
"27322",1542,2352,810,"CTTGGATAGTTCGGATCAAT","ATTTATCTGCTGTCAATTC","561307.5.peg.587","2007"
"27323",2787,2352,435,"AAGTGTTCGGTATCTGTACT","ATTTATCTGCTGTCAATTC","561307.5.peg.587","2007"
"27324",1315,2352,1037,"TCAACTTGTTGCTCAAATA","ATTTATCTGCTGTCAATTC","561307.5.peg.587","2007"
"27325",1782,2352,570,"AAGCGAACAATACCTCGGTG","ATTTATCTGCTGTCAATTC","561307.5.peg.587","2007"
"27326",2664,2436,228,"TTAACTGGTATCATGTACTC","AAATAATCTATGTTGCCATC","561307.5.peg.587","2007"
"27327",2214,2436,222,"TACCAATAGGAATACGATT","AAATAATCTATGTTGCCATC","561307.5.peg.587","2007"
"27328",1599,2436,837,"GGTACGTTATTACAACTTT","AAATAATCTATGTTGCCATC","561307.5.peg.587","2007"
"27329",1551,2436,885,"TGACGATCACTTGGATAGTT","AAATAATCTATGTTGCCATC","561307.5.peg.587","2007"
"27330",2298,2436,138,"CCACTTGTACATAATTCTCC","AAATAATCTATGTTGCCATC","561307.5.peg.587","2007"
"27331",331,2436,2105,"AGCTTCTAAATCATAGTTTG","AAATAATCTATGTTGCCATC","561307.5.peg.587","2007"
"27332",1763,2436,673,"GCGGAATTAGTGTCCCTTTA","AAATAATCTATGTTGCCATC","561307.5.peg.587","2007"
"27333",3363,2436,927,"ATCTCACTCTAATTTGACT","AAATAATCTATGTTGCCATC","561307.5.peg.587","2007"
"27334",1782,2436,654,"AAGCGAACAATACCTCGGTG","AAATAATCTATGTTGCCATC","561307.5.peg.587","2007"
"27335",1344,2436,1092,"AATTGCACAGCGACATGATT","AAATAATCTATGTTGCCATC","561307.5.peg.587","2007"
"27336",1560,2436,876,"ATGTACTCCTGACGATCACT","AAATAATCTATGTTGCCATC","561307.5.peg.587","2007"
"27337",2787,2436,351,"AAGTGTTCGGTATCTGTACT","AAATAATCTATGTTGCCATC","561307.5.peg.587","2007"
"27338",1284,2436,1152,"GTTTGCGCATCATCTATCTC","AAATAATCTATGTTGCCATC","561307.5.peg.587","2007"
"27339",1787,2436,649,"GGACCAAGCGAACAATACCT","AAATAATCTATGTTGCCATC","561307.5.peg.587","2007"
"27340",2202,2436,234,"TACGATTTGGAACTTTGTT","AAATAATCTATGTTGCCATC","561307.5.peg.587","2007"
"27341",1452,2436,984,"ATGACAGCGACACGATCATT","AAATAATCTATGTTGCCATC","561307.5.peg.587","2007"
"27342",2748,2436,312,"GTATCGACATAGTCCATGAT","AAATAATCTATGTTGCCATC","561307.5.peg.587","2007"
"27343",2776,2436,340,"ATCTGTACTCGGTGCTACAT","AAATAATCTATGTTGCCATC","561307.5.peg.587","2007"
"27344",143,2436,2293,"GTTTAACCCAATACGCATTA","AAATAATCTATGTTGCCATC","561307.5.peg.587","2007"
"27345",3410,2436,974,"ATGATGCGTATCTATAAAG","AAATAATCTATGTTGCCATC","561307.5.peg.587","2007"
"27346",3396,2436,960,"ATAAAGAGGTATGCATGTAA","AAATAATCTATGTTGCCATC","561307.5.peg.587","2007"
"27347",2659,2436,223,"TGGTATCATGTACTCCGGTA","AAATAATCTATGTTGCCATC","561307.5.peg.587","2007"
"27348",2800,2436,364,"AATTTGGCATAGCAAGTGTT","AAATAATCTATGTTGCCATC","561307.5.peg.587","2007"
"27349",3621,2436,1185,"TTTGGTCTAACATAGTCTGT","AAATAATCTATGTTGCCATC","561307.5.peg.587","2007"
"27350",669,2436,1767,"GTTCAAATGGATGCTTAAT","AAATAATCTATGTTGCCATC","561307.5.peg.587","2007"
"27351",1542,2436,894,"CTTGGATAGTTCGGATCAAT","AAATAATCTATGTTGCCATC","561307.5.peg.587","2007"
"27352",858,2436,1578,"GCATCGATTGTTAACGTTAA","AAATAATCTATGTTGCCATC","561307.5.peg.587","2007"
"27353",2130,2436,306,"TAATAATTTGAGGATGCTT","AAATAATCTATGTTGCCATC","561307.5.peg.587","2007"
"27354",1315,2436,1121,"TCAACTTGTTGCTCAAATA","AAATAATCTATGTTGCCATC","561307.5.peg.587","2007"
"27355",1956,2436,480,"TTAATTGTTCTACCGCTAT","AAATAATCTATGTTGCCATC","561307.5.peg.587","2007"
"27356",2226,2436,210,"CCCAGAATCGGTTTACCAAT","AAATAATCTATGTTGCCATC","561307.5.peg.587","2007"
"27357",2238,2436,198,"TAAACATGAGTACCCAGAAT","AAATAATCTATGTTGCCATC","561307.5.peg.587","2007"
"27358",3107,2436,671,"CGTTATACACCGTATCTTTA","AAATAATCTATGTTGCCATC","561307.5.peg.587","2007"
"27359",321,2436,2115,"TCATAGTTTGCGGAAGAAGA","AAATAATCTATGTTGCCATC","561307.5.peg.587","2007"
"27360",2787,2659,128,"AAGTGTTCGGTATCTGTACT","TGGTATCATGTACTCCGGTA","561307.5.peg.587","2007"
"27361",3107,2659,448,"CGTTATACACCGTATCTTTA","TGGTATCATGTACTCCGGTA","561307.5.peg.587","2007"
"27362",2214,2659,445,"TACCAATAGGAATACGATT","TGGTATCATGTACTCCGGTA","561307.5.peg.587","2007"
"27363",2800,2659,141,"AATTTGGCATAGCAAGTGTT","TGGTATCATGTACTCCGGTA","561307.5.peg.587","2007"
"27364",2202,2659,457,"TACGATTTGGAACTTTGTT","TGGTATCATGTACTCCGGTA","561307.5.peg.587","2007"
"27365",3363,2659,704,"ATCTCACTCTAATTTGACT","TGGTATCATGTACTCCGGTA","561307.5.peg.587","2007"
"27366",1763,2659,896,"GCGGAATTAGTGTCCCTTTA","TGGTATCATGTACTCCGGTA","561307.5.peg.587","2007"
"27367",2352,2659,307,"ATTTATCTGCTGTCAATTC","TGGTATCATGTACTCCGGTA","561307.5.peg.587","2007"
"27368",1284,2659,1375,"GTTTGCGCATCATCTATCTC","TGGTATCATGTACTCCGGTA","561307.5.peg.587","2007"
"27369",321,2659,2338,"TCATAGTTTGCGGAAGAAGA","TGGTATCATGTACTCCGGTA","561307.5.peg.587","2007"
"27370",1599,2659,1060,"GGTACGTTATTACAACTTT","TGGTATCATGTACTCCGGTA","561307.5.peg.587","2007"
"27371",858,2659,1801,"GCATCGATTGTTAACGTTAA","TGGTATCATGTACTCCGGTA","561307.5.peg.587","2007"
"27372",1551,2659,1108,"TGACGATCACTTGGATAGTT","TGGTATCATGTACTCCGGTA","561307.5.peg.587","2007"
"27373",3396,2659,737,"ATAAAGAGGTATGCATGTAA","TGGTATCATGTACTCCGGTA","561307.5.peg.587","2007"
"27374",2298,2659,361,"CCACTTGTACATAATTCTCC","TGGTATCATGTACTCCGGTA","561307.5.peg.587","2007"
"27375",2238,2659,421,"TAAACATGAGTACCCAGAAT","TGGTATCATGTACTCCGGTA","561307.5.peg.587","2007"
"27376",1344,2659,1315,"AATTGCACAGCGACATGATT","TGGTATCATGTACTCCGGTA","561307.5.peg.587","2007"
"27377",143,2659,2516,"GTTTAACCCAATACGCATTA","TGGTATCATGTACTCCGGTA","561307.5.peg.587","2007"
"27378",1452,2659,1207,"ATGACAGCGACACGATCATT","TGGTATCATGTACTCCGGTA","561307.5.peg.587","2007"
"27379",3410,2659,751,"ATGATGCGTATCTATAAAG","TGGTATCATGTACTCCGGTA","561307.5.peg.587","2007"
"27380",1315,2659,1344,"TCAACTTGTTGCTCAAATA","TGGTATCATGTACTCCGGTA","561307.5.peg.587","2007"
"27381",669,2659,1990,"GTTCAAATGGATGCTTAAT","TGGTATCATGTACTCCGGTA","561307.5.peg.587","2007"
"27382",3621,2659,962,"TTTGGTCTAACATAGTCTGT","TGGTATCATGTACTCCGGTA","561307.5.peg.587","2007"
"27383",1782,2659,877,"AAGCGAACAATACCTCGGTG","TGGTATCATGTACTCCGGTA","561307.5.peg.587","2007"
"27384",331,2659,2328,"AGCTTCTAAATCATAGTTTG","TGGTATCATGTACTCCGGTA","561307.5.peg.587","2007"
"27385",2130,2659,529,"TAATAATTTGAGGATGCTT","TGGTATCATGTACTCCGGTA","561307.5.peg.587","2007"
"27386",2436,2659,223,"AAATAATCTATGTTGCCATC","TGGTATCATGTACTCCGGTA","561307.5.peg.587","2007"
"27387",1787,2659,872,"GGACCAAGCGAACAATACCT","TGGTATCATGTACTCCGGTA","561307.5.peg.587","2007"
"27388",1560,2659,1099,"ATGTACTCCTGACGATCACT","TGGTATCATGTACTCCGGTA","561307.5.peg.587","2007"
"27389",2776,2659,117,"ATCTGTACTCGGTGCTACAT","TGGTATCATGTACTCCGGTA","561307.5.peg.587","2007"
"27390",2226,2659,433,"CCCAGAATCGGTTTACCAAT","TGGTATCATGTACTCCGGTA","561307.5.peg.587","2007"
"27391",1542,2659,1117,"CTTGGATAGTTCGGATCAAT","TGGTATCATGTACTCCGGTA","561307.5.peg.587","2007"
"27392",1956,2659,703,"TTAATTGTTCTACCGCTAT","TGGTATCATGTACTCCGGTA","561307.5.peg.587","2007"
"27393",2202,2664,462,"TACGATTTGGAACTTTGTT","TTAACTGGTATCATGTACTC","561307.5.peg.587","2007"
"27394",1787,2664,877,"GGACCAAGCGAACAATACCT","TTAACTGGTATCATGTACTC","561307.5.peg.587","2007"
"27395",1956,2664,708,"TTAATTGTTCTACCGCTAT","TTAACTGGTATCATGTACTC","561307.5.peg.587","2007"
"27396",1315,2664,1349,"TCAACTTGTTGCTCAAATA","TTAACTGGTATCATGTACTC","561307.5.peg.587","2007"
"27397",1551,2664,1113,"TGACGATCACTTGGATAGTT","TTAACTGGTATCATGTACTC","561307.5.peg.587","2007"
"27398",331,2664,2333,"AGCTTCTAAATCATAGTTTG","TTAACTGGTATCATGTACTC","561307.5.peg.587","2007"
"27399",2800,2664,136,"AATTTGGCATAGCAAGTGTT","TTAACTGGTATCATGTACTC","561307.5.peg.587","2007"
"27400",3107,2664,443,"CGTTATACACCGTATCTTTA","TTAACTGGTATCATGTACTC","561307.5.peg.587","2007"
"27401",1763,2664,901,"GCGGAATTAGTGTCCCTTTA","TTAACTGGTATCATGTACTC","561307.5.peg.587","2007"
"27402",669,2664,1995,"GTTCAAATGGATGCTTAAT","TTAACTGGTATCATGTACTC","561307.5.peg.587","2007"
"27403",858,2664,1806,"GCATCGATTGTTAACGTTAA","TTAACTGGTATCATGTACTC","561307.5.peg.587","2007"
"27404",2238,2664,426,"TAAACATGAGTACCCAGAAT","TTAACTGGTATCATGTACTC","561307.5.peg.587","2007"
"27405",3363,2664,699,"ATCTCACTCTAATTTGACT","TTAACTGGTATCATGTACTC","561307.5.peg.587","2007"
"27406",1542,2664,1122,"CTTGGATAGTTCGGATCAAT","TTAACTGGTATCATGTACTC","561307.5.peg.587","2007"
"27407",2214,2664,450,"TACCAATAGGAATACGATT","TTAACTGGTATCATGTACTC","561307.5.peg.587","2007"
"27408",3621,2664,957,"TTTGGTCTAACATAGTCTGT","TTAACTGGTATCATGTACTC","561307.5.peg.587","2007"
"27409",3410,2664,746,"ATGATGCGTATCTATAAAG","TTAACTGGTATCATGTACTC","561307.5.peg.587","2007"
"27410",1599,2664,1065,"GGTACGTTATTACAACTTT","TTAACTGGTATCATGTACTC","561307.5.peg.587","2007"
"27411",3396,2664,732,"ATAAAGAGGTATGCATGTAA","TTAACTGGTATCATGTACTC","561307.5.peg.587","2007"
"27412",2226,2664,438,"CCCAGAATCGGTTTACCAAT","TTAACTGGTATCATGTACTC","561307.5.peg.587","2007"
"27413",2298,2664,366,"CCACTTGTACATAATTCTCC","TTAACTGGTATCATGTACTC","561307.5.peg.587","2007"
"27414",2787,2664,123,"AAGTGTTCGGTATCTGTACT","TTAACTGGTATCATGTACTC","561307.5.peg.587","2007"
"27415",2436,2664,228,"AAATAATCTATGTTGCCATC","TTAACTGGTATCATGTACTC","561307.5.peg.587","2007"
"27416",321,2664,2343,"TCATAGTTTGCGGAAGAAGA","TTAACTGGTATCATGTACTC","561307.5.peg.587","2007"
"27417",1284,2664,1380,"GTTTGCGCATCATCTATCTC","TTAACTGGTATCATGTACTC","561307.5.peg.587","2007"
"27418",1452,2664,1212,"ATGACAGCGACACGATCATT","TTAACTGGTATCATGTACTC","561307.5.peg.587","2007"
"27419",143,2664,2521,"GTTTAACCCAATACGCATTA","TTAACTGGTATCATGTACTC","561307.5.peg.587","2007"
"27420",1344,2664,1320,"AATTGCACAGCGACATGATT","TTAACTGGTATCATGTACTC","561307.5.peg.587","2007"
"27421",2352,2664,312,"ATTTATCTGCTGTCAATTC","TTAACTGGTATCATGTACTC","561307.5.peg.587","2007"
"27422",2130,2664,534,"TAATAATTTGAGGATGCTT","TTAACTGGTATCATGTACTC","561307.5.peg.587","2007"
"27423",2776,2664,112,"ATCTGTACTCGGTGCTACAT","TTAACTGGTATCATGTACTC","561307.5.peg.587","2007"
"27424",1782,2664,882,"AAGCGAACAATACCTCGGTG","TTAACTGGTATCATGTACTC","561307.5.peg.587","2007"
"27425",1560,2664,1104,"ATGTACTCCTGACGATCACT","TTAACTGGTATCATGTACTC","561307.5.peg.587","2007"
"27426",2298,2748,450,"CCACTTGTACATAATTCTCC","GTATCGACATAGTCCATGAT","561307.5.peg.587","2007"
"27427",2226,2748,522,"CCCAGAATCGGTTTACCAAT","GTATCGACATAGTCCATGAT","561307.5.peg.587","2007"
"27428",1782,2748,966,"AAGCGAACAATACCTCGGTG","GTATCGACATAGTCCATGAT","561307.5.peg.587","2007"
"27429",1787,2748,961,"GGACCAAGCGAACAATACCT","GTATCGACATAGTCCATGAT","561307.5.peg.587","2007"
"27430",2130,2748,618,"TAATAATTTGAGGATGCTT","GTATCGACATAGTCCATGAT","561307.5.peg.587","2007"
"27431",2214,2748,534,"TACCAATAGGAATACGATT","GTATCGACATAGTCCATGAT","561307.5.peg.587","2007"
"27432",858,2748,1890,"GCATCGATTGTTAACGTTAA","GTATCGACATAGTCCATGAT","561307.5.peg.587","2007"
"27433",2352,2748,396,"ATTTATCTGCTGTCAATTC","GTATCGACATAGTCCATGAT","561307.5.peg.587","2007"
"27434",331,2748,2417,"AGCTTCTAAATCATAGTTTG","GTATCGACATAGTCCATGAT","561307.5.peg.587","2007"
"27435",1315,2748,1433,"TCAACTTGTTGCTCAAATA","GTATCGACATAGTCCATGAT","561307.5.peg.587","2007"
"27436",1560,2748,1188,"ATGTACTCCTGACGATCACT","GTATCGACATAGTCCATGAT","561307.5.peg.587","2007"
"27437",1599,2748,1149,"GGTACGTTATTACAACTTT","GTATCGACATAGTCCATGAT","561307.5.peg.587","2007"
"27438",2238,2748,510,"TAAACATGAGTACCCAGAAT","GTATCGACATAGTCCATGAT","561307.5.peg.587","2007"
"27439",3396,2748,648,"ATAAAGAGGTATGCATGTAA","GTATCGACATAGTCCATGAT","561307.5.peg.587","2007"
"27440",1344,2748,1404,"AATTGCACAGCGACATGATT","GTATCGACATAGTCCATGAT","561307.5.peg.587","2007"
"27441",3363,2748,615,"ATCTCACTCTAATTTGACT","GTATCGACATAGTCCATGAT","561307.5.peg.587","2007"
"27442",2436,2748,312,"AAATAATCTATGTTGCCATC","GTATCGACATAGTCCATGAT","561307.5.peg.587","2007"
"27443",3410,2748,662,"ATGATGCGTATCTATAAAG","GTATCGACATAGTCCATGAT","561307.5.peg.587","2007"
"27444",1542,2748,1206,"CTTGGATAGTTCGGATCAAT","GTATCGACATAGTCCATGAT","561307.5.peg.587","2007"
"27445",1763,2748,985,"GCGGAATTAGTGTCCCTTTA","GTATCGACATAGTCCATGAT","561307.5.peg.587","2007"
"27446",2202,2748,546,"TACGATTTGGAACTTTGTT","GTATCGACATAGTCCATGAT","561307.5.peg.587","2007"
"27447",3621,2748,873,"TTTGGTCTAACATAGTCTGT","GTATCGACATAGTCCATGAT","561307.5.peg.587","2007"
"27448",321,2748,2427,"TCATAGTTTGCGGAAGAAGA","GTATCGACATAGTCCATGAT","561307.5.peg.587","2007"
"27449",1452,2748,1296,"ATGACAGCGACACGATCATT","GTATCGACATAGTCCATGAT","561307.5.peg.587","2007"
"27450",143,2748,2605,"GTTTAACCCAATACGCATTA","GTATCGACATAGTCCATGAT","561307.5.peg.587","2007"
"27451",1956,2748,792,"TTAATTGTTCTACCGCTAT","GTATCGACATAGTCCATGAT","561307.5.peg.587","2007"
"27452",3107,2748,359,"CGTTATACACCGTATCTTTA","GTATCGACATAGTCCATGAT","561307.5.peg.587","2007"
"27453",1551,2748,1197,"TGACGATCACTTGGATAGTT","GTATCGACATAGTCCATGAT","561307.5.peg.587","2007"
"27454",1284,2748,1464,"GTTTGCGCATCATCTATCTC","GTATCGACATAGTCCATGAT","561307.5.peg.587","2007"
"27455",669,2748,2079,"GTTCAAATGGATGCTTAAT","GTATCGACATAGTCCATGAT","561307.5.peg.587","2007"
"27456",2238,2776,538,"TAAACATGAGTACCCAGAAT","ATCTGTACTCGGTGCTACAT","561307.5.peg.587","2007"
"27457",858,2776,1918,"GCATCGATTGTTAACGTTAA","ATCTGTACTCGGTGCTACAT","561307.5.peg.587","2007"
"27458",1560,2776,1216,"ATGTACTCCTGACGATCACT","ATCTGTACTCGGTGCTACAT","561307.5.peg.587","2007"
"27459",331,2776,2445,"AGCTTCTAAATCATAGTTTG","ATCTGTACTCGGTGCTACAT","561307.5.peg.587","2007"
"27460",1315,2776,1461,"TCAACTTGTTGCTCAAATA","ATCTGTACTCGGTGCTACAT","561307.5.peg.587","2007"
"27461",3107,2776,331,"CGTTATACACCGTATCTTTA","ATCTGTACTCGGTGCTACAT","561307.5.peg.587","2007"
"27462",2202,2776,574,"TACGATTTGGAACTTTGTT","ATCTGTACTCGGTGCTACAT","561307.5.peg.587","2007"
"27463",3396,2776,620,"ATAAAGAGGTATGCATGTAA","ATCTGTACTCGGTGCTACAT","561307.5.peg.587","2007"
"27464",1452,2776,1324,"ATGACAGCGACACGATCATT","ATCTGTACTCGGTGCTACAT","561307.5.peg.587","2007"
"27465",3410,2776,634,"ATGATGCGTATCTATAAAG","ATCTGTACTCGGTGCTACAT","561307.5.peg.587","2007"
"27466",2664,2776,112,"TTAACTGGTATCATGTACTC","ATCTGTACTCGGTGCTACAT","561307.5.peg.587","2007"
"27467",2130,2776,646,"TAATAATTTGAGGATGCTT","ATCTGTACTCGGTGCTACAT","561307.5.peg.587","2007"
"27468",3363,2776,587,"ATCTCACTCTAATTTGACT","ATCTGTACTCGGTGCTACAT","561307.5.peg.587","2007"
"27469",2659,2776,117,"TGGTATCATGTACTCCGGTA","ATCTGTACTCGGTGCTACAT","561307.5.peg.587","2007"
"27470",321,2776,2455,"TCATAGTTTGCGGAAGAAGA","ATCTGTACTCGGTGCTACAT","561307.5.peg.587","2007"
"27471",1782,2776,994,"AAGCGAACAATACCTCGGTG","ATCTGTACTCGGTGCTACAT","561307.5.peg.587","2007"
"27472",2226,2776,550,"CCCAGAATCGGTTTACCAAT","ATCTGTACTCGGTGCTACAT","561307.5.peg.587","2007"
"27473",1599,2776,1177,"GGTACGTTATTACAACTTT","ATCTGTACTCGGTGCTACAT","561307.5.peg.587","2007"
"27474",1763,2776,1013,"GCGGAATTAGTGTCCCTTTA","ATCTGTACTCGGTGCTACAT","561307.5.peg.587","2007"
"27475",1551,2776,1225,"TGACGATCACTTGGATAGTT","ATCTGTACTCGGTGCTACAT","561307.5.peg.587","2007"
"27476",1956,2776,820,"TTAATTGTTCTACCGCTAT","ATCTGTACTCGGTGCTACAT","561307.5.peg.587","2007"
"27477",1787,2776,989,"GGACCAAGCGAACAATACCT","ATCTGTACTCGGTGCTACAT","561307.5.peg.587","2007"
"27478",3621,2776,845,"TTTGGTCTAACATAGTCTGT","ATCTGTACTCGGTGCTACAT","561307.5.peg.587","2007"
"27479",2214,2776,562,"TACCAATAGGAATACGATT","ATCTGTACTCGGTGCTACAT","561307.5.peg.587","2007"
"27480",2436,2776,340,"AAATAATCTATGTTGCCATC","ATCTGTACTCGGTGCTACAT","561307.5.peg.587","2007"
"27481",669,2776,2107,"GTTCAAATGGATGCTTAAT","ATCTGTACTCGGTGCTACAT","561307.5.peg.587","2007"
"27482",1344,2776,1432,"AATTGCACAGCGACATGATT","ATCTGTACTCGGTGCTACAT","561307.5.peg.587","2007"
"27483",2298,2776,478,"CCACTTGTACATAATTCTCC","ATCTGTACTCGGTGCTACAT","561307.5.peg.587","2007"
"27484",143,2776,2633,"GTTTAACCCAATACGCATTA","ATCTGTACTCGGTGCTACAT","561307.5.peg.587","2007"
"27485",1542,2776,1234,"CTTGGATAGTTCGGATCAAT","ATCTGTACTCGGTGCTACAT","561307.5.peg.587","2007"
"27486",1284,2776,1492,"GTTTGCGCATCATCTATCTC","ATCTGTACTCGGTGCTACAT","561307.5.peg.587","2007"
"27487",2352,2776,424,"ATTTATCTGCTGTCAATTC","ATCTGTACTCGGTGCTACAT","561307.5.peg.587","2007"
"27488",3396,2787,609,"ATAAAGAGGTATGCATGTAA","AAGTGTTCGGTATCTGTACT","561307.5.peg.587","2007"
"27489",1787,2787,1000,"GGACCAAGCGAACAATACCT","AAGTGTTCGGTATCTGTACT","561307.5.peg.587","2007"
"27490",1560,2787,1227,"ATGTACTCCTGACGATCACT","AAGTGTTCGGTATCTGTACT","561307.5.peg.587","2007"
"27491",1452,2787,1335,"ATGACAGCGACACGATCATT","AAGTGTTCGGTATCTGTACT","561307.5.peg.587","2007"
"27492",3107,2787,320,"CGTTATACACCGTATCTTTA","AAGTGTTCGGTATCTGTACT","561307.5.peg.587","2007"
"27493",2436,2787,351,"AAATAATCTATGTTGCCATC","AAGTGTTCGGTATCTGTACT","561307.5.peg.587","2007"
"27494",2664,2787,123,"TTAACTGGTATCATGTACTC","AAGTGTTCGGTATCTGTACT","561307.5.peg.587","2007"
"27495",2202,2787,585,"TACGATTTGGAACTTTGTT","AAGTGTTCGGTATCTGTACT","561307.5.peg.587","2007"
"27496",2238,2787,549,"TAAACATGAGTACCCAGAAT","AAGTGTTCGGTATCTGTACT","561307.5.peg.587","2007"
"27497",331,2787,2456,"AGCTTCTAAATCATAGTTTG","AAGTGTTCGGTATCTGTACT","561307.5.peg.587","2007"
"27498",1344,2787,1443,"AATTGCACAGCGACATGATT","AAGTGTTCGGTATCTGTACT","561307.5.peg.587","2007"
"27499",1763,2787,1024,"GCGGAATTAGTGTCCCTTTA","AAGTGTTCGGTATCTGTACT","561307.5.peg.587","2007"
"27500",3410,2787,623,"ATGATGCGTATCTATAAAG","AAGTGTTCGGTATCTGTACT","561307.5.peg.587","2007"
"27501",669,2787,2118,"GTTCAAATGGATGCTTAAT","AAGTGTTCGGTATCTGTACT","561307.5.peg.587","2007"
"27502",2352,2787,435,"ATTTATCTGCTGTCAATTC","AAGTGTTCGGTATCTGTACT","561307.5.peg.587","2007"
"27503",321,2787,2466,"TCATAGTTTGCGGAAGAAGA","AAGTGTTCGGTATCTGTACT","561307.5.peg.587","2007"
"27504",1782,2787,1005,"AAGCGAACAATACCTCGGTG","AAGTGTTCGGTATCTGTACT","561307.5.peg.587","2007"
"27505",1315,2787,1472,"TCAACTTGTTGCTCAAATA","AAGTGTTCGGTATCTGTACT","561307.5.peg.587","2007"
"27506",2226,2787,561,"CCCAGAATCGGTTTACCAAT","AAGTGTTCGGTATCTGTACT","561307.5.peg.587","2007"
"27507",1551,2787,1236,"TGACGATCACTTGGATAGTT","AAGTGTTCGGTATCTGTACT","561307.5.peg.587","2007"
"27508",2298,2787,489,"CCACTTGTACATAATTCTCC","AAGTGTTCGGTATCTGTACT","561307.5.peg.587","2007"
"27509",1599,2787,1188,"GGTACGTTATTACAACTTT","AAGTGTTCGGTATCTGTACT","561307.5.peg.587","2007"
"27510",2659,2787,128,"TGGTATCATGTACTCCGGTA","AAGTGTTCGGTATCTGTACT","561307.5.peg.587","2007"
"27511",1542,2787,1245,"CTTGGATAGTTCGGATCAAT","AAGTGTTCGGTATCTGTACT","561307.5.peg.587","2007"
"27512",3621,2787,834,"TTTGGTCTAACATAGTCTGT","AAGTGTTCGGTATCTGTACT","561307.5.peg.587","2007"
"27513",858,2787,1929,"GCATCGATTGTTAACGTTAA","AAGTGTTCGGTATCTGTACT","561307.5.peg.587","2007"
"27514",143,2787,2644,"GTTTAACCCAATACGCATTA","AAGTGTTCGGTATCTGTACT","561307.5.peg.587","2007"
"27515",2130,2787,657,"TAATAATTTGAGGATGCTT","AAGTGTTCGGTATCTGTACT","561307.5.peg.587","2007"
"27516",3363,2787,576,"ATCTCACTCTAATTTGACT","AAGTGTTCGGTATCTGTACT","561307.5.peg.587","2007"
"27517",2214,2787,573,"TACCAATAGGAATACGATT","AAGTGTTCGGTATCTGTACT","561307.5.peg.587","2007"
"27518",1284,2787,1503,"GTTTGCGCATCATCTATCTC","AAGTGTTCGGTATCTGTACT","561307.5.peg.587","2007"
"27519",1956,2787,831,"TTAATTGTTCTACCGCTAT","AAGTGTTCGGTATCTGTACT","561307.5.peg.587","2007"
"27520",1542,2800,1258,"CTTGGATAGTTCGGATCAAT","AATTTGGCATAGCAAGTGTT","561307.5.peg.587","2007"
"27521",1782,2800,1018,"AAGCGAACAATACCTCGGTG","AATTTGGCATAGCAAGTGTT","561307.5.peg.587","2007"
"27522",2238,2800,562,"TAAACATGAGTACCCAGAAT","AATTTGGCATAGCAAGTGTT","561307.5.peg.587","2007"
"27523",3396,2800,596,"ATAAAGAGGTATGCATGTAA","AATTTGGCATAGCAAGTGTT","561307.5.peg.587","2007"
"27524",331,2800,2469,"AGCTTCTAAATCATAGTTTG","AATTTGGCATAGCAAGTGTT","561307.5.peg.587","2007"
"27525",2202,2800,598,"TACGATTTGGAACTTTGTT","AATTTGGCATAGCAAGTGTT","561307.5.peg.587","2007"
"27526",1452,2800,1348,"ATGACAGCGACACGATCATT","AATTTGGCATAGCAAGTGTT","561307.5.peg.587","2007"
"27527",1956,2800,844,"TTAATTGTTCTACCGCTAT","AATTTGGCATAGCAAGTGTT","561307.5.peg.587","2007"
"27528",143,2800,2657,"GTTTAACCCAATACGCATTA","AATTTGGCATAGCAAGTGTT","561307.5.peg.587","2007"
"27529",3410,2800,610,"ATGATGCGTATCTATAAAG","AATTTGGCATAGCAAGTGTT","561307.5.peg.587","2007"
"27530",1787,2800,1013,"GGACCAAGCGAACAATACCT","AATTTGGCATAGCAAGTGTT","561307.5.peg.587","2007"
"27531",1315,2800,1485,"TCAACTTGTTGCTCAAATA","AATTTGGCATAGCAAGTGTT","561307.5.peg.587","2007"
"27532",3621,2800,821,"TTTGGTCTAACATAGTCTGT","AATTTGGCATAGCAAGTGTT","561307.5.peg.587","2007"
"27533",2436,2800,364,"AAATAATCTATGTTGCCATC","AATTTGGCATAGCAAGTGTT","561307.5.peg.587","2007"
"27534",2298,2800,502,"CCACTTGTACATAATTCTCC","AATTTGGCATAGCAAGTGTT","561307.5.peg.587","2007"
"27535",1763,2800,1037,"GCGGAATTAGTGTCCCTTTA","AATTTGGCATAGCAAGTGTT","561307.5.peg.587","2007"
"27536",2214,2800,586,"TACCAATAGGAATACGATT","AATTTGGCATAGCAAGTGTT","561307.5.peg.587","2007"
"27537",321,2800,2479,"TCATAGTTTGCGGAAGAAGA","AATTTGGCATAGCAAGTGTT","561307.5.peg.587","2007"
"27538",2664,2800,136,"TTAACTGGTATCATGTACTC","AATTTGGCATAGCAAGTGTT","561307.5.peg.587","2007"
"27539",669,2800,2131,"GTTCAAATGGATGCTTAAT","AATTTGGCATAGCAAGTGTT","561307.5.peg.587","2007"
"27540",3363,2800,563,"ATCTCACTCTAATTTGACT","AATTTGGCATAGCAAGTGTT","561307.5.peg.587","2007"
"27541",2659,2800,141,"TGGTATCATGTACTCCGGTA","AATTTGGCATAGCAAGTGTT","561307.5.peg.587","2007"
"27542",858,2800,1942,"GCATCGATTGTTAACGTTAA","AATTTGGCATAGCAAGTGTT","561307.5.peg.587","2007"
"27543",1284,2800,1516,"GTTTGCGCATCATCTATCTC","AATTTGGCATAGCAAGTGTT","561307.5.peg.587","2007"
"27544",1344,2800,1456,"AATTGCACAGCGACATGATT","AATTTGGCATAGCAAGTGTT","561307.5.peg.587","2007"
"27545",2352,2800,448,"ATTTATCTGCTGTCAATTC","AATTTGGCATAGCAAGTGTT","561307.5.peg.587","2007"
"27546",3107,2800,307,"CGTTATACACCGTATCTTTA","AATTTGGCATAGCAAGTGTT","561307.5.peg.587","2007"
"27547",1560,2800,1240,"ATGTACTCCTGACGATCACT","AATTTGGCATAGCAAGTGTT","561307.5.peg.587","2007"
"27548",1551,2800,1249,"TGACGATCACTTGGATAGTT","AATTTGGCATAGCAAGTGTT","561307.5.peg.587","2007"
"27549",1599,2800,1201,"GGTACGTTATTACAACTTT","AATTTGGCATAGCAAGTGTT","561307.5.peg.587","2007"
"27550",2130,2800,670,"TAATAATTTGAGGATGCTT","AATTTGGCATAGCAAGTGTT","561307.5.peg.587","2007"
"27551",2226,2800,574,"CCCAGAATCGGTTTACCAAT","AATTTGGCATAGCAAGTGTT","561307.5.peg.587","2007"
"27552",1344,3107,1763,"AATTGCACAGCGACATGATT","CGTTATACACCGTATCTTTA","561307.5.peg.587","2007"
"27553",3621,3107,514,"TTTGGTCTAACATAGTCTGT","CGTTATACACCGTATCTTTA","561307.5.peg.587","2007"
"27554",3363,3107,256,"ATCTCACTCTAATTTGACT","CGTTATACACCGTATCTTTA","561307.5.peg.587","2007"
"27555",2226,3107,881,"CCCAGAATCGGTTTACCAAT","CGTTATACACCGTATCTTTA","561307.5.peg.587","2007"
"27556",2214,3107,893,"TACCAATAGGAATACGATT","CGTTATACACCGTATCTTTA","561307.5.peg.587","2007"
"27557",1560,3107,1547,"ATGTACTCCTGACGATCACT","CGTTATACACCGTATCTTTA","561307.5.peg.587","2007"
"27558",2776,3107,331,"ATCTGTACTCGGTGCTACAT","CGTTATACACCGTATCTTTA","561307.5.peg.587","2007"
"27559",321,3107,2786,"TCATAGTTTGCGGAAGAAGA","CGTTATACACCGTATCTTTA","561307.5.peg.587","2007"
"27560",2298,3107,809,"CCACTTGTACATAATTCTCC","CGTTATACACCGTATCTTTA","561307.5.peg.587","2007"
"27561",1284,3107,1823,"GTTTGCGCATCATCTATCTC","CGTTATACACCGTATCTTTA","561307.5.peg.587","2007"
"27562",1787,3107,1320,"GGACCAAGCGAACAATACCT","CGTTATACACCGTATCTTTA","561307.5.peg.587","2007"
"27563",1551,3107,1556,"TGACGATCACTTGGATAGTT","CGTTATACACCGTATCTTTA","561307.5.peg.587","2007"
"27564",1542,3107,1565,"CTTGGATAGTTCGGATCAAT","CGTTATACACCGTATCTTTA","561307.5.peg.587","2007"
"27565",2352,3107,755,"ATTTATCTGCTGTCAATTC","CGTTATACACCGTATCTTTA","561307.5.peg.587","2007"
"27566",1452,3107,1655,"ATGACAGCGACACGATCATT","CGTTATACACCGTATCTTTA","561307.5.peg.587","2007"
"27567",2787,3107,320,"AAGTGTTCGGTATCTGTACT","CGTTATACACCGTATCTTTA","561307.5.peg.587","2007"
"27568",1599,3107,1508,"GGTACGTTATTACAACTTT","CGTTATACACCGTATCTTTA","561307.5.peg.587","2007"
"27569",1956,3107,1151,"TTAATTGTTCTACCGCTAT","CGTTATACACCGTATCTTTA","561307.5.peg.587","2007"
"27570",2130,3107,977,"TAATAATTTGAGGATGCTT","CGTTATACACCGTATCTTTA","561307.5.peg.587","2007"
"27571",2748,3107,359,"GTATCGACATAGTCCATGAT","CGTTATACACCGTATCTTTA","561307.5.peg.587","2007"
"27572",2800,3107,307,"AATTTGGCATAGCAAGTGTT","CGTTATACACCGTATCTTTA","561307.5.peg.587","2007"
"27573",2202,3107,905,"TACGATTTGGAACTTTGTT","CGTTATACACCGTATCTTTA","561307.5.peg.587","2007"
"27574",858,3107,2249,"GCATCGATTGTTAACGTTAA","CGTTATACACCGTATCTTTA","561307.5.peg.587","2007"
"27575",1782,3107,1325,"AAGCGAACAATACCTCGGTG","CGTTATACACCGTATCTTTA","561307.5.peg.587","2007"
"27576",2436,3107,671,"AAATAATCTATGTTGCCATC","CGTTATACACCGTATCTTTA","561307.5.peg.587","2007"
"27577",2664,3107,443,"TTAACTGGTATCATGTACTC","CGTTATACACCGTATCTTTA","561307.5.peg.587","2007"
"27578",3396,3107,289,"ATAAAGAGGTATGCATGTAA","CGTTATACACCGTATCTTTA","561307.5.peg.587","2007"
"27579",2659,3107,448,"TGGTATCATGTACTCCGGTA","CGTTATACACCGTATCTTTA","561307.5.peg.587","2007"
"27580",1763,3107,1344,"GCGGAATTAGTGTCCCTTTA","CGTTATACACCGTATCTTTA","561307.5.peg.587","2007"
"27581",669,3107,2438,"GTTCAAATGGATGCTTAAT","CGTTATACACCGTATCTTTA","561307.5.peg.587","2007"
"27582",2238,3107,869,"TAAACATGAGTACCCAGAAT","CGTTATACACCGTATCTTTA","561307.5.peg.587","2007"
"27583",143,3107,2964,"GTTTAACCCAATACGCATTA","CGTTATACACCGTATCTTTA","561307.5.peg.587","2007"
"27584",1315,3107,1792,"TCAACTTGTTGCTCAAATA","CGTTATACACCGTATCTTTA","561307.5.peg.587","2007"
"27585",331,3107,2776,"AGCTTCTAAATCATAGTTTG","CGTTATACACCGTATCTTTA","561307.5.peg.587","2007"
"27586",3410,3107,303,"ATGATGCGTATCTATAAAG","CGTTATACACCGTATCTTTA","561307.5.peg.587","2007"
"27587",2748,3363,615,"GTATCGACATAGTCCATGAT","ATCTCACTCTAATTTGACT","561307.5.peg.587","2007"
"27588",3621,3363,258,"TTTGGTCTAACATAGTCTGT","ATCTCACTCTAATTTGACT","561307.5.peg.587","2007"
"27589",143,3363,3220,"GTTTAACCCAATACGCATTA","ATCTCACTCTAATTTGACT","561307.5.peg.587","2007"
"27590",2800,3363,563,"AATTTGGCATAGCAAGTGTT","ATCTCACTCTAATTTGACT","561307.5.peg.587","2007"
"27591",2298,3363,1065,"CCACTTGTACATAATTCTCC","ATCTCACTCTAATTTGACT","561307.5.peg.587","2007"
"27592",321,3363,3042,"TCATAGTTTGCGGAAGAAGA","ATCTCACTCTAATTTGACT","561307.5.peg.587","2007"
"27593",2659,3363,704,"TGGTATCATGTACTCCGGTA","ATCTCACTCTAATTTGACT","561307.5.peg.587","2007"
"27594",2776,3363,587,"ATCTGTACTCGGTGCTACAT","ATCTCACTCTAATTTGACT","561307.5.peg.587","2007"
"27595",1315,3363,2048,"TCAACTTGTTGCTCAAATA","ATCTCACTCTAATTTGACT","561307.5.peg.587","2007"
"27596",1787,3363,1576,"GGACCAAGCGAACAATACCT","ATCTCACTCTAATTTGACT","561307.5.peg.587","2007"
"27597",2214,3363,1149,"TACCAATAGGAATACGATT","ATCTCACTCTAATTTGACT","561307.5.peg.587","2007"
"27598",2226,3363,1137,"CCCAGAATCGGTTTACCAAT","ATCTCACTCTAATTTGACT","561307.5.peg.587","2007"
"27599",1344,3363,2019,"AATTGCACAGCGACATGATT","ATCTCACTCTAATTTGACT","561307.5.peg.587","2007"
"27600",331,3363,3032,"AGCTTCTAAATCATAGTTTG","ATCTCACTCTAATTTGACT","561307.5.peg.587","2007"
"27601",1542,3363,1821,"CTTGGATAGTTCGGATCAAT","ATCTCACTCTAATTTGACT","561307.5.peg.587","2007"
"27602",1782,3363,1581,"AAGCGAACAATACCTCGGTG","ATCTCACTCTAATTTGACT","561307.5.peg.587","2007"
"27603",1560,3363,1803,"ATGTACTCCTGACGATCACT","ATCTCACTCTAATTTGACT","561307.5.peg.587","2007"
"27604",2664,3363,699,"TTAACTGGTATCATGTACTC","ATCTCACTCTAATTTGACT","561307.5.peg.587","2007"
"27605",3107,3363,256,"CGTTATACACCGTATCTTTA","ATCTCACTCTAATTTGACT","561307.5.peg.587","2007"
"27606",2130,3363,1233,"TAATAATTTGAGGATGCTT","ATCTCACTCTAATTTGACT","561307.5.peg.587","2007"
"27607",2352,3363,1011,"ATTTATCTGCTGTCAATTC","ATCTCACTCTAATTTGACT","561307.5.peg.587","2007"
"27608",2202,3363,1161,"TACGATTTGGAACTTTGTT","ATCTCACTCTAATTTGACT","561307.5.peg.587","2007"
"27609",858,3363,2505,"GCATCGATTGTTAACGTTAA","ATCTCACTCTAATTTGACT","561307.5.peg.587","2007"
"27610",1599,3363,1764,"GGTACGTTATTACAACTTT","ATCTCACTCTAATTTGACT","561307.5.peg.587","2007"
"27611",1551,3363,1812,"TGACGATCACTTGGATAGTT","ATCTCACTCTAATTTGACT","561307.5.peg.587","2007"
"27612",669,3363,2694,"GTTCAAATGGATGCTTAAT","ATCTCACTCTAATTTGACT","561307.5.peg.587","2007"
"27613",2436,3363,927,"AAATAATCTATGTTGCCATC","ATCTCACTCTAATTTGACT","561307.5.peg.587","2007"
"27614",1956,3363,1407,"TTAATTGTTCTACCGCTAT","ATCTCACTCTAATTTGACT","561307.5.peg.587","2007"
"27615",1284,3363,2079,"GTTTGCGCATCATCTATCTC","ATCTCACTCTAATTTGACT","561307.5.peg.587","2007"
"27616",1763,3363,1600,"GCGGAATTAGTGTCCCTTTA","ATCTCACTCTAATTTGACT","561307.5.peg.587","2007"
"27617",1452,3363,1911,"ATGACAGCGACACGATCATT","ATCTCACTCTAATTTGACT","561307.5.peg.587","2007"
"27618",2238,3363,1125,"TAAACATGAGTACCCAGAAT","ATCTCACTCTAATTTGACT","561307.5.peg.587","2007"
"27619",2787,3363,576,"AAGTGTTCGGTATCTGTACT","ATCTCACTCTAATTTGACT","561307.5.peg.587","2007"
"27620",1452,3396,1944,"ATGACAGCGACACGATCATT","ATAAAGAGGTATGCATGTAA","561307.5.peg.587","2007"
"27621",2748,3396,648,"GTATCGACATAGTCCATGAT","ATAAAGAGGTATGCATGTAA","561307.5.peg.587","2007"
"27622",3621,3396,225,"TTTGGTCTAACATAGTCTGT","ATAAAGAGGTATGCATGTAA","561307.5.peg.587","2007"
"27623",858,3396,2538,"GCATCGATTGTTAACGTTAA","ATAAAGAGGTATGCATGTAA","561307.5.peg.587","2007"
"27624",1284,3396,2112,"GTTTGCGCATCATCTATCTC","ATAAAGAGGTATGCATGTAA","561307.5.peg.587","2007"
"27625",143,3396,3253,"GTTTAACCCAATACGCATTA","ATAAAGAGGTATGCATGTAA","561307.5.peg.587","2007"
"27626",321,3396,3075,"TCATAGTTTGCGGAAGAAGA","ATAAAGAGGTATGCATGTAA","561307.5.peg.587","2007"
"27627",1956,3396,1440,"TTAATTGTTCTACCGCTAT","ATAAAGAGGTATGCATGTAA","561307.5.peg.587","2007"
"27628",2352,3396,1044,"ATTTATCTGCTGTCAATTC","ATAAAGAGGTATGCATGTAA","561307.5.peg.587","2007"
"27629",2202,3396,1194,"TACGATTTGGAACTTTGTT","ATAAAGAGGTATGCATGTAA","561307.5.peg.587","2007"
"27630",2238,3396,1158,"TAAACATGAGTACCCAGAAT","ATAAAGAGGTATGCATGTAA","561307.5.peg.587","2007"
"27631",1787,3396,1609,"GGACCAAGCGAACAATACCT","ATAAAGAGGTATGCATGTAA","561307.5.peg.587","2007"
"27632",2659,3396,737,"TGGTATCATGTACTCCGGTA","ATAAAGAGGTATGCATGTAA","561307.5.peg.587","2007"
"27633",2776,3396,620,"ATCTGTACTCGGTGCTACAT","ATAAAGAGGTATGCATGTAA","561307.5.peg.587","2007"
"27634",1542,3396,1854,"CTTGGATAGTTCGGATCAAT","ATAAAGAGGTATGCATGTAA","561307.5.peg.587","2007"
"27635",2298,3396,1098,"CCACTTGTACATAATTCTCC","ATAAAGAGGTATGCATGTAA","561307.5.peg.587","2007"
"27636",2800,3396,596,"AATTTGGCATAGCAAGTGTT","ATAAAGAGGTATGCATGTAA","561307.5.peg.587","2007"
"27637",2436,3396,960,"AAATAATCTATGTTGCCATC","ATAAAGAGGTATGCATGTAA","561307.5.peg.587","2007"
"27638",1782,3396,1614,"AAGCGAACAATACCTCGGTG","ATAAAGAGGTATGCATGTAA","561307.5.peg.587","2007"
"27639",1763,3396,1633,"GCGGAATTAGTGTCCCTTTA","ATAAAGAGGTATGCATGTAA","561307.5.peg.587","2007"
"27640",331,3396,3065,"AGCTTCTAAATCATAGTTTG","ATAAAGAGGTATGCATGTAA","561307.5.peg.587","2007"
"27641",2787,3396,609,"AAGTGTTCGGTATCTGTACT","ATAAAGAGGTATGCATGTAA","561307.5.peg.587","2007"
"27642",2226,3396,1170,"CCCAGAATCGGTTTACCAAT","ATAAAGAGGTATGCATGTAA","561307.5.peg.587","2007"
"27643",1315,3396,2081,"TCAACTTGTTGCTCAAATA","ATAAAGAGGTATGCATGTAA","561307.5.peg.587","2007"
"27644",1560,3396,1836,"ATGTACTCCTGACGATCACT","ATAAAGAGGTATGCATGTAA","561307.5.peg.587","2007"
"27645",1551,3396,1845,"TGACGATCACTTGGATAGTT","ATAAAGAGGTATGCATGTAA","561307.5.peg.587","2007"
"27646",2214,3396,1182,"TACCAATAGGAATACGATT","ATAAAGAGGTATGCATGTAA","561307.5.peg.587","2007"
"27647",1599,3396,1797,"GGTACGTTATTACAACTTT","ATAAAGAGGTATGCATGTAA","561307.5.peg.587","2007"
"27648",2130,3396,1266,"TAATAATTTGAGGATGCTT","ATAAAGAGGTATGCATGTAA","561307.5.peg.587","2007"
"27649",2664,3396,732,"TTAACTGGTATCATGTACTC","ATAAAGAGGTATGCATGTAA","561307.5.peg.587","2007"
"27650",3107,3396,289,"CGTTATACACCGTATCTTTA","ATAAAGAGGTATGCATGTAA","561307.5.peg.587","2007"
"27651",669,3396,2727,"GTTCAAATGGATGCTTAAT","ATAAAGAGGTATGCATGTAA","561307.5.peg.587","2007"
"27652",1344,3396,2052,"AATTGCACAGCGACATGATT","ATAAAGAGGTATGCATGTAA","561307.5.peg.587","2007"
"27653",2436,3410,974,"AAATAATCTATGTTGCCATC","ATGATGCGTATCTATAAAG","561307.5.peg.587","2007"
"27654",1599,3410,1811,"GGTACGTTATTACAACTTT","ATGATGCGTATCTATAAAG","561307.5.peg.587","2007"
"27655",2664,3410,746,"TTAACTGGTATCATGTACTC","ATGATGCGTATCTATAAAG","561307.5.peg.587","2007"
"27656",2800,3410,610,"AATTTGGCATAGCAAGTGTT","ATGATGCGTATCTATAAAG","561307.5.peg.587","2007"
"27657",331,3410,3079,"AGCTTCTAAATCATAGTTTG","ATGATGCGTATCTATAAAG","561307.5.peg.587","2007"
"27658",3107,3410,303,"CGTTATACACCGTATCTTTA","ATGATGCGTATCTATAAAG","561307.5.peg.587","2007"
"27659",2352,3410,1058,"ATTTATCTGCTGTCAATTC","ATGATGCGTATCTATAAAG","561307.5.peg.587","2007"
"27660",2226,3410,1184,"CCCAGAATCGGTTTACCAAT","ATGATGCGTATCTATAAAG","561307.5.peg.587","2007"
"27661",1551,3410,1859,"TGACGATCACTTGGATAGTT","ATGATGCGTATCTATAAAG","561307.5.peg.587","2007"
"27662",143,3410,3267,"GTTTAACCCAATACGCATTA","ATGATGCGTATCTATAAAG","561307.5.peg.587","2007"
"27663",858,3410,2552,"GCATCGATTGTTAACGTTAA","ATGATGCGTATCTATAAAG","561307.5.peg.587","2007"
"27664",1542,3410,1868,"CTTGGATAGTTCGGATCAAT","ATGATGCGTATCTATAAAG","561307.5.peg.587","2007"
"27665",1452,3410,1958,"ATGACAGCGACACGATCATT","ATGATGCGTATCTATAAAG","561307.5.peg.587","2007"
"27666",1315,3410,2095,"TCAACTTGTTGCTCAAATA","ATGATGCGTATCTATAAAG","561307.5.peg.587","2007"
"27667",2130,3410,1280,"TAATAATTTGAGGATGCTT","ATGATGCGTATCTATAAAG","561307.5.peg.587","2007"
"27668",1787,3410,1623,"GGACCAAGCGAACAATACCT","ATGATGCGTATCTATAAAG","561307.5.peg.587","2007"
"27669",1560,3410,1850,"ATGTACTCCTGACGATCACT","ATGATGCGTATCTATAAAG","561307.5.peg.587","2007"
"27670",1284,3410,2126,"GTTTGCGCATCATCTATCTC","ATGATGCGTATCTATAAAG","561307.5.peg.587","2007"
"27671",2748,3410,662,"GTATCGACATAGTCCATGAT","ATGATGCGTATCTATAAAG","561307.5.peg.587","2007"
"27672",1782,3410,1628,"AAGCGAACAATACCTCGGTG","ATGATGCGTATCTATAAAG","561307.5.peg.587","2007"
"27673",2776,3410,634,"ATCTGTACTCGGTGCTACAT","ATGATGCGTATCTATAAAG","561307.5.peg.587","2007"
"27674",3621,3410,211,"TTTGGTCTAACATAGTCTGT","ATGATGCGTATCTATAAAG","561307.5.peg.587","2007"
"27675",1763,3410,1647,"GCGGAATTAGTGTCCCTTTA","ATGATGCGTATCTATAAAG","561307.5.peg.587","2007"
"27676",2787,3410,623,"AAGTGTTCGGTATCTGTACT","ATGATGCGTATCTATAAAG","561307.5.peg.587","2007"
"27677",2202,3410,1208,"TACGATTTGGAACTTTGTT","ATGATGCGTATCTATAAAG","561307.5.peg.587","2007"
"27678",669,3410,2741,"GTTCAAATGGATGCTTAAT","ATGATGCGTATCTATAAAG","561307.5.peg.587","2007"
"27679",2238,3410,1172,"TAAACATGAGTACCCAGAAT","ATGATGCGTATCTATAAAG","561307.5.peg.587","2007"
"27680",2659,3410,751,"TGGTATCATGTACTCCGGTA","ATGATGCGTATCTATAAAG","561307.5.peg.587","2007"
"27681",321,3410,3089,"TCATAGTTTGCGGAAGAAGA","ATGATGCGTATCTATAAAG","561307.5.peg.587","2007"
"27682",1956,3410,1454,"TTAATTGTTCTACCGCTAT","ATGATGCGTATCTATAAAG","561307.5.peg.587","2007"
"27683",2214,3410,1196,"TACCAATAGGAATACGATT","ATGATGCGTATCTATAAAG","561307.5.peg.587","2007"
"27684",2298,3410,1112,"CCACTTGTACATAATTCTCC","ATGATGCGTATCTATAAAG","561307.5.peg.587","2007"
"27685",1344,3410,2066,"AATTGCACAGCGACATGATT","ATGATGCGTATCTATAAAG","561307.5.peg.587","2007"
"27686",1284,3621,2337,"GTTTGCGCATCATCTATCTC","TTTGGTCTAACATAGTCTGT","561307.5.peg.587","2007"
"27687",2659,3621,962,"TGGTATCATGTACTCCGGTA","TTTGGTCTAACATAGTCTGT","561307.5.peg.587","2007"
"27688",669,3621,2952,"GTTCAAATGGATGCTTAAT","TTTGGTCTAACATAGTCTGT","561307.5.peg.587","2007"
"27689",2202,3621,1419,"TACGATTTGGAACTTTGTT","TTTGGTCTAACATAGTCTGT","561307.5.peg.587","2007"
"27690",858,3621,2763,"GCATCGATTGTTAACGTTAA","TTTGGTCTAACATAGTCTGT","561307.5.peg.587","2007"
"27691",1452,3621,2169,"ATGACAGCGACACGATCATT","TTTGGTCTAACATAGTCTGT","561307.5.peg.587","2007"
"27692",2226,3621,1395,"CCCAGAATCGGTTTACCAAT","TTTGGTCTAACATAGTCTGT","561307.5.peg.587","2007"
"27693",3396,3621,225,"ATAAAGAGGTATGCATGTAA","TTTGGTCTAACATAGTCTGT","561307.5.peg.587","2007"
"27694",2238,3621,1383,"TAAACATGAGTACCCAGAAT","TTTGGTCTAACATAGTCTGT","561307.5.peg.587","2007"
"27695",2664,3621,957,"TTAACTGGTATCATGTACTC","TTTGGTCTAACATAGTCTGT","561307.5.peg.587","2007"
"27696",2298,3621,1323,"CCACTTGTACATAATTCTCC","TTTGGTCTAACATAGTCTGT","561307.5.peg.587","2007"
"27697",2436,3621,1185,"AAATAATCTATGTTGCCATC","TTTGGTCTAACATAGTCTGT","561307.5.peg.587","2007"
"27698",1782,3621,1839,"AAGCGAACAATACCTCGGTG","TTTGGTCTAACATAGTCTGT","561307.5.peg.587","2007"
"27699",3363,3621,258,"ATCTCACTCTAATTTGACT","TTTGGTCTAACATAGTCTGT","561307.5.peg.587","2007"
"27700",1560,3621,2061,"ATGTACTCCTGACGATCACT","TTTGGTCTAACATAGTCTGT","561307.5.peg.587","2007"
"27701",1344,3621,2277,"AATTGCACAGCGACATGATT","TTTGGTCTAACATAGTCTGT","561307.5.peg.587","2007"
"27702",1956,3621,1665,"TTAATTGTTCTACCGCTAT","TTTGGTCTAACATAGTCTGT","561307.5.peg.587","2007"
"27703",2130,3621,1491,"TAATAATTTGAGGATGCTT","TTTGGTCTAACATAGTCTGT","561307.5.peg.587","2007"
"27704",1551,3621,2070,"TGACGATCACTTGGATAGTT","TTTGGTCTAACATAGTCTGT","561307.5.peg.587","2007"
"27705",1315,3621,2306,"TCAACTTGTTGCTCAAATA","TTTGGTCTAACATAGTCTGT","561307.5.peg.587","2007"
"27706",2787,3621,834,"AAGTGTTCGGTATCTGTACT","TTTGGTCTAACATAGTCTGT","561307.5.peg.587","2007"
"27707",3107,3621,514,"CGTTATACACCGTATCTTTA","TTTGGTCTAACATAGTCTGT","561307.5.peg.587","2007"
"27708",2214,3621,1407,"TACCAATAGGAATACGATT","TTTGGTCTAACATAGTCTGT","561307.5.peg.587","2007"
"27709",1599,3621,2022,"GGTACGTTATTACAACTTT","TTTGGTCTAACATAGTCTGT","561307.5.peg.587","2007"
"27710",321,3621,3300,"TCATAGTTTGCGGAAGAAGA","TTTGGTCTAACATAGTCTGT","561307.5.peg.587","2007"
"27711",1763,3621,1858,"GCGGAATTAGTGTCCCTTTA","TTTGGTCTAACATAGTCTGT","561307.5.peg.587","2007"
"27712",2800,3621,821,"AATTTGGCATAGCAAGTGTT","TTTGGTCTAACATAGTCTGT","561307.5.peg.587","2007"
"27713",143,3621,3478,"GTTTAACCCAATACGCATTA","TTTGGTCTAACATAGTCTGT","561307.5.peg.587","2007"
"27714",2352,3621,1269,"ATTTATCTGCTGTCAATTC","TTTGGTCTAACATAGTCTGT","561307.5.peg.587","2007"
"27715",2776,3621,845,"ATCTGTACTCGGTGCTACAT","TTTGGTCTAACATAGTCTGT","561307.5.peg.587","2007"
"27716",1787,3621,1834,"GGACCAAGCGAACAATACCT","TTTGGTCTAACATAGTCTGT","561307.5.peg.587","2007"
"27717",1542,3621,2079,"CTTGGATAGTTCGGATCAAT","TTTGGTCTAACATAGTCTGT","561307.5.peg.587","2007"
"27718",3410,3621,211,"ATGATGCGTATCTATAAAG","TTTGGTCTAACATAGTCTGT","561307.5.peg.587","2007"
"27719",331,3621,3290,"AGCTTCTAAATCATAGTTTG","TTTGGTCTAACATAGTCTGT","561307.5.peg.587","2007"
"27720",2748,3621,873,"GTATCGACATAGTCCATGAT","TTTGGTCTAACATAGTCTGT","561307.5.peg.587","2007"
"27721",261,135,126,"ACAATATCTGCCTTACCTCG","TATCTATAGTTGACTGTACG","561307.5.peg.588","2008"
"27722",306,135,171,"TATGATAAGCTCACATAGAT","TATCTATAGTTGACTGTACG","561307.5.peg.588","2008"
"27723",336,135,201,"TCGACAACACACACGATATA","TATCTATAGTTGACTGTACG","561307.5.peg.588","2008"
"27724",336,234,102,"TCGACAACACACACGATATA","ATGTGATAATGCCATTCATG","561307.5.peg.588","2008"
"27725",135,261,126,"TATCTATAGTTGACTGTACG","ACAATATCTGCCTTACCTCG","561307.5.peg.588","2008"
"27726",135,306,171,"TATCTATAGTTGACTGTACG","TATGATAAGCTCACATAGAT","561307.5.peg.588","2008"
"27727",135,336,201,"TATCTATAGTTGACTGTACG","TCGACAACACACACGATATA","561307.5.peg.588","2008"
"27728",234,336,102,"ATGTGATAATGCCATTCATG","TCGACAACACACACGATATA","561307.5.peg.588","2008"
"27729",258,144,114,"TGGACAATAAAGCTTACCCA","TTACGTTCTGGTGTGCGAGG","561307.5.peg.589","2009"
"27730",258,147,111,"TGGACAATAAAGCTTACCCA","GCATTACGTTCTGGTGTGCG","561307.5.peg.589","2009"
"27731",258,156,102,"TGGACAATAAAGCTTACCCA","GGGTTCGTTGCATTACGTTC","561307.5.peg.589","2009"
"27732",144,258,114,"TTACGTTCTGGTGTGCGAGG","TGGACAATAAAGCTTACCCA","561307.5.peg.589","2009"
"27733",147,258,111,"GCATTACGTTCTGGTGTGCG","TGGACAATAAAGCTTACCCA","561307.5.peg.589","2009"
"27734",156,258,102,"GGGTTCGTTGCATTACGTTC","TGGACAATAAAGCTTACCCA","561307.5.peg.589","2009"
"27735",230,5,225,"TTGCTTTATCAGTCACTCTT","TATCGAACATAAGGTGGTGT","561307.5.peg.590","2011"
"27736",149,5,144,"CACCGCCATGAACGATAATG","TATCGAACATAAGGTGGTGT","561307.5.peg.590","2011"
"27737",151,5,146,"GCCACCGCCATGAACGATAA","TATCGAACATAAGGTGGTGT","561307.5.peg.590","2011"
"27738",317,5,312,"CTATTGCAGAACATTGGTGC","TATCGAACATAAGGTGGTGT","561307.5.peg.590","2011"
"27739",323,5,318,"ATAAGCCTATTGCAGAACAT","TATCGAACATAAGGTGGTGT","561307.5.peg.590","2011"
"27740",200,5,195,"CAAAGTGTGGCTCGATTTGC","TATCGAACATAAGGTGGTGT","561307.5.peg.590","2011"
"27741",253,5,248,"CGTGTGTTTAGTAATGGTCA","TATCGAACATAAGGTGGTGT","561307.5.peg.590","2011"
"27742",259,5,254,"AATGAGCGTGTGTTTAGTAA","TATCGAACATAAGGTGGTGT","561307.5.peg.590","2011"
"27743",149,11,138,"CACCGCCATGAACGATAATG","GCATCATATCGAACATAAGG","561307.5.peg.590","2011"
"27744",200,11,189,"CAAAGTGTGGCTCGATTTGC","GCATCATATCGAACATAAGG","561307.5.peg.590","2011"
"27745",230,11,219,"TTGCTTTATCAGTCACTCTT","GCATCATATCGAACATAAGG","561307.5.peg.590","2011"
"27746",151,11,140,"GCCACCGCCATGAACGATAA","GCATCATATCGAACATAAGG","561307.5.peg.590","2011"
"27747",317,11,306,"CTATTGCAGAACATTGGTGC","GCATCATATCGAACATAAGG","561307.5.peg.590","2011"
"27748",253,11,242,"CGTGTGTTTAGTAATGGTCA","GCATCATATCGAACATAAGG","561307.5.peg.590","2011"
"27749",259,11,248,"AATGAGCGTGTGTTTAGTAA","GCATCATATCGAACATAAGG","561307.5.peg.590","2011"
"27750",323,11,312,"ATAAGCCTATTGCAGAACAT","GCATCATATCGAACATAAGG","561307.5.peg.590","2011"
"27751",259,14,245,"AATGAGCGTGTGTTTAGTAA","AACGCATCATATCGAACATA","561307.5.peg.590","2011"
"27752",323,14,309,"ATAAGCCTATTGCAGAACAT","AACGCATCATATCGAACATA","561307.5.peg.590","2011"
"27753",151,14,137,"GCCACCGCCATGAACGATAA","AACGCATCATATCGAACATA","561307.5.peg.590","2011"
"27754",253,14,239,"CGTGTGTTTAGTAATGGTCA","AACGCATCATATCGAACATA","561307.5.peg.590","2011"
"27755",200,14,186,"CAAAGTGTGGCTCGATTTGC","AACGCATCATATCGAACATA","561307.5.peg.590","2011"
"27756",149,14,135,"CACCGCCATGAACGATAATG","AACGCATCATATCGAACATA","561307.5.peg.590","2011"
"27757",317,14,303,"CTATTGCAGAACATTGGTGC","AACGCATCATATCGAACATA","561307.5.peg.590","2011"
"27758",230,14,216,"TTGCTTTATCAGTCACTCTT","AACGCATCATATCGAACATA","561307.5.peg.590","2011"
"27759",5,149,144,"TATCGAACATAAGGTGGTGT","CACCGCCATGAACGATAATG","561307.5.peg.590","2011"
"27760",323,149,174,"ATAAGCCTATTGCAGAACAT","CACCGCCATGAACGATAATG","561307.5.peg.590","2011"
"27761",259,149,110,"AATGAGCGTGTGTTTAGTAA","CACCGCCATGAACGATAATG","561307.5.peg.590","2011"
"27762",317,149,168,"CTATTGCAGAACATTGGTGC","CACCGCCATGAACGATAATG","561307.5.peg.590","2011"
"27763",14,149,135,"AACGCATCATATCGAACATA","CACCGCCATGAACGATAATG","561307.5.peg.590","2011"
"27764",11,149,138,"GCATCATATCGAACATAAGG","CACCGCCATGAACGATAATG","561307.5.peg.590","2011"
"27765",253,149,104,"CGTGTGTTTAGTAATGGTCA","CACCGCCATGAACGATAATG","561307.5.peg.590","2011"
"27766",5,151,146,"TATCGAACATAAGGTGGTGT","GCCACCGCCATGAACGATAA","561307.5.peg.590","2011"
"27767",253,151,102,"CGTGTGTTTAGTAATGGTCA","GCCACCGCCATGAACGATAA","561307.5.peg.590","2011"
"27768",14,151,137,"AACGCATCATATCGAACATA","GCCACCGCCATGAACGATAA","561307.5.peg.590","2011"
"27769",11,151,140,"GCATCATATCGAACATAAGG","GCCACCGCCATGAACGATAA","561307.5.peg.590","2011"
"27770",259,151,108,"AATGAGCGTGTGTTTAGTAA","GCCACCGCCATGAACGATAA","561307.5.peg.590","2011"
"27771",323,151,172,"ATAAGCCTATTGCAGAACAT","GCCACCGCCATGAACGATAA","561307.5.peg.590","2011"
"27772",317,151,166,"CTATTGCAGAACATTGGTGC","GCCACCGCCATGAACGATAA","561307.5.peg.590","2011"
"27773",5,200,195,"TATCGAACATAAGGTGGTGT","CAAAGTGTGGCTCGATTTGC","561307.5.peg.590","2011"
"27774",14,200,186,"AACGCATCATATCGAACATA","CAAAGTGTGGCTCGATTTGC","561307.5.peg.590","2011"
"27775",317,200,117,"CTATTGCAGAACATTGGTGC","CAAAGTGTGGCTCGATTTGC","561307.5.peg.590","2011"
"27776",323,200,123,"ATAAGCCTATTGCAGAACAT","CAAAGTGTGGCTCGATTTGC","561307.5.peg.590","2011"
"27777",11,200,189,"GCATCATATCGAACATAAGG","CAAAGTGTGGCTCGATTTGC","561307.5.peg.590","2011"
"27778",11,230,219,"GCATCATATCGAACATAAGG","TTGCTTTATCAGTCACTCTT","561307.5.peg.590","2011"
"27779",14,230,216,"AACGCATCATATCGAACATA","TTGCTTTATCAGTCACTCTT","561307.5.peg.590","2011"
"27780",5,230,225,"TATCGAACATAAGGTGGTGT","TTGCTTTATCAGTCACTCTT","561307.5.peg.590","2011"
"27781",151,253,102,"GCCACCGCCATGAACGATAA","CGTGTGTTTAGTAATGGTCA","561307.5.peg.590","2011"
"27782",149,253,104,"CACCGCCATGAACGATAATG","CGTGTGTTTAGTAATGGTCA","561307.5.peg.590","2011"
"27783",5,253,248,"TATCGAACATAAGGTGGTGT","CGTGTGTTTAGTAATGGTCA","561307.5.peg.590","2011"
"27784",14,253,239,"AACGCATCATATCGAACATA","CGTGTGTTTAGTAATGGTCA","561307.5.peg.590","2011"
"27785",11,253,242,"GCATCATATCGAACATAAGG","CGTGTGTTTAGTAATGGTCA","561307.5.peg.590","2011"
"27786",5,259,254,"TATCGAACATAAGGTGGTGT","AATGAGCGTGTGTTTAGTAA","561307.5.peg.590","2011"
"27787",151,259,108,"GCCACCGCCATGAACGATAA","AATGAGCGTGTGTTTAGTAA","561307.5.peg.590","2011"
"27788",14,259,245,"AACGCATCATATCGAACATA","AATGAGCGTGTGTTTAGTAA","561307.5.peg.590","2011"
"27789",149,259,110,"CACCGCCATGAACGATAATG","AATGAGCGTGTGTTTAGTAA","561307.5.peg.590","2011"
"27790",11,259,248,"GCATCATATCGAACATAAGG","AATGAGCGTGTGTTTAGTAA","561307.5.peg.590","2011"
"27791",5,317,312,"TATCGAACATAAGGTGGTGT","CTATTGCAGAACATTGGTGC","561307.5.peg.590","2011"
"27792",11,317,306,"GCATCATATCGAACATAAGG","CTATTGCAGAACATTGGTGC","561307.5.peg.590","2011"
"27793",14,317,303,"AACGCATCATATCGAACATA","CTATTGCAGAACATTGGTGC","561307.5.peg.590","2011"
"27794",151,317,166,"GCCACCGCCATGAACGATAA","CTATTGCAGAACATTGGTGC","561307.5.peg.590","2011"
"27795",149,317,168,"CACCGCCATGAACGATAATG","CTATTGCAGAACATTGGTGC","561307.5.peg.590","2011"
"27796",200,317,117,"CAAAGTGTGGCTCGATTTGC","CTATTGCAGAACATTGGTGC","561307.5.peg.590","2011"
"27797",5,323,318,"TATCGAACATAAGGTGGTGT","ATAAGCCTATTGCAGAACAT","561307.5.peg.590","2011"
"27798",151,323,172,"GCCACCGCCATGAACGATAA","ATAAGCCTATTGCAGAACAT","561307.5.peg.590","2011"
"27799",14,323,309,"AACGCATCATATCGAACATA","ATAAGCCTATTGCAGAACAT","561307.5.peg.590","2011"
"27800",200,323,123,"CAAAGTGTGGCTCGATTTGC","ATAAGCCTATTGCAGAACAT","561307.5.peg.590","2011"
"27801",11,323,312,"GCATCATATCGAACATAAGG","ATAAGCCTATTGCAGAACAT","561307.5.peg.590","2011"
"27802",149,323,174,"CACCGCCATGAACGATAATG","ATAAGCCTATTGCAGAACAT","561307.5.peg.590","2011"
"27803",510,8,502,"ATTGCCTCGTTAAACGCACC","ATCACCAGTTTATCCATAAG","561307.5.peg.591","2012"
"27804",120,8,112,"CCACCAGCCGTGAAGCCTTG","ATCACCAGTTTATCCATAAG","561307.5.peg.591","2012"
"27805",613,8,605,"GTGAATCATACCTGAACCTT","ATCACCAGTTTATCCATAAG","561307.5.peg.591","2012"
"27806",635,8,627,"CAAGCATGGTAGCCATATTT","ATCACCAGTTTATCCATAAG","561307.5.peg.591","2012"
"27807",337,8,329,"ATCATCTATGCCTTGTTGAC","ATCACCAGTTTATCCATAAG","561307.5.peg.591","2012"
"27808",478,8,470,"TTAGCATCCTTAATATGTT","ATCACCAGTTTATCCATAAG","561307.5.peg.591","2012"
"27809",402,8,394,"GCAACAGCAACATGCTCAGA","ATCACCAGTTTATCCATAAG","561307.5.peg.591","2012"
"27810",337,10,327,"ATCATCTATGCCTTGTTGAC","CAATCACCAGTTTATCCATA","561307.5.peg.591","2012"
"27811",510,10,500,"ATTGCCTCGTTAAACGCACC","CAATCACCAGTTTATCCATA","561307.5.peg.591","2012"
"27812",402,10,392,"GCAACAGCAACATGCTCAGA","CAATCACCAGTTTATCCATA","561307.5.peg.591","2012"
"27813",120,10,110,"CCACCAGCCGTGAAGCCTTG","CAATCACCAGTTTATCCATA","561307.5.peg.591","2012"
"27814",635,10,625,"CAAGCATGGTAGCCATATTT","CAATCACCAGTTTATCCATA","561307.5.peg.591","2012"
"27815",478,10,468,"TTAGCATCCTTAATATGTT","CAATCACCAGTTTATCCATA","561307.5.peg.591","2012"
"27816",613,10,603,"GTGAATCATACCTGAACCTT","CAATCACCAGTTTATCCATA","561307.5.peg.591","2012"
"27817",402,25,377,"GCAACAGCAACATGCTCAGA","AACACCCCTTATGGATAAAC","561307.5.peg.591","2012"
"27818",337,25,312,"ATCATCTATGCCTTGTTGAC","AACACCCCTTATGGATAAAC","561307.5.peg.591","2012"
"27819",510,25,485,"ATTGCCTCGTTAAACGCACC","AACACCCCTTATGGATAAAC","561307.5.peg.591","2012"
"27820",635,25,610,"CAAGCATGGTAGCCATATTT","AACACCCCTTATGGATAAAC","561307.5.peg.591","2012"
"27821",613,25,588,"GTGAATCATACCTGAACCTT","AACACCCCTTATGGATAAAC","561307.5.peg.591","2012"
"27822",478,25,453,"TTAGCATCCTTAATATGTT","AACACCCCTTATGGATAAAC","561307.5.peg.591","2012"
"27823",478,34,444,"TTAGCATCCTTAATATGTT","TTTCATTCTAACACCCCTTA","561307.5.peg.591","2012"
"27824",613,34,579,"GTGAATCATACCTGAACCTT","TTTCATTCTAACACCCCTTA","561307.5.peg.591","2012"
"27825",337,34,303,"ATCATCTATGCCTTGTTGAC","TTTCATTCTAACACCCCTTA","561307.5.peg.591","2012"
"27826",510,34,476,"ATTGCCTCGTTAAACGCACC","TTTCATTCTAACACCCCTTA","561307.5.peg.591","2012"
"27827",402,34,368,"GCAACAGCAACATGCTCAGA","TTTCATTCTAACACCCCTTA","561307.5.peg.591","2012"
"27828",635,34,601,"CAAGCATGGTAGCCATATTT","TTTCATTCTAACACCCCTTA","561307.5.peg.591","2012"
"27829",10,120,110,"CAATCACCAGTTTATCCATA","CCACCAGCCGTGAAGCCTTG","561307.5.peg.591","2012"
"27830",402,120,282,"GCAACAGCAACATGCTCAGA","CCACCAGCCGTGAAGCCTTG","561307.5.peg.591","2012"
"27831",613,120,493,"GTGAATCATACCTGAACCTT","CCACCAGCCGTGAAGCCTTG","561307.5.peg.591","2012"
"27832",635,120,515,"CAAGCATGGTAGCCATATTT","CCACCAGCCGTGAAGCCTTG","561307.5.peg.591","2012"
"27833",478,120,358,"TTAGCATCCTTAATATGTT","CCACCAGCCGTGAAGCCTTG","561307.5.peg.591","2012"
"27834",510,120,390,"ATTGCCTCGTTAAACGCACC","CCACCAGCCGTGAAGCCTTG","561307.5.peg.591","2012"
"27835",8,120,112,"ATCACCAGTTTATCCATAAG","CCACCAGCCGTGAAGCCTTG","561307.5.peg.591","2012"
"27836",337,120,217,"ATCATCTATGCCTTGTTGAC","CCACCAGCCGTGAAGCCTTG","561307.5.peg.591","2012"
"27837",613,337,276,"GTGAATCATACCTGAACCTT","ATCATCTATGCCTTGTTGAC","561307.5.peg.591","2012"
"27838",120,337,217,"CCACCAGCCGTGAAGCCTTG","ATCATCTATGCCTTGTTGAC","561307.5.peg.591","2012"
"27839",8,337,329,"ATCACCAGTTTATCCATAAG","ATCATCTATGCCTTGTTGAC","561307.5.peg.591","2012"
"27840",25,337,312,"AACACCCCTTATGGATAAAC","ATCATCTATGCCTTGTTGAC","561307.5.peg.591","2012"
"27841",34,337,303,"TTTCATTCTAACACCCCTTA","ATCATCTATGCCTTGTTGAC","561307.5.peg.591","2012"
"27842",635,337,298,"CAAGCATGGTAGCCATATTT","ATCATCTATGCCTTGTTGAC","561307.5.peg.591","2012"
"27843",10,337,327,"CAATCACCAGTTTATCCATA","ATCATCTATGCCTTGTTGAC","561307.5.peg.591","2012"
"27844",478,337,141,"TTAGCATCCTTAATATGTT","ATCATCTATGCCTTGTTGAC","561307.5.peg.591","2012"
"27845",510,337,173,"ATTGCCTCGTTAAACGCACC","ATCATCTATGCCTTGTTGAC","561307.5.peg.591","2012"
"27846",8,402,394,"ATCACCAGTTTATCCATAAG","GCAACAGCAACATGCTCAGA","561307.5.peg.591","2012"
"27847",25,402,377,"AACACCCCTTATGGATAAAC","GCAACAGCAACATGCTCAGA","561307.5.peg.591","2012"
"27848",120,402,282,"CCACCAGCCGTGAAGCCTTG","GCAACAGCAACATGCTCAGA","561307.5.peg.591","2012"
"27849",10,402,392,"CAATCACCAGTTTATCCATA","GCAACAGCAACATGCTCAGA","561307.5.peg.591","2012"
"27850",34,402,368,"TTTCATTCTAACACCCCTTA","GCAACAGCAACATGCTCAGA","561307.5.peg.591","2012"
"27851",613,402,211,"GTGAATCATACCTGAACCTT","GCAACAGCAACATGCTCAGA","561307.5.peg.591","2012"
"27852",635,402,233,"CAAGCATGGTAGCCATATTT","GCAACAGCAACATGCTCAGA","561307.5.peg.591","2012"
"27853",510,402,108,"ATTGCCTCGTTAAACGCACC","GCAACAGCAACATGCTCAGA","561307.5.peg.591","2012"
"27854",8,478,470,"ATCACCAGTTTATCCATAAG","TTAGCATCCTTAATATGTT","561307.5.peg.591","2012"
"27855",635,478,157,"CAAGCATGGTAGCCATATTT","TTAGCATCCTTAATATGTT","561307.5.peg.591","2012"
"27856",34,478,444,"TTTCATTCTAACACCCCTTA","TTAGCATCCTTAATATGTT","561307.5.peg.591","2012"
"27857",25,478,453,"AACACCCCTTATGGATAAAC","TTAGCATCCTTAATATGTT","561307.5.peg.591","2012"
"27858",10,478,468,"CAATCACCAGTTTATCCATA","TTAGCATCCTTAATATGTT","561307.5.peg.591","2012"
"27859",120,478,358,"CCACCAGCCGTGAAGCCTTG","TTAGCATCCTTAATATGTT","561307.5.peg.591","2012"
"27860",613,478,135,"GTGAATCATACCTGAACCTT","TTAGCATCCTTAATATGTT","561307.5.peg.591","2012"
"27861",337,478,141,"ATCATCTATGCCTTGTTGAC","TTAGCATCCTTAATATGTT","561307.5.peg.591","2012"
"27862",635,510,125,"CAAGCATGGTAGCCATATTT","ATTGCCTCGTTAAACGCACC","561307.5.peg.591","2012"
"27863",120,510,390,"CCACCAGCCGTGAAGCCTTG","ATTGCCTCGTTAAACGCACC","561307.5.peg.591","2012"
"27864",8,510,502,"ATCACCAGTTTATCCATAAG","ATTGCCTCGTTAAACGCACC","561307.5.peg.591","2012"
"27865",10,510,500,"CAATCACCAGTTTATCCATA","ATTGCCTCGTTAAACGCACC","561307.5.peg.591","2012"
"27866",402,510,108,"GCAACAGCAACATGCTCAGA","ATTGCCTCGTTAAACGCACC","561307.5.peg.591","2012"
"27867",337,510,173,"ATCATCTATGCCTTGTTGAC","ATTGCCTCGTTAAACGCACC","561307.5.peg.591","2012"
"27868",25,510,485,"AACACCCCTTATGGATAAAC","ATTGCCTCGTTAAACGCACC","561307.5.peg.591","2012"
"27869",613,510,103,"GTGAATCATACCTGAACCTT","ATTGCCTCGTTAAACGCACC","561307.5.peg.591","2012"
"27870",34,510,476,"TTTCATTCTAACACCCCTTA","ATTGCCTCGTTAAACGCACC","561307.5.peg.591","2012"
"27871",337,613,276,"ATCATCTATGCCTTGTTGAC","GTGAATCATACCTGAACCTT","561307.5.peg.591","2012"
"27872",34,613,579,"TTTCATTCTAACACCCCTTA","GTGAATCATACCTGAACCTT","561307.5.peg.591","2012"
"27873",478,613,135,"TTAGCATCCTTAATATGTT","GTGAATCATACCTGAACCTT","561307.5.peg.591","2012"
"27874",25,613,588,"AACACCCCTTATGGATAAAC","GTGAATCATACCTGAACCTT","561307.5.peg.591","2012"
"27875",510,613,103,"ATTGCCTCGTTAAACGCACC","GTGAATCATACCTGAACCTT","561307.5.peg.591","2012"
"27876",120,613,493,"CCACCAGCCGTGAAGCCTTG","GTGAATCATACCTGAACCTT","561307.5.peg.591","2012"
"27877",10,613,603,"CAATCACCAGTTTATCCATA","GTGAATCATACCTGAACCTT","561307.5.peg.591","2012"
"27878",402,613,211,"GCAACAGCAACATGCTCAGA","GTGAATCATACCTGAACCTT","561307.5.peg.591","2012"
"27879",8,613,605,"ATCACCAGTTTATCCATAAG","GTGAATCATACCTGAACCTT","561307.5.peg.591","2012"
"27880",8,635,627,"ATCACCAGTTTATCCATAAG","CAAGCATGGTAGCCATATTT","561307.5.peg.591","2012"
"27881",10,635,625,"CAATCACCAGTTTATCCATA","CAAGCATGGTAGCCATATTT","561307.5.peg.591","2012"
"27882",402,635,233,"GCAACAGCAACATGCTCAGA","CAAGCATGGTAGCCATATTT","561307.5.peg.591","2012"
"27883",337,635,298,"ATCATCTATGCCTTGTTGAC","CAAGCATGGTAGCCATATTT","561307.5.peg.591","2012"
"27884",25,635,610,"AACACCCCTTATGGATAAAC","CAAGCATGGTAGCCATATTT","561307.5.peg.591","2012"
"27885",510,635,125,"ATTGCCTCGTTAAACGCACC","CAAGCATGGTAGCCATATTT","561307.5.peg.591","2012"
"27886",478,635,157,"TTAGCATCCTTAATATGTT","CAAGCATGGTAGCCATATTT","561307.5.peg.591","2012"
"27887",34,635,601,"TTTCATTCTAACACCCCTTA","CAAGCATGGTAGCCATATTT","561307.5.peg.591","2012"
"27888",120,635,515,"CCACCAGCCGTGAAGCCTTG","CAAGCATGGTAGCCATATTT","561307.5.peg.591","2012"
"27889",486,126,360,"GTTGCTGTAGGGAAACAGCC","ATGTGTGCAATCGTTACATG","561307.5.peg.592","2013"
"27890",126,486,360,"ATGTGTGCAATCGTTACATG","GTTGCTGTAGGGAAACAGCC","561307.5.peg.592","2013"
"27891",206,102,104,"AACAATTGTTGGATGACAA","TAGAAATGACAAGCTTAAG","561307.5.peg.593","2014"
"27892",500,102,398,"ATCCTGCTTTATATGCGTCG","TAGAAATGACAAGCTTAAG","561307.5.peg.593","2014"
"27893",346,102,244,"AGCTTCAGTACCAGAGTTAA","TAGAAATGACAAGCTTAAG","561307.5.peg.593","2014"
"27894",527,102,425,"TTGTAGTGCCTTGAAGTAGG","TAGAAATGACAAGCTTAAG","561307.5.peg.593","2014"
"27895",275,102,173,"TCCCGAGATTGTCACTATAA","TAGAAATGACAAGCTTAAG","561307.5.peg.593","2014"
"27896",529,102,427,"TGTTGTAGTGCCTTGAAGTA","TAGAAATGACAAGCTTAAG","561307.5.peg.593","2014"
"27897",344,102,242,"CTTCAGTACCAGAGTTAAGG","TAGAAATGACAAGCTTAAG","561307.5.peg.593","2014"
"27898",527,200,327,"TTGTAGTGCCTTGAAGTAGG","TTGTTGGATGACAATGGCCT","561307.5.peg.593","2014"
"27899",346,200,146,"AGCTTCAGTACCAGAGTTAA","TTGTTGGATGACAATGGCCT","561307.5.peg.593","2014"
"27900",529,200,329,"TGTTGTAGTGCCTTGAAGTA","TTGTTGGATGACAATGGCCT","561307.5.peg.593","2014"
"27901",500,200,300,"ATCCTGCTTTATATGCGTCG","TTGTTGGATGACAATGGCCT","561307.5.peg.593","2014"
"27902",344,200,144,"CTTCAGTACCAGAGTTAAGG","TTGTTGGATGACAATGGCCT","561307.5.peg.593","2014"
"27903",529,206,323,"TGTTGTAGTGCCTTGAAGTA","AACAATTGTTGGATGACAA","561307.5.peg.593","2014"
"27904",102,206,104,"TAGAAATGACAAGCTTAAG","AACAATTGTTGGATGACAA","561307.5.peg.593","2014"
"27905",527,206,321,"TTGTAGTGCCTTGAAGTAGG","AACAATTGTTGGATGACAA","561307.5.peg.593","2014"
"27906",344,206,138,"CTTCAGTACCAGAGTTAAGG","AACAATTGTTGGATGACAA","561307.5.peg.593","2014"
"27907",346,206,140,"AGCTTCAGTACCAGAGTTAA","AACAATTGTTGGATGACAA","561307.5.peg.593","2014"
"27908",500,206,294,"ATCCTGCTTTATATGCGTCG","AACAATTGTTGGATGACAA","561307.5.peg.593","2014"
"27909",500,275,225,"ATCCTGCTTTATATGCGTCG","TCCCGAGATTGTCACTATAA","561307.5.peg.593","2014"
"27910",102,275,173,"TAGAAATGACAAGCTTAAG","TCCCGAGATTGTCACTATAA","561307.5.peg.593","2014"
"27911",527,275,252,"TTGTAGTGCCTTGAAGTAGG","TCCCGAGATTGTCACTATAA","561307.5.peg.593","2014"
"27912",529,275,254,"TGTTGTAGTGCCTTGAAGTA","TCCCGAGATTGTCACTATAA","561307.5.peg.593","2014"
"27913",500,344,156,"ATCCTGCTTTATATGCGTCG","CTTCAGTACCAGAGTTAAGG","561307.5.peg.593","2014"
"27914",529,344,185,"TGTTGTAGTGCCTTGAAGTA","CTTCAGTACCAGAGTTAAGG","561307.5.peg.593","2014"
"27915",206,344,138,"AACAATTGTTGGATGACAA","CTTCAGTACCAGAGTTAAGG","561307.5.peg.593","2014"
"27916",102,344,242,"TAGAAATGACAAGCTTAAG","CTTCAGTACCAGAGTTAAGG","561307.5.peg.593","2014"
"27917",527,344,183,"TTGTAGTGCCTTGAAGTAGG","CTTCAGTACCAGAGTTAAGG","561307.5.peg.593","2014"
"27918",200,344,144,"TTGTTGGATGACAATGGCCT","CTTCAGTACCAGAGTTAAGG","561307.5.peg.593","2014"
"27919",102,346,244,"TAGAAATGACAAGCTTAAG","AGCTTCAGTACCAGAGTTAA","561307.5.peg.593","2014"
"27920",500,346,154,"ATCCTGCTTTATATGCGTCG","AGCTTCAGTACCAGAGTTAA","561307.5.peg.593","2014"
"27921",200,346,146,"TTGTTGGATGACAATGGCCT","AGCTTCAGTACCAGAGTTAA","561307.5.peg.593","2014"
"27922",206,346,140,"AACAATTGTTGGATGACAA","AGCTTCAGTACCAGAGTTAA","561307.5.peg.593","2014"
"27923",527,346,181,"TTGTAGTGCCTTGAAGTAGG","AGCTTCAGTACCAGAGTTAA","561307.5.peg.593","2014"
"27924",529,346,183,"TGTTGTAGTGCCTTGAAGTA","AGCTTCAGTACCAGAGTTAA","561307.5.peg.593","2014"
"27925",346,500,154,"AGCTTCAGTACCAGAGTTAA","ATCCTGCTTTATATGCGTCG","561307.5.peg.593","2014"
"27926",200,500,300,"TTGTTGGATGACAATGGCCT","ATCCTGCTTTATATGCGTCG","561307.5.peg.593","2014"
"27927",275,500,225,"TCCCGAGATTGTCACTATAA","ATCCTGCTTTATATGCGTCG","561307.5.peg.593","2014"
"27928",102,500,398,"TAGAAATGACAAGCTTAAG","ATCCTGCTTTATATGCGTCG","561307.5.peg.593","2014"
"27929",206,500,294,"AACAATTGTTGGATGACAA","ATCCTGCTTTATATGCGTCG","561307.5.peg.593","2014"
"27930",344,500,156,"CTTCAGTACCAGAGTTAAGG","ATCCTGCTTTATATGCGTCG","561307.5.peg.593","2014"
"27931",102,527,425,"TAGAAATGACAAGCTTAAG","TTGTAGTGCCTTGAAGTAGG","561307.5.peg.593","2014"
"27932",200,527,327,"TTGTTGGATGACAATGGCCT","TTGTAGTGCCTTGAAGTAGG","561307.5.peg.593","2014"
"27933",275,527,252,"TCCCGAGATTGTCACTATAA","TTGTAGTGCCTTGAAGTAGG","561307.5.peg.593","2014"
"27934",206,527,321,"AACAATTGTTGGATGACAA","TTGTAGTGCCTTGAAGTAGG","561307.5.peg.593","2014"
"27935",344,527,183,"CTTCAGTACCAGAGTTAAGG","TTGTAGTGCCTTGAAGTAGG","561307.5.peg.593","2014"
"27936",346,527,181,"AGCTTCAGTACCAGAGTTAA","TTGTAGTGCCTTGAAGTAGG","561307.5.peg.593","2014"
"27937",206,529,323,"AACAATTGTTGGATGACAA","TGTTGTAGTGCCTTGAAGTA","561307.5.peg.593","2014"
"27938",200,529,329,"TTGTTGGATGACAATGGCCT","TGTTGTAGTGCCTTGAAGTA","561307.5.peg.593","2014"
"27939",275,529,254,"TCCCGAGATTGTCACTATAA","TGTTGTAGTGCCTTGAAGTA","561307.5.peg.593","2014"
"27940",102,529,427,"TAGAAATGACAAGCTTAAG","TGTTGTAGTGCCTTGAAGTA","561307.5.peg.593","2014"
"27941",344,529,185,"CTTCAGTACCAGAGTTAAGG","TGTTGTAGTGCCTTGAAGTA","561307.5.peg.593","2014"
"27942",346,529,183,"AGCTTCAGTACCAGAGTTAA","TGTTGTAGTGCCTTGAAGTA","561307.5.peg.593","2014"
"27943",351,121,230,"AATGATGTCGTTGCCAGTCT","TATTGGGAAGATAAGATTGC","561307.5.peg.594","2015"
"27944",567,121,446,"GCATCAGATATGCCACCTAA","TATTGGGAAGATAAGATTGC","561307.5.peg.594","2015"
"27945",563,121,442,"CAGATATGCCACCTAATGGA","TATTGGGAAGATAAGATTGC","561307.5.peg.594","2015"
"27946",652,121,531,"CAATGACGCTAGCGCATCTA","TATTGGGAAGATAAGATTGC","561307.5.peg.594","2015"
"27947",346,121,225,"TGTCGTTGCCAGTCTAGGTA","TATTGGGAAGATAAGATTGC","561307.5.peg.594","2015"
"27948",316,121,195,"TGGTCCGATAACTAGATATA","TATTGGGAAGATAAGATTGC","561307.5.peg.594","2015"
"27949",652,137,515,"CAATGACGCTAGCGCATCTA","CAGCTTGACCCAAGTGTATT","561307.5.peg.594","2015"
"27950",346,137,209,"TGTCGTTGCCAGTCTAGGTA","CAGCTTGACCCAAGTGTATT","561307.5.peg.594","2015"
"27951",567,137,430,"GCATCAGATATGCCACCTAA","CAGCTTGACCCAAGTGTATT","561307.5.peg.594","2015"
"27952",351,137,214,"AATGATGTCGTTGCCAGTCT","CAGCTTGACCCAAGTGTATT","561307.5.peg.594","2015"
"27953",316,137,179,"TGGTCCGATAACTAGATATA","CAGCTTGACCCAAGTGTATT","561307.5.peg.594","2015"
"27954",563,137,426,"CAGATATGCCACCTAATGGA","CAGCTTGACCCAAGTGTATT","561307.5.peg.594","2015"
"27955",563,216,347,"CAGATATGCCACCTAATGGA","TAGCAATGATACCTAGAAA","561307.5.peg.594","2015"
"27956",316,216,100,"TGGTCCGATAACTAGATATA","TAGCAATGATACCTAGAAA","561307.5.peg.594","2015"
"27957",567,216,351,"GCATCAGATATGCCACCTAA","TAGCAATGATACCTAGAAA","561307.5.peg.594","2015"
"27958",652,216,436,"CAATGACGCTAGCGCATCTA","TAGCAATGATACCTAGAAA","561307.5.peg.594","2015"
"27959",351,216,135,"AATGATGTCGTTGCCAGTCT","TAGCAATGATACCTAGAAA","561307.5.peg.594","2015"
"27960",346,216,130,"TGTCGTTGCCAGTCTAGGTA","TAGCAATGATACCTAGAAA","561307.5.peg.594","2015"
"27961",121,316,195,"TATTGGGAAGATAAGATTGC","TGGTCCGATAACTAGATATA","561307.5.peg.594","2015"
"27962",567,316,251,"GCATCAGATATGCCACCTAA","TGGTCCGATAACTAGATATA","561307.5.peg.594","2015"
"27963",563,316,247,"CAGATATGCCACCTAATGGA","TGGTCCGATAACTAGATATA","561307.5.peg.594","2015"
"27964",137,316,179,"CAGCTTGACCCAAGTGTATT","TGGTCCGATAACTAGATATA","561307.5.peg.594","2015"
"27965",216,316,100,"TAGCAATGATACCTAGAAA","TGGTCCGATAACTAGATATA","561307.5.peg.594","2015"
"27966",652,316,336,"CAATGACGCTAGCGCATCTA","TGGTCCGATAACTAGATATA","561307.5.peg.594","2015"
"27967",563,346,217,"CAGATATGCCACCTAATGGA","TGTCGTTGCCAGTCTAGGTA","561307.5.peg.594","2015"
"27968",121,346,225,"TATTGGGAAGATAAGATTGC","TGTCGTTGCCAGTCTAGGTA","561307.5.peg.594","2015"
"27969",137,346,209,"CAGCTTGACCCAAGTGTATT","TGTCGTTGCCAGTCTAGGTA","561307.5.peg.594","2015"
"27970",216,346,130,"TAGCAATGATACCTAGAAA","TGTCGTTGCCAGTCTAGGTA","561307.5.peg.594","2015"
"27971",567,346,221,"GCATCAGATATGCCACCTAA","TGTCGTTGCCAGTCTAGGTA","561307.5.peg.594","2015"
"27972",652,346,306,"CAATGACGCTAGCGCATCTA","TGTCGTTGCCAGTCTAGGTA","561307.5.peg.594","2015"
"27973",137,351,214,"CAGCTTGACCCAAGTGTATT","AATGATGTCGTTGCCAGTCT","561307.5.peg.594","2015"
"27974",563,351,212,"CAGATATGCCACCTAATGGA","AATGATGTCGTTGCCAGTCT","561307.5.peg.594","2015"
"27975",652,351,301,"CAATGACGCTAGCGCATCTA","AATGATGTCGTTGCCAGTCT","561307.5.peg.594","2015"
"27976",121,351,230,"TATTGGGAAGATAAGATTGC","AATGATGTCGTTGCCAGTCT","561307.5.peg.594","2015"
"27977",216,351,135,"TAGCAATGATACCTAGAAA","AATGATGTCGTTGCCAGTCT","561307.5.peg.594","2015"
"27978",567,351,216,"GCATCAGATATGCCACCTAA","AATGATGTCGTTGCCAGTCT","561307.5.peg.594","2015"
"27979",137,563,426,"CAGCTTGACCCAAGTGTATT","CAGATATGCCACCTAATGGA","561307.5.peg.594","2015"
"27980",121,563,442,"TATTGGGAAGATAAGATTGC","CAGATATGCCACCTAATGGA","561307.5.peg.594","2015"
"27981",346,563,217,"TGTCGTTGCCAGTCTAGGTA","CAGATATGCCACCTAATGGA","561307.5.peg.594","2015"
"27982",351,563,212,"AATGATGTCGTTGCCAGTCT","CAGATATGCCACCTAATGGA","561307.5.peg.594","2015"
"27983",216,563,347,"TAGCAATGATACCTAGAAA","CAGATATGCCACCTAATGGA","561307.5.peg.594","2015"
"27984",316,563,247,"TGGTCCGATAACTAGATATA","CAGATATGCCACCTAATGGA","561307.5.peg.594","2015"
"27985",137,567,430,"CAGCTTGACCCAAGTGTATT","GCATCAGATATGCCACCTAA","561307.5.peg.594","2015"
"27986",351,567,216,"AATGATGTCGTTGCCAGTCT","GCATCAGATATGCCACCTAA","561307.5.peg.594","2015"
"27987",216,567,351,"TAGCAATGATACCTAGAAA","GCATCAGATATGCCACCTAA","561307.5.peg.594","2015"
"27988",121,567,446,"TATTGGGAAGATAAGATTGC","GCATCAGATATGCCACCTAA","561307.5.peg.594","2015"
"27989",316,567,251,"TGGTCCGATAACTAGATATA","GCATCAGATATGCCACCTAA","561307.5.peg.594","2015"
"27990",346,567,221,"TGTCGTTGCCAGTCTAGGTA","GCATCAGATATGCCACCTAA","561307.5.peg.594","2015"
"27991",316,652,336,"TGGTCCGATAACTAGATATA","CAATGACGCTAGCGCATCTA","561307.5.peg.594","2015"
"27992",346,652,306,"TGTCGTTGCCAGTCTAGGTA","CAATGACGCTAGCGCATCTA","561307.5.peg.594","2015"
"27993",137,652,515,"CAGCTTGACCCAAGTGTATT","CAATGACGCTAGCGCATCTA","561307.5.peg.594","2015"
"27994",216,652,436,"TAGCAATGATACCTAGAAA","CAATGACGCTAGCGCATCTA","561307.5.peg.594","2015"
"27995",121,652,531,"TATTGGGAAGATAAGATTGC","CAATGACGCTAGCGCATCTA","561307.5.peg.594","2015"
"27996",351,652,301,"AATGATGTCGTTGCCAGTCT","CAATGACGCTAGCGCATCTA","561307.5.peg.594","2015"
"27997",517,289,228,"TAAATGAACTGGGCGTCTTT","TGAACCTGCGATACCGTTGA","561307.5.peg.596","2017"
"27998",445,289,156,"TGTGATATAACCTTGTGCAA","TGAACCTGCGATACCGTTGA","561307.5.peg.596","2017"
"27999",750,289,461,"CCTAATGAAAGTTGTGCTAC","TGAACCTGCGATACCGTTGA","561307.5.peg.596","2017"
"28000",546,289,257,"TCAGAGATTGCGACATCGAT","TGAACCTGCGATACCGTTGA","561307.5.peg.596","2017"
"28001",707,289,418,"ATCTTCTAATTCTTGATGG","TGAACCTGCGATACCGTTGA","561307.5.peg.596","2017"
"28002",669,289,380,"TCATGTCCAGTAATGATGAT","TGAACCTGCGATACCGTTGA","561307.5.peg.596","2017"
"28003",527,289,238,"TGGTAAATGTAAATGAACT","TGAACCTGCGATACCGTTGA","561307.5.peg.596","2017"
"28004",585,289,296,"TTAGTTGCCGTCACTTCAAA","TGAACCTGCGATACCGTTGA","561307.5.peg.596","2017"
"28005",669,327,342,"TCATGTCCAGTAATGATGAT","GCACCTGTAATCGCAATGAC","561307.5.peg.596","2017"
"28006",517,327,190,"TAAATGAACTGGGCGTCTTT","GCACCTGTAATCGCAATGAC","561307.5.peg.596","2017"
"28007",527,327,200,"TGGTAAATGTAAATGAACT","GCACCTGTAATCGCAATGAC","561307.5.peg.596","2017"
"28008",585,327,258,"TTAGTTGCCGTCACTTCAAA","GCACCTGTAATCGCAATGAC","561307.5.peg.596","2017"
"28009",445,327,118,"TGTGATATAACCTTGTGCAA","GCACCTGTAATCGCAATGAC","561307.5.peg.596","2017"
"28010",750,327,423,"CCTAATGAAAGTTGTGCTAC","GCACCTGTAATCGCAATGAC","561307.5.peg.596","2017"
"28011",546,327,219,"TCAGAGATTGCGACATCGAT","GCACCTGTAATCGCAATGAC","561307.5.peg.596","2017"
"28012",707,327,380,"ATCTTCTAATTCTTGATGG","GCACCTGTAATCGCAATGAC","561307.5.peg.596","2017"
"28013",669,351,318,"TCATGTCCAGTAATGATGAT","CCTTGTTCAACAGCACGTGT","561307.5.peg.596","2017"
"28014",527,351,176,"TGGTAAATGTAAATGAACT","CCTTGTTCAACAGCACGTGT","561307.5.peg.596","2017"
"28015",750,351,399,"CCTAATGAAAGTTGTGCTAC","CCTTGTTCAACAGCACGTGT","561307.5.peg.596","2017"
"28016",546,351,195,"TCAGAGATTGCGACATCGAT","CCTTGTTCAACAGCACGTGT","561307.5.peg.596","2017"
"28017",585,351,234,"TTAGTTGCCGTCACTTCAAA","CCTTGTTCAACAGCACGTGT","561307.5.peg.596","2017"
"28018",707,351,356,"ATCTTCTAATTCTTGATGG","CCTTGTTCAACAGCACGTGT","561307.5.peg.596","2017"
"28019",517,351,166,"TAAATGAACTGGGCGTCTTT","CCTTGTTCAACAGCACGTGT","561307.5.peg.596","2017"
"28020",546,445,101,"TCAGAGATTGCGACATCGAT","TGTGATATAACCTTGTGCAA","561307.5.peg.596","2017"
"28021",289,445,156,"TGAACCTGCGATACCGTTGA","TGTGATATAACCTTGTGCAA","561307.5.peg.596","2017"
"28022",327,445,118,"GCACCTGTAATCGCAATGAC","TGTGATATAACCTTGTGCAA","561307.5.peg.596","2017"
"28023",669,445,224,"TCATGTCCAGTAATGATGAT","TGTGATATAACCTTGTGCAA","561307.5.peg.596","2017"
"28024",750,445,305,"CCTAATGAAAGTTGTGCTAC","TGTGATATAACCTTGTGCAA","561307.5.peg.596","2017"
"28025",585,445,140,"TTAGTTGCCGTCACTTCAAA","TGTGATATAACCTTGTGCAA","561307.5.peg.596","2017"
"28026",707,445,262,"ATCTTCTAATTCTTGATGG","TGTGATATAACCTTGTGCAA","561307.5.peg.596","2017"
"28027",669,517,152,"TCATGTCCAGTAATGATGAT","TAAATGAACTGGGCGTCTTT","561307.5.peg.596","2017"
"28028",327,517,190,"GCACCTGTAATCGCAATGAC","TAAATGAACTGGGCGTCTTT","561307.5.peg.596","2017"
"28029",351,517,166,"CCTTGTTCAACAGCACGTGT","TAAATGAACTGGGCGTCTTT","561307.5.peg.596","2017"
"28030",289,517,228,"TGAACCTGCGATACCGTTGA","TAAATGAACTGGGCGTCTTT","561307.5.peg.596","2017"
"28031",750,517,233,"CCTAATGAAAGTTGTGCTAC","TAAATGAACTGGGCGTCTTT","561307.5.peg.596","2017"
"28032",707,517,190,"ATCTTCTAATTCTTGATGG","TAAATGAACTGGGCGTCTTT","561307.5.peg.596","2017"
"28033",351,527,176,"CCTTGTTCAACAGCACGTGT","TGGTAAATGTAAATGAACT","561307.5.peg.596","2017"
"28034",289,527,238,"TGAACCTGCGATACCGTTGA","TGGTAAATGTAAATGAACT","561307.5.peg.596","2017"
"28035",669,527,142,"TCATGTCCAGTAATGATGAT","TGGTAAATGTAAATGAACT","561307.5.peg.596","2017"
"28036",707,527,180,"ATCTTCTAATTCTTGATGG","TGGTAAATGTAAATGAACT","561307.5.peg.596","2017"
"28037",327,527,200,"GCACCTGTAATCGCAATGAC","TGGTAAATGTAAATGAACT","561307.5.peg.596","2017"
"28038",750,527,223,"CCTAATGAAAGTTGTGCTAC","TGGTAAATGTAAATGAACT","561307.5.peg.596","2017"
"28039",707,546,161,"ATCTTCTAATTCTTGATGG","TCAGAGATTGCGACATCGAT","561307.5.peg.596","2017"
"28040",289,546,257,"TGAACCTGCGATACCGTTGA","TCAGAGATTGCGACATCGAT","561307.5.peg.596","2017"
"28041",750,546,204,"CCTAATGAAAGTTGTGCTAC","TCAGAGATTGCGACATCGAT","561307.5.peg.596","2017"
"28042",327,546,219,"GCACCTGTAATCGCAATGAC","TCAGAGATTGCGACATCGAT","561307.5.peg.596","2017"
"28043",445,546,101,"TGTGATATAACCTTGTGCAA","TCAGAGATTGCGACATCGAT","561307.5.peg.596","2017"
"28044",351,546,195,"CCTTGTTCAACAGCACGTGT","TCAGAGATTGCGACATCGAT","561307.5.peg.596","2017"
"28045",669,546,123,"TCATGTCCAGTAATGATGAT","TCAGAGATTGCGACATCGAT","561307.5.peg.596","2017"
"28046",351,585,234,"CCTTGTTCAACAGCACGTGT","TTAGTTGCCGTCACTTCAAA","561307.5.peg.596","2017"
"28047",445,585,140,"TGTGATATAACCTTGTGCAA","TTAGTTGCCGTCACTTCAAA","561307.5.peg.596","2017"
"28048",327,585,258,"GCACCTGTAATCGCAATGAC","TTAGTTGCCGTCACTTCAAA","561307.5.peg.596","2017"
"28049",289,585,296,"TGAACCTGCGATACCGTTGA","TTAGTTGCCGTCACTTCAAA","561307.5.peg.596","2017"
"28050",707,585,122,"ATCTTCTAATTCTTGATGG","TTAGTTGCCGTCACTTCAAA","561307.5.peg.596","2017"
"28051",750,585,165,"CCTAATGAAAGTTGTGCTAC","TTAGTTGCCGTCACTTCAAA","561307.5.peg.596","2017"
"28052",289,669,380,"TGAACCTGCGATACCGTTGA","TCATGTCCAGTAATGATGAT","561307.5.peg.596","2017"
"28053",517,669,152,"TAAATGAACTGGGCGTCTTT","TCATGTCCAGTAATGATGAT","561307.5.peg.596","2017"
"28054",351,669,318,"CCTTGTTCAACAGCACGTGT","TCATGTCCAGTAATGATGAT","561307.5.peg.596","2017"
"28055",546,669,123,"TCAGAGATTGCGACATCGAT","TCATGTCCAGTAATGATGAT","561307.5.peg.596","2017"
"28056",327,669,342,"GCACCTGTAATCGCAATGAC","TCATGTCCAGTAATGATGAT","561307.5.peg.596","2017"
"28057",445,669,224,"TGTGATATAACCTTGTGCAA","TCATGTCCAGTAATGATGAT","561307.5.peg.596","2017"
"28058",527,669,142,"TGGTAAATGTAAATGAACT","TCATGTCCAGTAATGATGAT","561307.5.peg.596","2017"
"28059",327,707,380,"GCACCTGTAATCGCAATGAC","ATCTTCTAATTCTTGATGG","561307.5.peg.596","2017"
"28060",445,707,262,"TGTGATATAACCTTGTGCAA","ATCTTCTAATTCTTGATGG","561307.5.peg.596","2017"
"28061",585,707,122,"TTAGTTGCCGTCACTTCAAA","ATCTTCTAATTCTTGATGG","561307.5.peg.596","2017"
"28062",351,707,356,"CCTTGTTCAACAGCACGTGT","ATCTTCTAATTCTTGATGG","561307.5.peg.596","2017"
"28063",546,707,161,"TCAGAGATTGCGACATCGAT","ATCTTCTAATTCTTGATGG","561307.5.peg.596","2017"
"28064",289,707,418,"TGAACCTGCGATACCGTTGA","ATCTTCTAATTCTTGATGG","561307.5.peg.596","2017"
"28065",517,707,190,"TAAATGAACTGGGCGTCTTT","ATCTTCTAATTCTTGATGG","561307.5.peg.596","2017"
"28066",527,707,180,"TGGTAAATGTAAATGAACT","ATCTTCTAATTCTTGATGG","561307.5.peg.596","2017"
"28067",289,750,461,"TGAACCTGCGATACCGTTGA","CCTAATGAAAGTTGTGCTAC","561307.5.peg.596","2017"
"28068",517,750,233,"TAAATGAACTGGGCGTCTTT","CCTAATGAAAGTTGTGCTAC","561307.5.peg.596","2017"
"28069",327,750,423,"GCACCTGTAATCGCAATGAC","CCTAATGAAAGTTGTGCTAC","561307.5.peg.596","2017"
"28070",445,750,305,"TGTGATATAACCTTGTGCAA","CCTAATGAAAGTTGTGCTAC","561307.5.peg.596","2017"
"28071",351,750,399,"CCTTGTTCAACAGCACGTGT","CCTAATGAAAGTTGTGCTAC","561307.5.peg.596","2017"
"28072",527,750,223,"TGGTAAATGTAAATGAACT","CCTAATGAAAGTTGTGCTAC","561307.5.peg.596","2017"
"28073",546,750,204,"TCAGAGATTGCGACATCGAT","CCTAATGAAAGTTGTGCTAC","561307.5.peg.596","2017"
"28074",585,750,165,"TTAGTTGCCGTCACTTCAAA","CCTAATGAAAGTTGTGCTAC","561307.5.peg.596","2017"
"28075",564,5,559,"GATGTTGTAGCCATCATAAT","TAAATACAACTTTGGAGGT","561307.5.peg.597","2018"
"28076",481,5,476,"GTTATAACACCAAGCTGCCA","TAAATACAACTTTGGAGGT","561307.5.peg.597","2018"
"28077",437,5,432,"ACACACCTGTTTGTAATGTT","TAAATACAACTTTGGAGGT","561307.5.peg.597","2018"
"28078",387,5,382,"GCTGGATCACCAATATTCTT","TAAATACAACTTTGGAGGT","561307.5.peg.597","2018"
"28079",753,5,748,"GAACCAAACTCGAACCAGAA","TAAATACAACTTTGGAGGT","561307.5.peg.597","2018"
"28080",746,5,741,"ACTCGAACCAGAACGGTGCG","TAAATACAACTTTGGAGGT","561307.5.peg.597","2018"
"28081",405,5,400,"ATGCTAGCGTAACCACTCGC","TAAATACAACTTTGGAGGT","561307.5.peg.597","2018"
"28082",120,5,115,"GCTAATAACAGACCAGCTGC","TAAATACAACTTTGGAGGT","561307.5.peg.597","2018"
"28083",405,120,285,"ATGCTAGCGTAACCACTCGC","GCTAATAACAGACCAGCTGC","561307.5.peg.597","2018"
"28084",481,120,361,"GTTATAACACCAAGCTGCCA","GCTAATAACAGACCAGCTGC","561307.5.peg.597","2018"
"28085",437,120,317,"ACACACCTGTTTGTAATGTT","GCTAATAACAGACCAGCTGC","561307.5.peg.597","2018"
"28086",746,120,626,"ACTCGAACCAGAACGGTGCG","GCTAATAACAGACCAGCTGC","561307.5.peg.597","2018"
"28087",753,120,633,"GAACCAAACTCGAACCAGAA","GCTAATAACAGACCAGCTGC","561307.5.peg.597","2018"
"28088",387,120,267,"GCTGGATCACCAATATTCTT","GCTAATAACAGACCAGCTGC","561307.5.peg.597","2018"
"28089",5,120,115,"TAAATACAACTTTGGAGGT","GCTAATAACAGACCAGCTGC","561307.5.peg.597","2018"
"28090",564,120,444,"GATGTTGTAGCCATCATAAT","GCTAATAACAGACCAGCTGC","561307.5.peg.597","2018"
"28091",5,387,382,"TAAATACAACTTTGGAGGT","GCTGGATCACCAATATTCTT","561307.5.peg.597","2018"
"28092",120,387,267,"GCTAATAACAGACCAGCTGC","GCTGGATCACCAATATTCTT","561307.5.peg.597","2018"
"28093",746,387,359,"ACTCGAACCAGAACGGTGCG","GCTGGATCACCAATATTCTT","561307.5.peg.597","2018"
"28094",564,387,177,"GATGTTGTAGCCATCATAAT","GCTGGATCACCAATATTCTT","561307.5.peg.597","2018"
"28095",753,387,366,"GAACCAAACTCGAACCAGAA","GCTGGATCACCAATATTCTT","561307.5.peg.597","2018"
"28096",120,405,285,"GCTAATAACAGACCAGCTGC","ATGCTAGCGTAACCACTCGC","561307.5.peg.597","2018"
"28097",746,405,341,"ACTCGAACCAGAACGGTGCG","ATGCTAGCGTAACCACTCGC","561307.5.peg.597","2018"
"28098",564,405,159,"GATGTTGTAGCCATCATAAT","ATGCTAGCGTAACCACTCGC","561307.5.peg.597","2018"
"28099",5,405,400,"TAAATACAACTTTGGAGGT","ATGCTAGCGTAACCACTCGC","561307.5.peg.597","2018"
"28100",753,405,348,"GAACCAAACTCGAACCAGAA","ATGCTAGCGTAACCACTCGC","561307.5.peg.597","2018"
"28101",5,437,432,"TAAATACAACTTTGGAGGT","ACACACCTGTTTGTAATGTT","561307.5.peg.597","2018"
"28102",120,437,317,"GCTAATAACAGACCAGCTGC","ACACACCTGTTTGTAATGTT","561307.5.peg.597","2018"
"28103",564,437,127,"GATGTTGTAGCCATCATAAT","ACACACCTGTTTGTAATGTT","561307.5.peg.597","2018"
"28104",753,437,316,"GAACCAAACTCGAACCAGAA","ACACACCTGTTTGTAATGTT","561307.5.peg.597","2018"
"28105",746,437,309,"ACTCGAACCAGAACGGTGCG","ACACACCTGTTTGTAATGTT","561307.5.peg.597","2018"
"28106",5,481,476,"TAAATACAACTTTGGAGGT","GTTATAACACCAAGCTGCCA","561307.5.peg.597","2018"
"28107",120,481,361,"GCTAATAACAGACCAGCTGC","GTTATAACACCAAGCTGCCA","561307.5.peg.597","2018"
"28108",753,481,272,"GAACCAAACTCGAACCAGAA","GTTATAACACCAAGCTGCCA","561307.5.peg.597","2018"
"28109",746,481,265,"ACTCGAACCAGAACGGTGCG","GTTATAACACCAAGCTGCCA","561307.5.peg.597","2018"
"28110",5,564,559,"TAAATACAACTTTGGAGGT","GATGTTGTAGCCATCATAAT","561307.5.peg.597","2018"
"28111",387,564,177,"GCTGGATCACCAATATTCTT","GATGTTGTAGCCATCATAAT","561307.5.peg.597","2018"
"28112",437,564,127,"ACACACCTGTTTGTAATGTT","GATGTTGTAGCCATCATAAT","561307.5.peg.597","2018"
"28113",746,564,182,"ACTCGAACCAGAACGGTGCG","GATGTTGTAGCCATCATAAT","561307.5.peg.597","2018"
"28114",405,564,159,"ATGCTAGCGTAACCACTCGC","GATGTTGTAGCCATCATAAT","561307.5.peg.597","2018"
"28115",120,564,444,"GCTAATAACAGACCAGCTGC","GATGTTGTAGCCATCATAAT","561307.5.peg.597","2018"
"28116",753,564,189,"GAACCAAACTCGAACCAGAA","GATGTTGTAGCCATCATAAT","561307.5.peg.597","2018"
"28117",405,746,341,"ATGCTAGCGTAACCACTCGC","ACTCGAACCAGAACGGTGCG","561307.5.peg.597","2018"
"28118",437,746,309,"ACACACCTGTTTGTAATGTT","ACTCGAACCAGAACGGTGCG","561307.5.peg.597","2018"
"28119",5,746,741,"TAAATACAACTTTGGAGGT","ACTCGAACCAGAACGGTGCG","561307.5.peg.597","2018"
"28120",387,746,359,"GCTGGATCACCAATATTCTT","ACTCGAACCAGAACGGTGCG","561307.5.peg.597","2018"
"28121",481,746,265,"GTTATAACACCAAGCTGCCA","ACTCGAACCAGAACGGTGCG","561307.5.peg.597","2018"
"28122",120,746,626,"GCTAATAACAGACCAGCTGC","ACTCGAACCAGAACGGTGCG","561307.5.peg.597","2018"
"28123",564,746,182,"GATGTTGTAGCCATCATAAT","ACTCGAACCAGAACGGTGCG","561307.5.peg.597","2018"
"28124",5,753,748,"TAAATACAACTTTGGAGGT","GAACCAAACTCGAACCAGAA","561307.5.peg.597","2018"
"28125",387,753,366,"GCTGGATCACCAATATTCTT","GAACCAAACTCGAACCAGAA","561307.5.peg.597","2018"
"28126",437,753,316,"ACACACCTGTTTGTAATGTT","GAACCAAACTCGAACCAGAA","561307.5.peg.597","2018"
"28127",120,753,633,"GCTAATAACAGACCAGCTGC","GAACCAAACTCGAACCAGAA","561307.5.peg.597","2018"
"28128",564,753,189,"GATGTTGTAGCCATCATAAT","GAACCAAACTCGAACCAGAA","561307.5.peg.597","2018"
"28129",481,753,272,"GTTATAACACCAAGCTGCCA","GAACCAAACTCGAACCAGAA","561307.5.peg.597","2018"
"28130",405,753,348,"ATGCTAGCGTAACCACTCGC","GAACCAAACTCGAACCAGAA","561307.5.peg.597","2018"
"28131",275,153,122,"GTGCATCATATTGTCGAAGA","TTTGTCTCGTCATCTTCTTC","561307.5.peg.598","2019"
"28132",468,153,315,"GATAATCCCGTATCTGGTCT","TTTGTCTCGTCATCTTCTTC","561307.5.peg.598","2019"
"28133",394,153,241,"TAAGCTTGTTAACAATTCCC","TTTGTCTCGTCATCTTCTTC","561307.5.peg.598","2019"
"28134",474,153,321,"TCAACAGATAATCCCGTATC","TTTGTCTCGTCATCTTCTTC","561307.5.peg.598","2019"
"28135",394,230,164,"TAAGCTTGTTAACAATTCCC","TAGATGGATTAGCATCTATG","561307.5.peg.598","2019"
"28136",474,230,244,"TCAACAGATAATCCCGTATC","TAGATGGATTAGCATCTATG","561307.5.peg.598","2019"
"28137",468,230,238,"GATAATCCCGTATCTGGTCT","TAGATGGATTAGCATCTATG","561307.5.peg.598","2019"
"28138",153,275,122,"TTTGTCTCGTCATCTTCTTC","GTGCATCATATTGTCGAAGA","561307.5.peg.598","2019"
"28139",394,275,119,"TAAGCTTGTTAACAATTCCC","GTGCATCATATTGTCGAAGA","561307.5.peg.598","2019"
"28140",474,275,199,"TCAACAGATAATCCCGTATC","GTGCATCATATTGTCGAAGA","561307.5.peg.598","2019"
"28141",468,275,193,"GATAATCCCGTATCTGGTCT","GTGCATCATATTGTCGAAGA","561307.5.peg.598","2019"
"28142",230,394,164,"TAGATGGATTAGCATCTATG","TAAGCTTGTTAACAATTCCC","561307.5.peg.598","2019"
"28143",153,394,241,"TTTGTCTCGTCATCTTCTTC","TAAGCTTGTTAACAATTCCC","561307.5.peg.598","2019"
"28144",275,394,119,"GTGCATCATATTGTCGAAGA","TAAGCTTGTTAACAATTCCC","561307.5.peg.598","2019"
"28145",230,468,238,"TAGATGGATTAGCATCTATG","GATAATCCCGTATCTGGTCT","561307.5.peg.598","2019"
"28146",153,468,315,"TTTGTCTCGTCATCTTCTTC","GATAATCCCGTATCTGGTCT","561307.5.peg.598","2019"
"28147",275,468,193,"GTGCATCATATTGTCGAAGA","GATAATCCCGTATCTGGTCT","561307.5.peg.598","2019"
"28148",153,474,321,"TTTGTCTCGTCATCTTCTTC","TCAACAGATAATCCCGTATC","561307.5.peg.598","2019"
"28149",230,474,244,"TAGATGGATTAGCATCTATG","TCAACAGATAATCCCGTATC","561307.5.peg.598","2019"
"28150",275,474,199,"GTGCATCATATTGTCGAAGA","TCAACAGATAATCCCGTATC","561307.5.peg.598","2019"
"28151",300,67,233,"TGAGGGTCAGTATTGAATGT","CGTCGCTTCATTACGCGCTT","561307.5.peg.599","2020"
"28152",300,155,145,"TGAGGGTCAGTATTGAATGT","TTGCCTTTCGAACTGCTAAC","561307.5.peg.599","2020"
"28153",67,300,233,"CGTCGCTTCATTACGCGCTT","TGAGGGTCAGTATTGAATGT","561307.5.peg.599","2020"
"28154",155,300,145,"TTGCCTTTCGAACTGCTAAC","TGAGGGTCAGTATTGAATGT","561307.5.peg.599","2020"
"28155",471,7,464,"AATCCAGCTCCAATAAATGC","AGAGATAGACAACCTTAGGA","561307.5.peg.600","2023"
"28156",311,7,304,"CATTGTGATGGTGTGGTATT","AGAGATAGACAACCTTAGGA","561307.5.peg.600","2023"
"28157",462,7,455,"CCAATAAATGCAGGAATCAA","AGAGATAGACAACCTTAGGA","561307.5.peg.600","2023"
"28158",318,7,311,"TCACTATCATTGTGATGGTG","AGAGATAGACAACCTTAGGA","561307.5.peg.600","2023"
"28159",747,7,740,"CCACCTTGTCCAGGTTGCAA","AGAGATAGACAACCTTAGGA","561307.5.peg.600","2023"
"28160",179,7,172,"CATCAATATGCCTTAGTTCT","AGAGATAGACAACCTTAGGA","561307.5.peg.600","2023"
"28161",660,7,653,"CCAATCACGCCACCAAGTCC","AGAGATAGACAACCTTAGGA","561307.5.peg.600","2023"
"28162",179,11,168,"CATCAATATGCCTTAGTTCT","AATCAGAGATAGACAACCTT","561307.5.peg.600","2023"
"28163",660,11,649,"CCAATCACGCCACCAAGTCC","AATCAGAGATAGACAACCTT","561307.5.peg.600","2023"
"28164",311,11,300,"CATTGTGATGGTGTGGTATT","AATCAGAGATAGACAACCTT","561307.5.peg.600","2023"
"28165",318,11,307,"TCACTATCATTGTGATGGTG","AATCAGAGATAGACAACCTT","561307.5.peg.600","2023"
"28166",462,11,451,"CCAATAAATGCAGGAATCAA","AATCAGAGATAGACAACCTT","561307.5.peg.600","2023"
"28167",747,11,736,"CCACCTTGTCCAGGTTGCAA","AATCAGAGATAGACAACCTT","561307.5.peg.600","2023"
"28168",471,11,460,"AATCCAGCTCCAATAAATGC","AATCAGAGATAGACAACCTT","561307.5.peg.600","2023"
"28169",462,34,428,"CCAATAAATGCAGGAATCAA","GGTCATTTAAATCCCTCCTA","561307.5.peg.600","2023"
"28170",179,34,145,"CATCAATATGCCTTAGTTCT","GGTCATTTAAATCCCTCCTA","561307.5.peg.600","2023"
"28171",318,34,284,"TCACTATCATTGTGATGGTG","GGTCATTTAAATCCCTCCTA","561307.5.peg.600","2023"
"28172",471,34,437,"AATCCAGCTCCAATAAATGC","GGTCATTTAAATCCCTCCTA","561307.5.peg.600","2023"
"28173",660,34,626,"CCAATCACGCCACCAAGTCC","GGTCATTTAAATCCCTCCTA","561307.5.peg.600","2023"
"28174",311,34,277,"CATTGTGATGGTGTGGTATT","GGTCATTTAAATCCCTCCTA","561307.5.peg.600","2023"
"28175",747,34,713,"CCACCTTGTCCAGGTTGCAA","GGTCATTTAAATCCCTCCTA","561307.5.peg.600","2023"
"28176",660,55,605,"CCAATCACGCCACCAAGTCC","TTCTGCAAGTTGTTGTTCTT","561307.5.peg.600","2023"
"28177",318,55,263,"TCACTATCATTGTGATGGTG","TTCTGCAAGTTGTTGTTCTT","561307.5.peg.600","2023"
"28178",179,55,124,"CATCAATATGCCTTAGTTCT","TTCTGCAAGTTGTTGTTCTT","561307.5.peg.600","2023"
"28179",311,55,256,"CATTGTGATGGTGTGGTATT","TTCTGCAAGTTGTTGTTCTT","561307.5.peg.600","2023"
"28180",747,55,692,"CCACCTTGTCCAGGTTGCAA","TTCTGCAAGTTGTTGTTCTT","561307.5.peg.600","2023"
"28181",462,55,407,"CCAATAAATGCAGGAATCAA","TTCTGCAAGTTGTTGTTCTT","561307.5.peg.600","2023"
"28182",471,55,416,"AATCCAGCTCCAATAAATGC","TTCTGCAAGTTGTTGTTCTT","561307.5.peg.600","2023"
"28183",7,179,172,"AGAGATAGACAACCTTAGGA","CATCAATATGCCTTAGTTCT","561307.5.peg.600","2023"
"28184",55,179,124,"TTCTGCAAGTTGTTGTTCTT","CATCAATATGCCTTAGTTCT","561307.5.peg.600","2023"
"28185",318,179,139,"TCACTATCATTGTGATGGTG","CATCAATATGCCTTAGTTCT","561307.5.peg.600","2023"
"28186",462,179,283,"CCAATAAATGCAGGAATCAA","CATCAATATGCCTTAGTTCT","561307.5.peg.600","2023"
"28187",34,179,145,"GGTCATTTAAATCCCTCCTA","CATCAATATGCCTTAGTTCT","561307.5.peg.600","2023"
"28188",311,179,132,"CATTGTGATGGTGTGGTATT","CATCAATATGCCTTAGTTCT","561307.5.peg.600","2023"
"28189",660,179,481,"CCAATCACGCCACCAAGTCC","CATCAATATGCCTTAGTTCT","561307.5.peg.600","2023"
"28190",11,179,168,"AATCAGAGATAGACAACCTT","CATCAATATGCCTTAGTTCT","561307.5.peg.600","2023"
"28191",471,179,292,"AATCCAGCTCCAATAAATGC","CATCAATATGCCTTAGTTCT","561307.5.peg.600","2023"
"28192",747,179,568,"CCACCTTGTCCAGGTTGCAA","CATCAATATGCCTTAGTTCT","561307.5.peg.600","2023"
"28193",462,311,151,"CCAATAAATGCAGGAATCAA","CATTGTGATGGTGTGGTATT","561307.5.peg.600","2023"
"28194",660,311,349,"CCAATCACGCCACCAAGTCC","CATTGTGATGGTGTGGTATT","561307.5.peg.600","2023"
"28195",55,311,256,"TTCTGCAAGTTGTTGTTCTT","CATTGTGATGGTGTGGTATT","561307.5.peg.600","2023"
"28196",7,311,304,"AGAGATAGACAACCTTAGGA","CATTGTGATGGTGTGGTATT","561307.5.peg.600","2023"
"28197",747,311,436,"CCACCTTGTCCAGGTTGCAA","CATTGTGATGGTGTGGTATT","561307.5.peg.600","2023"
"28198",34,311,277,"GGTCATTTAAATCCCTCCTA","CATTGTGATGGTGTGGTATT","561307.5.peg.600","2023"
"28199",11,311,300,"AATCAGAGATAGACAACCTT","CATTGTGATGGTGTGGTATT","561307.5.peg.600","2023"
"28200",179,311,132,"CATCAATATGCCTTAGTTCT","CATTGTGATGGTGTGGTATT","561307.5.peg.600","2023"
"28201",471,311,160,"AATCCAGCTCCAATAAATGC","CATTGTGATGGTGTGGTATT","561307.5.peg.600","2023"
"28202",747,318,429,"CCACCTTGTCCAGGTTGCAA","TCACTATCATTGTGATGGTG","561307.5.peg.600","2023"
"28203",471,318,153,"AATCCAGCTCCAATAAATGC","TCACTATCATTGTGATGGTG","561307.5.peg.600","2023"
"28204",11,318,307,"AATCAGAGATAGACAACCTT","TCACTATCATTGTGATGGTG","561307.5.peg.600","2023"
"28205",55,318,263,"TTCTGCAAGTTGTTGTTCTT","TCACTATCATTGTGATGGTG","561307.5.peg.600","2023"
"28206",34,318,284,"GGTCATTTAAATCCCTCCTA","TCACTATCATTGTGATGGTG","561307.5.peg.600","2023"
"28207",462,318,144,"CCAATAAATGCAGGAATCAA","TCACTATCATTGTGATGGTG","561307.5.peg.600","2023"
"28208",660,318,342,"CCAATCACGCCACCAAGTCC","TCACTATCATTGTGATGGTG","561307.5.peg.600","2023"
"28209",7,318,311,"AGAGATAGACAACCTTAGGA","TCACTATCATTGTGATGGTG","561307.5.peg.600","2023"
"28210",179,318,139,"CATCAATATGCCTTAGTTCT","TCACTATCATTGTGATGGTG","561307.5.peg.600","2023"
"28211",660,462,198,"CCAATCACGCCACCAAGTCC","CCAATAAATGCAGGAATCAA","561307.5.peg.600","2023"
"28212",311,462,151,"CATTGTGATGGTGTGGTATT","CCAATAAATGCAGGAATCAA","561307.5.peg.600","2023"
"28213",318,462,144,"TCACTATCATTGTGATGGTG","CCAATAAATGCAGGAATCAA","561307.5.peg.600","2023"
"28214",11,462,451,"AATCAGAGATAGACAACCTT","CCAATAAATGCAGGAATCAA","561307.5.peg.600","2023"
"28215",34,462,428,"GGTCATTTAAATCCCTCCTA","CCAATAAATGCAGGAATCAA","561307.5.peg.600","2023"
"28216",7,462,455,"AGAGATAGACAACCTTAGGA","CCAATAAATGCAGGAATCAA","561307.5.peg.600","2023"
"28217",179,462,283,"CATCAATATGCCTTAGTTCT","CCAATAAATGCAGGAATCAA","561307.5.peg.600","2023"
"28218",55,462,407,"TTCTGCAAGTTGTTGTTCTT","CCAATAAATGCAGGAATCAA","561307.5.peg.600","2023"
"28219",747,462,285,"CCACCTTGTCCAGGTTGCAA","CCAATAAATGCAGGAATCAA","561307.5.peg.600","2023"
"28220",55,471,416,"TTCTGCAAGTTGTTGTTCTT","AATCCAGCTCCAATAAATGC","561307.5.peg.600","2023"
"28221",34,471,437,"GGTCATTTAAATCCCTCCTA","AATCCAGCTCCAATAAATGC","561307.5.peg.600","2023"
"28222",660,471,189,"CCAATCACGCCACCAAGTCC","AATCCAGCTCCAATAAATGC","561307.5.peg.600","2023"
"28223",11,471,460,"AATCAGAGATAGACAACCTT","AATCCAGCTCCAATAAATGC","561307.5.peg.600","2023"
"28224",179,471,292,"CATCAATATGCCTTAGTTCT","AATCCAGCTCCAATAAATGC","561307.5.peg.600","2023"
"28225",318,471,153,"TCACTATCATTGTGATGGTG","AATCCAGCTCCAATAAATGC","561307.5.peg.600","2023"
"28226",7,471,464,"AGAGATAGACAACCTTAGGA","AATCCAGCTCCAATAAATGC","561307.5.peg.600","2023"
"28227",747,471,276,"CCACCTTGTCCAGGTTGCAA","AATCCAGCTCCAATAAATGC","561307.5.peg.600","2023"
"28228",311,471,160,"CATTGTGATGGTGTGGTATT","AATCCAGCTCCAATAAATGC","561307.5.peg.600","2023"
"28229",7,660,653,"AGAGATAGACAACCTTAGGA","CCAATCACGCCACCAAGTCC","561307.5.peg.600","2023"
"28230",471,660,189,"AATCCAGCTCCAATAAATGC","CCAATCACGCCACCAAGTCC","561307.5.peg.600","2023"
"28231",318,660,342,"TCACTATCATTGTGATGGTG","CCAATCACGCCACCAAGTCC","561307.5.peg.600","2023"
"28232",11,660,649,"AATCAGAGATAGACAACCTT","CCAATCACGCCACCAAGTCC","561307.5.peg.600","2023"
"28233",34,660,626,"GGTCATTTAAATCCCTCCTA","CCAATCACGCCACCAAGTCC","561307.5.peg.600","2023"
"28234",311,660,349,"CATTGTGATGGTGTGGTATT","CCAATCACGCCACCAAGTCC","561307.5.peg.600","2023"
"28235",179,660,481,"CATCAATATGCCTTAGTTCT","CCAATCACGCCACCAAGTCC","561307.5.peg.600","2023"
"28236",462,660,198,"CCAATAAATGCAGGAATCAA","CCAATCACGCCACCAAGTCC","561307.5.peg.600","2023"
"28237",55,660,605,"TTCTGCAAGTTGTTGTTCTT","CCAATCACGCCACCAAGTCC","561307.5.peg.600","2023"
"28238",11,747,736,"AATCAGAGATAGACAACCTT","CCACCTTGTCCAGGTTGCAA","561307.5.peg.600","2023"
"28239",179,747,568,"CATCAATATGCCTTAGTTCT","CCACCTTGTCCAGGTTGCAA","561307.5.peg.600","2023"
"28240",471,747,276,"AATCCAGCTCCAATAAATGC","CCACCTTGTCCAGGTTGCAA","561307.5.peg.600","2023"
"28241",462,747,285,"CCAATAAATGCAGGAATCAA","CCACCTTGTCCAGGTTGCAA","561307.5.peg.600","2023"
"28242",7,747,740,"AGAGATAGACAACCTTAGGA","CCACCTTGTCCAGGTTGCAA","561307.5.peg.600","2023"
"28243",55,747,692,"TTCTGCAAGTTGTTGTTCTT","CCACCTTGTCCAGGTTGCAA","561307.5.peg.600","2023"
"28244",311,747,436,"CATTGTGATGGTGTGGTATT","CCACCTTGTCCAGGTTGCAA","561307.5.peg.600","2023"
"28245",318,747,429,"TCACTATCATTGTGATGGTG","CCACCTTGTCCAGGTTGCAA","561307.5.peg.600","2023"
"28246",34,747,713,"GGTCATTTAAATCCCTCCTA","CCACCTTGTCCAGGTTGCAA","561307.5.peg.600","2023"
"28247",297,7,290,"GACTCATCATCACGTCTAAG","CAATAGAAAGTGTATGGAAG","561307.5.peg.602","2025"
"28248",297,9,288,"GACTCATCATCACGTCTAAG","AGCAATAGAAAGTGTATGGA","561307.5.peg.602","2025"
"28249",297,59,238,"GACTCATCATCACGTCTAAG","TTCTAATGCGTATTCACTT","561307.5.peg.602","2025"
"28250",7,297,290,"CAATAGAAAGTGTATGGAAG","GACTCATCATCACGTCTAAG","561307.5.peg.602","2025"
"28251",9,297,288,"AGCAATAGAAAGTGTATGGA","GACTCATCATCACGTCTAAG","561307.5.peg.602","2025"
"28252",59,297,238,"TTCTAATGCGTATTCACTT","GACTCATCATCACGTCTAAG","561307.5.peg.602","2025"
"28253",538,18,520,"ACCAGTGAATCCAAAGTATT","TCATCTTAGCTAATTGACA","561307.5.peg.603","2026"
"28254",260,18,242,"TTTGACTATCCAAGTCTTTA","TCATCTTAGCTAATTGACA","561307.5.peg.603","2026"
"28255",652,18,634,"AGTACATTACCATCATGAA","TCATCTTAGCTAATTGACA","561307.5.peg.603","2026"
"28256",866,18,848,"TAATAAGCGCGTGAATACTT","TCATCTTAGCTAATTGACA","561307.5.peg.603","2026"
"28257",375,18,357,"TGAATCGTCGTTACAATAAG","TCATCTTAGCTAATTGACA","561307.5.peg.603","2026"
"28258",933,18,915,"AATATACCAGCTATCGTTAA","TCATCTTAGCTAATTGACA","561307.5.peg.603","2026"
"28259",337,18,319,"TAGTTGGCGTACCAGTTGCG","TCATCTTAGCTAATTGACA","561307.5.peg.603","2026"
"28260",375,93,282,"TGAATCGTCGTTACAATAAG","TCTACCGCATACACTTGATA","561307.5.peg.603","2026"
"28261",652,93,559,"AGTACATTACCATCATGAA","TCTACCGCATACACTTGATA","561307.5.peg.603","2026"
"28262",866,93,773,"TAATAAGCGCGTGAATACTT","TCTACCGCATACACTTGATA","561307.5.peg.603","2026"
"28263",538,93,445,"ACCAGTGAATCCAAAGTATT","TCTACCGCATACACTTGATA","561307.5.peg.603","2026"
"28264",337,93,244,"TAGTTGGCGTACCAGTTGCG","TCTACCGCATACACTTGATA","561307.5.peg.603","2026"
"28265",933,93,840,"AATATACCAGCTATCGTTAA","TCTACCGCATACACTTGATA","561307.5.peg.603","2026"
"28266",260,93,167,"TTTGACTATCCAAGTCTTTA","TCTACCGCATACACTTGATA","561307.5.peg.603","2026"
"28267",18,260,242,"TCATCTTAGCTAATTGACA","TTTGACTATCCAAGTCTTTA","561307.5.peg.603","2026"
"28268",538,260,278,"ACCAGTGAATCCAAAGTATT","TTTGACTATCCAAGTCTTTA","561307.5.peg.603","2026"
"28269",652,260,392,"AGTACATTACCATCATGAA","TTTGACTATCCAAGTCTTTA","561307.5.peg.603","2026"
"28270",866,260,606,"TAATAAGCGCGTGAATACTT","TTTGACTATCCAAGTCTTTA","561307.5.peg.603","2026"
"28271",375,260,115,"TGAATCGTCGTTACAATAAG","TTTGACTATCCAAGTCTTTA","561307.5.peg.603","2026"
"28272",933,260,673,"AATATACCAGCTATCGTTAA","TTTGACTATCCAAGTCTTTA","561307.5.peg.603","2026"
"28273",93,260,167,"TCTACCGCATACACTTGATA","TTTGACTATCCAAGTCTTTA","561307.5.peg.603","2026"
"28274",18,337,319,"TCATCTTAGCTAATTGACA","TAGTTGGCGTACCAGTTGCG","561307.5.peg.603","2026"
"28275",93,337,244,"TCTACCGCATACACTTGATA","TAGTTGGCGTACCAGTTGCG","561307.5.peg.603","2026"
"28276",933,337,596,"AATATACCAGCTATCGTTAA","TAGTTGGCGTACCAGTTGCG","561307.5.peg.603","2026"
"28277",652,337,315,"AGTACATTACCATCATGAA","TAGTTGGCGTACCAGTTGCG","561307.5.peg.603","2026"
"28278",866,337,529,"TAATAAGCGCGTGAATACTT","TAGTTGGCGTACCAGTTGCG","561307.5.peg.603","2026"
"28279",538,337,201,"ACCAGTGAATCCAAAGTATT","TAGTTGGCGTACCAGTTGCG","561307.5.peg.603","2026"
"28280",18,375,357,"TCATCTTAGCTAATTGACA","TGAATCGTCGTTACAATAAG","561307.5.peg.603","2026"
"28281",652,375,277,"AGTACATTACCATCATGAA","TGAATCGTCGTTACAATAAG","561307.5.peg.603","2026"
"28282",260,375,115,"TTTGACTATCCAAGTCTTTA","TGAATCGTCGTTACAATAAG","561307.5.peg.603","2026"
"28283",93,375,282,"TCTACCGCATACACTTGATA","TGAATCGTCGTTACAATAAG","561307.5.peg.603","2026"
"28284",933,375,558,"AATATACCAGCTATCGTTAA","TGAATCGTCGTTACAATAAG","561307.5.peg.603","2026"
"28285",538,375,163,"ACCAGTGAATCCAAAGTATT","TGAATCGTCGTTACAATAAG","561307.5.peg.603","2026"
"28286",866,375,491,"TAATAAGCGCGTGAATACTT","TGAATCGTCGTTACAATAAG","561307.5.peg.603","2026"
"28287",933,538,395,"AATATACCAGCTATCGTTAA","ACCAGTGAATCCAAAGTATT","561307.5.peg.603","2026"
"28288",375,538,163,"TGAATCGTCGTTACAATAAG","ACCAGTGAATCCAAAGTATT","561307.5.peg.603","2026"
"28289",18,538,520,"TCATCTTAGCTAATTGACA","ACCAGTGAATCCAAAGTATT","561307.5.peg.603","2026"
"28290",866,538,328,"TAATAAGCGCGTGAATACTT","ACCAGTGAATCCAAAGTATT","561307.5.peg.603","2026"
"28291",337,538,201,"TAGTTGGCGTACCAGTTGCG","ACCAGTGAATCCAAAGTATT","561307.5.peg.603","2026"
"28292",260,538,278,"TTTGACTATCCAAGTCTTTA","ACCAGTGAATCCAAAGTATT","561307.5.peg.603","2026"
"28293",652,538,114,"AGTACATTACCATCATGAA","ACCAGTGAATCCAAAGTATT","561307.5.peg.603","2026"
"28294",93,538,445,"TCTACCGCATACACTTGATA","ACCAGTGAATCCAAAGTATT","561307.5.peg.603","2026"
"28295",260,652,392,"TTTGACTATCCAAGTCTTTA","AGTACATTACCATCATGAA","561307.5.peg.603","2026"
"28296",93,652,559,"TCTACCGCATACACTTGATA","AGTACATTACCATCATGAA","561307.5.peg.603","2026"
"28297",337,652,315,"TAGTTGGCGTACCAGTTGCG","AGTACATTACCATCATGAA","561307.5.peg.603","2026"
"28298",18,652,634,"TCATCTTAGCTAATTGACA","AGTACATTACCATCATGAA","561307.5.peg.603","2026"
"28299",866,652,214,"TAATAAGCGCGTGAATACTT","AGTACATTACCATCATGAA","561307.5.peg.603","2026"
"28300",375,652,277,"TGAATCGTCGTTACAATAAG","AGTACATTACCATCATGAA","561307.5.peg.603","2026"
"28301",538,652,114,"ACCAGTGAATCCAAAGTATT","AGTACATTACCATCATGAA","561307.5.peg.603","2026"
"28302",933,652,281,"AATATACCAGCTATCGTTAA","AGTACATTACCATCATGAA","561307.5.peg.603","2026"
"28303",18,866,848,"TCATCTTAGCTAATTGACA","TAATAAGCGCGTGAATACTT","561307.5.peg.603","2026"
"28304",538,866,328,"ACCAGTGAATCCAAAGTATT","TAATAAGCGCGTGAATACTT","561307.5.peg.603","2026"
"28305",93,866,773,"TCTACCGCATACACTTGATA","TAATAAGCGCGTGAATACTT","561307.5.peg.603","2026"
"28306",652,866,214,"AGTACATTACCATCATGAA","TAATAAGCGCGTGAATACTT","561307.5.peg.603","2026"
"28307",337,866,529,"TAGTTGGCGTACCAGTTGCG","TAATAAGCGCGTGAATACTT","561307.5.peg.603","2026"
"28308",260,866,606,"TTTGACTATCCAAGTCTTTA","TAATAAGCGCGTGAATACTT","561307.5.peg.603","2026"
"28309",375,866,491,"TGAATCGTCGTTACAATAAG","TAATAAGCGCGTGAATACTT","561307.5.peg.603","2026"
"28310",538,933,395,"ACCAGTGAATCCAAAGTATT","AATATACCAGCTATCGTTAA","561307.5.peg.603","2026"
"28311",375,933,558,"TGAATCGTCGTTACAATAAG","AATATACCAGCTATCGTTAA","561307.5.peg.603","2026"
"28312",652,933,281,"AGTACATTACCATCATGAA","AATATACCAGCTATCGTTAA","561307.5.peg.603","2026"
"28313",260,933,673,"TTTGACTATCCAAGTCTTTA","AATATACCAGCTATCGTTAA","561307.5.peg.603","2026"
"28314",18,933,915,"TCATCTTAGCTAATTGACA","AATATACCAGCTATCGTTAA","561307.5.peg.603","2026"
"28315",337,933,596,"TAGTTGGCGTACCAGTTGCG","AATATACCAGCTATCGTTAA","561307.5.peg.603","2026"
"28316",93,933,840,"TCTACCGCATACACTTGATA","AATATACCAGCTATCGTTAA","561307.5.peg.603","2026"
"28317",456,333,123,"CGTTTAATGTGTCTATCATC","CTATCATTGCCTTCATCAGA","561307.5.peg.605","2028"
"28318",333,456,123,"CTATCATTGCCTTCATCAGA","CGTTTAATGTGTCTATCATC","561307.5.peg.605","2028"
"28319",366,10,356,"TGTTTGCCAATCGTTAATCT","TTACACATTTGTGAATAGGG","561307.5.peg.607","2030"
"28320",507,10,497,"ATACCACCAGAAAGTTCATG","TTACACATTTGTGAATAGGG","561307.5.peg.607","2030"
"28321",594,10,584,"CTGGCATCTAATGCCGTTGT","TTACACATTTGTGAATAGGG","561307.5.peg.607","2030"
"28322",158,10,148,"CTGATTCACCAACAATACCT","TTACACATTTGTGAATAGGG","561307.5.peg.607","2030"
"28323",649,10,639,"TGTTTCTGTGTACTCATAAA","TTACACATTTGTGAATAGGG","561307.5.peg.607","2030"
"28324",234,10,224,"TCTCCTGTTAATGTGTGATC","TTACACATTTGTGAATAGGG","561307.5.peg.607","2030"
"28325",366,158,208,"TGTTTGCCAATCGTTAATCT","CTGATTCACCAACAATACCT","561307.5.peg.607","2030"
"28326",594,158,436,"CTGGCATCTAATGCCGTTGT","CTGATTCACCAACAATACCT","561307.5.peg.607","2030"
"28327",10,158,148,"TTACACATTTGTGAATAGGG","CTGATTCACCAACAATACCT","561307.5.peg.607","2030"
"28328",507,158,349,"ATACCACCAGAAAGTTCATG","CTGATTCACCAACAATACCT","561307.5.peg.607","2030"
"28329",649,158,491,"TGTTTCTGTGTACTCATAAA","CTGATTCACCAACAATACCT","561307.5.peg.607","2030"
"28330",10,234,224,"TTACACATTTGTGAATAGGG","TCTCCTGTTAATGTGTGATC","561307.5.peg.607","2030"
"28331",649,234,415,"TGTTTCTGTGTACTCATAAA","TCTCCTGTTAATGTGTGATC","561307.5.peg.607","2030"
"28332",366,234,132,"TGTTTGCCAATCGTTAATCT","TCTCCTGTTAATGTGTGATC","561307.5.peg.607","2030"
"28333",594,234,360,"CTGGCATCTAATGCCGTTGT","TCTCCTGTTAATGTGTGATC","561307.5.peg.607","2030"
"28334",507,234,273,"ATACCACCAGAAAGTTCATG","TCTCCTGTTAATGTGTGATC","561307.5.peg.607","2030"
"28335",649,366,283,"TGTTTCTGTGTACTCATAAA","TGTTTGCCAATCGTTAATCT","561307.5.peg.607","2030"
"28336",10,366,356,"TTACACATTTGTGAATAGGG","TGTTTGCCAATCGTTAATCT","561307.5.peg.607","2030"
"28337",507,366,141,"ATACCACCAGAAAGTTCATG","TGTTTGCCAATCGTTAATCT","561307.5.peg.607","2030"
"28338",158,366,208,"CTGATTCACCAACAATACCT","TGTTTGCCAATCGTTAATCT","561307.5.peg.607","2030"
"28339",234,366,132,"TCTCCTGTTAATGTGTGATC","TGTTTGCCAATCGTTAATCT","561307.5.peg.607","2030"
"28340",594,366,228,"CTGGCATCTAATGCCGTTGT","TGTTTGCCAATCGTTAATCT","561307.5.peg.607","2030"
"28341",234,507,273,"TCTCCTGTTAATGTGTGATC","ATACCACCAGAAAGTTCATG","561307.5.peg.607","2030"
"28342",366,507,141,"TGTTTGCCAATCGTTAATCT","ATACCACCAGAAAGTTCATG","561307.5.peg.607","2030"
"28343",158,507,349,"CTGATTCACCAACAATACCT","ATACCACCAGAAAGTTCATG","561307.5.peg.607","2030"
"28344",10,507,497,"TTACACATTTGTGAATAGGG","ATACCACCAGAAAGTTCATG","561307.5.peg.607","2030"
"28345",649,507,142,"TGTTTCTGTGTACTCATAAA","ATACCACCAGAAAGTTCATG","561307.5.peg.607","2030"
"28346",10,594,584,"TTACACATTTGTGAATAGGG","CTGGCATCTAATGCCGTTGT","561307.5.peg.607","2030"
"28347",158,594,436,"CTGATTCACCAACAATACCT","CTGGCATCTAATGCCGTTGT","561307.5.peg.607","2030"
"28348",366,594,228,"TGTTTGCCAATCGTTAATCT","CTGGCATCTAATGCCGTTGT","561307.5.peg.607","2030"
"28349",234,594,360,"TCTCCTGTTAATGTGTGATC","CTGGCATCTAATGCCGTTGT","561307.5.peg.607","2030"
"28350",366,649,283,"TGTTTGCCAATCGTTAATCT","TGTTTCTGTGTACTCATAAA","561307.5.peg.607","2030"
"28351",10,649,639,"TTACACATTTGTGAATAGGG","TGTTTCTGTGTACTCATAAA","561307.5.peg.607","2030"
"28352",234,649,415,"TCTCCTGTTAATGTGTGATC","TGTTTCTGTGTACTCATAAA","561307.5.peg.607","2030"
"28353",158,649,491,"CTGATTCACCAACAATACCT","TGTTTCTGTGTACTCATAAA","561307.5.peg.607","2030"
"28354",507,649,142,"ATACCACCAGAAAGTTCATG","TGTTTCTGTGTACTCATAAA","561307.5.peg.607","2030"
"28355",465,334,131,"ATGCTATAAGCCGCATCAAG","CAATAAGATGAACATCGGCA","561307.5.peg.608","2031"
"28356",595,334,261,"GTAAGTCGTACCTAAGTCAA","CAATAAGATGAACATCGGCA","561307.5.peg.608","2031"
"28357",465,339,126,"ATGCTATAAGCCGCATCAAG","AAGTCAATAAGATGAACAT","561307.5.peg.608","2031"
"28358",595,339,256,"GTAAGTCGTACCTAAGTCAA","AAGTCAATAAGATGAACAT","561307.5.peg.608","2031"
"28359",334,465,131,"CAATAAGATGAACATCGGCA","ATGCTATAAGCCGCATCAAG","561307.5.peg.608","2031"
"28360",595,465,130,"GTAAGTCGTACCTAAGTCAA","ATGCTATAAGCCGCATCAAG","561307.5.peg.608","2031"
"28361",339,465,126,"AAGTCAATAAGATGAACAT","ATGCTATAAGCCGCATCAAG","561307.5.peg.608","2031"
"28362",339,595,256,"AAGTCAATAAGATGAACAT","GTAAGTCGTACCTAAGTCAA","561307.5.peg.608","2031"
"28363",334,595,261,"CAATAAGATGAACATCGGCA","GTAAGTCGTACCTAAGTCAA","561307.5.peg.608","2031"
"28364",465,595,130,"ATGCTATAAGCCGCATCAAG","GTAAGTCGTACCTAAGTCAA","561307.5.peg.608","2031"
"28365",540,4,536,"CCAAACGGATAGGCTAGACT","GAAATCAACGAAAGGAAGTG","561307.5.peg.609","2032"
"28366",550,4,546,"ATCATCAGTACCAAACGGAT","GAAATCAACGAAAGGAAGTG","561307.5.peg.609","2032"
"28367",166,4,162,"TTCAGCAATATAGAACGTAT","GAAATCAACGAAAGGAAGTG","561307.5.peg.609","2032"
"28368",353,4,349,"TATGTATTTGCGATGTACGT","GAAATCAACGAAAGGAAGTG","561307.5.peg.609","2032"
"28369",353,12,341,"TATGTATTTGCGATGTACGT","TACGTAGTGAAATCAACGAA","561307.5.peg.609","2032"
"28370",166,12,154,"TTCAGCAATATAGAACGTAT","TACGTAGTGAAATCAACGAA","561307.5.peg.609","2032"
"28371",550,12,538,"ATCATCAGTACCAAACGGAT","TACGTAGTGAAATCAACGAA","561307.5.peg.609","2032"
"28372",540,12,528,"CCAAACGGATAGGCTAGACT","TACGTAGTGAAATCAACGAA","561307.5.peg.609","2032"
"28373",4,166,162,"GAAATCAACGAAAGGAAGTG","TTCAGCAATATAGAACGTAT","561307.5.peg.609","2032"
"28374",353,166,187,"TATGTATTTGCGATGTACGT","TTCAGCAATATAGAACGTAT","561307.5.peg.609","2032"
"28375",12,166,154,"TACGTAGTGAAATCAACGAA","TTCAGCAATATAGAACGTAT","561307.5.peg.609","2032"
"28376",540,166,374,"CCAAACGGATAGGCTAGACT","TTCAGCAATATAGAACGTAT","561307.5.peg.609","2032"
"28377",550,166,384,"ATCATCAGTACCAAACGGAT","TTCAGCAATATAGAACGTAT","561307.5.peg.609","2032"
"28378",4,353,349,"GAAATCAACGAAAGGAAGTG","TATGTATTTGCGATGTACGT","561307.5.peg.609","2032"
"28379",12,353,341,"TACGTAGTGAAATCAACGAA","TATGTATTTGCGATGTACGT","561307.5.peg.609","2032"
"28380",166,353,187,"TTCAGCAATATAGAACGTAT","TATGTATTTGCGATGTACGT","561307.5.peg.609","2032"
"28381",550,353,197,"ATCATCAGTACCAAACGGAT","TATGTATTTGCGATGTACGT","561307.5.peg.609","2032"
"28382",540,353,187,"CCAAACGGATAGGCTAGACT","TATGTATTTGCGATGTACGT","561307.5.peg.609","2032"
"28383",4,540,536,"GAAATCAACGAAAGGAAGTG","CCAAACGGATAGGCTAGACT","561307.5.peg.609","2032"
"28384",166,540,374,"TTCAGCAATATAGAACGTAT","CCAAACGGATAGGCTAGACT","561307.5.peg.609","2032"
"28385",12,540,528,"TACGTAGTGAAATCAACGAA","CCAAACGGATAGGCTAGACT","561307.5.peg.609","2032"
"28386",353,540,187,"TATGTATTTGCGATGTACGT","CCAAACGGATAGGCTAGACT","561307.5.peg.609","2032"
"28387",4,550,546,"GAAATCAACGAAAGGAAGTG","ATCATCAGTACCAAACGGAT","561307.5.peg.609","2032"
"28388",12,550,538,"TACGTAGTGAAATCAACGAA","ATCATCAGTACCAAACGGAT","561307.5.peg.609","2032"
"28389",353,550,197,"TATGTATTTGCGATGTACGT","ATCATCAGTACCAAACGGAT","561307.5.peg.609","2032"
"28390",166,550,384,"TTCAGCAATATAGAACGTAT","ATCATCAGTACCAAACGGAT","561307.5.peg.609","2032"
"28391",269,113,156,"GATAGCTACCATAATCTGGT","GAGCCACTTCTGATTTCGTA","561307.5.peg.610","2034"
"28392",696,113,583,"GAACGTATTGGATCCAATGT","GAGCCACTTCTGATTTCGTA","561307.5.peg.610","2034"
"28393",273,113,160,"GTACGATAGCTACCATAATC","GAGCCACTTCTGATTTCGTA","561307.5.peg.610","2034"
"28394",307,113,194,"ATTTGGATATCATAATTGC","GAGCCACTTCTGATTTCGTA","561307.5.peg.610","2034"
"28395",663,113,550,"TCTTGTTGTGTCATCACAAG","GAGCCACTTCTGATTTCGTA","561307.5.peg.610","2034"
"28396",356,113,243,"ATGCCGTCATAGCATAGTTC","GAGCCACTTCTGATTTCGTA","561307.5.peg.610","2034"
"28397",708,113,595,"GACGGCGCAATTGAACGTAT","GAGCCACTTCTGATTTCGTA","561307.5.peg.610","2034"
"28398",323,113,210,"CTGTCATCCAGTCATCAATT","GAGCCACTTCTGATTTCGTA","561307.5.peg.610","2034"
"28399",307,185,122,"ATTTGGATATCATAATTGC","TTTCATAACTTGCTTGTCCT","561307.5.peg.610","2034"
"28400",708,185,523,"GACGGCGCAATTGAACGTAT","TTTCATAACTTGCTTGTCCT","561307.5.peg.610","2034"
"28401",663,185,478,"TCTTGTTGTGTCATCACAAG","TTTCATAACTTGCTTGTCCT","561307.5.peg.610","2034"
"28402",323,185,138,"CTGTCATCCAGTCATCAATT","TTTCATAACTTGCTTGTCCT","561307.5.peg.610","2034"
"28403",356,185,171,"ATGCCGTCATAGCATAGTTC","TTTCATAACTTGCTTGTCCT","561307.5.peg.610","2034"
"28404",696,185,511,"GAACGTATTGGATCCAATGT","TTTCATAACTTGCTTGTCCT","561307.5.peg.610","2034"
"28405",663,269,394,"TCTTGTTGTGTCATCACAAG","GATAGCTACCATAATCTGGT","561307.5.peg.610","2034"
"28406",696,269,427,"GAACGTATTGGATCCAATGT","GATAGCTACCATAATCTGGT","561307.5.peg.610","2034"
"28407",708,269,439,"GACGGCGCAATTGAACGTAT","GATAGCTACCATAATCTGGT","561307.5.peg.610","2034"
"28408",113,269,156,"GAGCCACTTCTGATTTCGTA","GATAGCTACCATAATCTGGT","561307.5.peg.610","2034"
"28409",696,273,423,"GAACGTATTGGATCCAATGT","GTACGATAGCTACCATAATC","561307.5.peg.610","2034"
"28410",113,273,160,"GAGCCACTTCTGATTTCGTA","GTACGATAGCTACCATAATC","561307.5.peg.610","2034"
"28411",708,273,435,"GACGGCGCAATTGAACGTAT","GTACGATAGCTACCATAATC","561307.5.peg.610","2034"
"28412",663,273,390,"TCTTGTTGTGTCATCACAAG","GTACGATAGCTACCATAATC","561307.5.peg.610","2034"
"28413",663,307,356,"TCTTGTTGTGTCATCACAAG","ATTTGGATATCATAATTGC","561307.5.peg.610","2034"
"28414",696,307,389,"GAACGTATTGGATCCAATGT","ATTTGGATATCATAATTGC","561307.5.peg.610","2034"
"28415",113,307,194,"GAGCCACTTCTGATTTCGTA","ATTTGGATATCATAATTGC","561307.5.peg.610","2034"
"28416",185,307,122,"TTTCATAACTTGCTTGTCCT","ATTTGGATATCATAATTGC","561307.5.peg.610","2034"
"28417",708,307,401,"GACGGCGCAATTGAACGTAT","ATTTGGATATCATAATTGC","561307.5.peg.610","2034"
"28418",185,323,138,"TTTCATAACTTGCTTGTCCT","CTGTCATCCAGTCATCAATT","561307.5.peg.610","2034"
"28419",663,323,340,"TCTTGTTGTGTCATCACAAG","CTGTCATCCAGTCATCAATT","561307.5.peg.610","2034"
"28420",113,323,210,"GAGCCACTTCTGATTTCGTA","CTGTCATCCAGTCATCAATT","561307.5.peg.610","2034"
"28421",696,323,373,"GAACGTATTGGATCCAATGT","CTGTCATCCAGTCATCAATT","561307.5.peg.610","2034"
"28422",708,323,385,"GACGGCGCAATTGAACGTAT","CTGTCATCCAGTCATCAATT","561307.5.peg.610","2034"
"28423",113,356,243,"GAGCCACTTCTGATTTCGTA","ATGCCGTCATAGCATAGTTC","561307.5.peg.610","2034"
"28424",696,356,340,"GAACGTATTGGATCCAATGT","ATGCCGTCATAGCATAGTTC","561307.5.peg.610","2034"
"28425",663,356,307,"TCTTGTTGTGTCATCACAAG","ATGCCGTCATAGCATAGTTC","561307.5.peg.610","2034"
"28426",185,356,171,"TTTCATAACTTGCTTGTCCT","ATGCCGTCATAGCATAGTTC","561307.5.peg.610","2034"
"28427",708,356,352,"GACGGCGCAATTGAACGTAT","ATGCCGTCATAGCATAGTTC","561307.5.peg.610","2034"
"28428",356,663,307,"ATGCCGTCATAGCATAGTTC","TCTTGTTGTGTCATCACAAG","561307.5.peg.610","2034"
"28429",273,663,390,"GTACGATAGCTACCATAATC","TCTTGTTGTGTCATCACAAG","561307.5.peg.610","2034"
"28430",323,663,340,"CTGTCATCCAGTCATCAATT","TCTTGTTGTGTCATCACAAG","561307.5.peg.610","2034"
"28431",307,663,356,"ATTTGGATATCATAATTGC","TCTTGTTGTGTCATCACAAG","561307.5.peg.610","2034"
"28432",269,663,394,"GATAGCTACCATAATCTGGT","TCTTGTTGTGTCATCACAAG","561307.5.peg.610","2034"
"28433",113,663,550,"GAGCCACTTCTGATTTCGTA","TCTTGTTGTGTCATCACAAG","561307.5.peg.610","2034"
"28434",185,663,478,"TTTCATAACTTGCTTGTCCT","TCTTGTTGTGTCATCACAAG","561307.5.peg.610","2034"
"28435",113,696,583,"GAGCCACTTCTGATTTCGTA","GAACGTATTGGATCCAATGT","561307.5.peg.610","2034"
"28436",307,696,389,"ATTTGGATATCATAATTGC","GAACGTATTGGATCCAATGT","561307.5.peg.610","2034"
"28437",356,696,340,"ATGCCGTCATAGCATAGTTC","GAACGTATTGGATCCAATGT","561307.5.peg.610","2034"
"28438",323,696,373,"CTGTCATCCAGTCATCAATT","GAACGTATTGGATCCAATGT","561307.5.peg.610","2034"
"28439",185,696,511,"TTTCATAACTTGCTTGTCCT","GAACGTATTGGATCCAATGT","561307.5.peg.610","2034"
"28440",273,696,423,"GTACGATAGCTACCATAATC","GAACGTATTGGATCCAATGT","561307.5.peg.610","2034"
"28441",269,696,427,"GATAGCTACCATAATCTGGT","GAACGTATTGGATCCAATGT","561307.5.peg.610","2034"
"28442",307,708,401,"ATTTGGATATCATAATTGC","GACGGCGCAATTGAACGTAT","561307.5.peg.610","2034"
"28443",113,708,595,"GAGCCACTTCTGATTTCGTA","GACGGCGCAATTGAACGTAT","561307.5.peg.610","2034"
"28444",356,708,352,"ATGCCGTCATAGCATAGTTC","GACGGCGCAATTGAACGTAT","561307.5.peg.610","2034"
"28445",269,708,439,"GATAGCTACCATAATCTGGT","GACGGCGCAATTGAACGTAT","561307.5.peg.610","2034"
"28446",273,708,435,"GTACGATAGCTACCATAATC","GACGGCGCAATTGAACGTAT","561307.5.peg.610","2034"
"28447",323,708,385,"CTGTCATCCAGTCATCAATT","GACGGCGCAATTGAACGTAT","561307.5.peg.610","2034"
"28448",185,708,523,"TTTCATAACTTGCTTGTCCT","GACGGCGCAATTGAACGTAT","561307.5.peg.610","2034"
"28449",471,106,365,"TCAATGGCTAGTTCAATTGC","AGCCGCAAGAGGATGTGATA","561307.5.peg.611","2035"
"28450",399,106,293,"TCAAACAGCTTTGGAATTGC","AGCCGCAAGAGGATGTGATA","561307.5.peg.611","2035"
"28451",828,106,722,"GTGATACCGCCAGAACTAGA","AGCCGCAAGAGGATGTGATA","561307.5.peg.611","2035"
"28452",533,106,427,"TTGTCAATCGTGCGTGTTGC","AGCCGCAAGAGGATGTGATA","561307.5.peg.611","2035"
"28453",891,106,785,"ACAGATCTTGGACCCATAGA","AGCCGCAAGAGGATGTGATA","561307.5.peg.611","2035"
"28454",487,106,381,"ATTGGCTGCATGACCTTCAA","AGCCGCAAGAGGATGTGATA","561307.5.peg.611","2035"
"28455",1002,106,896,"CATCAATTAATGACTGTAC","AGCCGCAAGAGGATGTGATA","561307.5.peg.611","2035"
"28456",627,106,521,"TGAAATGTCTTACCTAATTC","AGCCGCAAGAGGATGTGATA","561307.5.peg.611","2035"
"28457",1002,166,836,"CATCAATTAATGACTGTAC","AATTGCAATCACTGCATCCA","561307.5.peg.611","2035"
"28458",533,166,367,"TTGTCAATCGTGCGTGTTGC","AATTGCAATCACTGCATCCA","561307.5.peg.611","2035"
"28459",828,166,662,"GTGATACCGCCAGAACTAGA","AATTGCAATCACTGCATCCA","561307.5.peg.611","2035"
"28460",487,166,321,"ATTGGCTGCATGACCTTCAA","AATTGCAATCACTGCATCCA","561307.5.peg.611","2035"
"28461",891,166,725,"ACAGATCTTGGACCCATAGA","AATTGCAATCACTGCATCCA","561307.5.peg.611","2035"
"28462",627,166,461,"TGAAATGTCTTACCTAATTC","AATTGCAATCACTGCATCCA","561307.5.peg.611","2035"
"28463",471,166,305,"TCAATGGCTAGTTCAATTGC","AATTGCAATCACTGCATCCA","561307.5.peg.611","2035"
"28464",399,166,233,"TCAAACAGCTTTGGAATTGC","AATTGCAATCACTGCATCCA","561307.5.peg.611","2035"
"28465",106,399,293,"AGCCGCAAGAGGATGTGATA","TCAAACAGCTTTGGAATTGC","561307.5.peg.611","2035"
"28466",828,399,429,"GTGATACCGCCAGAACTAGA","TCAAACAGCTTTGGAATTGC","561307.5.peg.611","2035"
"28467",1002,399,603,"CATCAATTAATGACTGTAC","TCAAACAGCTTTGGAATTGC","561307.5.peg.611","2035"
"28468",891,399,492,"ACAGATCTTGGACCCATAGA","TCAAACAGCTTTGGAATTGC","561307.5.peg.611","2035"
"28469",627,399,228,"TGAAATGTCTTACCTAATTC","TCAAACAGCTTTGGAATTGC","561307.5.peg.611","2035"
"28470",166,399,233,"AATTGCAATCACTGCATCCA","TCAAACAGCTTTGGAATTGC","561307.5.peg.611","2035"
"28471",533,399,134,"TTGTCAATCGTGCGTGTTGC","TCAAACAGCTTTGGAATTGC","561307.5.peg.611","2035"
"28472",166,471,305,"AATTGCAATCACTGCATCCA","TCAATGGCTAGTTCAATTGC","561307.5.peg.611","2035"
"28473",627,471,156,"TGAAATGTCTTACCTAATTC","TCAATGGCTAGTTCAATTGC","561307.5.peg.611","2035"
"28474",828,471,357,"GTGATACCGCCAGAACTAGA","TCAATGGCTAGTTCAATTGC","561307.5.peg.611","2035"
"28475",1002,471,531,"CATCAATTAATGACTGTAC","TCAATGGCTAGTTCAATTGC","561307.5.peg.611","2035"
"28476",106,471,365,"AGCCGCAAGAGGATGTGATA","TCAATGGCTAGTTCAATTGC","561307.5.peg.611","2035"
"28477",891,471,420,"ACAGATCTTGGACCCATAGA","TCAATGGCTAGTTCAATTGC","561307.5.peg.611","2035"
"28478",828,487,341,"GTGATACCGCCAGAACTAGA","ATTGGCTGCATGACCTTCAA","561307.5.peg.611","2035"
"28479",627,487,140,"TGAAATGTCTTACCTAATTC","ATTGGCTGCATGACCTTCAA","561307.5.peg.611","2035"
"28480",1002,487,515,"CATCAATTAATGACTGTAC","ATTGGCTGCATGACCTTCAA","561307.5.peg.611","2035"
"28481",891,487,404,"ACAGATCTTGGACCCATAGA","ATTGGCTGCATGACCTTCAA","561307.5.peg.611","2035"
"28482",166,487,321,"AATTGCAATCACTGCATCCA","ATTGGCTGCATGACCTTCAA","561307.5.peg.611","2035"
"28483",106,487,381,"AGCCGCAAGAGGATGTGATA","ATTGGCTGCATGACCTTCAA","561307.5.peg.611","2035"
"28484",166,533,367,"AATTGCAATCACTGCATCCA","TTGTCAATCGTGCGTGTTGC","561307.5.peg.611","2035"
"28485",399,533,134,"TCAAACAGCTTTGGAATTGC","TTGTCAATCGTGCGTGTTGC","561307.5.peg.611","2035"
"28486",1002,533,469,"CATCAATTAATGACTGTAC","TTGTCAATCGTGCGTGTTGC","561307.5.peg.611","2035"
"28487",891,533,358,"ACAGATCTTGGACCCATAGA","TTGTCAATCGTGCGTGTTGC","561307.5.peg.611","2035"
"28488",828,533,295,"GTGATACCGCCAGAACTAGA","TTGTCAATCGTGCGTGTTGC","561307.5.peg.611","2035"
"28489",106,533,427,"AGCCGCAAGAGGATGTGATA","TTGTCAATCGTGCGTGTTGC","561307.5.peg.611","2035"
"28490",106,627,521,"AGCCGCAAGAGGATGTGATA","TGAAATGTCTTACCTAATTC","561307.5.peg.611","2035"
"28491",891,627,264,"ACAGATCTTGGACCCATAGA","TGAAATGTCTTACCTAATTC","561307.5.peg.611","2035"
"28492",1002,627,375,"CATCAATTAATGACTGTAC","TGAAATGTCTTACCTAATTC","561307.5.peg.611","2035"
"28493",399,627,228,"TCAAACAGCTTTGGAATTGC","TGAAATGTCTTACCTAATTC","561307.5.peg.611","2035"
"28494",487,627,140,"ATTGGCTGCATGACCTTCAA","TGAAATGTCTTACCTAATTC","561307.5.peg.611","2035"
"28495",166,627,461,"AATTGCAATCACTGCATCCA","TGAAATGTCTTACCTAATTC","561307.5.peg.611","2035"
"28496",471,627,156,"TCAATGGCTAGTTCAATTGC","TGAAATGTCTTACCTAATTC","561307.5.peg.611","2035"
"28497",828,627,201,"GTGATACCGCCAGAACTAGA","TGAAATGTCTTACCTAATTC","561307.5.peg.611","2035"
"28498",471,828,357,"TCAATGGCTAGTTCAATTGC","GTGATACCGCCAGAACTAGA","561307.5.peg.611","2035"
"28499",627,828,201,"TGAAATGTCTTACCTAATTC","GTGATACCGCCAGAACTAGA","561307.5.peg.611","2035"
"28500",487,828,341,"ATTGGCTGCATGACCTTCAA","GTGATACCGCCAGAACTAGA","561307.5.peg.611","2035"
"28501",166,828,662,"AATTGCAATCACTGCATCCA","GTGATACCGCCAGAACTAGA","561307.5.peg.611","2035"
"28502",399,828,429,"TCAAACAGCTTTGGAATTGC","GTGATACCGCCAGAACTAGA","561307.5.peg.611","2035"
"28503",533,828,295,"TTGTCAATCGTGCGTGTTGC","GTGATACCGCCAGAACTAGA","561307.5.peg.611","2035"
"28504",106,828,722,"AGCCGCAAGAGGATGTGATA","GTGATACCGCCAGAACTAGA","561307.5.peg.611","2035"
"28505",1002,828,174,"CATCAATTAATGACTGTAC","GTGATACCGCCAGAACTAGA","561307.5.peg.611","2035"
"28506",106,891,785,"AGCCGCAAGAGGATGTGATA","ACAGATCTTGGACCCATAGA","561307.5.peg.611","2035"
"28507",1002,891,111,"CATCAATTAATGACTGTAC","ACAGATCTTGGACCCATAGA","561307.5.peg.611","2035"
"28508",399,891,492,"TCAAACAGCTTTGGAATTGC","ACAGATCTTGGACCCATAGA","561307.5.peg.611","2035"
"28509",533,891,358,"TTGTCAATCGTGCGTGTTGC","ACAGATCTTGGACCCATAGA","561307.5.peg.611","2035"
"28510",471,891,420,"TCAATGGCTAGTTCAATTGC","ACAGATCTTGGACCCATAGA","561307.5.peg.611","2035"
"28511",487,891,404,"ATTGGCTGCATGACCTTCAA","ACAGATCTTGGACCCATAGA","561307.5.peg.611","2035"
"28512",627,891,264,"TGAAATGTCTTACCTAATTC","ACAGATCTTGGACCCATAGA","561307.5.peg.611","2035"
"28513",166,891,725,"AATTGCAATCACTGCATCCA","ACAGATCTTGGACCCATAGA","561307.5.peg.611","2035"
"28514",471,1002,531,"TCAATGGCTAGTTCAATTGC","CATCAATTAATGACTGTAC","561307.5.peg.611","2035"
"28515",399,1002,603,"TCAAACAGCTTTGGAATTGC","CATCAATTAATGACTGTAC","561307.5.peg.611","2035"
"28516",487,1002,515,"ATTGGCTGCATGACCTTCAA","CATCAATTAATGACTGTAC","561307.5.peg.611","2035"
"28517",533,1002,469,"TTGTCAATCGTGCGTGTTGC","CATCAATTAATGACTGTAC","561307.5.peg.611","2035"
"28518",627,1002,375,"TGAAATGTCTTACCTAATTC","CATCAATTAATGACTGTAC","561307.5.peg.611","2035"
"28519",166,1002,836,"AATTGCAATCACTGCATCCA","CATCAATTAATGACTGTAC","561307.5.peg.611","2035"
"28520",891,1002,111,"ACAGATCTTGGACCCATAGA","CATCAATTAATGACTGTAC","561307.5.peg.611","2035"
"28521",106,1002,896,"AGCCGCAAGAGGATGTGATA","CATCAATTAATGACTGTAC","561307.5.peg.611","2035"
"28522",828,1002,174,"GTGATACCGCCAGAACTAGA","CATCAATTAATGACTGTAC","561307.5.peg.611","2035"
"28523",162,7,155,"GTTGATTTACCACATCCCGA","AACTGTAAACAAAGTATGGG","561307.5.peg.615","2039"
"28524",531,7,524,"TTCGCATCAAGATTCGATAA","AACTGTAAACAAAGTATGGG","561307.5.peg.615","2039"
"28525",162,10,152,"GTTGATTTACCACATCCCGA","CAAACTGTAAACAAAGTAT","561307.5.peg.615","2039"
"28526",531,10,521,"TTCGCATCAAGATTCGATAA","CAAACTGTAAACAAAGTAT","561307.5.peg.615","2039"
"28527",7,162,155,"AACTGTAAACAAAGTATGGG","GTTGATTTACCACATCCCGA","561307.5.peg.615","2039"
"28528",531,162,369,"TTCGCATCAAGATTCGATAA","GTTGATTTACCACATCCCGA","561307.5.peg.615","2039"
"28529",10,162,152,"CAAACTGTAAACAAAGTAT","GTTGATTTACCACATCCCGA","561307.5.peg.615","2039"
"28530",10,531,521,"CAAACTGTAAACAAAGTAT","TTCGCATCAAGATTCGATAA","561307.5.peg.615","2039"
"28531",7,531,524,"AACTGTAAACAAAGTATGGG","TTCGCATCAAGATTCGATAA","561307.5.peg.615","2039"
"28532",162,531,369,"GTTGATTTACCACATCCCGA","TTCGCATCAAGATTCGATAA","561307.5.peg.615","2039"
"28533",492,8,484,"GCGGTTGTTTCAACGATAGC","GGAAATCGTATCGTCTAAGG","561307.5.peg.616","2040"
"28534",182,8,174,"CATCCACCCACATCGTAAGT","GGAAATCGTATCGTCTAAGG","561307.5.peg.616","2040"
"28535",116,8,108,"TATCTTCTTTCGAACGATTA","GGAAATCGTATCGTCTAAGG","561307.5.peg.616","2040"
"28536",382,8,374,"AGCAGCTAAGCCTTGTAGAT","GGAAATCGTATCGTCTAAGG","561307.5.peg.616","2040"
"28537",116,10,106,"TATCTTCTTTCGAACGATTA","CAGGAAATCGTATCGTCTAA","561307.5.peg.616","2040"
"28538",182,10,172,"CATCCACCCACATCGTAAGT","CAGGAAATCGTATCGTCTAA","561307.5.peg.616","2040"
"28539",492,10,482,"GCGGTTGTTTCAACGATAGC","CAGGAAATCGTATCGTCTAA","561307.5.peg.616","2040"
"28540",382,10,372,"AGCAGCTAAGCCTTGTAGAT","CAGGAAATCGTATCGTCTAA","561307.5.peg.616","2040"
"28541",492,82,410,"GCGGTTGTTTCAACGATAGC","ACGATTAATAACATTACCA","561307.5.peg.616","2040"
"28542",182,82,100,"CATCCACCCACATCGTAAGT","ACGATTAATAACATTACCA","561307.5.peg.616","2040"
"28543",382,82,300,"AGCAGCTAAGCCTTGTAGAT","ACGATTAATAACATTACCA","561307.5.peg.616","2040"
"28544",10,116,106,"CAGGAAATCGTATCGTCTAA","TATCTTCTTTCGAACGATTA","561307.5.peg.616","2040"
"28545",8,116,108,"GGAAATCGTATCGTCTAAGG","TATCTTCTTTCGAACGATTA","561307.5.peg.616","2040"
"28546",492,116,376,"GCGGTTGTTTCAACGATAGC","TATCTTCTTTCGAACGATTA","561307.5.peg.616","2040"
"28547",382,116,266,"AGCAGCTAAGCCTTGTAGAT","TATCTTCTTTCGAACGATTA","561307.5.peg.616","2040"
"28548",382,182,200,"AGCAGCTAAGCCTTGTAGAT","CATCCACCCACATCGTAAGT","561307.5.peg.616","2040"
"28549",10,182,172,"CAGGAAATCGTATCGTCTAA","CATCCACCCACATCGTAAGT","561307.5.peg.616","2040"
"28550",8,182,174,"GGAAATCGTATCGTCTAAGG","CATCCACCCACATCGTAAGT","561307.5.peg.616","2040"
"28551",82,182,100,"ACGATTAATAACATTACCA","CATCCACCCACATCGTAAGT","561307.5.peg.616","2040"
"28552",492,182,310,"GCGGTTGTTTCAACGATAGC","CATCCACCCACATCGTAAGT","561307.5.peg.616","2040"
"28553",8,382,374,"GGAAATCGTATCGTCTAAGG","AGCAGCTAAGCCTTGTAGAT","561307.5.peg.616","2040"
"28554",116,382,266,"TATCTTCTTTCGAACGATTA","AGCAGCTAAGCCTTGTAGAT","561307.5.peg.616","2040"
"28555",10,382,372,"CAGGAAATCGTATCGTCTAA","AGCAGCTAAGCCTTGTAGAT","561307.5.peg.616","2040"
"28556",182,382,200,"CATCCACCCACATCGTAAGT","AGCAGCTAAGCCTTGTAGAT","561307.5.peg.616","2040"
"28557",82,382,300,"ACGATTAATAACATTACCA","AGCAGCTAAGCCTTGTAGAT","561307.5.peg.616","2040"
"28558",492,382,110,"GCGGTTGTTTCAACGATAGC","AGCAGCTAAGCCTTGTAGAT","561307.5.peg.616","2040"
"28559",82,492,410,"ACGATTAATAACATTACCA","GCGGTTGTTTCAACGATAGC","561307.5.peg.616","2040"
"28560",10,492,482,"CAGGAAATCGTATCGTCTAA","GCGGTTGTTTCAACGATAGC","561307.5.peg.616","2040"
"28561",116,492,376,"TATCTTCTTTCGAACGATTA","GCGGTTGTTTCAACGATAGC","561307.5.peg.616","2040"
"28562",382,492,110,"AGCAGCTAAGCCTTGTAGAT","GCGGTTGTTTCAACGATAGC","561307.5.peg.616","2040"
"28563",8,492,484,"GGAAATCGTATCGTCTAAGG","GCGGTTGTTTCAACGATAGC","561307.5.peg.616","2040"
"28564",182,492,310,"CATCCACCCACATCGTAAGT","GCGGTTGTTTCAACGATAGC","561307.5.peg.616","2040"
"28565",416,65,351,"CTGGTGAGATTAGTAAGTAT","TAATAATGCCGCTAATTTA","561307.5.peg.617","2041"
"28566",525,65,460,"CATTCTAATGTGTGTCTCGG","TAATAATGCCGCTAATTTA","561307.5.peg.617","2041"
"28567",378,65,313,"GTTGCCACCATACGCGCCTT","TAATAATGCCGCTAATTTA","561307.5.peg.617","2041"
"28568",528,65,463,"ACCCATTCTAATGTGTGTCT","TAATAATGCCGCTAATTTA","561307.5.peg.617","2041"
"28569",65,378,313,"TAATAATGCCGCTAATTTA","GTTGCCACCATACGCGCCTT","561307.5.peg.617","2041"
"28570",525,378,147,"CATTCTAATGTGTGTCTCGG","GTTGCCACCATACGCGCCTT","561307.5.peg.617","2041"
"28571",528,378,150,"ACCCATTCTAATGTGTGTCT","GTTGCCACCATACGCGCCTT","561307.5.peg.617","2041"
"28572",65,416,351,"TAATAATGCCGCTAATTTA","CTGGTGAGATTAGTAAGTAT","561307.5.peg.617","2041"
"28573",525,416,109,"CATTCTAATGTGTGTCTCGG","CTGGTGAGATTAGTAAGTAT","561307.5.peg.617","2041"
"28574",528,416,112,"ACCCATTCTAATGTGTGTCT","CTGGTGAGATTAGTAAGTAT","561307.5.peg.617","2041"
"28575",416,525,109,"CTGGTGAGATTAGTAAGTAT","CATTCTAATGTGTGTCTCGG","561307.5.peg.617","2041"
"28576",65,525,460,"TAATAATGCCGCTAATTTA","CATTCTAATGTGTGTCTCGG","561307.5.peg.617","2041"
"28577",378,525,147,"GTTGCCACCATACGCGCCTT","CATTCTAATGTGTGTCTCGG","561307.5.peg.617","2041"
"28578",65,528,463,"TAATAATGCCGCTAATTTA","ACCCATTCTAATGTGTGTCT","561307.5.peg.617","2041"
"28579",378,528,150,"GTTGCCACCATACGCGCCTT","ACCCATTCTAATGTGTGTCT","561307.5.peg.617","2041"
"28580",416,528,112,"CTGGTGAGATTAGTAAGTAT","ACCCATTCTAATGTGTGTCT","561307.5.peg.617","2041"
"28581",154,9,145,"CAAGTTCGTACCTGGATTAA","AGTACGTTTAAAGATGAGGG","561307.5.peg.618","2042"
"28582",162,9,153,"GCACCATACAAGTTCGTACC","AGTACGTTTAAAGATGAGGG","561307.5.peg.618","2042"
"28583",129,9,120,"ATGCCAAATGTCCACAGTAG","AGTACGTTTAAAGATGAGGG","561307.5.peg.618","2042"
"28584",404,9,395,"CGACCATTGCCATTAATACA","AGTACGTTTAAAGATGAGGG","561307.5.peg.618","2042"
"28585",162,12,150,"GCACCATACAAGTTCGTACC","ACAAGTACGTTTAAAGATGA","561307.5.peg.618","2042"
"28586",129,12,117,"ATGCCAAATGTCCACAGTAG","ACAAGTACGTTTAAAGATGA","561307.5.peg.618","2042"
"28587",404,12,392,"CGACCATTGCCATTAATACA","ACAAGTACGTTTAAAGATGA","561307.5.peg.618","2042"
"28588",154,12,142,"CAAGTTCGTACCTGGATTAA","ACAAGTACGTTTAAAGATGA","561307.5.peg.618","2042"
"28589",12,129,117,"ACAAGTACGTTTAAAGATGA","ATGCCAAATGTCCACAGTAG","561307.5.peg.618","2042"
"28590",9,129,120,"AGTACGTTTAAAGATGAGGG","ATGCCAAATGTCCACAGTAG","561307.5.peg.618","2042"
"28591",404,129,275,"CGACCATTGCCATTAATACA","ATGCCAAATGTCCACAGTAG","561307.5.peg.618","2042"
"28592",12,154,142,"ACAAGTACGTTTAAAGATGA","CAAGTTCGTACCTGGATTAA","561307.5.peg.618","2042"
"28593",9,154,145,"AGTACGTTTAAAGATGAGGG","CAAGTTCGTACCTGGATTAA","561307.5.peg.618","2042"
"28594",404,154,250,"CGACCATTGCCATTAATACA","CAAGTTCGTACCTGGATTAA","561307.5.peg.618","2042"
"28595",9,162,153,"AGTACGTTTAAAGATGAGGG","GCACCATACAAGTTCGTACC","561307.5.peg.618","2042"
"28596",12,162,150,"ACAAGTACGTTTAAAGATGA","GCACCATACAAGTTCGTACC","561307.5.peg.618","2042"
"28597",404,162,242,"CGACCATTGCCATTAATACA","GCACCATACAAGTTCGTACC","561307.5.peg.618","2042"
"28598",9,404,395,"AGTACGTTTAAAGATGAGGG","CGACCATTGCCATTAATACA","561307.5.peg.618","2042"
"28599",12,404,392,"ACAAGTACGTTTAAAGATGA","CGACCATTGCCATTAATACA","561307.5.peg.618","2042"
"28600",162,404,242,"GCACCATACAAGTTCGTACC","CGACCATTGCCATTAATACA","561307.5.peg.618","2042"
"28601",129,404,275,"ATGCCAAATGTCCACAGTAG","CGACCATTGCCATTAATACA","561307.5.peg.618","2042"
"28602",154,404,250,"CAAGTTCGTACCTGGATTAA","CGACCATTGCCATTAATACA","561307.5.peg.618","2042"
"28603",517,266,251,"TGGTACTGCTCGACGACGAA","AGTCATTTGGCGTACAAACA","561307.5.peg.619","2043"
"28604",537,266,271,"TCTAGAAAGACACCCCATGT","AGTCATTTGGCGTACAAACA","561307.5.peg.619","2043"
"28605",266,517,251,"AGTCATTTGGCGTACAAACA","TGGTACTGCTCGACGACGAA","561307.5.peg.619","2043"
"28606",266,537,271,"AGTCATTTGGCGTACAAACA","TCTAGAAAGACACCCCATGT","561307.5.peg.619","2043"
"28607",384,239,145,"TGTGTATATTCTTCGGCTCC","TATTCACTTGTGGATGATTA","561307.5.peg.62","2044"
"28608",443,239,204,"CTGGTAGTTCACTAATACTA","TATTCACTTGTGGATGATTA","561307.5.peg.62","2044"
"28609",517,239,278,"TCTACTTTCTCTTAATTCGC","TATTCACTTGTGGATGATTA","561307.5.peg.62","2044"
"28610",239,384,145,"TATTCACTTGTGGATGATTA","TGTGTATATTCTTCGGCTCC","561307.5.peg.62","2044"
"28611",517,384,133,"TCTACTTTCTCTTAATTCGC","TGTGTATATTCTTCGGCTCC","561307.5.peg.62","2044"
"28612",239,443,204,"TATTCACTTGTGGATGATTA","CTGGTAGTTCACTAATACTA","561307.5.peg.62","2044"
"28613",239,517,278,"TATTCACTTGTGGATGATTA","TCTACTTTCTCTTAATTCGC","561307.5.peg.62","2044"
"28614",384,517,133,"TGTGTATATTCTTCGGCTCC","TCTACTTTCTCTTAATTCGC","561307.5.peg.62","2044"
"28615",225,7,218,"ACAAGTTTAAACAGCTCGCT","AATAACATCATACGGTAAGG","561307.5.peg.620","2045"
"28616",339,7,332,"TCTTCCGTCGTCATCGCCAT","AATAACATCATACGGTAAGG","561307.5.peg.620","2045"
"28617",281,7,274,"CTTCTATAGAAAGATCAGCA","AATAACATCATACGGTAAGG","561307.5.peg.620","2045"
"28618",207,7,200,"CTAGGTGTCTCAACTGCATG","AATAACATCATACGGTAAGG","561307.5.peg.620","2045"
"28619",111,7,104,"TCTTTGAGTTTCAGCAATGC","AATAACATCATACGGTAAGG","561307.5.peg.620","2045"
"28620",311,7,304,"CACACAATACATGGACACCA","AATAACATCATACGGTAAGG","561307.5.peg.620","2045"
"28621",486,7,479,"GCTTGTACACGTGCTACTAA","AATAACATCATACGGTAAGG","561307.5.peg.620","2045"
"28622",339,10,329,"TCTTCCGTCGTCATCGCCAT","TGAATAACATCATACGGTA","561307.5.peg.620","2045"
"28623",281,10,271,"CTTCTATAGAAAGATCAGCA","TGAATAACATCATACGGTA","561307.5.peg.620","2045"
"28624",225,10,215,"ACAAGTTTAAACAGCTCGCT","TGAATAACATCATACGGTA","561307.5.peg.620","2045"
"28625",207,10,197,"CTAGGTGTCTCAACTGCATG","TGAATAACATCATACGGTA","561307.5.peg.620","2045"
"28626",486,10,476,"GCTTGTACACGTGCTACTAA","TGAATAACATCATACGGTA","561307.5.peg.620","2045"
"28627",111,10,101,"TCTTTGAGTTTCAGCAATGC","TGAATAACATCATACGGTA","561307.5.peg.620","2045"
"28628",311,10,301,"CACACAATACATGGACACCA","TGAATAACATCATACGGTA","561307.5.peg.620","2045"
"28629",311,101,210,"CACACAATACATGGACACCA","TCAGCAATGCTGGAATATGA","561307.5.peg.620","2045"
"28630",207,101,106,"CTAGGTGTCTCAACTGCATG","TCAGCAATGCTGGAATATGA","561307.5.peg.620","2045"
"28631",225,101,124,"ACAAGTTTAAACAGCTCGCT","TCAGCAATGCTGGAATATGA","561307.5.peg.620","2045"
"28632",281,101,180,"CTTCTATAGAAAGATCAGCA","TCAGCAATGCTGGAATATGA","561307.5.peg.620","2045"
"28633",339,101,238,"TCTTCCGTCGTCATCGCCAT","TCAGCAATGCTGGAATATGA","561307.5.peg.620","2045"
"28634",486,101,385,"GCTTGTACACGTGCTACTAA","TCAGCAATGCTGGAATATGA","561307.5.peg.620","2045"
"28635",339,111,228,"TCTTCCGTCGTCATCGCCAT","TCTTTGAGTTTCAGCAATGC","561307.5.peg.620","2045"
"28636",10,111,101,"TGAATAACATCATACGGTA","TCTTTGAGTTTCAGCAATGC","561307.5.peg.620","2045"
"28637",311,111,200,"CACACAATACATGGACACCA","TCTTTGAGTTTCAGCAATGC","561307.5.peg.620","2045"
"28638",7,111,104,"AATAACATCATACGGTAAGG","TCTTTGAGTTTCAGCAATGC","561307.5.peg.620","2045"
"28639",281,111,170,"CTTCTATAGAAAGATCAGCA","TCTTTGAGTTTCAGCAATGC","561307.5.peg.620","2045"
"28640",225,111,114,"ACAAGTTTAAACAGCTCGCT","TCTTTGAGTTTCAGCAATGC","561307.5.peg.620","2045"
"28641",486,111,375,"GCTTGTACACGTGCTACTAA","TCTTTGAGTTTCAGCAATGC","561307.5.peg.620","2045"
"28642",311,207,104,"CACACAATACATGGACACCA","CTAGGTGTCTCAACTGCATG","561307.5.peg.620","2045"
"28643",7,207,200,"AATAACATCATACGGTAAGG","CTAGGTGTCTCAACTGCATG","561307.5.peg.620","2045"
"28644",339,207,132,"TCTTCCGTCGTCATCGCCAT","CTAGGTGTCTCAACTGCATG","561307.5.peg.620","2045"
"28645",101,207,106,"TCAGCAATGCTGGAATATGA","CTAGGTGTCTCAACTGCATG","561307.5.peg.620","2045"
"28646",10,207,197,"TGAATAACATCATACGGTA","CTAGGTGTCTCAACTGCATG","561307.5.peg.620","2045"
"28647",486,207,279,"GCTTGTACACGTGCTACTAA","CTAGGTGTCTCAACTGCATG","561307.5.peg.620","2045"
"28648",7,225,218,"AATAACATCATACGGTAAGG","ACAAGTTTAAACAGCTCGCT","561307.5.peg.620","2045"
"28649",111,225,114,"TCTTTGAGTTTCAGCAATGC","ACAAGTTTAAACAGCTCGCT","561307.5.peg.620","2045"
"28650",101,225,124,"TCAGCAATGCTGGAATATGA","ACAAGTTTAAACAGCTCGCT","561307.5.peg.620","2045"
"28651",339,225,114,"TCTTCCGTCGTCATCGCCAT","ACAAGTTTAAACAGCTCGCT","561307.5.peg.620","2045"
"28652",486,225,261,"GCTTGTACACGTGCTACTAA","ACAAGTTTAAACAGCTCGCT","561307.5.peg.620","2045"
"28653",10,225,215,"TGAATAACATCATACGGTA","ACAAGTTTAAACAGCTCGCT","561307.5.peg.620","2045"
"28654",7,281,274,"AATAACATCATACGGTAAGG","CTTCTATAGAAAGATCAGCA","561307.5.peg.620","2045"
"28655",111,281,170,"TCTTTGAGTTTCAGCAATGC","CTTCTATAGAAAGATCAGCA","561307.5.peg.620","2045"
"28656",10,281,271,"TGAATAACATCATACGGTA","CTTCTATAGAAAGATCAGCA","561307.5.peg.620","2045"
"28657",486,281,205,"GCTTGTACACGTGCTACTAA","CTTCTATAGAAAGATCAGCA","561307.5.peg.620","2045"
"28658",101,281,180,"TCAGCAATGCTGGAATATGA","CTTCTATAGAAAGATCAGCA","561307.5.peg.620","2045"
"28659",111,311,200,"TCTTTGAGTTTCAGCAATGC","CACACAATACATGGACACCA","561307.5.peg.620","2045"
"28660",207,311,104,"CTAGGTGTCTCAACTGCATG","CACACAATACATGGACACCA","561307.5.peg.620","2045"
"28661",7,311,304,"AATAACATCATACGGTAAGG","CACACAATACATGGACACCA","561307.5.peg.620","2045"
"28662",101,311,210,"TCAGCAATGCTGGAATATGA","CACACAATACATGGACACCA","561307.5.peg.620","2045"
"28663",486,311,175,"GCTTGTACACGTGCTACTAA","CACACAATACATGGACACCA","561307.5.peg.620","2045"
"28664",10,311,301,"TGAATAACATCATACGGTA","CACACAATACATGGACACCA","561307.5.peg.620","2045"
"28665",207,339,132,"CTAGGTGTCTCAACTGCATG","TCTTCCGTCGTCATCGCCAT","561307.5.peg.620","2045"
"28666",111,339,228,"TCTTTGAGTTTCAGCAATGC","TCTTCCGTCGTCATCGCCAT","561307.5.peg.620","2045"
"28667",10,339,329,"TGAATAACATCATACGGTA","TCTTCCGTCGTCATCGCCAT","561307.5.peg.620","2045"
"28668",101,339,238,"TCAGCAATGCTGGAATATGA","TCTTCCGTCGTCATCGCCAT","561307.5.peg.620","2045"
"28669",7,339,332,"AATAACATCATACGGTAAGG","TCTTCCGTCGTCATCGCCAT","561307.5.peg.620","2045"
"28670",486,339,147,"GCTTGTACACGTGCTACTAA","TCTTCCGTCGTCATCGCCAT","561307.5.peg.620","2045"
"28671",225,339,114,"ACAAGTTTAAACAGCTCGCT","TCTTCCGTCGTCATCGCCAT","561307.5.peg.620","2045"
"28672",101,486,385,"TCAGCAATGCTGGAATATGA","GCTTGTACACGTGCTACTAA","561307.5.peg.620","2045"
"28673",207,486,279,"CTAGGTGTCTCAACTGCATG","GCTTGTACACGTGCTACTAA","561307.5.peg.620","2045"
"28674",225,486,261,"ACAAGTTTAAACAGCTCGCT","GCTTGTACACGTGCTACTAA","561307.5.peg.620","2045"
"28675",281,486,205,"CTTCTATAGAAAGATCAGCA","GCTTGTACACGTGCTACTAA","561307.5.peg.620","2045"
"28676",10,486,476,"TGAATAACATCATACGGTA","GCTTGTACACGTGCTACTAA","561307.5.peg.620","2045"
"28677",7,486,479,"AATAACATCATACGGTAAGG","GCTTGTACACGTGCTACTAA","561307.5.peg.620","2045"
"28678",111,486,375,"TCTTTGAGTTTCAGCAATGC","GCTTGTACACGTGCTACTAA","561307.5.peg.620","2045"
"28679",339,486,147,"TCTTCCGTCGTCATCGCCAT","GCTTGTACACGTGCTACTAA","561307.5.peg.620","2045"
"28680",311,486,175,"CACACAATACATGGACACCA","GCTTGTACACGTGCTACTAA","561307.5.peg.620","2045"
"28681",420,291,129,"CAAGGTGTAACAGGCCAATT","TCTTTCGCTTCTATCGGATC","561307.5.peg.621","2046"
"28682",438,291,147,"TCAGAGTAGGCTGTTGGCCA","TCTTTCGCTTCTATCGGATC","561307.5.peg.621","2046"
"28683",429,291,138,"GCTGTTGGCCAAGGTGTAAC","TCTTTCGCTTCTATCGGATC","561307.5.peg.621","2046"
"28684",495,291,204,"TCAGCTAAATCTTGCCAATA","TCTTTCGCTTCTATCGGATC","561307.5.peg.621","2046"
"28685",444,291,153,"TAAATTTCAGAGTAGGCTGT","TCTTTCGCTTCTATCGGATC","561307.5.peg.621","2046"
"28686",429,297,132,"GCTGTTGGCCAAGGTGTAAC","TCGGCTTCTTTCGCTTCTAT","561307.5.peg.621","2046"
"28687",438,297,141,"TCAGAGTAGGCTGTTGGCCA","TCGGCTTCTTTCGCTTCTAT","561307.5.peg.621","2046"
"28688",444,297,147,"TAAATTTCAGAGTAGGCTGT","TCGGCTTCTTTCGCTTCTAT","561307.5.peg.621","2046"
"28689",420,297,123,"CAAGGTGTAACAGGCCAATT","TCGGCTTCTTTCGCTTCTAT","561307.5.peg.621","2046"
"28690",495,297,198,"TCAGCTAAATCTTGCCAATA","TCGGCTTCTTTCGCTTCTAT","561307.5.peg.621","2046"
"28691",444,341,103,"TAAATTTCAGAGTAGGCTGT","CGTCTAATAGATTTGCTAAA","561307.5.peg.621","2046"
"28692",495,341,154,"TCAGCTAAATCTTGCCAATA","CGTCTAATAGATTTGCTAAA","561307.5.peg.621","2046"
"28693",291,420,129,"TCTTTCGCTTCTATCGGATC","CAAGGTGTAACAGGCCAATT","561307.5.peg.621","2046"
"28694",297,420,123,"TCGGCTTCTTTCGCTTCTAT","CAAGGTGTAACAGGCCAATT","561307.5.peg.621","2046"
"28695",291,429,138,"TCTTTCGCTTCTATCGGATC","GCTGTTGGCCAAGGTGTAAC","561307.5.peg.621","2046"
"28696",297,429,132,"TCGGCTTCTTTCGCTTCTAT","GCTGTTGGCCAAGGTGTAAC","561307.5.peg.621","2046"
"28697",297,438,141,"TCGGCTTCTTTCGCTTCTAT","TCAGAGTAGGCTGTTGGCCA","561307.5.peg.621","2046"
"28698",291,438,147,"TCTTTCGCTTCTATCGGATC","TCAGAGTAGGCTGTTGGCCA","561307.5.peg.621","2046"
"28699",291,444,153,"TCTTTCGCTTCTATCGGATC","TAAATTTCAGAGTAGGCTGT","561307.5.peg.621","2046"
"28700",341,444,103,"CGTCTAATAGATTTGCTAAA","TAAATTTCAGAGTAGGCTGT","561307.5.peg.621","2046"
"28701",297,444,147,"TCGGCTTCTTTCGCTTCTAT","TAAATTTCAGAGTAGGCTGT","561307.5.peg.621","2046"
"28702",291,495,204,"TCTTTCGCTTCTATCGGATC","TCAGCTAAATCTTGCCAATA","561307.5.peg.621","2046"
"28703",341,495,154,"CGTCTAATAGATTTGCTAAA","TCAGCTAAATCTTGCCAATA","561307.5.peg.621","2046"
"28704",297,495,198,"TCGGCTTCTTTCGCTTCTAT","TCAGCTAAATCTTGCCAATA","561307.5.peg.621","2046"
"28705",455,5,450,"TTGCAGGTCCACCAACTGAT","TTAAGCCAAATATATCACGT","561307.5.peg.623","2048"
"28706",521,5,516,"TATTCCAGAATCCTAAGTAT","TTAAGCCAAATATATCACGT","561307.5.peg.623","2048"
"28707",696,5,691,"CGATTCCATCCTAATTCTTC","TTAAGCCAAATATATCACGT","561307.5.peg.623","2048"
"28708",565,5,560,"AAGTGCAACACCACCTGCTA","TTAAGCCAAATATATCACGT","561307.5.peg.623","2048"
"28709",471,5,466,"GAAATCGTTGAATAACTTGC","TTAAGCCAAATATATCACGT","561307.5.peg.623","2048"
"28710",638,5,633,"TAAGTAATGCAATCACCGAT","TTAAGCCAAATATATCACGT","561307.5.peg.623","2048"
"28711",565,29,536,"AAGTGCAACACCACCTGCTA","TACACCGACGTGATATATT","561307.5.peg.623","2048"
"28712",696,29,667,"CGATTCCATCCTAATTCTTC","TACACCGACGTGATATATT","561307.5.peg.623","2048"
"28713",638,29,609,"TAAGTAATGCAATCACCGAT","TACACCGACGTGATATATT","561307.5.peg.623","2048"
"28714",471,29,442,"GAAATCGTTGAATAACTTGC","TACACCGACGTGATATATT","561307.5.peg.623","2048"
"28715",455,29,426,"TTGCAGGTCCACCAACTGAT","TACACCGACGTGATATATT","561307.5.peg.623","2048"
"28716",521,29,492,"TATTCCAGAATCCTAAGTAT","TACACCGACGTGATATATT","561307.5.peg.623","2048"
"28717",521,68,453,"TATTCCAGAATCCTAAGTAT","TGCCTTTGTTCGGAATCTTA","561307.5.peg.623","2048"
"28718",471,68,403,"GAAATCGTTGAATAACTTGC","TGCCTTTGTTCGGAATCTTA","561307.5.peg.623","2048"
"28719",696,68,628,"CGATTCCATCCTAATTCTTC","TGCCTTTGTTCGGAATCTTA","561307.5.peg.623","2048"
"28720",455,68,387,"TTGCAGGTCCACCAACTGAT","TGCCTTTGTTCGGAATCTTA","561307.5.peg.623","2048"
"28721",638,68,570,"TAAGTAATGCAATCACCGAT","TGCCTTTGTTCGGAATCTTA","561307.5.peg.623","2048"
"28722",565,68,497,"AAGTGCAACACCACCTGCTA","TGCCTTTGTTCGGAATCTTA","561307.5.peg.623","2048"
"28723",471,78,393,"GAAATCGTTGAATAACTTGC","GATAATGGAATGCCTTTGTT","561307.5.peg.623","2048"
"28724",521,78,443,"TATTCCAGAATCCTAAGTAT","GATAATGGAATGCCTTTGTT","561307.5.peg.623","2048"
"28725",565,78,487,"AAGTGCAACACCACCTGCTA","GATAATGGAATGCCTTTGTT","561307.5.peg.623","2048"
"28726",696,78,618,"CGATTCCATCCTAATTCTTC","GATAATGGAATGCCTTTGTT","561307.5.peg.623","2048"
"28727",455,78,377,"TTGCAGGTCCACCAACTGAT","GATAATGGAATGCCTTTGTT","561307.5.peg.623","2048"
"28728",638,78,560,"TAAGTAATGCAATCACCGAT","GATAATGGAATGCCTTTGTT","561307.5.peg.623","2048"
"28729",455,93,362,"TTGCAGGTCCACCAACTGAT","ATTTACGTTGTACCGATAA","561307.5.peg.623","2048"
"28730",471,93,378,"GAAATCGTTGAATAACTTGC","ATTTACGTTGTACCGATAA","561307.5.peg.623","2048"
"28731",638,93,545,"TAAGTAATGCAATCACCGAT","ATTTACGTTGTACCGATAA","561307.5.peg.623","2048"
"28732",565,93,472,"AAGTGCAACACCACCTGCTA","ATTTACGTTGTACCGATAA","561307.5.peg.623","2048"
"28733",521,93,428,"TATTCCAGAATCCTAAGTAT","ATTTACGTTGTACCGATAA","561307.5.peg.623","2048"
"28734",696,93,603,"CGATTCCATCCTAATTCTTC","ATTTACGTTGTACCGATAA","561307.5.peg.623","2048"
"28735",78,455,377,"GATAATGGAATGCCTTTGTT","TTGCAGGTCCACCAACTGAT","561307.5.peg.623","2048"
"28736",565,455,110,"AAGTGCAACACCACCTGCTA","TTGCAGGTCCACCAACTGAT","561307.5.peg.623","2048"
"28737",5,455,450,"TTAAGCCAAATATATCACGT","TTGCAGGTCCACCAACTGAT","561307.5.peg.623","2048"
"28738",93,455,362,"ATTTACGTTGTACCGATAA","TTGCAGGTCCACCAACTGAT","561307.5.peg.623","2048"
"28739",29,455,426,"TACACCGACGTGATATATT","TTGCAGGTCCACCAACTGAT","561307.5.peg.623","2048"
"28740",638,455,183,"TAAGTAATGCAATCACCGAT","TTGCAGGTCCACCAACTGAT","561307.5.peg.623","2048"
"28741",68,455,387,"TGCCTTTGTTCGGAATCTTA","TTGCAGGTCCACCAACTGAT","561307.5.peg.623","2048"
"28742",696,455,241,"CGATTCCATCCTAATTCTTC","TTGCAGGTCCACCAACTGAT","561307.5.peg.623","2048"
"28743",29,471,442,"TACACCGACGTGATATATT","GAAATCGTTGAATAACTTGC","561307.5.peg.623","2048"
"28744",78,471,393,"GATAATGGAATGCCTTTGTT","GAAATCGTTGAATAACTTGC","561307.5.peg.623","2048"
"28745",68,471,403,"TGCCTTTGTTCGGAATCTTA","GAAATCGTTGAATAACTTGC","561307.5.peg.623","2048"
"28746",696,471,225,"CGATTCCATCCTAATTCTTC","GAAATCGTTGAATAACTTGC","561307.5.peg.623","2048"
"28747",5,471,466,"TTAAGCCAAATATATCACGT","GAAATCGTTGAATAACTTGC","561307.5.peg.623","2048"
"28748",93,471,378,"ATTTACGTTGTACCGATAA","GAAATCGTTGAATAACTTGC","561307.5.peg.623","2048"
"28749",638,471,167,"TAAGTAATGCAATCACCGAT","GAAATCGTTGAATAACTTGC","561307.5.peg.623","2048"
"28750",696,521,175,"CGATTCCATCCTAATTCTTC","TATTCCAGAATCCTAAGTAT","561307.5.peg.623","2048"
"28751",68,521,453,"TGCCTTTGTTCGGAATCTTA","TATTCCAGAATCCTAAGTAT","561307.5.peg.623","2048"
"28752",93,521,428,"ATTTACGTTGTACCGATAA","TATTCCAGAATCCTAAGTAT","561307.5.peg.623","2048"
"28753",638,521,117,"TAAGTAATGCAATCACCGAT","TATTCCAGAATCCTAAGTAT","561307.5.peg.623","2048"
"28754",5,521,516,"TTAAGCCAAATATATCACGT","TATTCCAGAATCCTAAGTAT","561307.5.peg.623","2048"
"28755",78,521,443,"GATAATGGAATGCCTTTGTT","TATTCCAGAATCCTAAGTAT","561307.5.peg.623","2048"
"28756",29,521,492,"TACACCGACGTGATATATT","TATTCCAGAATCCTAAGTAT","561307.5.peg.623","2048"
"28757",5,565,560,"TTAAGCCAAATATATCACGT","AAGTGCAACACCACCTGCTA","561307.5.peg.623","2048"
"28758",78,565,487,"GATAATGGAATGCCTTTGTT","AAGTGCAACACCACCTGCTA","561307.5.peg.623","2048"
"28759",455,565,110,"TTGCAGGTCCACCAACTGAT","AAGTGCAACACCACCTGCTA","561307.5.peg.623","2048"
"28760",68,565,497,"TGCCTTTGTTCGGAATCTTA","AAGTGCAACACCACCTGCTA","561307.5.peg.623","2048"
"28761",29,565,536,"TACACCGACGTGATATATT","AAGTGCAACACCACCTGCTA","561307.5.peg.623","2048"
"28762",696,565,131,"CGATTCCATCCTAATTCTTC","AAGTGCAACACCACCTGCTA","561307.5.peg.623","2048"
"28763",93,565,472,"ATTTACGTTGTACCGATAA","AAGTGCAACACCACCTGCTA","561307.5.peg.623","2048"
"28764",93,638,545,"ATTTACGTTGTACCGATAA","TAAGTAATGCAATCACCGAT","561307.5.peg.623","2048"
"28765",5,638,633,"TTAAGCCAAATATATCACGT","TAAGTAATGCAATCACCGAT","561307.5.peg.623","2048"
"28766",521,638,117,"TATTCCAGAATCCTAAGTAT","TAAGTAATGCAATCACCGAT","561307.5.peg.623","2048"
"28767",68,638,570,"TGCCTTTGTTCGGAATCTTA","TAAGTAATGCAATCACCGAT","561307.5.peg.623","2048"
"28768",29,638,609,"TACACCGACGTGATATATT","TAAGTAATGCAATCACCGAT","561307.5.peg.623","2048"
"28769",455,638,183,"TTGCAGGTCCACCAACTGAT","TAAGTAATGCAATCACCGAT","561307.5.peg.623","2048"
"28770",471,638,167,"GAAATCGTTGAATAACTTGC","TAAGTAATGCAATCACCGAT","561307.5.peg.623","2048"
"28771",78,638,560,"GATAATGGAATGCCTTTGTT","TAAGTAATGCAATCACCGAT","561307.5.peg.623","2048"
"28772",5,696,691,"TTAAGCCAAATATATCACGT","CGATTCCATCCTAATTCTTC","561307.5.peg.623","2048"
"28773",68,696,628,"TGCCTTTGTTCGGAATCTTA","CGATTCCATCCTAATTCTTC","561307.5.peg.623","2048"
"28774",565,696,131,"AAGTGCAACACCACCTGCTA","CGATTCCATCCTAATTCTTC","561307.5.peg.623","2048"
"28775",455,696,241,"TTGCAGGTCCACCAACTGAT","CGATTCCATCCTAATTCTTC","561307.5.peg.623","2048"
"28776",471,696,225,"GAAATCGTTGAATAACTTGC","CGATTCCATCCTAATTCTTC","561307.5.peg.623","2048"
"28777",78,696,618,"GATAATGGAATGCCTTTGTT","CGATTCCATCCTAATTCTTC","561307.5.peg.623","2048"
"28778",29,696,667,"TACACCGACGTGATATATT","CGATTCCATCCTAATTCTTC","561307.5.peg.623","2048"
"28779",521,696,175,"TATTCCAGAATCCTAAGTAT","CGATTCCATCCTAATTCTTC","561307.5.peg.623","2048"
"28780",93,696,603,"ATTTACGTTGTACCGATAA","CGATTCCATCCTAATTCTTC","561307.5.peg.623","2048"
"28781",322,29,293,"AAGAACATGATGTTGAATGC","TCTACATTCCCCCTTGAAAG","561307.5.peg.624","2049"
"28782",360,29,331,"TCTAATTGTGCATGGTCTAC","TCTACATTCCCCCTTGAAAG","561307.5.peg.624","2049"
"28783",404,29,375,"ATTGTTGCTCTAATAAGGTA","TCTACATTCCCCCTTGAAAG","561307.5.peg.624","2049"
"28784",322,114,208,"AAGAACATGATGTTGAATGC","TTGAAATGATAGTCTCCCCA","561307.5.peg.624","2049"
"28785",360,114,246,"TCTAATTGTGCATGGTCTAC","TTGAAATGATAGTCTCCCCA","561307.5.peg.624","2049"
"28786",404,114,290,"ATTGTTGCTCTAATAAGGTA","TTGAAATGATAGTCTCCCCA","561307.5.peg.624","2049"
"28787",29,322,293,"TCTACATTCCCCCTTGAAAG","AAGAACATGATGTTGAATGC","561307.5.peg.624","2049"
"28788",114,322,208,"TTGAAATGATAGTCTCCCCA","AAGAACATGATGTTGAATGC","561307.5.peg.624","2049"
"28789",29,360,331,"TCTACATTCCCCCTTGAAAG","TCTAATTGTGCATGGTCTAC","561307.5.peg.624","2049"
"28790",114,360,246,"TTGAAATGATAGTCTCCCCA","TCTAATTGTGCATGGTCTAC","561307.5.peg.624","2049"
"28791",29,404,375,"TCTACATTCCCCCTTGAAAG","ATTGTTGCTCTAATAAGGTA","561307.5.peg.624","2049"
"28792",114,404,290,"TTGAAATGATAGTCTCCCCA","ATTGTTGCTCTAATAAGGTA","561307.5.peg.624","2049"
"28793",618,13,605,"TCATAAATCCGAATTGTTG","ATTTATGATGTGGAATATC","561307.5.peg.625","2050"
"28794",344,13,331,"AATAAAGTGTTGCGGGCTGT","ATTTATGATGTGGAATATC","561307.5.peg.625","2050"
"28795",157,13,144,"TGCTCAATCCAAATATAGA","ATTTATGATGTGGAATATC","561307.5.peg.625","2050"
"28796",533,13,520,"CAACGATAAGTGCGAATTGT","ATTTATGATGTGGAATATC","561307.5.peg.625","2050"
"28797",659,13,646,"TAATGAGACGATGGTCAGCA","ATTTATGATGTGGAATATC","561307.5.peg.625","2050"
"28798",502,13,489,"CTTAATTTCACTTAAACGTG","ATTTATGATGTGGAATATC","561307.5.peg.625","2050"
"28799",13,157,144,"ATTTATGATGTGGAATATC","TGCTCAATCCAAATATAGA","561307.5.peg.625","2050"
"28800",502,157,345,"CTTAATTTCACTTAAACGTG","TGCTCAATCCAAATATAGA","561307.5.peg.625","2050"
"28801",618,157,461,"TCATAAATCCGAATTGTTG","TGCTCAATCCAAATATAGA","561307.5.peg.625","2050"
"28802",659,157,502,"TAATGAGACGATGGTCAGCA","TGCTCAATCCAAATATAGA","561307.5.peg.625","2050"
"28803",344,157,187,"AATAAAGTGTTGCGGGCTGT","TGCTCAATCCAAATATAGA","561307.5.peg.625","2050"
"28804",533,157,376,"CAACGATAAGTGCGAATTGT","TGCTCAATCCAAATATAGA","561307.5.peg.625","2050"
"28805",502,344,158,"CTTAATTTCACTTAAACGTG","AATAAAGTGTTGCGGGCTGT","561307.5.peg.625","2050"
"28806",659,344,315,"TAATGAGACGATGGTCAGCA","AATAAAGTGTTGCGGGCTGT","561307.5.peg.625","2050"
"28807",13,344,331,"ATTTATGATGTGGAATATC","AATAAAGTGTTGCGGGCTGT","561307.5.peg.625","2050"
"28808",533,344,189,"CAACGATAAGTGCGAATTGT","AATAAAGTGTTGCGGGCTGT","561307.5.peg.625","2050"
"28809",157,344,187,"TGCTCAATCCAAATATAGA","AATAAAGTGTTGCGGGCTGT","561307.5.peg.625","2050"
"28810",618,344,274,"TCATAAATCCGAATTGTTG","AATAAAGTGTTGCGGGCTGT","561307.5.peg.625","2050"
"28811",157,502,345,"TGCTCAATCCAAATATAGA","CTTAATTTCACTTAAACGTG","561307.5.peg.625","2050"
"28812",344,502,158,"AATAAAGTGTTGCGGGCTGT","CTTAATTTCACTTAAACGTG","561307.5.peg.625","2050"
"28813",659,502,157,"TAATGAGACGATGGTCAGCA","CTTAATTTCACTTAAACGTG","561307.5.peg.625","2050"
"28814",618,502,116,"TCATAAATCCGAATTGTTG","CTTAATTTCACTTAAACGTG","561307.5.peg.625","2050"
"28815",13,502,489,"ATTTATGATGTGGAATATC","CTTAATTTCACTTAAACGTG","561307.5.peg.625","2050"
"28816",13,533,520,"ATTTATGATGTGGAATATC","CAACGATAAGTGCGAATTGT","561307.5.peg.625","2050"
"28817",157,533,376,"TGCTCAATCCAAATATAGA","CAACGATAAGTGCGAATTGT","561307.5.peg.625","2050"
"28818",659,533,126,"TAATGAGACGATGGTCAGCA","CAACGATAAGTGCGAATTGT","561307.5.peg.625","2050"
"28819",344,533,189,"AATAAAGTGTTGCGGGCTGT","CAACGATAAGTGCGAATTGT","561307.5.peg.625","2050"
"28820",344,618,274,"AATAAAGTGTTGCGGGCTGT","TCATAAATCCGAATTGTTG","561307.5.peg.625","2050"
"28821",13,618,605,"ATTTATGATGTGGAATATC","TCATAAATCCGAATTGTTG","561307.5.peg.625","2050"
"28822",502,618,116,"CTTAATTTCACTTAAACGTG","TCATAAATCCGAATTGTTG","561307.5.peg.625","2050"
"28823",157,618,461,"TGCTCAATCCAAATATAGA","TCATAAATCCGAATTGTTG","561307.5.peg.625","2050"
"28824",344,659,315,"AATAAAGTGTTGCGGGCTGT","TAATGAGACGATGGTCAGCA","561307.5.peg.625","2050"
"28825",157,659,502,"TGCTCAATCCAAATATAGA","TAATGAGACGATGGTCAGCA","561307.5.peg.625","2050"
"28826",533,659,126,"CAACGATAAGTGCGAATTGT","TAATGAGACGATGGTCAGCA","561307.5.peg.625","2050"
"28827",502,659,157,"CTTAATTTCACTTAAACGTG","TAATGAGACGATGGTCAGCA","561307.5.peg.625","2050"
"28828",13,659,646,"ATTTATGATGTGGAATATC","TAATGAGACGATGGTCAGCA","561307.5.peg.625","2050"
"28829",348,156,192,"GTTACAGATGTATCTTGATA","CGAATCAAGTTTGATTGATA","561307.5.peg.626","2051"
"28830",156,348,192,"CGAATCAAGTTTGATTGATA","GTTACAGATGTATCTTGATA","561307.5.peg.626","2051"
"28831",1100,9,1091,"ATCTAATGAGTGTAAGAAA","TCACAACATTATACAGATGG","561307.5.peg.627","2052"
"28832",956,9,947,"ACGTAATTTCATGATGAAG","TCACAACATTATACAGATGG","561307.5.peg.627","2052"
"28833",908,9,899,"CAGTAATAACGCCTGCTTTA","TCACAACATTATACAGATGG","561307.5.peg.627","2052"
"28834",1131,9,1122,"GTTAAGTTTGGTTCTGGAGC","TCACAACATTATACAGATGG","561307.5.peg.627","2052"
"28835",488,9,479,"AATATGCATCGAATACACCT","TCACAACATTATACAGATGG","561307.5.peg.627","2052"
"28836",1028,9,1019,"TAGATTCAGTTACCCAAGTT","TCACAACATTATACAGATGG","561307.5.peg.627","2052"
"28837",1137,9,1128,"ATACTGTTAAGTTTGGTTC","TCACAACATTATACAGATGG","561307.5.peg.627","2052"
"28838",530,9,521,"CAGTGATTACACCTGCTTTA","TCACAACATTATACAGATGG","561307.5.peg.627","2052"
"28839",1100,488,612,"ATCTAATGAGTGTAAGAAA","AATATGCATCGAATACACCT","561307.5.peg.627","2052"
"28840",9,488,479,"TCACAACATTATACAGATGG","AATATGCATCGAATACACCT","561307.5.peg.627","2052"
"28841",1137,488,649,"ATACTGTTAAGTTTGGTTC","AATATGCATCGAATACACCT","561307.5.peg.627","2052"
"28842",956,488,468,"ACGTAATTTCATGATGAAG","AATATGCATCGAATACACCT","561307.5.peg.627","2052"
"28843",1131,488,643,"GTTAAGTTTGGTTCTGGAGC","AATATGCATCGAATACACCT","561307.5.peg.627","2052"
"28844",1028,488,540,"TAGATTCAGTTACCCAAGTT","AATATGCATCGAATACACCT","561307.5.peg.627","2052"
"28845",908,488,420,"CAGTAATAACGCCTGCTTTA","AATATGCATCGAATACACCT","561307.5.peg.627","2052"
"28846",9,530,521,"TCACAACATTATACAGATGG","CAGTGATTACACCTGCTTTA","561307.5.peg.627","2052"
"28847",956,530,426,"ACGTAATTTCATGATGAAG","CAGTGATTACACCTGCTTTA","561307.5.peg.627","2052"
"28848",908,530,378,"CAGTAATAACGCCTGCTTTA","CAGTGATTACACCTGCTTTA","561307.5.peg.627","2052"
"28849",1137,530,607,"ATACTGTTAAGTTTGGTTC","CAGTGATTACACCTGCTTTA","561307.5.peg.627","2052"
"28850",1131,530,601,"GTTAAGTTTGGTTCTGGAGC","CAGTGATTACACCTGCTTTA","561307.5.peg.627","2052"
"28851",1028,530,498,"TAGATTCAGTTACCCAAGTT","CAGTGATTACACCTGCTTTA","561307.5.peg.627","2052"
"28852",1100,530,570,"ATCTAATGAGTGTAAGAAA","CAGTGATTACACCTGCTTTA","561307.5.peg.627","2052"
"28853",9,908,899,"TCACAACATTATACAGATGG","CAGTAATAACGCCTGCTTTA","561307.5.peg.627","2052"
"28854",1137,908,229,"ATACTGTTAAGTTTGGTTC","CAGTAATAACGCCTGCTTTA","561307.5.peg.627","2052"
"28855",530,908,378,"CAGTGATTACACCTGCTTTA","CAGTAATAACGCCTGCTTTA","561307.5.peg.627","2052"
"28856",1028,908,120,"TAGATTCAGTTACCCAAGTT","CAGTAATAACGCCTGCTTTA","561307.5.peg.627","2052"
"28857",1100,908,192,"ATCTAATGAGTGTAAGAAA","CAGTAATAACGCCTGCTTTA","561307.5.peg.627","2052"
"28858",488,908,420,"AATATGCATCGAATACACCT","CAGTAATAACGCCTGCTTTA","561307.5.peg.627","2052"
"28859",1131,908,223,"GTTAAGTTTGGTTCTGGAGC","CAGTAATAACGCCTGCTTTA","561307.5.peg.627","2052"
"28860",530,956,426,"CAGTGATTACACCTGCTTTA","ACGTAATTTCATGATGAAG","561307.5.peg.627","2052"
"28861",1100,956,144,"ATCTAATGAGTGTAAGAAA","ACGTAATTTCATGATGAAG","561307.5.peg.627","2052"
"28862",488,956,468,"AATATGCATCGAATACACCT","ACGTAATTTCATGATGAAG","561307.5.peg.627","2052"
"28863",1131,956,175,"GTTAAGTTTGGTTCTGGAGC","ACGTAATTTCATGATGAAG","561307.5.peg.627","2052"
"28864",9,956,947,"TCACAACATTATACAGATGG","ACGTAATTTCATGATGAAG","561307.5.peg.627","2052"
"28865",1137,956,181,"ATACTGTTAAGTTTGGTTC","ACGTAATTTCATGATGAAG","561307.5.peg.627","2052"
"28866",1137,1028,109,"ATACTGTTAAGTTTGGTTC","TAGATTCAGTTACCCAAGTT","561307.5.peg.627","2052"
"28867",9,1028,1019,"TCACAACATTATACAGATGG","TAGATTCAGTTACCCAAGTT","561307.5.peg.627","2052"
"28868",1131,1028,103,"GTTAAGTTTGGTTCTGGAGC","TAGATTCAGTTACCCAAGTT","561307.5.peg.627","2052"
"28869",908,1028,120,"CAGTAATAACGCCTGCTTTA","TAGATTCAGTTACCCAAGTT","561307.5.peg.627","2052"
"28870",488,1028,540,"AATATGCATCGAATACACCT","TAGATTCAGTTACCCAAGTT","561307.5.peg.627","2052"
"28871",530,1028,498,"CAGTGATTACACCTGCTTTA","TAGATTCAGTTACCCAAGTT","561307.5.peg.627","2052"
"28872",908,1100,192,"CAGTAATAACGCCTGCTTTA","ATCTAATGAGTGTAAGAAA","561307.5.peg.627","2052"
"28873",956,1100,144,"ACGTAATTTCATGATGAAG","ATCTAATGAGTGTAAGAAA","561307.5.peg.627","2052"
"28874",530,1100,570,"CAGTGATTACACCTGCTTTA","ATCTAATGAGTGTAAGAAA","561307.5.peg.627","2052"
"28875",488,1100,612,"AATATGCATCGAATACACCT","ATCTAATGAGTGTAAGAAA","561307.5.peg.627","2052"
"28876",9,1100,1091,"TCACAACATTATACAGATGG","ATCTAATGAGTGTAAGAAA","561307.5.peg.627","2052"
"28877",9,1131,1122,"TCACAACATTATACAGATGG","GTTAAGTTTGGTTCTGGAGC","561307.5.peg.627","2052"
"28878",530,1131,601,"CAGTGATTACACCTGCTTTA","GTTAAGTTTGGTTCTGGAGC","561307.5.peg.627","2052"
"28879",908,1131,223,"CAGTAATAACGCCTGCTTTA","GTTAAGTTTGGTTCTGGAGC","561307.5.peg.627","2052"
"28880",488,1131,643,"AATATGCATCGAATACACCT","GTTAAGTTTGGTTCTGGAGC","561307.5.peg.627","2052"
"28881",1028,1131,103,"TAGATTCAGTTACCCAAGTT","GTTAAGTTTGGTTCTGGAGC","561307.5.peg.627","2052"
"28882",956,1131,175,"ACGTAATTTCATGATGAAG","GTTAAGTTTGGTTCTGGAGC","561307.5.peg.627","2052"
"28883",9,1137,1128,"TCACAACATTATACAGATGG","ATACTGTTAAGTTTGGTTC","561307.5.peg.627","2052"
"28884",908,1137,229,"CAGTAATAACGCCTGCTTTA","ATACTGTTAAGTTTGGTTC","561307.5.peg.627","2052"
"28885",1028,1137,109,"TAGATTCAGTTACCCAAGTT","ATACTGTTAAGTTTGGTTC","561307.5.peg.627","2052"
"28886",530,1137,607,"CAGTGATTACACCTGCTTTA","ATACTGTTAAGTTTGGTTC","561307.5.peg.627","2052"
"28887",488,1137,649,"AATATGCATCGAATACACCT","ATACTGTTAAGTTTGGTTC","561307.5.peg.627","2052"
"28888",956,1137,181,"ACGTAATTTCATGATGAAG","ATACTGTTAAGTTTGGTTC","561307.5.peg.627","2052"
"28889",346,215,131,"AATAATCTGTCGATCAAAGC","CCAATTGTTAATCGTAAGT","561307.5.peg.629","2054"
"28890",472,215,257,"TACTGAACTTAGTCCTAGGT","CCAATTGTTAATCGTAAGT","561307.5.peg.629","2054"
"28891",465,215,250,"CTTAGTCCTAGGTTGGCAAT","CCAATTGTTAATCGTAAGT","561307.5.peg.629","2054"
"28892",476,215,261,"TAATACTGAACTTAGTCCT","CCAATTGTTAATCGTAAGT","561307.5.peg.629","2054"
"28893",465,255,210,"CTTAGTCCTAGGTTGGCAAT","ATAAGAAGTATCACACTGGC","561307.5.peg.629","2054"
"28894",476,255,221,"TAATACTGAACTTAGTCCT","ATAAGAAGTATCACACTGGC","561307.5.peg.629","2054"
"28895",472,255,217,"TACTGAACTTAGTCCTAGGT","ATAAGAAGTATCACACTGGC","561307.5.peg.629","2054"
"28896",215,346,131,"CCAATTGTTAATCGTAAGT","AATAATCTGTCGATCAAAGC","561307.5.peg.629","2054"
"28897",465,346,119,"CTTAGTCCTAGGTTGGCAAT","AATAATCTGTCGATCAAAGC","561307.5.peg.629","2054"
"28898",476,346,130,"TAATACTGAACTTAGTCCT","AATAATCTGTCGATCAAAGC","561307.5.peg.629","2054"
"28899",472,346,126,"TACTGAACTTAGTCCTAGGT","AATAATCTGTCGATCAAAGC","561307.5.peg.629","2054"
"28900",255,465,210,"ATAAGAAGTATCACACTGGC","CTTAGTCCTAGGTTGGCAAT","561307.5.peg.629","2054"
"28901",215,465,250,"CCAATTGTTAATCGTAAGT","CTTAGTCCTAGGTTGGCAAT","561307.5.peg.629","2054"
"28902",346,465,119,"AATAATCTGTCGATCAAAGC","CTTAGTCCTAGGTTGGCAAT","561307.5.peg.629","2054"
"28903",255,472,217,"ATAAGAAGTATCACACTGGC","TACTGAACTTAGTCCTAGGT","561307.5.peg.629","2054"
"28904",215,472,257,"CCAATTGTTAATCGTAAGT","TACTGAACTTAGTCCTAGGT","561307.5.peg.629","2054"
"28905",346,472,126,"AATAATCTGTCGATCAAAGC","TACTGAACTTAGTCCTAGGT","561307.5.peg.629","2054"
"28906",215,476,261,"CCAATTGTTAATCGTAAGT","TAATACTGAACTTAGTCCT","561307.5.peg.629","2054"
"28907",255,476,221,"ATAAGAAGTATCACACTGGC","TAATACTGAACTTAGTCCT","561307.5.peg.629","2054"
"28908",346,476,130,"AATAATCTGTCGATCAAAGC","TAATACTGAACTTAGTCCT","561307.5.peg.629","2054"
"28909",444,49,395,"TGTAAGGTTGGATTGTTTGT","TACAATGTATGCTTCTTGCA","561307.5.peg.632","2058"
"28910",421,49,372,"CTCGTTGCCACCCATTGGTA","TACAATGTATGCTTCTTGCA","561307.5.peg.632","2058"
"28911",358,49,309,"TTGACCAGCCATAATTTGAT","TACAATGTATGCTTCTTGCA","561307.5.peg.632","2058"
"28912",300,49,251,"TAGCGATTCACTGTTTGACC","TACAATGTATGCTTCTTGCA","561307.5.peg.632","2058"
"28913",523,49,474,"TTCGCGTGATACGTCAAATT","TACAATGTATGCTTCTTGCA","561307.5.peg.632","2058"
"28914",583,49,534,"ACCATCACGTTGTGCGTCAT","TACAATGTATGCTTCTTGCA","561307.5.peg.632","2058"
"28915",426,49,377,"GTGGGCTCGTTGCCACCCAT","TACAATGTATGCTTCTTGCA","561307.5.peg.632","2058"
"28916",343,49,294,"TTGATTGGCTGCAATCGCGA","TACAATGTATGCTTCTTGCA","561307.5.peg.632","2058"
"28917",343,119,224,"TTGATTGGCTGCAATCGCGA","CGACATCATCAGGTCTTTCG","561307.5.peg.632","2058"
"28918",358,119,239,"TTGACCAGCCATAATTTGAT","CGACATCATCAGGTCTTTCG","561307.5.peg.632","2058"
"28919",426,119,307,"GTGGGCTCGTTGCCACCCAT","CGACATCATCAGGTCTTTCG","561307.5.peg.632","2058"
"28920",444,119,325,"TGTAAGGTTGGATTGTTTGT","CGACATCATCAGGTCTTTCG","561307.5.peg.632","2058"
"28921",421,119,302,"CTCGTTGCCACCCATTGGTA","CGACATCATCAGGTCTTTCG","561307.5.peg.632","2058"
"28922",583,119,464,"ACCATCACGTTGTGCGTCAT","CGACATCATCAGGTCTTTCG","561307.5.peg.632","2058"
"28923",523,119,404,"TTCGCGTGATACGTCAAATT","CGACATCATCAGGTCTTTCG","561307.5.peg.632","2058"
"28924",300,119,181,"TAGCGATTCACTGTTTGACC","CGACATCATCAGGTCTTTCG","561307.5.peg.632","2058"
"28925",444,129,315,"TGTAAGGTTGGATTGTTTGT","ACTTTGGCTGCGACATCATC","561307.5.peg.632","2058"
"28926",421,129,292,"CTCGTTGCCACCCATTGGTA","ACTTTGGCTGCGACATCATC","561307.5.peg.632","2058"
"28927",358,129,229,"TTGACCAGCCATAATTTGAT","ACTTTGGCTGCGACATCATC","561307.5.peg.632","2058"
"28928",300,129,171,"TAGCGATTCACTGTTTGACC","ACTTTGGCTGCGACATCATC","561307.5.peg.632","2058"
"28929",426,129,297,"GTGGGCTCGTTGCCACCCAT","ACTTTGGCTGCGACATCATC","561307.5.peg.632","2058"
"28930",523,129,394,"TTCGCGTGATACGTCAAATT","ACTTTGGCTGCGACATCATC","561307.5.peg.632","2058"
"28931",583,129,454,"ACCATCACGTTGTGCGTCAT","ACTTTGGCTGCGACATCATC","561307.5.peg.632","2058"
"28932",343,129,214,"TTGATTGGCTGCAATCGCGA","ACTTTGGCTGCGACATCATC","561307.5.peg.632","2058"
"28933",358,145,213,"TTGACCAGCCATAATTTGAT","CAATACGCCTTGTAATACTT","561307.5.peg.632","2058"
"28934",300,145,155,"TAGCGATTCACTGTTTGACC","CAATACGCCTTGTAATACTT","561307.5.peg.632","2058"
"28935",426,145,281,"GTGGGCTCGTTGCCACCCAT","CAATACGCCTTGTAATACTT","561307.5.peg.632","2058"
"28936",583,145,438,"ACCATCACGTTGTGCGTCAT","CAATACGCCTTGTAATACTT","561307.5.peg.632","2058"
"28937",343,145,198,"TTGATTGGCTGCAATCGCGA","CAATACGCCTTGTAATACTT","561307.5.peg.632","2058"
"28938",421,145,276,"CTCGTTGCCACCCATTGGTA","CAATACGCCTTGTAATACTT","561307.5.peg.632","2058"
"28939",444,145,299,"TGTAAGGTTGGATTGTTTGT","CAATACGCCTTGTAATACTT","561307.5.peg.632","2058"
"28940",523,145,378,"TTCGCGTGATACGTCAAATT","CAATACGCCTTGTAATACTT","561307.5.peg.632","2058"
"28941",583,300,283,"ACCATCACGTTGTGCGTCAT","TAGCGATTCACTGTTTGACC","561307.5.peg.632","2058"
"28942",444,300,144,"TGTAAGGTTGGATTGTTTGT","TAGCGATTCACTGTTTGACC","561307.5.peg.632","2058"
"28943",119,300,181,"CGACATCATCAGGTCTTTCG","TAGCGATTCACTGTTTGACC","561307.5.peg.632","2058"
"28944",421,300,121,"CTCGTTGCCACCCATTGGTA","TAGCGATTCACTGTTTGACC","561307.5.peg.632","2058"
"28945",145,300,155,"CAATACGCCTTGTAATACTT","TAGCGATTCACTGTTTGACC","561307.5.peg.632","2058"
"28946",129,300,171,"ACTTTGGCTGCGACATCATC","TAGCGATTCACTGTTTGACC","561307.5.peg.632","2058"
"28947",49,300,251,"TACAATGTATGCTTCTTGCA","TAGCGATTCACTGTTTGACC","561307.5.peg.632","2058"
"28948",523,300,223,"TTCGCGTGATACGTCAAATT","TAGCGATTCACTGTTTGACC","561307.5.peg.632","2058"
"28949",426,300,126,"GTGGGCTCGTTGCCACCCAT","TAGCGATTCACTGTTTGACC","561307.5.peg.632","2058"
"28950",49,343,294,"TACAATGTATGCTTCTTGCA","TTGATTGGCTGCAATCGCGA","561307.5.peg.632","2058"
"28951",129,343,214,"ACTTTGGCTGCGACATCATC","TTGATTGGCTGCAATCGCGA","561307.5.peg.632","2058"
"28952",444,343,101,"TGTAAGGTTGGATTGTTTGT","TTGATTGGCTGCAATCGCGA","561307.5.peg.632","2058"
"28953",119,343,224,"CGACATCATCAGGTCTTTCG","TTGATTGGCTGCAATCGCGA","561307.5.peg.632","2058"
"28954",523,343,180,"TTCGCGTGATACGTCAAATT","TTGATTGGCTGCAATCGCGA","561307.5.peg.632","2058"
"28955",583,343,240,"ACCATCACGTTGTGCGTCAT","TTGATTGGCTGCAATCGCGA","561307.5.peg.632","2058"
"28956",145,343,198,"CAATACGCCTTGTAATACTT","TTGATTGGCTGCAATCGCGA","561307.5.peg.632","2058"
"28957",49,358,309,"TACAATGTATGCTTCTTGCA","TTGACCAGCCATAATTTGAT","561307.5.peg.632","2058"
"28958",129,358,229,"ACTTTGGCTGCGACATCATC","TTGACCAGCCATAATTTGAT","561307.5.peg.632","2058"
"28959",145,358,213,"CAATACGCCTTGTAATACTT","TTGACCAGCCATAATTTGAT","561307.5.peg.632","2058"
"28960",119,358,239,"CGACATCATCAGGTCTTTCG","TTGACCAGCCATAATTTGAT","561307.5.peg.632","2058"
"28961",523,358,165,"TTCGCGTGATACGTCAAATT","TTGACCAGCCATAATTTGAT","561307.5.peg.632","2058"
"28962",583,358,225,"ACCATCACGTTGTGCGTCAT","TTGACCAGCCATAATTTGAT","561307.5.peg.632","2058"
"28963",49,421,372,"TACAATGTATGCTTCTTGCA","CTCGTTGCCACCCATTGGTA","561307.5.peg.632","2058"
"28964",145,421,276,"CAATACGCCTTGTAATACTT","CTCGTTGCCACCCATTGGTA","561307.5.peg.632","2058"
"28965",129,421,292,"ACTTTGGCTGCGACATCATC","CTCGTTGCCACCCATTGGTA","561307.5.peg.632","2058"
"28966",119,421,302,"CGACATCATCAGGTCTTTCG","CTCGTTGCCACCCATTGGTA","561307.5.peg.632","2058"
"28967",523,421,102,"TTCGCGTGATACGTCAAATT","CTCGTTGCCACCCATTGGTA","561307.5.peg.632","2058"
"28968",583,421,162,"ACCATCACGTTGTGCGTCAT","CTCGTTGCCACCCATTGGTA","561307.5.peg.632","2058"
"28969",300,421,121,"TAGCGATTCACTGTTTGACC","CTCGTTGCCACCCATTGGTA","561307.5.peg.632","2058"
"28970",145,426,281,"CAATACGCCTTGTAATACTT","GTGGGCTCGTTGCCACCCAT","561307.5.peg.632","2058"
"28971",49,426,377,"TACAATGTATGCTTCTTGCA","GTGGGCTCGTTGCCACCCAT","561307.5.peg.632","2058"
"28972",129,426,297,"ACTTTGGCTGCGACATCATC","GTGGGCTCGTTGCCACCCAT","561307.5.peg.632","2058"
"28973",119,426,307,"CGACATCATCAGGTCTTTCG","GTGGGCTCGTTGCCACCCAT","561307.5.peg.632","2058"
"28974",583,426,157,"ACCATCACGTTGTGCGTCAT","GTGGGCTCGTTGCCACCCAT","561307.5.peg.632","2058"
"28975",300,426,126,"TAGCGATTCACTGTTTGACC","GTGGGCTCGTTGCCACCCAT","561307.5.peg.632","2058"
"28976",119,444,325,"CGACATCATCAGGTCTTTCG","TGTAAGGTTGGATTGTTTGT","561307.5.peg.632","2058"
"28977",343,444,101,"TTGATTGGCTGCAATCGCGA","TGTAAGGTTGGATTGTTTGT","561307.5.peg.632","2058"
"28978",300,444,144,"TAGCGATTCACTGTTTGACC","TGTAAGGTTGGATTGTTTGT","561307.5.peg.632","2058"
"28979",583,444,139,"ACCATCACGTTGTGCGTCAT","TGTAAGGTTGGATTGTTTGT","561307.5.peg.632","2058"
"28980",49,444,395,"TACAATGTATGCTTCTTGCA","TGTAAGGTTGGATTGTTTGT","561307.5.peg.632","2058"
"28981",129,444,315,"ACTTTGGCTGCGACATCATC","TGTAAGGTTGGATTGTTTGT","561307.5.peg.632","2058"
"28982",145,444,299,"CAATACGCCTTGTAATACTT","TGTAAGGTTGGATTGTTTGT","561307.5.peg.632","2058"
"28983",49,523,474,"TACAATGTATGCTTCTTGCA","TTCGCGTGATACGTCAAATT","561307.5.peg.632","2058"
"28984",129,523,394,"ACTTTGGCTGCGACATCATC","TTCGCGTGATACGTCAAATT","561307.5.peg.632","2058"
"28985",343,523,180,"TTGATTGGCTGCAATCGCGA","TTCGCGTGATACGTCAAATT","561307.5.peg.632","2058"
"28986",421,523,102,"CTCGTTGCCACCCATTGGTA","TTCGCGTGATACGTCAAATT","561307.5.peg.632","2058"
"28987",145,523,378,"CAATACGCCTTGTAATACTT","TTCGCGTGATACGTCAAATT","561307.5.peg.632","2058"
"28988",300,523,223,"TAGCGATTCACTGTTTGACC","TTCGCGTGATACGTCAAATT","561307.5.peg.632","2058"
"28989",119,523,404,"CGACATCATCAGGTCTTTCG","TTCGCGTGATACGTCAAATT","561307.5.peg.632","2058"
"28990",358,523,165,"TTGACCAGCCATAATTTGAT","TTCGCGTGATACGTCAAATT","561307.5.peg.632","2058"
"28991",145,583,438,"CAATACGCCTTGTAATACTT","ACCATCACGTTGTGCGTCAT","561307.5.peg.632","2058"
"28992",444,583,139,"TGTAAGGTTGGATTGTTTGT","ACCATCACGTTGTGCGTCAT","561307.5.peg.632","2058"
"28993",119,583,464,"CGACATCATCAGGTCTTTCG","ACCATCACGTTGTGCGTCAT","561307.5.peg.632","2058"
"28994",343,583,240,"TTGATTGGCTGCAATCGCGA","ACCATCACGTTGTGCGTCAT","561307.5.peg.632","2058"
"28995",300,583,283,"TAGCGATTCACTGTTTGACC","ACCATCACGTTGTGCGTCAT","561307.5.peg.632","2058"
"28996",49,583,534,"TACAATGTATGCTTCTTGCA","ACCATCACGTTGTGCGTCAT","561307.5.peg.632","2058"
"28997",426,583,157,"GTGGGCTCGTTGCCACCCAT","ACCATCACGTTGTGCGTCAT","561307.5.peg.632","2058"
"28998",421,583,162,"CTCGTTGCCACCCATTGGTA","ACCATCACGTTGTGCGTCAT","561307.5.peg.632","2058"
"28999",129,583,454,"ACTTTGGCTGCGACATCATC","ACCATCACGTTGTGCGTCAT","561307.5.peg.632","2058"
"29000",358,583,225,"TTGACCAGCCATAATTTGAT","ACCATCACGTTGTGCGTCAT","561307.5.peg.632","2058"
"29001",1148,8,1140,"TGAACCCCCAGACAAGCGCA","CTTATCCTCAACTAAATTGG","561307.5.peg.633","2059"
"29002",1116,8,1108,"CGGAAATCATCGGTAGCTTT","CTTATCCTCAACTAAATTGG","561307.5.peg.633","2059"
"29003",222,8,214,"AGATTTAAGTCGAATAGTAG","CTTATCCTCAACTAAATTGG","561307.5.peg.633","2059"
"29004",519,8,511,"GATTCCTTCGTGTGTGACGT","CTTATCCTCAACTAAATTGG","561307.5.peg.633","2059"
"29005",1136,8,1128,"CAAGCGCACGGTCTATGTCT","CTTATCCTCAACTAAATTGG","561307.5.peg.633","2059"
"29006",670,8,662,"AATGCTTATCTTGTGTTGCT","CTTATCCTCAACTAAATTGG","561307.5.peg.633","2059"
"29007",485,8,477,"CTAATTTCATAATACGTGGT","CTTATCCTCAACTAAATTGG","561307.5.peg.633","2059"
"29008",612,8,604,"ACTCTATTTGCGACAAAGCC","CTTATCCTCAACTAAATTGG","561307.5.peg.633","2059"
"29009",761,8,753,"CTGCAATATCTAAACCGACT","CTTATCCTCAACTAAATTGG","561307.5.peg.633","2059"
"29010",1126,8,1118,"GTCTATGTCTCGGAAATCAT","CTTATCCTCAACTAAATTGG","561307.5.peg.633","2059"
"29011",1033,8,1025,"TTCGTCTTGCGCATTGAATA","CTTATCCTCAACTAAATTGG","561307.5.peg.633","2059"
"29012",966,8,958,"GGTAATTGTGGTTGCGATAC","CTTATCCTCAACTAAATTGG","561307.5.peg.633","2059"
"29013",485,70,415,"CTAATTTCATAATACGTGGT","CATTGTGCCTGCGCCAAGAA","561307.5.peg.633","2059"
"29014",1136,70,1066,"CAAGCGCACGGTCTATGTCT","CATTGTGCCTGCGCCAAGAA","561307.5.peg.633","2059"
"29015",761,70,691,"CTGCAATATCTAAACCGACT","CATTGTGCCTGCGCCAAGAA","561307.5.peg.633","2059"
"29016",612,70,542,"ACTCTATTTGCGACAAAGCC","CATTGTGCCTGCGCCAAGAA","561307.5.peg.633","2059"
"29017",1116,70,1046,"CGGAAATCATCGGTAGCTTT","CATTGTGCCTGCGCCAAGAA","561307.5.peg.633","2059"
"29018",1126,70,1056,"GTCTATGTCTCGGAAATCAT","CATTGTGCCTGCGCCAAGAA","561307.5.peg.633","2059"
"29019",1148,70,1078,"TGAACCCCCAGACAAGCGCA","CATTGTGCCTGCGCCAAGAA","561307.5.peg.633","2059"
"29020",519,70,449,"GATTCCTTCGTGTGTGACGT","CATTGTGCCTGCGCCAAGAA","561307.5.peg.633","2059"
"29021",966,70,896,"GGTAATTGTGGTTGCGATAC","CATTGTGCCTGCGCCAAGAA","561307.5.peg.633","2059"
"29022",670,70,600,"AATGCTTATCTTGTGTTGCT","CATTGTGCCTGCGCCAAGAA","561307.5.peg.633","2059"
"29023",222,70,152,"AGATTTAAGTCGAATAGTAG","CATTGTGCCTGCGCCAAGAA","561307.5.peg.633","2059"
"29024",1033,70,963,"TTCGTCTTGCGCATTGAATA","CATTGTGCCTGCGCCAAGAA","561307.5.peg.633","2059"
"29025",8,222,214,"CTTATCCTCAACTAAATTGG","AGATTTAAGTCGAATAGTAG","561307.5.peg.633","2059"
"29026",761,222,539,"CTGCAATATCTAAACCGACT","AGATTTAAGTCGAATAGTAG","561307.5.peg.633","2059"
"29027",612,222,390,"ACTCTATTTGCGACAAAGCC","AGATTTAAGTCGAATAGTAG","561307.5.peg.633","2059"
"29028",966,222,744,"GGTAATTGTGGTTGCGATAC","AGATTTAAGTCGAATAGTAG","561307.5.peg.633","2059"
"29029",70,222,152,"CATTGTGCCTGCGCCAAGAA","AGATTTAAGTCGAATAGTAG","561307.5.peg.633","2059"
"29030",1126,222,904,"GTCTATGTCTCGGAAATCAT","AGATTTAAGTCGAATAGTAG","561307.5.peg.633","2059"
"29031",670,222,448,"AATGCTTATCTTGTGTTGCT","AGATTTAAGTCGAATAGTAG","561307.5.peg.633","2059"
"29032",1148,222,926,"TGAACCCCCAGACAAGCGCA","AGATTTAAGTCGAATAGTAG","561307.5.peg.633","2059"
"29033",1116,222,894,"CGGAAATCATCGGTAGCTTT","AGATTTAAGTCGAATAGTAG","561307.5.peg.633","2059"
"29034",485,222,263,"CTAATTTCATAATACGTGGT","AGATTTAAGTCGAATAGTAG","561307.5.peg.633","2059"
"29035",1136,222,914,"CAAGCGCACGGTCTATGTCT","AGATTTAAGTCGAATAGTAG","561307.5.peg.633","2059"
"29036",1033,222,811,"TTCGTCTTGCGCATTGAATA","AGATTTAAGTCGAATAGTAG","561307.5.peg.633","2059"
"29037",519,222,297,"GATTCCTTCGTGTGTGACGT","AGATTTAAGTCGAATAGTAG","561307.5.peg.633","2059"
"29038",966,485,481,"GGTAATTGTGGTTGCGATAC","CTAATTTCATAATACGTGGT","561307.5.peg.633","2059"
"29039",1136,485,651,"CAAGCGCACGGTCTATGTCT","CTAATTTCATAATACGTGGT","561307.5.peg.633","2059"
"29040",222,485,263,"AGATTTAAGTCGAATAGTAG","CTAATTTCATAATACGTGGT","561307.5.peg.633","2059"
"29041",1116,485,631,"CGGAAATCATCGGTAGCTTT","CTAATTTCATAATACGTGGT","561307.5.peg.633","2059"
"29042",612,485,127,"ACTCTATTTGCGACAAAGCC","CTAATTTCATAATACGTGGT","561307.5.peg.633","2059"
"29043",8,485,477,"CTTATCCTCAACTAAATTGG","CTAATTTCATAATACGTGGT","561307.5.peg.633","2059"
"29044",1148,485,663,"TGAACCCCCAGACAAGCGCA","CTAATTTCATAATACGTGGT","561307.5.peg.633","2059"
"29045",670,485,185,"AATGCTTATCTTGTGTTGCT","CTAATTTCATAATACGTGGT","561307.5.peg.633","2059"
"29046",761,485,276,"CTGCAATATCTAAACCGACT","CTAATTTCATAATACGTGGT","561307.5.peg.633","2059"
"29047",1126,485,641,"GTCTATGTCTCGGAAATCAT","CTAATTTCATAATACGTGGT","561307.5.peg.633","2059"
"29048",70,485,415,"CATTGTGCCTGCGCCAAGAA","CTAATTTCATAATACGTGGT","561307.5.peg.633","2059"
"29049",1033,485,548,"TTCGTCTTGCGCATTGAATA","CTAATTTCATAATACGTGGT","561307.5.peg.633","2059"
"29050",670,519,151,"AATGCTTATCTTGTGTTGCT","GATTCCTTCGTGTGTGACGT","561307.5.peg.633","2059"
"29051",761,519,242,"CTGCAATATCTAAACCGACT","GATTCCTTCGTGTGTGACGT","561307.5.peg.633","2059"
"29052",966,519,447,"GGTAATTGTGGTTGCGATAC","GATTCCTTCGTGTGTGACGT","561307.5.peg.633","2059"
"29053",1136,519,617,"CAAGCGCACGGTCTATGTCT","GATTCCTTCGTGTGTGACGT","561307.5.peg.633","2059"
"29054",1116,519,597,"CGGAAATCATCGGTAGCTTT","GATTCCTTCGTGTGTGACGT","561307.5.peg.633","2059"
"29055",1126,519,607,"GTCTATGTCTCGGAAATCAT","GATTCCTTCGTGTGTGACGT","561307.5.peg.633","2059"
"29056",1033,519,514,"TTCGTCTTGCGCATTGAATA","GATTCCTTCGTGTGTGACGT","561307.5.peg.633","2059"
"29057",1148,519,629,"TGAACCCCCAGACAAGCGCA","GATTCCTTCGTGTGTGACGT","561307.5.peg.633","2059"
"29058",222,519,297,"AGATTTAAGTCGAATAGTAG","GATTCCTTCGTGTGTGACGT","561307.5.peg.633","2059"
"29059",8,519,511,"CTTATCCTCAACTAAATTGG","GATTCCTTCGTGTGTGACGT","561307.5.peg.633","2059"
"29060",70,519,449,"CATTGTGCCTGCGCCAAGAA","GATTCCTTCGTGTGTGACGT","561307.5.peg.633","2059"
"29061",222,612,390,"AGATTTAAGTCGAATAGTAG","ACTCTATTTGCGACAAAGCC","561307.5.peg.633","2059"
"29062",1126,612,514,"GTCTATGTCTCGGAAATCAT","ACTCTATTTGCGACAAAGCC","561307.5.peg.633","2059"
"29063",485,612,127,"CTAATTTCATAATACGTGGT","ACTCTATTTGCGACAAAGCC","561307.5.peg.633","2059"
"29064",761,612,149,"CTGCAATATCTAAACCGACT","ACTCTATTTGCGACAAAGCC","561307.5.peg.633","2059"
"29065",70,612,542,"CATTGTGCCTGCGCCAAGAA","ACTCTATTTGCGACAAAGCC","561307.5.peg.633","2059"
"29066",1148,612,536,"TGAACCCCCAGACAAGCGCA","ACTCTATTTGCGACAAAGCC","561307.5.peg.633","2059"
"29067",1033,612,421,"TTCGTCTTGCGCATTGAATA","ACTCTATTTGCGACAAAGCC","561307.5.peg.633","2059"
"29068",8,612,604,"CTTATCCTCAACTAAATTGG","ACTCTATTTGCGACAAAGCC","561307.5.peg.633","2059"
"29069",966,612,354,"GGTAATTGTGGTTGCGATAC","ACTCTATTTGCGACAAAGCC","561307.5.peg.633","2059"
"29070",1116,612,504,"CGGAAATCATCGGTAGCTTT","ACTCTATTTGCGACAAAGCC","561307.5.peg.633","2059"
"29071",1136,612,524,"CAAGCGCACGGTCTATGTCT","ACTCTATTTGCGACAAAGCC","561307.5.peg.633","2059"
"29072",485,670,185,"CTAATTTCATAATACGTGGT","AATGCTTATCTTGTGTTGCT","561307.5.peg.633","2059"
"29073",519,670,151,"GATTCCTTCGTGTGTGACGT","AATGCTTATCTTGTGTTGCT","561307.5.peg.633","2059"
"29074",1116,670,446,"CGGAAATCATCGGTAGCTTT","AATGCTTATCTTGTGTTGCT","561307.5.peg.633","2059"
"29075",70,670,600,"CATTGTGCCTGCGCCAAGAA","AATGCTTATCTTGTGTTGCT","561307.5.peg.633","2059"
"29076",966,670,296,"GGTAATTGTGGTTGCGATAC","AATGCTTATCTTGTGTTGCT","561307.5.peg.633","2059"
"29077",1126,670,456,"GTCTATGTCTCGGAAATCAT","AATGCTTATCTTGTGTTGCT","561307.5.peg.633","2059"
"29078",1148,670,478,"TGAACCCCCAGACAAGCGCA","AATGCTTATCTTGTGTTGCT","561307.5.peg.633","2059"
"29079",1033,670,363,"TTCGTCTTGCGCATTGAATA","AATGCTTATCTTGTGTTGCT","561307.5.peg.633","2059"
"29080",8,670,662,"CTTATCCTCAACTAAATTGG","AATGCTTATCTTGTGTTGCT","561307.5.peg.633","2059"
"29081",1136,670,466,"CAAGCGCACGGTCTATGTCT","AATGCTTATCTTGTGTTGCT","561307.5.peg.633","2059"
"29082",222,670,448,"AGATTTAAGTCGAATAGTAG","AATGCTTATCTTGTGTTGCT","561307.5.peg.633","2059"
"29083",1126,761,365,"GTCTATGTCTCGGAAATCAT","CTGCAATATCTAAACCGACT","561307.5.peg.633","2059"
"29084",1136,761,375,"CAAGCGCACGGTCTATGTCT","CTGCAATATCTAAACCGACT","561307.5.peg.633","2059"
"29085",966,761,205,"GGTAATTGTGGTTGCGATAC","CTGCAATATCTAAACCGACT","561307.5.peg.633","2059"
"29086",485,761,276,"CTAATTTCATAATACGTGGT","CTGCAATATCTAAACCGACT","561307.5.peg.633","2059"
"29087",1148,761,387,"TGAACCCCCAGACAAGCGCA","CTGCAATATCTAAACCGACT","561307.5.peg.633","2059"
"29088",1116,761,355,"CGGAAATCATCGGTAGCTTT","CTGCAATATCTAAACCGACT","561307.5.peg.633","2059"
"29089",222,761,539,"AGATTTAAGTCGAATAGTAG","CTGCAATATCTAAACCGACT","561307.5.peg.633","2059"
"29090",519,761,242,"GATTCCTTCGTGTGTGACGT","CTGCAATATCTAAACCGACT","561307.5.peg.633","2059"
"29091",70,761,691,"CATTGTGCCTGCGCCAAGAA","CTGCAATATCTAAACCGACT","561307.5.peg.633","2059"
"29092",612,761,149,"ACTCTATTTGCGACAAAGCC","CTGCAATATCTAAACCGACT","561307.5.peg.633","2059"
"29093",1033,761,272,"TTCGTCTTGCGCATTGAATA","CTGCAATATCTAAACCGACT","561307.5.peg.633","2059"
"29094",8,761,753,"CTTATCCTCAACTAAATTGG","CTGCAATATCTAAACCGACT","561307.5.peg.633","2059"
"29095",761,966,205,"CTGCAATATCTAAACCGACT","GGTAATTGTGGTTGCGATAC","561307.5.peg.633","2059"
"29096",612,966,354,"ACTCTATTTGCGACAAAGCC","GGTAATTGTGGTTGCGATAC","561307.5.peg.633","2059"
"29097",519,966,447,"GATTCCTTCGTGTGTGACGT","GGTAATTGTGGTTGCGATAC","561307.5.peg.633","2059"
"29098",1148,966,182,"TGAACCCCCAGACAAGCGCA","GGTAATTGTGGTTGCGATAC","561307.5.peg.633","2059"
"29099",485,966,481,"CTAATTTCATAATACGTGGT","GGTAATTGTGGTTGCGATAC","561307.5.peg.633","2059"
"29100",670,966,296,"AATGCTTATCTTGTGTTGCT","GGTAATTGTGGTTGCGATAC","561307.5.peg.633","2059"
"29101",1126,966,160,"GTCTATGTCTCGGAAATCAT","GGTAATTGTGGTTGCGATAC","561307.5.peg.633","2059"
"29102",70,966,896,"CATTGTGCCTGCGCCAAGAA","GGTAATTGTGGTTGCGATAC","561307.5.peg.633","2059"
"29103",1136,966,170,"CAAGCGCACGGTCTATGTCT","GGTAATTGTGGTTGCGATAC","561307.5.peg.633","2059"
"29104",1116,966,150,"CGGAAATCATCGGTAGCTTT","GGTAATTGTGGTTGCGATAC","561307.5.peg.633","2059"
"29105",222,966,744,"AGATTTAAGTCGAATAGTAG","GGTAATTGTGGTTGCGATAC","561307.5.peg.633","2059"
"29106",8,966,958,"CTTATCCTCAACTAAATTGG","GGTAATTGTGGTTGCGATAC","561307.5.peg.633","2059"
"29107",519,1033,514,"GATTCCTTCGTGTGTGACGT","TTCGTCTTGCGCATTGAATA","561307.5.peg.633","2059"
"29108",485,1033,548,"CTAATTTCATAATACGTGGT","TTCGTCTTGCGCATTGAATA","561307.5.peg.633","2059"
"29109",761,1033,272,"CTGCAATATCTAAACCGACT","TTCGTCTTGCGCATTGAATA","561307.5.peg.633","2059"
"29110",8,1033,1025,"CTTATCCTCAACTAAATTGG","TTCGTCTTGCGCATTGAATA","561307.5.peg.633","2059"
"29111",1136,1033,103,"CAAGCGCACGGTCTATGTCT","TTCGTCTTGCGCATTGAATA","561307.5.peg.633","2059"
"29112",670,1033,363,"AATGCTTATCTTGTGTTGCT","TTCGTCTTGCGCATTGAATA","561307.5.peg.633","2059"
"29113",1148,1033,115,"TGAACCCCCAGACAAGCGCA","TTCGTCTTGCGCATTGAATA","561307.5.peg.633","2059"
"29114",222,1033,811,"AGATTTAAGTCGAATAGTAG","TTCGTCTTGCGCATTGAATA","561307.5.peg.633","2059"
"29115",612,1033,421,"ACTCTATTTGCGACAAAGCC","TTCGTCTTGCGCATTGAATA","561307.5.peg.633","2059"
"29116",70,1033,963,"CATTGTGCCTGCGCCAAGAA","TTCGTCTTGCGCATTGAATA","561307.5.peg.633","2059"
"29117",966,1116,150,"GGTAATTGTGGTTGCGATAC","CGGAAATCATCGGTAGCTTT","561307.5.peg.633","2059"
"29118",670,1116,446,"AATGCTTATCTTGTGTTGCT","CGGAAATCATCGGTAGCTTT","561307.5.peg.633","2059"
"29119",8,1116,1108,"CTTATCCTCAACTAAATTGG","CGGAAATCATCGGTAGCTTT","561307.5.peg.633","2059"
"29120",761,1116,355,"CTGCAATATCTAAACCGACT","CGGAAATCATCGGTAGCTTT","561307.5.peg.633","2059"
"29121",519,1116,597,"GATTCCTTCGTGTGTGACGT","CGGAAATCATCGGTAGCTTT","561307.5.peg.633","2059"
"29122",485,1116,631,"CTAATTTCATAATACGTGGT","CGGAAATCATCGGTAGCTTT","561307.5.peg.633","2059"
"29123",70,1116,1046,"CATTGTGCCTGCGCCAAGAA","CGGAAATCATCGGTAGCTTT","561307.5.peg.633","2059"
"29124",222,1116,894,"AGATTTAAGTCGAATAGTAG","CGGAAATCATCGGTAGCTTT","561307.5.peg.633","2059"
"29125",612,1116,504,"ACTCTATTTGCGACAAAGCC","CGGAAATCATCGGTAGCTTT","561307.5.peg.633","2059"
"29126",670,1126,456,"AATGCTTATCTTGTGTTGCT","GTCTATGTCTCGGAAATCAT","561307.5.peg.633","2059"
"29127",8,1126,1118,"CTTATCCTCAACTAAATTGG","GTCTATGTCTCGGAAATCAT","561307.5.peg.633","2059"
"29128",519,1126,607,"GATTCCTTCGTGTGTGACGT","GTCTATGTCTCGGAAATCAT","561307.5.peg.633","2059"
"29129",966,1126,160,"GGTAATTGTGGTTGCGATAC","GTCTATGTCTCGGAAATCAT","561307.5.peg.633","2059"
"29130",222,1126,904,"AGATTTAAGTCGAATAGTAG","GTCTATGTCTCGGAAATCAT","561307.5.peg.633","2059"
"29131",612,1126,514,"ACTCTATTTGCGACAAAGCC","GTCTATGTCTCGGAAATCAT","561307.5.peg.633","2059"
"29132",485,1126,641,"CTAATTTCATAATACGTGGT","GTCTATGTCTCGGAAATCAT","561307.5.peg.633","2059"
"29133",761,1126,365,"CTGCAATATCTAAACCGACT","GTCTATGTCTCGGAAATCAT","561307.5.peg.633","2059"
"29134",70,1126,1056,"CATTGTGCCTGCGCCAAGAA","GTCTATGTCTCGGAAATCAT","561307.5.peg.633","2059"
"29135",761,1136,375,"CTGCAATATCTAAACCGACT","CAAGCGCACGGTCTATGTCT","561307.5.peg.633","2059"
"29136",8,1136,1128,"CTTATCCTCAACTAAATTGG","CAAGCGCACGGTCTATGTCT","561307.5.peg.633","2059"
"29137",222,1136,914,"AGATTTAAGTCGAATAGTAG","CAAGCGCACGGTCTATGTCT","561307.5.peg.633","2059"
"29138",519,1136,617,"GATTCCTTCGTGTGTGACGT","CAAGCGCACGGTCTATGTCT","561307.5.peg.633","2059"
"29139",70,1136,1066,"CATTGTGCCTGCGCCAAGAA","CAAGCGCACGGTCTATGTCT","561307.5.peg.633","2059"
"29140",485,1136,651,"CTAATTTCATAATACGTGGT","CAAGCGCACGGTCTATGTCT","561307.5.peg.633","2059"
"29141",966,1136,170,"GGTAATTGTGGTTGCGATAC","CAAGCGCACGGTCTATGTCT","561307.5.peg.633","2059"
"29142",670,1136,466,"AATGCTTATCTTGTGTTGCT","CAAGCGCACGGTCTATGTCT","561307.5.peg.633","2059"
"29143",612,1136,524,"ACTCTATTTGCGACAAAGCC","CAAGCGCACGGTCTATGTCT","561307.5.peg.633","2059"
"29144",1033,1136,103,"TTCGTCTTGCGCATTGAATA","CAAGCGCACGGTCTATGTCT","561307.5.peg.633","2059"
"29145",222,1148,926,"AGATTTAAGTCGAATAGTAG","TGAACCCCCAGACAAGCGCA","561307.5.peg.633","2059"
"29146",761,1148,387,"CTGCAATATCTAAACCGACT","TGAACCCCCAGACAAGCGCA","561307.5.peg.633","2059"
"29147",485,1148,663,"CTAATTTCATAATACGTGGT","TGAACCCCCAGACAAGCGCA","561307.5.peg.633","2059"
"29148",519,1148,629,"GATTCCTTCGTGTGTGACGT","TGAACCCCCAGACAAGCGCA","561307.5.peg.633","2059"
"29149",8,1148,1140,"CTTATCCTCAACTAAATTGG","TGAACCCCCAGACAAGCGCA","561307.5.peg.633","2059"
"29150",612,1148,536,"ACTCTATTTGCGACAAAGCC","TGAACCCCCAGACAAGCGCA","561307.5.peg.633","2059"
"29151",70,1148,1078,"CATTGTGCCTGCGCCAAGAA","TGAACCCCCAGACAAGCGCA","561307.5.peg.633","2059"
"29152",1033,1148,115,"TTCGTCTTGCGCATTGAATA","TGAACCCCCAGACAAGCGCA","561307.5.peg.633","2059"
"29153",966,1148,182,"GGTAATTGTGGTTGCGATAC","TGAACCCCCAGACAAGCGCA","561307.5.peg.633","2059"
"29154",670,1148,478,"AATGCTTATCTTGTGTTGCT","TGAACCCCCAGACAAGCGCA","561307.5.peg.633","2059"
"29155",495,267,228,"GCAACGTCCGAACCGTGTTC","GGACGATCCTTGTAAAGTAA","561307.5.peg.634","2060"
"29156",545,267,278,"TGATAACCCAAGTATCGCCT","GGACGATCCTTGTAAAGTAA","561307.5.peg.634","2060"
"29157",367,267,100,"ACCTTGGTGAACACCGAGTA","GGACGATCCTTGTAAAGTAA","561307.5.peg.634","2060"
"29158",615,267,348,"CTTTATTTACTGCGAATAC","GGACGATCCTTGTAAAGTAA","561307.5.peg.634","2060"
"29159",545,335,210,"TGATAACCCAAGTATCGCCT","AAATATCAAATCGCGCGAGT","561307.5.peg.634","2060"
"29160",615,335,280,"CTTTATTTACTGCGAATAC","AAATATCAAATCGCGCGAGT","561307.5.peg.634","2060"
"29161",495,335,160,"GCAACGTCCGAACCGTGTTC","AAATATCAAATCGCGCGAGT","561307.5.peg.634","2060"
"29162",545,358,187,"TGATAACCCAAGTATCGCCT","AACACCGAGTAGGGTAGCTA","561307.5.peg.634","2060"
"29163",615,358,257,"CTTTATTTACTGCGAATAC","AACACCGAGTAGGGTAGCTA","561307.5.peg.634","2060"
"29164",495,358,137,"GCAACGTCCGAACCGTGTTC","AACACCGAGTAGGGTAGCTA","561307.5.peg.634","2060"
"29165",267,367,100,"GGACGATCCTTGTAAAGTAA","ACCTTGGTGAACACCGAGTA","561307.5.peg.634","2060"
"29166",545,367,178,"TGATAACCCAAGTATCGCCT","ACCTTGGTGAACACCGAGTA","561307.5.peg.634","2060"
"29167",495,367,128,"GCAACGTCCGAACCGTGTTC","ACCTTGGTGAACACCGAGTA","561307.5.peg.634","2060"
"29168",615,367,248,"CTTTATTTACTGCGAATAC","ACCTTGGTGAACACCGAGTA","561307.5.peg.634","2060"
"29169",267,495,228,"GGACGATCCTTGTAAAGTAA","GCAACGTCCGAACCGTGTTC","561307.5.peg.634","2060"
"29170",367,495,128,"ACCTTGGTGAACACCGAGTA","GCAACGTCCGAACCGTGTTC","561307.5.peg.634","2060"
"29171",358,495,137,"AACACCGAGTAGGGTAGCTA","GCAACGTCCGAACCGTGTTC","561307.5.peg.634","2060"
"29172",615,495,120,"CTTTATTTACTGCGAATAC","GCAACGTCCGAACCGTGTTC","561307.5.peg.634","2060"
"29173",335,495,160,"AAATATCAAATCGCGCGAGT","GCAACGTCCGAACCGTGTTC","561307.5.peg.634","2060"
"29174",267,545,278,"GGACGATCCTTGTAAAGTAA","TGATAACCCAAGTATCGCCT","561307.5.peg.634","2060"
"29175",358,545,187,"AACACCGAGTAGGGTAGCTA","TGATAACCCAAGTATCGCCT","561307.5.peg.634","2060"
"29176",335,545,210,"AAATATCAAATCGCGCGAGT","TGATAACCCAAGTATCGCCT","561307.5.peg.634","2060"
"29177",367,545,178,"ACCTTGGTGAACACCGAGTA","TGATAACCCAAGTATCGCCT","561307.5.peg.634","2060"
"29178",335,615,280,"AAATATCAAATCGCGCGAGT","CTTTATTTACTGCGAATAC","561307.5.peg.634","2060"
"29179",267,615,348,"GGACGATCCTTGTAAAGTAA","CTTTATTTACTGCGAATAC","561307.5.peg.634","2060"
"29180",358,615,257,"AACACCGAGTAGGGTAGCTA","CTTTATTTACTGCGAATAC","561307.5.peg.634","2060"
"29181",495,615,120,"GCAACGTCCGAACCGTGTTC","CTTTATTTACTGCGAATAC","561307.5.peg.634","2060"
"29182",367,615,248,"ACCTTGGTGAACACCGAGTA","CTTTATTTACTGCGAATAC","561307.5.peg.634","2060"
"29183",140,8,132,"CAGCGCGTGCATTGAGTTGT","TATGAAAGTGAAGCTAAAGG","561307.5.peg.635","2061"
"29184",291,8,283,"GGGTTAAGCCGCCAATTCAA","TATGAAAGTGAAGCTAAAGG","561307.5.peg.635","2061"
"29185",328,8,320,"TAATTGTGCATCTTCCACAA","TATGAAAGTGAAGCTAAAGG","561307.5.peg.635","2061"
"29186",535,8,527,"CATCACACCTTTAGGTGATC","TATGAAAGTGAAGCTAAAGG","561307.5.peg.635","2061"
"29187",543,8,535,"TATGAGAACATCACACCTTT","TATGAAAGTGAAGCTAAAGG","561307.5.peg.635","2061"
"29188",291,99,192,"GGGTTAAGCCGCCAATTCAA","TTTGCGTGATCAATAACGGC","561307.5.peg.635","2061"
"29189",328,99,229,"TAATTGTGCATCTTCCACAA","TTTGCGTGATCAATAACGGC","561307.5.peg.635","2061"
"29190",535,99,436,"CATCACACCTTTAGGTGATC","TTTGCGTGATCAATAACGGC","561307.5.peg.635","2061"
"29191",543,99,444,"TATGAGAACATCACACCTTT","TTTGCGTGATCAATAACGGC","561307.5.peg.635","2061"
"29192",8,140,132,"TATGAAAGTGAAGCTAAAGG","CAGCGCGTGCATTGAGTTGT","561307.5.peg.635","2061"
"29193",535,140,395,"CATCACACCTTTAGGTGATC","CAGCGCGTGCATTGAGTTGT","561307.5.peg.635","2061"
"29194",543,140,403,"TATGAGAACATCACACCTTT","CAGCGCGTGCATTGAGTTGT","561307.5.peg.635","2061"
"29195",291,140,151,"GGGTTAAGCCGCCAATTCAA","CAGCGCGTGCATTGAGTTGT","561307.5.peg.635","2061"
"29196",328,140,188,"TAATTGTGCATCTTCCACAA","CAGCGCGTGCATTGAGTTGT","561307.5.peg.635","2061"
"29197",8,291,283,"TATGAAAGTGAAGCTAAAGG","GGGTTAAGCCGCCAATTCAA","561307.5.peg.635","2061"
"29198",99,291,192,"TTTGCGTGATCAATAACGGC","GGGTTAAGCCGCCAATTCAA","561307.5.peg.635","2061"
"29199",543,291,252,"TATGAGAACATCACACCTTT","GGGTTAAGCCGCCAATTCAA","561307.5.peg.635","2061"
"29200",140,291,151,"CAGCGCGTGCATTGAGTTGT","GGGTTAAGCCGCCAATTCAA","561307.5.peg.635","2061"
"29201",535,291,244,"CATCACACCTTTAGGTGATC","GGGTTAAGCCGCCAATTCAA","561307.5.peg.635","2061"
"29202",543,328,215,"TATGAGAACATCACACCTTT","TAATTGTGCATCTTCCACAA","561307.5.peg.635","2061"
"29203",99,328,229,"TTTGCGTGATCAATAACGGC","TAATTGTGCATCTTCCACAA","561307.5.peg.635","2061"
"29204",8,328,320,"TATGAAAGTGAAGCTAAAGG","TAATTGTGCATCTTCCACAA","561307.5.peg.635","2061"
"29205",535,328,207,"CATCACACCTTTAGGTGATC","TAATTGTGCATCTTCCACAA","561307.5.peg.635","2061"
"29206",140,328,188,"CAGCGCGTGCATTGAGTTGT","TAATTGTGCATCTTCCACAA","561307.5.peg.635","2061"
"29207",99,535,436,"TTTGCGTGATCAATAACGGC","CATCACACCTTTAGGTGATC","561307.5.peg.635","2061"
"29208",328,535,207,"TAATTGTGCATCTTCCACAA","CATCACACCTTTAGGTGATC","561307.5.peg.635","2061"
"29209",291,535,244,"GGGTTAAGCCGCCAATTCAA","CATCACACCTTTAGGTGATC","561307.5.peg.635","2061"
"29210",8,535,527,"TATGAAAGTGAAGCTAAAGG","CATCACACCTTTAGGTGATC","561307.5.peg.635","2061"
"29211",140,535,395,"CAGCGCGTGCATTGAGTTGT","CATCACACCTTTAGGTGATC","561307.5.peg.635","2061"
"29212",99,543,444,"TTTGCGTGATCAATAACGGC","TATGAGAACATCACACCTTT","561307.5.peg.635","2061"
"29213",8,543,535,"TATGAAAGTGAAGCTAAAGG","TATGAGAACATCACACCTTT","561307.5.peg.635","2061"
"29214",291,543,252,"GGGTTAAGCCGCCAATTCAA","TATGAGAACATCACACCTTT","561307.5.peg.635","2061"
"29215",328,543,215,"TAATTGTGCATCTTCCACAA","TATGAGAACATCACACCTTT","561307.5.peg.635","2061"
"29216",140,543,403,"CAGCGCGTGCATTGAGTTGT","TATGAGAACATCACACCTTT","561307.5.peg.635","2061"
"29217",514,114,400,"AAGTATGTTTCATCGTTGA","AAGTTGGCTACAGCTAATGC","561307.5.peg.636","2062"
"29218",791,114,677,"AATGACTTTGAATTACTTGG","AAGTTGGCTACAGCTAATGC","561307.5.peg.636","2062"
"29219",548,114,434,"GTAGTGCCACATCAACGCTA","AAGTTGGCTACAGCTAATGC","561307.5.peg.636","2062"
"29220",453,114,339,"ACTTTACCGCCACCGTATCT","AAGTTGGCTACAGCTAATGC","561307.5.peg.636","2062"
"29221",723,114,609,"CCTGGGATAACAACTTCATT","AAGTTGGCTACAGCTAATGC","561307.5.peg.636","2062"
"29222",664,114,550,"ACAATAACTTTCCCATGAT","AAGTTGGCTACAGCTAATGC","561307.5.peg.636","2062"
"29223",723,130,593,"CCTGGGATAACAACTTCATT","TAGAACTTCGGCGGGTAAGT","561307.5.peg.636","2062"
"29224",791,130,661,"AATGACTTTGAATTACTTGG","TAGAACTTCGGCGGGTAAGT","561307.5.peg.636","2062"
"29225",514,130,384,"AAGTATGTTTCATCGTTGA","TAGAACTTCGGCGGGTAAGT","561307.5.peg.636","2062"
"29226",664,130,534,"ACAATAACTTTCCCATGAT","TAGAACTTCGGCGGGTAAGT","561307.5.peg.636","2062"
"29227",453,130,323,"ACTTTACCGCCACCGTATCT","TAGAACTTCGGCGGGTAAGT","561307.5.peg.636","2062"
"29228",548,130,418,"GTAGTGCCACATCAACGCTA","TAGAACTTCGGCGGGTAAGT","561307.5.peg.636","2062"
"29229",514,138,376,"AAGTATGTTTCATCGTTGA","ACAGCACGTAGAACTTCGGC","561307.5.peg.636","2062"
"29230",791,138,653,"AATGACTTTGAATTACTTGG","ACAGCACGTAGAACTTCGGC","561307.5.peg.636","2062"
"29231",548,138,410,"GTAGTGCCACATCAACGCTA","ACAGCACGTAGAACTTCGGC","561307.5.peg.636","2062"
"29232",664,138,526,"ACAATAACTTTCCCATGAT","ACAGCACGTAGAACTTCGGC","561307.5.peg.636","2062"
"29233",453,138,315,"ACTTTACCGCCACCGTATCT","ACAGCACGTAGAACTTCGGC","561307.5.peg.636","2062"
"29234",723,138,585,"CCTGGGATAACAACTTCATT","ACAGCACGTAGAACTTCGGC","561307.5.peg.636","2062"
"29235",514,142,372,"AAGTATGTTTCATCGTTGA","TAACACAGCACGTAGAACTT","561307.5.peg.636","2062"
"29236",548,142,406,"GTAGTGCCACATCAACGCTA","TAACACAGCACGTAGAACTT","561307.5.peg.636","2062"
"29237",453,142,311,"ACTTTACCGCCACCGTATCT","TAACACAGCACGTAGAACTT","561307.5.peg.636","2062"
"29238",723,142,581,"CCTGGGATAACAACTTCATT","TAACACAGCACGTAGAACTT","561307.5.peg.636","2062"
"29239",664,142,522,"ACAATAACTTTCCCATGAT","TAACACAGCACGTAGAACTT","561307.5.peg.636","2062"
"29240",791,142,649,"AATGACTTTGAATTACTTGG","TAACACAGCACGTAGAACTT","561307.5.peg.636","2062"
"29241",114,453,339,"AAGTTGGCTACAGCTAATGC","ACTTTACCGCCACCGTATCT","561307.5.peg.636","2062"
"29242",130,453,323,"TAGAACTTCGGCGGGTAAGT","ACTTTACCGCCACCGTATCT","561307.5.peg.636","2062"
"29243",723,453,270,"CCTGGGATAACAACTTCATT","ACTTTACCGCCACCGTATCT","561307.5.peg.636","2062"
"29244",791,453,338,"AATGACTTTGAATTACTTGG","ACTTTACCGCCACCGTATCT","561307.5.peg.636","2062"
"29245",138,453,315,"ACAGCACGTAGAACTTCGGC","ACTTTACCGCCACCGTATCT","561307.5.peg.636","2062"
"29246",142,453,311,"TAACACAGCACGTAGAACTT","ACTTTACCGCCACCGTATCT","561307.5.peg.636","2062"
"29247",664,453,211,"ACAATAACTTTCCCATGAT","ACTTTACCGCCACCGTATCT","561307.5.peg.636","2062"
"29248",664,514,150,"ACAATAACTTTCCCATGAT","AAGTATGTTTCATCGTTGA","561307.5.peg.636","2062"
"29249",142,514,372,"TAACACAGCACGTAGAACTT","AAGTATGTTTCATCGTTGA","561307.5.peg.636","2062"
"29250",723,514,209,"CCTGGGATAACAACTTCATT","AAGTATGTTTCATCGTTGA","561307.5.peg.636","2062"
"29251",114,514,400,"AAGTTGGCTACAGCTAATGC","AAGTATGTTTCATCGTTGA","561307.5.peg.636","2062"
"29252",130,514,384,"TAGAACTTCGGCGGGTAAGT","AAGTATGTTTCATCGTTGA","561307.5.peg.636","2062"
"29253",791,514,277,"AATGACTTTGAATTACTTGG","AAGTATGTTTCATCGTTGA","561307.5.peg.636","2062"
"29254",138,514,376,"ACAGCACGTAGAACTTCGGC","AAGTATGTTTCATCGTTGA","561307.5.peg.636","2062"
"29255",130,548,418,"TAGAACTTCGGCGGGTAAGT","GTAGTGCCACATCAACGCTA","561307.5.peg.636","2062"
"29256",791,548,243,"AATGACTTTGAATTACTTGG","GTAGTGCCACATCAACGCTA","561307.5.peg.636","2062"
"29257",114,548,434,"AAGTTGGCTACAGCTAATGC","GTAGTGCCACATCAACGCTA","561307.5.peg.636","2062"
"29258",723,548,175,"CCTGGGATAACAACTTCATT","GTAGTGCCACATCAACGCTA","561307.5.peg.636","2062"
"29259",138,548,410,"ACAGCACGTAGAACTTCGGC","GTAGTGCCACATCAACGCTA","561307.5.peg.636","2062"
"29260",664,548,116,"ACAATAACTTTCCCATGAT","GTAGTGCCACATCAACGCTA","561307.5.peg.636","2062"
"29261",142,548,406,"TAACACAGCACGTAGAACTT","GTAGTGCCACATCAACGCTA","561307.5.peg.636","2062"
"29262",142,664,522,"TAACACAGCACGTAGAACTT","ACAATAACTTTCCCATGAT","561307.5.peg.636","2062"
"29263",453,664,211,"ACTTTACCGCCACCGTATCT","ACAATAACTTTCCCATGAT","561307.5.peg.636","2062"
"29264",114,664,550,"AAGTTGGCTACAGCTAATGC","ACAATAACTTTCCCATGAT","561307.5.peg.636","2062"
"29265",548,664,116,"GTAGTGCCACATCAACGCTA","ACAATAACTTTCCCATGAT","561307.5.peg.636","2062"
"29266",130,664,534,"TAGAACTTCGGCGGGTAAGT","ACAATAACTTTCCCATGAT","561307.5.peg.636","2062"
"29267",138,664,526,"ACAGCACGTAGAACTTCGGC","ACAATAACTTTCCCATGAT","561307.5.peg.636","2062"
"29268",791,664,127,"AATGACTTTGAATTACTTGG","ACAATAACTTTCCCATGAT","561307.5.peg.636","2062"
"29269",514,664,150,"AAGTATGTTTCATCGTTGA","ACAATAACTTTCCCATGAT","561307.5.peg.636","2062"
"29270",114,723,609,"AAGTTGGCTACAGCTAATGC","CCTGGGATAACAACTTCATT","561307.5.peg.636","2062"
"29271",142,723,581,"TAACACAGCACGTAGAACTT","CCTGGGATAACAACTTCATT","561307.5.peg.636","2062"
"29272",138,723,585,"ACAGCACGTAGAACTTCGGC","CCTGGGATAACAACTTCATT","561307.5.peg.636","2062"
"29273",514,723,209,"AAGTATGTTTCATCGTTGA","CCTGGGATAACAACTTCATT","561307.5.peg.636","2062"
"29274",130,723,593,"TAGAACTTCGGCGGGTAAGT","CCTGGGATAACAACTTCATT","561307.5.peg.636","2062"
"29275",548,723,175,"GTAGTGCCACATCAACGCTA","CCTGGGATAACAACTTCATT","561307.5.peg.636","2062"
"29276",453,723,270,"ACTTTACCGCCACCGTATCT","CCTGGGATAACAACTTCATT","561307.5.peg.636","2062"
"29277",114,791,677,"AAGTTGGCTACAGCTAATGC","AATGACTTTGAATTACTTGG","561307.5.peg.636","2062"
"29278",548,791,243,"GTAGTGCCACATCAACGCTA","AATGACTTTGAATTACTTGG","561307.5.peg.636","2062"
"29279",453,791,338,"ACTTTACCGCCACCGTATCT","AATGACTTTGAATTACTTGG","561307.5.peg.636","2062"
"29280",514,791,277,"AAGTATGTTTCATCGTTGA","AATGACTTTGAATTACTTGG","561307.5.peg.636","2062"
"29281",138,791,653,"ACAGCACGTAGAACTTCGGC","AATGACTTTGAATTACTTGG","561307.5.peg.636","2062"
"29282",130,791,661,"TAGAACTTCGGCGGGTAAGT","AATGACTTTGAATTACTTGG","561307.5.peg.636","2062"
"29283",142,791,649,"TAACACAGCACGTAGAACTT","AATGACTTTGAATTACTTGG","561307.5.peg.636","2062"
"29284",664,791,127,"ACAATAACTTTCCCATGAT","AATGACTTTGAATTACTTGG","561307.5.peg.636","2062"
"29285",417,117,300,"TCTGATATGTCACAAATTGC","ATCCCCTCTTCACCTGTATT","561307.5.peg.637","2063"
"29286",579,117,462,"AAGAAGAACAAACCCGATAA","ATCCCCTCTTCACCTGTATT","561307.5.peg.637","2063"
"29287",117,417,300,"ATCCCCTCTTCACCTGTATT","TCTGATATGTCACAAATTGC","561307.5.peg.637","2063"
"29288",579,417,162,"AAGAAGAACAAACCCGATAA","TCTGATATGTCACAAATTGC","561307.5.peg.637","2063"
"29289",117,579,462,"ATCCCCTCTTCACCTGTATT","AAGAAGAACAAACCCGATAA","561307.5.peg.637","2063"
"29290",417,579,162,"TCTGATATGTCACAAATTGC","AAGAAGAACAAACCCGATAA","561307.5.peg.637","2063"
"29291",552,174,378,"TGGTAAGGGCCTGTACCAAC","ACTGGTACATCTGTTTCATA","561307.5.peg.638","2064"
"29292",460,174,286,"AAGTTCAGGGTAAGCGGAGT","ACTGGTACATCTGTTTCATA","561307.5.peg.638","2064"
"29293",466,174,292,"AGATACAAGTTCAGGGTAAG","ACTGGTACATCTGTTTCATA","561307.5.peg.638","2064"
"29294",642,174,468,"CAGTAATATGATCAAGTTT","ACTGGTACATCTGTTTCATA","561307.5.peg.638","2064"
"29295",473,174,299,"CTAATTCAGATACAAGTTCA","ACTGGTACATCTGTTTCATA","561307.5.peg.638","2064"
"29296",737,174,563,"GTCTTGAACTTTATTAACT","ACTGGTACATCTGTTTCATA","561307.5.peg.638","2064"
"29297",642,192,450,"CAGTAATATGATCAAGTTT","TCTGCAGCACCAATCTTAAC","561307.5.peg.638","2064"
"29298",737,192,545,"GTCTTGAACTTTATTAACT","TCTGCAGCACCAATCTTAAC","561307.5.peg.638","2064"
"29299",552,192,360,"TGGTAAGGGCCTGTACCAAC","TCTGCAGCACCAATCTTAAC","561307.5.peg.638","2064"
"29300",466,192,274,"AGATACAAGTTCAGGGTAAG","TCTGCAGCACCAATCTTAAC","561307.5.peg.638","2064"
"29301",473,192,281,"CTAATTCAGATACAAGTTCA","TCTGCAGCACCAATCTTAAC","561307.5.peg.638","2064"
"29302",460,192,268,"AAGTTCAGGGTAAGCGGAGT","TCTGCAGCACCAATCTTAAC","561307.5.peg.638","2064"
"29303",174,460,286,"ACTGGTACATCTGTTTCATA","AAGTTCAGGGTAAGCGGAGT","561307.5.peg.638","2064"
"29304",737,460,277,"GTCTTGAACTTTATTAACT","AAGTTCAGGGTAAGCGGAGT","561307.5.peg.638","2064"
"29305",192,460,268,"TCTGCAGCACCAATCTTAAC","AAGTTCAGGGTAAGCGGAGT","561307.5.peg.638","2064"
"29306",642,460,182,"CAGTAATATGATCAAGTTT","AAGTTCAGGGTAAGCGGAGT","561307.5.peg.638","2064"
"29307",174,466,292,"ACTGGTACATCTGTTTCATA","AGATACAAGTTCAGGGTAAG","561307.5.peg.638","2064"
"29308",737,466,271,"GTCTTGAACTTTATTAACT","AGATACAAGTTCAGGGTAAG","561307.5.peg.638","2064"
"29309",192,466,274,"TCTGCAGCACCAATCTTAAC","AGATACAAGTTCAGGGTAAG","561307.5.peg.638","2064"
"29310",642,466,176,"CAGTAATATGATCAAGTTT","AGATACAAGTTCAGGGTAAG","561307.5.peg.638","2064"
"29311",642,473,169,"CAGTAATATGATCAAGTTT","CTAATTCAGATACAAGTTCA","561307.5.peg.638","2064"
"29312",737,473,264,"GTCTTGAACTTTATTAACT","CTAATTCAGATACAAGTTCA","561307.5.peg.638","2064"
"29313",174,473,299,"ACTGGTACATCTGTTTCATA","CTAATTCAGATACAAGTTCA","561307.5.peg.638","2064"
"29314",192,473,281,"TCTGCAGCACCAATCTTAAC","CTAATTCAGATACAAGTTCA","561307.5.peg.638","2064"
"29315",192,552,360,"TCTGCAGCACCAATCTTAAC","TGGTAAGGGCCTGTACCAAC","561307.5.peg.638","2064"
"29316",737,552,185,"GTCTTGAACTTTATTAACT","TGGTAAGGGCCTGTACCAAC","561307.5.peg.638","2064"
"29317",174,552,378,"ACTGGTACATCTGTTTCATA","TGGTAAGGGCCTGTACCAAC","561307.5.peg.638","2064"
"29318",460,642,182,"AAGTTCAGGGTAAGCGGAGT","CAGTAATATGATCAAGTTT","561307.5.peg.638","2064"
"29319",466,642,176,"AGATACAAGTTCAGGGTAAG","CAGTAATATGATCAAGTTT","561307.5.peg.638","2064"
"29320",174,642,468,"ACTGGTACATCTGTTTCATA","CAGTAATATGATCAAGTTT","561307.5.peg.638","2064"
"29321",192,642,450,"TCTGCAGCACCAATCTTAAC","CAGTAATATGATCAAGTTT","561307.5.peg.638","2064"
"29322",473,642,169,"CTAATTCAGATACAAGTTCA","CAGTAATATGATCAAGTTT","561307.5.peg.638","2064"
"29323",192,737,545,"TCTGCAGCACCAATCTTAAC","GTCTTGAACTTTATTAACT","561307.5.peg.638","2064"
"29324",460,737,277,"AAGTTCAGGGTAAGCGGAGT","GTCTTGAACTTTATTAACT","561307.5.peg.638","2064"
"29325",174,737,563,"ACTGGTACATCTGTTTCATA","GTCTTGAACTTTATTAACT","561307.5.peg.638","2064"
"29326",466,737,271,"AGATACAAGTTCAGGGTAAG","GTCTTGAACTTTATTAACT","561307.5.peg.638","2064"
"29327",473,737,264,"CTAATTCAGATACAAGTTCA","GTCTTGAACTTTATTAACT","561307.5.peg.638","2064"
"29328",552,737,185,"TGGTAAGGGCCTGTACCAAC","GTCTTGAACTTTATTAACT","561307.5.peg.638","2064"
"29329",184,55,129,"TTGTCGCAACTCAGTAGAAG","ATAAATCCGTCCAATATCTA","561307.5.peg.639","2065"
"29330",186,55,131,"CATTGTCGCAACTCAGTAGA","ATAAATCCGTCCAATATCTA","561307.5.peg.639","2065"
"29331",55,184,129,"ATAAATCCGTCCAATATCTA","TTGTCGCAACTCAGTAGAAG","561307.5.peg.639","2065"
"29332",55,186,131,"ATAAATCCGTCCAATATCTA","CATTGTCGCAACTCAGTAGA","561307.5.peg.639","2065"
"29333",364,93,271,"TAATCCTGTCACGTCTTGAA","GTCCCTTTCTCTTTAAGTAA","561307.5.peg.641","2068"
"29334",288,93,195,"GCGCAGTGTTTATATGCGAC","GTCCCTTTCTCTTTAAGTAA","561307.5.peg.641","2068"
"29335",596,93,503,"AACATCAACTGTGATGTAT","GTCCCTTTCTCTTTAAGTAA","561307.5.peg.641","2068"
"29336",398,93,305,"TTGCCCAAGCTTGAATGACA","GTCCCTTTCTCTTTAAGTAA","561307.5.peg.641","2068"
"29337",93,288,195,"GTCCCTTTCTCTTTAAGTAA","GCGCAGTGTTTATATGCGAC","561307.5.peg.641","2068"
"29338",398,288,110,"TTGCCCAAGCTTGAATGACA","GCGCAGTGTTTATATGCGAC","561307.5.peg.641","2068"
"29339",596,288,308,"AACATCAACTGTGATGTAT","GCGCAGTGTTTATATGCGAC","561307.5.peg.641","2068"
"29340",93,364,271,"GTCCCTTTCTCTTTAAGTAA","TAATCCTGTCACGTCTTGAA","561307.5.peg.641","2068"
"29341",596,364,232,"AACATCAACTGTGATGTAT","TAATCCTGTCACGTCTTGAA","561307.5.peg.641","2068"
"29342",93,398,305,"GTCCCTTTCTCTTTAAGTAA","TTGCCCAAGCTTGAATGACA","561307.5.peg.641","2068"
"29343",288,398,110,"GCGCAGTGTTTATATGCGAC","TTGCCCAAGCTTGAATGACA","561307.5.peg.641","2068"
"29344",596,398,198,"AACATCAACTGTGATGTAT","TTGCCCAAGCTTGAATGACA","561307.5.peg.641","2068"
"29345",93,596,503,"GTCCCTTTCTCTTTAAGTAA","AACATCAACTGTGATGTAT","561307.5.peg.641","2068"
"29346",364,596,232,"TAATCCTGTCACGTCTTGAA","AACATCAACTGTGATGTAT","561307.5.peg.641","2068"
"29347",288,596,308,"GCGCAGTGTTTATATGCGAC","AACATCAACTGTGATGTAT","561307.5.peg.641","2068"
"29348",398,596,198,"TTGCCCAAGCTTGAATGACA","AACATCAACTGTGATGTAT","561307.5.peg.641","2068"
"29349",312,211,101,"AAATCTAAACGTGTTTCTCC","TGTTGTTGGAGAATATGGTG","561307.5.peg.642","2069"
"29350",468,211,257,"GAACCTATAACACGTTCTTT","TGTTGTTGGAGAATATGGTG","561307.5.peg.642","2069"
"29351",468,216,252,"GAACCTATAACACGTTCTTT","CGAACTGTTGTTGGAGAATA","561307.5.peg.642","2069"
"29352",468,225,243,"GAACCTATAACACGTTCTTT","GCTTTCACACGAACTGTTGT","561307.5.peg.642","2069"
"29353",211,312,101,"TGTTGTTGGAGAATATGGTG","AAATCTAAACGTGTTTCTCC","561307.5.peg.642","2069"
"29354",468,312,156,"GAACCTATAACACGTTCTTT","AAATCTAAACGTGTTTCTCC","561307.5.peg.642","2069"
"29355",216,468,252,"CGAACTGTTGTTGGAGAATA","GAACCTATAACACGTTCTTT","561307.5.peg.642","2069"
"29356",225,468,243,"GCTTTCACACGAACTGTTGT","GAACCTATAACACGTTCTTT","561307.5.peg.642","2069"
"29357",211,468,257,"TGTTGTTGGAGAATATGGTG","GAACCTATAACACGTTCTTT","561307.5.peg.642","2069"
"29358",312,468,156,"AAATCTAAACGTGTTTCTCC","GAACCTATAACACGTTCTTT","561307.5.peg.642","2069"
"29359",261,91,170,"ACACCAATTGCAAAGATGAC","GATTGCGATAGGTAACATAA","561307.5.peg.644","2071"
"29360",627,91,536,"TAAATGCCGGCTTGTATGCT","GATTGCGATAGGTAACATAA","561307.5.peg.644","2071"
"29361",640,91,549,"TCCACCAACATGATAAATGC","GATTGCGATAGGTAACATAA","561307.5.peg.644","2071"
"29362",569,91,478,"CGGCAAATGCTGTGACAATA","GATTGCGATAGGTAACATAA","561307.5.peg.644","2071"
"29363",531,91,440,"CCAAAGAAACCTAAATACGG","GATTGCGATAGGTAACATAA","561307.5.peg.644","2071"
"29364",534,91,443,"CCACCAAAGAAACCTAAATA","GATTGCGATAGGTAACATAA","561307.5.peg.644","2071"
"29365",627,102,525,"TAAATGCCGGCTTGTATGCT","GCAGCTGGTAAGATTGCGAT","561307.5.peg.644","2071"
"29366",569,102,467,"CGGCAAATGCTGTGACAATA","GCAGCTGGTAAGATTGCGAT","561307.5.peg.644","2071"
"29367",534,102,432,"CCACCAAAGAAACCTAAATA","GCAGCTGGTAAGATTGCGAT","561307.5.peg.644","2071"
"29368",261,102,159,"ACACCAATTGCAAAGATGAC","GCAGCTGGTAAGATTGCGAT","561307.5.peg.644","2071"
"29369",531,102,429,"CCAAAGAAACCTAAATACGG","GCAGCTGGTAAGATTGCGAT","561307.5.peg.644","2071"
"29370",640,102,538,"TCCACCAACATGATAAATGC","GCAGCTGGTAAGATTGCGAT","561307.5.peg.644","2071"
"29371",261,117,144,"ACACCAATTGCAAAGATGAC","CCCAACAATAGACCTGCAGC","561307.5.peg.644","2071"
"29372",627,117,510,"TAAATGCCGGCTTGTATGCT","CCCAACAATAGACCTGCAGC","561307.5.peg.644","2071"
"29373",640,117,523,"TCCACCAACATGATAAATGC","CCCAACAATAGACCTGCAGC","561307.5.peg.644","2071"
"29374",569,117,452,"CGGCAAATGCTGTGACAATA","CCCAACAATAGACCTGCAGC","561307.5.peg.644","2071"
"29375",531,117,414,"CCAAAGAAACCTAAATACGG","CCCAACAATAGACCTGCAGC","561307.5.peg.644","2071"
"29376",534,117,417,"CCACCAAAGAAACCTAAATA","CCCAACAATAGACCTGCAGC","561307.5.peg.644","2071"
"29377",534,162,372,"CCACCAAAGAAACCTAAATA","GGGTATGCTTTAACGGTGTT","561307.5.peg.644","2071"
"29378",627,162,465,"TAAATGCCGGCTTGTATGCT","GGGTATGCTTTAACGGTGTT","561307.5.peg.644","2071"
"29379",569,162,407,"CGGCAAATGCTGTGACAATA","GGGTATGCTTTAACGGTGTT","561307.5.peg.644","2071"
"29380",531,162,369,"CCAAAGAAACCTAAATACGG","GGGTATGCTTTAACGGTGTT","561307.5.peg.644","2071"
"29381",640,162,478,"TCCACCAACATGATAAATGC","GGGTATGCTTTAACGGTGTT","561307.5.peg.644","2071"
"29382",91,261,170,"GATTGCGATAGGTAACATAA","ACACCAATTGCAAAGATGAC","561307.5.peg.644","2071"
"29383",531,261,270,"CCAAAGAAACCTAAATACGG","ACACCAATTGCAAAGATGAC","561307.5.peg.644","2071"
"29384",534,261,273,"CCACCAAAGAAACCTAAATA","ACACCAATTGCAAAGATGAC","561307.5.peg.644","2071"
"29385",117,261,144,"CCCAACAATAGACCTGCAGC","ACACCAATTGCAAAGATGAC","561307.5.peg.644","2071"
"29386",569,261,308,"CGGCAAATGCTGTGACAATA","ACACCAATTGCAAAGATGAC","561307.5.peg.644","2071"
"29387",102,261,159,"GCAGCTGGTAAGATTGCGAT","ACACCAATTGCAAAGATGAC","561307.5.peg.644","2071"
"29388",640,261,379,"TCCACCAACATGATAAATGC","ACACCAATTGCAAAGATGAC","561307.5.peg.644","2071"
"29389",627,261,366,"TAAATGCCGGCTTGTATGCT","ACACCAATTGCAAAGATGAC","561307.5.peg.644","2071"
"29390",117,531,414,"CCCAACAATAGACCTGCAGC","CCAAAGAAACCTAAATACGG","561307.5.peg.644","2071"
"29391",102,531,429,"GCAGCTGGTAAGATTGCGAT","CCAAAGAAACCTAAATACGG","561307.5.peg.644","2071"
"29392",261,531,270,"ACACCAATTGCAAAGATGAC","CCAAAGAAACCTAAATACGG","561307.5.peg.644","2071"
"29393",162,531,369,"GGGTATGCTTTAACGGTGTT","CCAAAGAAACCTAAATACGG","561307.5.peg.644","2071"
"29394",91,531,440,"GATTGCGATAGGTAACATAA","CCAAAGAAACCTAAATACGG","561307.5.peg.644","2071"
"29395",640,531,109,"TCCACCAACATGATAAATGC","CCAAAGAAACCTAAATACGG","561307.5.peg.644","2071"
"29396",91,534,443,"GATTGCGATAGGTAACATAA","CCACCAAAGAAACCTAAATA","561307.5.peg.644","2071"
"29397",117,534,417,"CCCAACAATAGACCTGCAGC","CCACCAAAGAAACCTAAATA","561307.5.peg.644","2071"
"29398",640,534,106,"TCCACCAACATGATAAATGC","CCACCAAAGAAACCTAAATA","561307.5.peg.644","2071"
"29399",162,534,372,"GGGTATGCTTTAACGGTGTT","CCACCAAAGAAACCTAAATA","561307.5.peg.644","2071"
"29400",102,534,432,"GCAGCTGGTAAGATTGCGAT","CCACCAAAGAAACCTAAATA","561307.5.peg.644","2071"
"29401",261,534,273,"ACACCAATTGCAAAGATGAC","CCACCAAAGAAACCTAAATA","561307.5.peg.644","2071"
"29402",162,569,407,"GGGTATGCTTTAACGGTGTT","CGGCAAATGCTGTGACAATA","561307.5.peg.644","2071"
"29403",261,569,308,"ACACCAATTGCAAAGATGAC","CGGCAAATGCTGTGACAATA","561307.5.peg.644","2071"
"29404",117,569,452,"CCCAACAATAGACCTGCAGC","CGGCAAATGCTGTGACAATA","561307.5.peg.644","2071"
"29405",102,569,467,"GCAGCTGGTAAGATTGCGAT","CGGCAAATGCTGTGACAATA","561307.5.peg.644","2071"
"29406",91,569,478,"GATTGCGATAGGTAACATAA","CGGCAAATGCTGTGACAATA","561307.5.peg.644","2071"
"29407",261,627,366,"ACACCAATTGCAAAGATGAC","TAAATGCCGGCTTGTATGCT","561307.5.peg.644","2071"
"29408",117,627,510,"CCCAACAATAGACCTGCAGC","TAAATGCCGGCTTGTATGCT","561307.5.peg.644","2071"
"29409",102,627,525,"GCAGCTGGTAAGATTGCGAT","TAAATGCCGGCTTGTATGCT","561307.5.peg.644","2071"
"29410",162,627,465,"GGGTATGCTTTAACGGTGTT","TAAATGCCGGCTTGTATGCT","561307.5.peg.644","2071"
"29411",91,627,536,"GATTGCGATAGGTAACATAA","TAAATGCCGGCTTGTATGCT","561307.5.peg.644","2071"
"29412",117,640,523,"CCCAACAATAGACCTGCAGC","TCCACCAACATGATAAATGC","561307.5.peg.644","2071"
"29413",261,640,379,"ACACCAATTGCAAAGATGAC","TCCACCAACATGATAAATGC","561307.5.peg.644","2071"
"29414",162,640,478,"GGGTATGCTTTAACGGTGTT","TCCACCAACATGATAAATGC","561307.5.peg.644","2071"
"29415",91,640,549,"GATTGCGATAGGTAACATAA","TCCACCAACATGATAAATGC","561307.5.peg.644","2071"
"29416",534,640,106,"CCACCAAAGAAACCTAAATA","TCCACCAACATGATAAATGC","561307.5.peg.644","2071"
"29417",102,640,538,"GCAGCTGGTAAGATTGCGAT","TCCACCAACATGATAAATGC","561307.5.peg.644","2071"
"29418",531,640,109,"CCAAAGAAACCTAAATACGG","TCCACCAACATGATAAATGC","561307.5.peg.644","2071"
"29419",132,9,123,"GTTACAGCTAATATCTCTAG","CGATAACAACTTAAGAAAGG","561307.5.peg.645","2072"
"29420",339,9,330,"ATTGCAACTGCTTGACGTGA","CGATAACAACTTAAGAAAGG","561307.5.peg.645","2072"
"29421",321,9,312,"GATGGTGTCGACGGTAGTTT","CGATAACAACTTAAGAAAGG","561307.5.peg.645","2072"
"29422",227,9,218,"CTTTCGCTACTGCTATATCT","CGATAACAACTTAAGAAAGG","561307.5.peg.645","2072"
"29423",273,9,264,"ATTTCAGAAGCAAAGGCAGC","CGATAACAACTTAAGAAAGG","561307.5.peg.645","2072"
"29424",408,9,399,"CCTGTCGCTACAATTGTTAC","CGATAACAACTTAAGAAAGG","561307.5.peg.645","2072"
"29425",468,9,459,"TCAATATGCTCAGCGATTCT","CGATAACAACTTAAGAAAGG","561307.5.peg.645","2072"
"29426",363,9,354,"TTATAATCACATCTGATGC","CGATAACAACTTAAGAAAGG","561307.5.peg.645","2072"
"29427",330,9,321,"GCTTGACGTGATGGTGTCGA","CGATAACAACTTAAGAAAGG","561307.5.peg.645","2072"
"29428",273,81,192,"ATTTCAGAAGCAAAGGCAGC","GCTATTGCATCATCGTGTCC","561307.5.peg.645","2072"
"29429",330,81,249,"GCTTGACGTGATGGTGTCGA","GCTATTGCATCATCGTGTCC","561307.5.peg.645","2072"
"29430",339,81,258,"ATTGCAACTGCTTGACGTGA","GCTATTGCATCATCGTGTCC","561307.5.peg.645","2072"
"29431",468,81,387,"TCAATATGCTCAGCGATTCT","GCTATTGCATCATCGTGTCC","561307.5.peg.645","2072"
"29432",321,81,240,"GATGGTGTCGACGGTAGTTT","GCTATTGCATCATCGTGTCC","561307.5.peg.645","2072"
"29433",363,81,282,"TTATAATCACATCTGATGC","GCTATTGCATCATCGTGTCC","561307.5.peg.645","2072"
"29434",227,81,146,"CTTTCGCTACTGCTATATCT","GCTATTGCATCATCGTGTCC","561307.5.peg.645","2072"
"29435",408,81,327,"CCTGTCGCTACAATTGTTAC","GCTATTGCATCATCGTGTCC","561307.5.peg.645","2072"
"29436",9,132,123,"CGATAACAACTTAAGAAAGG","GTTACAGCTAATATCTCTAG","561307.5.peg.645","2072"
"29437",408,132,276,"CCTGTCGCTACAATTGTTAC","GTTACAGCTAATATCTCTAG","561307.5.peg.645","2072"
"29438",330,132,198,"GCTTGACGTGATGGTGTCGA","GTTACAGCTAATATCTCTAG","561307.5.peg.645","2072"
"29439",363,132,231,"TTATAATCACATCTGATGC","GTTACAGCTAATATCTCTAG","561307.5.peg.645","2072"
"29440",339,132,207,"ATTGCAACTGCTTGACGTGA","GTTACAGCTAATATCTCTAG","561307.5.peg.645","2072"
"29441",273,132,141,"ATTTCAGAAGCAAAGGCAGC","GTTACAGCTAATATCTCTAG","561307.5.peg.645","2072"
"29442",468,132,336,"TCAATATGCTCAGCGATTCT","GTTACAGCTAATATCTCTAG","561307.5.peg.645","2072"
"29443",321,132,189,"GATGGTGTCGACGGTAGTTT","GTTACAGCTAATATCTCTAG","561307.5.peg.645","2072"
"29444",339,227,112,"ATTGCAACTGCTTGACGTGA","CTTTCGCTACTGCTATATCT","561307.5.peg.645","2072"
"29445",363,227,136,"TTATAATCACATCTGATGC","CTTTCGCTACTGCTATATCT","561307.5.peg.645","2072"
"29446",330,227,103,"GCTTGACGTGATGGTGTCGA","CTTTCGCTACTGCTATATCT","561307.5.peg.645","2072"
"29447",408,227,181,"CCTGTCGCTACAATTGTTAC","CTTTCGCTACTGCTATATCT","561307.5.peg.645","2072"
"29448",9,227,218,"CGATAACAACTTAAGAAAGG","CTTTCGCTACTGCTATATCT","561307.5.peg.645","2072"
"29449",81,227,146,"GCTATTGCATCATCGTGTCC","CTTTCGCTACTGCTATATCT","561307.5.peg.645","2072"
"29450",468,227,241,"TCAATATGCTCAGCGATTCT","CTTTCGCTACTGCTATATCT","561307.5.peg.645","2072"
"29451",468,273,195,"TCAATATGCTCAGCGATTCT","ATTTCAGAAGCAAAGGCAGC","561307.5.peg.645","2072"
"29452",408,273,135,"CCTGTCGCTACAATTGTTAC","ATTTCAGAAGCAAAGGCAGC","561307.5.peg.645","2072"
"29453",81,273,192,"GCTATTGCATCATCGTGTCC","ATTTCAGAAGCAAAGGCAGC","561307.5.peg.645","2072"
"29454",9,273,264,"CGATAACAACTTAAGAAAGG","ATTTCAGAAGCAAAGGCAGC","561307.5.peg.645","2072"
"29455",132,273,141,"GTTACAGCTAATATCTCTAG","ATTTCAGAAGCAAAGGCAGC","561307.5.peg.645","2072"
"29456",9,321,312,"CGATAACAACTTAAGAAAGG","GATGGTGTCGACGGTAGTTT","561307.5.peg.645","2072"
"29457",81,321,240,"GCTATTGCATCATCGTGTCC","GATGGTGTCGACGGTAGTTT","561307.5.peg.645","2072"
"29458",132,321,189,"GTTACAGCTAATATCTCTAG","GATGGTGTCGACGGTAGTTT","561307.5.peg.645","2072"
"29459",468,321,147,"TCAATATGCTCAGCGATTCT","GATGGTGTCGACGGTAGTTT","561307.5.peg.645","2072"
"29460",9,330,321,"CGATAACAACTTAAGAAAGG","GCTTGACGTGATGGTGTCGA","561307.5.peg.645","2072"
"29461",227,330,103,"CTTTCGCTACTGCTATATCT","GCTTGACGTGATGGTGTCGA","561307.5.peg.645","2072"
"29462",132,330,198,"GTTACAGCTAATATCTCTAG","GCTTGACGTGATGGTGTCGA","561307.5.peg.645","2072"
"29463",468,330,138,"TCAATATGCTCAGCGATTCT","GCTTGACGTGATGGTGTCGA","561307.5.peg.645","2072"
"29464",81,330,249,"GCTATTGCATCATCGTGTCC","GCTTGACGTGATGGTGTCGA","561307.5.peg.645","2072"
"29465",468,339,129,"TCAATATGCTCAGCGATTCT","ATTGCAACTGCTTGACGTGA","561307.5.peg.645","2072"
"29466",227,339,112,"CTTTCGCTACTGCTATATCT","ATTGCAACTGCTTGACGTGA","561307.5.peg.645","2072"
"29467",9,339,330,"CGATAACAACTTAAGAAAGG","ATTGCAACTGCTTGACGTGA","561307.5.peg.645","2072"
"29468",132,339,207,"GTTACAGCTAATATCTCTAG","ATTGCAACTGCTTGACGTGA","561307.5.peg.645","2072"
"29469",81,339,258,"GCTATTGCATCATCGTGTCC","ATTGCAACTGCTTGACGTGA","561307.5.peg.645","2072"
"29470",9,363,354,"CGATAACAACTTAAGAAAGG","TTATAATCACATCTGATGC","561307.5.peg.645","2072"
"29471",81,363,282,"GCTATTGCATCATCGTGTCC","TTATAATCACATCTGATGC","561307.5.peg.645","2072"
"29472",227,363,136,"CTTTCGCTACTGCTATATCT","TTATAATCACATCTGATGC","561307.5.peg.645","2072"
"29473",468,363,105,"TCAATATGCTCAGCGATTCT","TTATAATCACATCTGATGC","561307.5.peg.645","2072"
"29474",132,363,231,"GTTACAGCTAATATCTCTAG","TTATAATCACATCTGATGC","561307.5.peg.645","2072"
"29475",81,408,327,"GCTATTGCATCATCGTGTCC","CCTGTCGCTACAATTGTTAC","561307.5.peg.645","2072"
"29476",9,408,399,"CGATAACAACTTAAGAAAGG","CCTGTCGCTACAATTGTTAC","561307.5.peg.645","2072"
"29477",132,408,276,"GTTACAGCTAATATCTCTAG","CCTGTCGCTACAATTGTTAC","561307.5.peg.645","2072"
"29478",273,408,135,"ATTTCAGAAGCAAAGGCAGC","CCTGTCGCTACAATTGTTAC","561307.5.peg.645","2072"
"29479",227,408,181,"CTTTCGCTACTGCTATATCT","CCTGTCGCTACAATTGTTAC","561307.5.peg.645","2072"
"29480",273,468,195,"ATTTCAGAAGCAAAGGCAGC","TCAATATGCTCAGCGATTCT","561307.5.peg.645","2072"
"29481",81,468,387,"GCTATTGCATCATCGTGTCC","TCAATATGCTCAGCGATTCT","561307.5.peg.645","2072"
"29482",330,468,138,"GCTTGACGTGATGGTGTCGA","TCAATATGCTCAGCGATTCT","561307.5.peg.645","2072"
"29483",227,468,241,"CTTTCGCTACTGCTATATCT","TCAATATGCTCAGCGATTCT","561307.5.peg.645","2072"
"29484",132,468,336,"GTTACAGCTAATATCTCTAG","TCAATATGCTCAGCGATTCT","561307.5.peg.645","2072"
"29485",321,468,147,"GATGGTGTCGACGGTAGTTT","TCAATATGCTCAGCGATTCT","561307.5.peg.645","2072"
"29486",339,468,129,"ATTGCAACTGCTTGACGTGA","TCAATATGCTCAGCGATTCT","561307.5.peg.645","2072"
"29487",9,468,459,"CGATAACAACTTAAGAAAGG","TCAATATGCTCAGCGATTCT","561307.5.peg.645","2072"
"29488",363,468,105,"TTATAATCACATCTGATGC","TCAATATGCTCAGCGATTCT","561307.5.peg.645","2072"
"29489",710,11,699,"TTCGTCTACGAATCACACAA","AATTGAGCTCAGATGCTCAA","561307.5.peg.646","2073"
"29490",702,11,691,"CGAATCACACAAAGGACATA","AATTGAGCTCAGATGCTCAA","561307.5.peg.646","2073"
"29491",940,11,929,"ATGGTGAATCATTTGAGCGA","AATTGAGCTCAGATGCTCAA","561307.5.peg.646","2073"
"29492",702,96,606,"CGAATCACACAAAGGACATA","GTTCTTTACCATGAATAGT","561307.5.peg.646","2073"
"29493",940,96,844,"ATGGTGAATCATTTGAGCGA","GTTCTTTACCATGAATAGT","561307.5.peg.646","2073"
"29494",710,96,614,"TTCGTCTACGAATCACACAA","GTTCTTTACCATGAATAGT","561307.5.peg.646","2073"
"29495",11,702,691,"AATTGAGCTCAGATGCTCAA","CGAATCACACAAAGGACATA","561307.5.peg.646","2073"
"29496",940,702,238,"ATGGTGAATCATTTGAGCGA","CGAATCACACAAAGGACATA","561307.5.peg.646","2073"
"29497",96,702,606,"GTTCTTTACCATGAATAGT","CGAATCACACAAAGGACATA","561307.5.peg.646","2073"
"29498",11,710,699,"AATTGAGCTCAGATGCTCAA","TTCGTCTACGAATCACACAA","561307.5.peg.646","2073"
"29499",940,710,230,"ATGGTGAATCATTTGAGCGA","TTCGTCTACGAATCACACAA","561307.5.peg.646","2073"
"29500",96,710,614,"GTTCTTTACCATGAATAGT","TTCGTCTACGAATCACACAA","561307.5.peg.646","2073"
"29501",11,940,929,"AATTGAGCTCAGATGCTCAA","ATGGTGAATCATTTGAGCGA","561307.5.peg.646","2073"
"29502",96,940,844,"GTTCTTTACCATGAATAGT","ATGGTGAATCATTTGAGCGA","561307.5.peg.646","2073"
"29503",702,940,238,"CGAATCACACAAAGGACATA","ATGGTGAATCATTTGAGCGA","561307.5.peg.646","2073"
"29504",710,940,230,"TTCGTCTACGAATCACACAA","ATGGTGAATCATTTGAGCGA","561307.5.peg.646","2073"
"29505",115,8,107,"ATCTGACATTTGTGACAATA","TATTCAAATAAAGAAGCGA","561307.5.peg.647","2074"
"29506",219,8,211,"GCGACCGAACATAGATGCGT","TATTCAAATAAAGAAGCGA","561307.5.peg.647","2074"
"29507",246,8,238,"ATATGTTCGACATCTGTATG","TATTCAAATAAAGAAGCGA","561307.5.peg.647","2074"
"29508",219,115,104,"GCGACCGAACATAGATGCGT","ATCTGACATTTGTGACAATA","561307.5.peg.647","2074"
"29509",8,115,107,"TATTCAAATAAAGAAGCGA","ATCTGACATTTGTGACAATA","561307.5.peg.647","2074"
"29510",246,115,131,"ATATGTTCGACATCTGTATG","ATCTGACATTTGTGACAATA","561307.5.peg.647","2074"
"29511",8,219,211,"TATTCAAATAAAGAAGCGA","GCGACCGAACATAGATGCGT","561307.5.peg.647","2074"
"29512",115,219,104,"ATCTGACATTTGTGACAATA","GCGACCGAACATAGATGCGT","561307.5.peg.647","2074"
"29513",115,246,131,"ATCTGACATTTGTGACAATA","ATATGTTCGACATCTGTATG","561307.5.peg.647","2074"
"29514",8,246,238,"TATTCAAATAAAGAAGCGA","ATATGTTCGACATCTGTATG","561307.5.peg.647","2074"
"29515",552,8,544,"TCAAAGAACTCACTCATCAT","CAATGCATATATAACAGGGA","561307.5.peg.649","2076"
"29516",243,8,235,"TTAACCATCGCTTGTGCTGC","CAATGCATATATAACAGGGA","561307.5.peg.649","2076"
"29517",111,8,103,"CCAAGCAAGAATATGACAAC","CAATGCATATATAACAGGGA","561307.5.peg.649","2076"
"29518",579,8,571,"CCTGTAGCAATCGATACACC","CAATGCATATATAACAGGGA","561307.5.peg.649","2076"
"29519",469,8,461,"TTGCCAAATACTGCCTGATA","CAATGCATATATAACAGGGA","561307.5.peg.649","2076"
"29520",243,12,231,"TTAACCATCGCTTGTGCTGC","GTGACAATGCATATATAACA","561307.5.peg.649","2076"
"29521",469,12,457,"TTGCCAAATACTGCCTGATA","GTGACAATGCATATATAACA","561307.5.peg.649","2076"
"29522",579,12,567,"CCTGTAGCAATCGATACACC","GTGACAATGCATATATAACA","561307.5.peg.649","2076"
"29523",552,12,540,"TCAAAGAACTCACTCATCAT","GTGACAATGCATATATAACA","561307.5.peg.649","2076"
"29524",8,111,103,"CAATGCATATATAACAGGGA","CCAAGCAAGAATATGACAAC","561307.5.peg.649","2076"
"29525",552,111,441,"TCAAAGAACTCACTCATCAT","CCAAGCAAGAATATGACAAC","561307.5.peg.649","2076"
"29526",243,111,132,"TTAACCATCGCTTGTGCTGC","CCAAGCAAGAATATGACAAC","561307.5.peg.649","2076"
"29527",579,111,468,"CCTGTAGCAATCGATACACC","CCAAGCAAGAATATGACAAC","561307.5.peg.649","2076"
"29528",469,111,358,"TTGCCAAATACTGCCTGATA","CCAAGCAAGAATATGACAAC","561307.5.peg.649","2076"
"29529",552,243,309,"TCAAAGAACTCACTCATCAT","TTAACCATCGCTTGTGCTGC","561307.5.peg.649","2076"
"29530",12,243,231,"GTGACAATGCATATATAACA","TTAACCATCGCTTGTGCTGC","561307.5.peg.649","2076"
"29531",8,243,235,"CAATGCATATATAACAGGGA","TTAACCATCGCTTGTGCTGC","561307.5.peg.649","2076"
"29532",111,243,132,"CCAAGCAAGAATATGACAAC","TTAACCATCGCTTGTGCTGC","561307.5.peg.649","2076"
"29533",469,243,226,"TTGCCAAATACTGCCTGATA","TTAACCATCGCTTGTGCTGC","561307.5.peg.649","2076"
"29534",579,243,336,"CCTGTAGCAATCGATACACC","TTAACCATCGCTTGTGCTGC","561307.5.peg.649","2076"
"29535",111,469,358,"CCAAGCAAGAATATGACAAC","TTGCCAAATACTGCCTGATA","561307.5.peg.649","2076"
"29536",243,469,226,"TTAACCATCGCTTGTGCTGC","TTGCCAAATACTGCCTGATA","561307.5.peg.649","2076"
"29537",8,469,461,"CAATGCATATATAACAGGGA","TTGCCAAATACTGCCTGATA","561307.5.peg.649","2076"
"29538",579,469,110,"CCTGTAGCAATCGATACACC","TTGCCAAATACTGCCTGATA","561307.5.peg.649","2076"
"29539",12,469,457,"GTGACAATGCATATATAACA","TTGCCAAATACTGCCTGATA","561307.5.peg.649","2076"
"29540",8,552,544,"CAATGCATATATAACAGGGA","TCAAAGAACTCACTCATCAT","561307.5.peg.649","2076"
"29541",111,552,441,"CCAAGCAAGAATATGACAAC","TCAAAGAACTCACTCATCAT","561307.5.peg.649","2076"
"29542",12,552,540,"GTGACAATGCATATATAACA","TCAAAGAACTCACTCATCAT","561307.5.peg.649","2076"
"29543",243,552,309,"TTAACCATCGCTTGTGCTGC","TCAAAGAACTCACTCATCAT","561307.5.peg.649","2076"
"29544",12,579,567,"GTGACAATGCATATATAACA","CCTGTAGCAATCGATACACC","561307.5.peg.649","2076"
"29545",8,579,571,"CAATGCATATATAACAGGGA","CCTGTAGCAATCGATACACC","561307.5.peg.649","2076"
"29546",469,579,110,"TTGCCAAATACTGCCTGATA","CCTGTAGCAATCGATACACC","561307.5.peg.649","2076"
"29547",243,579,336,"TTAACCATCGCTTGTGCTGC","CCTGTAGCAATCGATACACC","561307.5.peg.649","2076"
"29548",111,579,468,"CCAAGCAAGAATATGACAAC","CCTGTAGCAATCGATACACC","561307.5.peg.649","2076"
"29549",243,117,126,"AATTCACTAGAGCCGTATAT","AATCCTGTAAACCAACTAGC","561307.5.peg.65","2077"
"29550",432,117,315,"CCATGGTTTGTAAACCATTG","AATCCTGTAAACCAACTAGC","561307.5.peg.65","2077"
"29551",278,117,161,"ATGCAATTGCAGGATTAAAT","AATCCTGTAAACCAACTAGC","561307.5.peg.65","2077"
"29552",117,243,126,"AATCCTGTAAACCAACTAGC","AATTCACTAGAGCCGTATAT","561307.5.peg.65","2077"
"29553",432,243,189,"CCATGGTTTGTAAACCATTG","AATTCACTAGAGCCGTATAT","561307.5.peg.65","2077"
"29554",117,278,161,"AATCCTGTAAACCAACTAGC","ATGCAATTGCAGGATTAAAT","561307.5.peg.65","2077"
"29555",432,278,154,"CCATGGTTTGTAAACCATTG","ATGCAATTGCAGGATTAAAT","561307.5.peg.65","2077"
"29556",278,432,154,"ATGCAATTGCAGGATTAAAT","CCATGGTTTGTAAACCATTG","561307.5.peg.65","2077"
"29557",243,432,189,"AATTCACTAGAGCCGTATAT","CCATGGTTTGTAAACCATTG","561307.5.peg.65","2077"
"29558",117,432,315,"AATCCTGTAAACCAACTAGC","CCATGGTTTGTAAACCATTG","561307.5.peg.65","2077"
"29559",290,120,170,"ATGTCGTTTCAGATGTGACA","TCTTTACTTTATCATCTAG","561307.5.peg.650","2078"
"29560",450,120,330,"GACTGATACGATACTTCGTC","TCTTTACTTTATCATCTAG","561307.5.peg.650","2078"
"29561",489,120,369,"CCATGATGTGCACATGCTAA","TCTTTACTTTATCATCTAG","561307.5.peg.650","2078"
"29562",489,213,276,"CCATGATGTGCACATGCTAA","AATTCATGACCTAATGTCAC","561307.5.peg.650","2078"
"29563",450,213,237,"GACTGATACGATACTTCGTC","AATTCATGACCTAATGTCAC","561307.5.peg.650","2078"
"29564",120,290,170,"TCTTTACTTTATCATCTAG","ATGTCGTTTCAGATGTGACA","561307.5.peg.650","2078"
"29565",450,290,160,"GACTGATACGATACTTCGTC","ATGTCGTTTCAGATGTGACA","561307.5.peg.650","2078"
"29566",489,290,199,"CCATGATGTGCACATGCTAA","ATGTCGTTTCAGATGTGACA","561307.5.peg.650","2078"
"29567",120,450,330,"TCTTTACTTTATCATCTAG","GACTGATACGATACTTCGTC","561307.5.peg.650","2078"
"29568",290,450,160,"ATGTCGTTTCAGATGTGACA","GACTGATACGATACTTCGTC","561307.5.peg.650","2078"
"29569",213,450,237,"AATTCATGACCTAATGTCAC","GACTGATACGATACTTCGTC","561307.5.peg.650","2078"
"29570",120,489,369,"TCTTTACTTTATCATCTAG","CCATGATGTGCACATGCTAA","561307.5.peg.650","2078"
"29571",213,489,276,"AATTCATGACCTAATGTCAC","CCATGATGTGCACATGCTAA","561307.5.peg.650","2078"
"29572",290,489,199,"ATGTCGTTTCAGATGTGACA","CCATGATGTGCACATGCTAA","561307.5.peg.650","2078"
"29573",250,108,142,"ATGCGTAACATCACTTCCAA","TCATTCGCACTTTCAATGAC","561307.5.peg.652","2080"
"29574",390,108,282,"ACATATTCCGCGAACGATCC","TCATTCGCACTTTCAATGAC","561307.5.peg.652","2080"
"29575",312,108,204,"CAATACTCGCATTGATAACA","TCATTCGCACTTTCAATGAC","561307.5.peg.652","2080"
"29576",302,108,194,"ATTGATAACAAGGTATTGCT","TCATTCGCACTTTCAATGAC","561307.5.peg.652","2080"
"29577",444,108,336,"CAATGTAATCAACATTGTC","TCATTCGCACTTTCAATGAC","561307.5.peg.652","2080"
"29578",528,108,420,"ATTACTGCAACAGTCATACC","TCATTCGCACTTTCAATGAC","561307.5.peg.652","2080"
"29579",302,198,104,"ATTGATAACAAGGTATTGCT","ATGGCATACCTTTAATGTA","561307.5.peg.652","2080"
"29580",312,198,114,"CAATACTCGCATTGATAACA","ATGGCATACCTTTAATGTA","561307.5.peg.652","2080"
"29581",444,198,246,"CAATGTAATCAACATTGTC","ATGGCATACCTTTAATGTA","561307.5.peg.652","2080"
"29582",528,198,330,"ATTACTGCAACAGTCATACC","ATGGCATACCTTTAATGTA","561307.5.peg.652","2080"
"29583",390,198,192,"ACATATTCCGCGAACGATCC","ATGGCATACCTTTAATGTA","561307.5.peg.652","2080"
"29584",108,250,142,"TCATTCGCACTTTCAATGAC","ATGCGTAACATCACTTCCAA","561307.5.peg.652","2080"
"29585",528,250,278,"ATTACTGCAACAGTCATACC","ATGCGTAACATCACTTCCAA","561307.5.peg.652","2080"
"29586",444,250,194,"CAATGTAATCAACATTGTC","ATGCGTAACATCACTTCCAA","561307.5.peg.652","2080"
"29587",390,250,140,"ACATATTCCGCGAACGATCC","ATGCGTAACATCACTTCCAA","561307.5.peg.652","2080"
"29588",528,302,226,"ATTACTGCAACAGTCATACC","ATTGATAACAAGGTATTGCT","561307.5.peg.652","2080"
"29589",444,302,142,"CAATGTAATCAACATTGTC","ATTGATAACAAGGTATTGCT","561307.5.peg.652","2080"
"29590",108,302,194,"TCATTCGCACTTTCAATGAC","ATTGATAACAAGGTATTGCT","561307.5.peg.652","2080"
"29591",198,302,104,"ATGGCATACCTTTAATGTA","ATTGATAACAAGGTATTGCT","561307.5.peg.652","2080"
"29592",108,312,204,"TCATTCGCACTTTCAATGAC","CAATACTCGCATTGATAACA","561307.5.peg.652","2080"
"29593",198,312,114,"ATGGCATACCTTTAATGTA","CAATACTCGCATTGATAACA","561307.5.peg.652","2080"
"29594",528,312,216,"ATTACTGCAACAGTCATACC","CAATACTCGCATTGATAACA","561307.5.peg.652","2080"
"29595",444,312,132,"CAATGTAATCAACATTGTC","CAATACTCGCATTGATAACA","561307.5.peg.652","2080"
"29596",108,390,282,"TCATTCGCACTTTCAATGAC","ACATATTCCGCGAACGATCC","561307.5.peg.652","2080"
"29597",528,390,138,"ATTACTGCAACAGTCATACC","ACATATTCCGCGAACGATCC","561307.5.peg.652","2080"
"29598",198,390,192,"ATGGCATACCTTTAATGTA","ACATATTCCGCGAACGATCC","561307.5.peg.652","2080"
"29599",250,390,140,"ATGCGTAACATCACTTCCAA","ACATATTCCGCGAACGATCC","561307.5.peg.652","2080"
"29600",250,444,194,"ATGCGTAACATCACTTCCAA","CAATGTAATCAACATTGTC","561307.5.peg.652","2080"
"29601",108,444,336,"TCATTCGCACTTTCAATGAC","CAATGTAATCAACATTGTC","561307.5.peg.652","2080"
"29602",198,444,246,"ATGGCATACCTTTAATGTA","CAATGTAATCAACATTGTC","561307.5.peg.652","2080"
"29603",302,444,142,"ATTGATAACAAGGTATTGCT","CAATGTAATCAACATTGTC","561307.5.peg.652","2080"
"29604",312,444,132,"CAATACTCGCATTGATAACA","CAATGTAATCAACATTGTC","561307.5.peg.652","2080"
"29605",390,528,138,"ACATATTCCGCGAACGATCC","ATTACTGCAACAGTCATACC","561307.5.peg.652","2080"
"29606",302,528,226,"ATTGATAACAAGGTATTGCT","ATTACTGCAACAGTCATACC","561307.5.peg.652","2080"
"29607",312,528,216,"CAATACTCGCATTGATAACA","ATTACTGCAACAGTCATACC","561307.5.peg.652","2080"
"29608",198,528,330,"ATGGCATACCTTTAATGTA","ATTACTGCAACAGTCATACC","561307.5.peg.652","2080"
"29609",108,528,420,"TCATTCGCACTTTCAATGAC","ATTACTGCAACAGTCATACC","561307.5.peg.652","2080"
"29610",250,528,278,"ATGCGTAACATCACTTCCAA","ATTACTGCAACAGTCATACC","561307.5.peg.652","2080"
"29611",210,6,204,"GTATGGGAAATCCACTGTGC","ATGATGTAATGACAGAATGG","561307.5.peg.653","2081"
"29612",329,6,323,"TCCATTTACATTGCGAATA","ATGATGTAATGACAGAATGG","561307.5.peg.653","2081"
"29613",6,210,204,"ATGATGTAATGACAGAATGG","GTATGGGAAATCCACTGTGC","561307.5.peg.653","2081"
"29614",329,210,119,"TCCATTTACATTGCGAATA","GTATGGGAAATCCACTGTGC","561307.5.peg.653","2081"
"29615",6,329,323,"ATGATGTAATGACAGAATGG","TCCATTTACATTGCGAATA","561307.5.peg.653","2081"
"29616",210,329,119,"GTATGGGAAATCCACTGTGC","TCCATTTACATTGCGAATA","561307.5.peg.653","2081"
"29617",312,27,285,"TGTTGCTCTGTAGGTGTATT","GGCAATATCACCTTGAATAA","561307.5.peg.654","2082"
"29618",321,27,294,"TAATATGATGTTGCTCTGT","GGCAATATCACCTTGAATAA","561307.5.peg.654","2082"
"29619",225,27,198,"GCTTCATGAACTAATGACAT","GGCAATATCACCTTGAATAA","561307.5.peg.654","2082"
"29620",438,27,411,"AAATCAATGTCATTAGGCAG","GGCAATATCACCTTGAATAA","561307.5.peg.654","2082"
"29621",321,81,240,"TAATATGATGTTGCTCTGT","TATGTGACGTCGAACTGTCT","561307.5.peg.654","2082"
"29622",225,81,144,"GCTTCATGAACTAATGACAT","TATGTGACGTCGAACTGTCT","561307.5.peg.654","2082"
"29623",438,81,357,"AAATCAATGTCATTAGGCAG","TATGTGACGTCGAACTGTCT","561307.5.peg.654","2082"
"29624",312,81,231,"TGTTGCTCTGTAGGTGTATT","TATGTGACGTCGAACTGTCT","561307.5.peg.654","2082"
"29625",81,225,144,"TATGTGACGTCGAACTGTCT","GCTTCATGAACTAATGACAT","561307.5.peg.654","2082"
"29626",27,225,198,"GGCAATATCACCTTGAATAA","GCTTCATGAACTAATGACAT","561307.5.peg.654","2082"
"29627",438,225,213,"AAATCAATGTCATTAGGCAG","GCTTCATGAACTAATGACAT","561307.5.peg.654","2082"
"29628",81,312,231,"TATGTGACGTCGAACTGTCT","TGTTGCTCTGTAGGTGTATT","561307.5.peg.654","2082"
"29629",27,312,285,"GGCAATATCACCTTGAATAA","TGTTGCTCTGTAGGTGTATT","561307.5.peg.654","2082"
"29630",438,312,126,"AAATCAATGTCATTAGGCAG","TGTTGCTCTGTAGGTGTATT","561307.5.peg.654","2082"
"29631",27,321,294,"GGCAATATCACCTTGAATAA","TAATATGATGTTGCTCTGT","561307.5.peg.654","2082"
"29632",81,321,240,"TATGTGACGTCGAACTGTCT","TAATATGATGTTGCTCTGT","561307.5.peg.654","2082"
"29633",438,321,117,"AAATCAATGTCATTAGGCAG","TAATATGATGTTGCTCTGT","561307.5.peg.654","2082"
"29634",27,438,411,"GGCAATATCACCTTGAATAA","AAATCAATGTCATTAGGCAG","561307.5.peg.654","2082"
"29635",81,438,357,"TATGTGACGTCGAACTGTCT","AAATCAATGTCATTAGGCAG","561307.5.peg.654","2082"
"29636",321,438,117,"TAATATGATGTTGCTCTGT","AAATCAATGTCATTAGGCAG","561307.5.peg.654","2082"
"29637",225,438,213,"GCTTCATGAACTAATGACAT","AAATCAATGTCATTAGGCAG","561307.5.peg.654","2082"
"29638",312,438,126,"TGTTGCTCTGTAGGTGTATT","AAATCAATGTCATTAGGCAG","561307.5.peg.654","2082"
"29639",495,8,487,"TTAACGTCACTTGCTATTTC","ACGATTTAATAAACCGATGG","561307.5.peg.655","2083"
"29640",717,8,709,"TGAAATTCCCTGATAAATT","ACGATTTAATAAACCGATGG","561307.5.peg.655","2083"
"29641",487,8,479,"ACTTGCTATTTCCGGAGTAA","ACGATTTAATAAACCGATGG","561307.5.peg.655","2083"
"29642",852,8,844,"TCGGCCTTACCAAGTAAATA","ACGATTTAATAAACCGATGG","561307.5.peg.655","2083"
"29643",549,8,541,"ATGACCCCTGATTTCTCTTG","ACGATTTAATAAACCGATGG","561307.5.peg.655","2083"
"29644",717,10,707,"TGAAATTCCCTGATAAATT","GGACGATTTAATAAACCGAT","561307.5.peg.655","2083"
"29645",495,10,485,"TTAACGTCACTTGCTATTTC","GGACGATTTAATAAACCGAT","561307.5.peg.655","2083"
"29646",549,10,539,"ATGACCCCTGATTTCTCTTG","GGACGATTTAATAAACCGAT","561307.5.peg.655","2083"
"29647",852,10,842,"TCGGCCTTACCAAGTAAATA","GGACGATTTAATAAACCGAT","561307.5.peg.655","2083"
"29648",487,10,477,"ACTTGCTATTTCCGGAGTAA","GGACGATTTAATAAACCGAT","561307.5.peg.655","2083"
"29649",852,34,818,"TCGGCCTTACCAAGTAAATA","TGTCATTGTTATTCCCCCAT","561307.5.peg.655","2083"
"29650",495,34,461,"TTAACGTCACTTGCTATTTC","TGTCATTGTTATTCCCCCAT","561307.5.peg.655","2083"
"29651",549,34,515,"ATGACCCCTGATTTCTCTTG","TGTCATTGTTATTCCCCCAT","561307.5.peg.655","2083"
"29652",487,34,453,"ACTTGCTATTTCCGGAGTAA","TGTCATTGTTATTCCCCCAT","561307.5.peg.655","2083"
"29653",717,34,683,"TGAAATTCCCTGATAAATT","TGTCATTGTTATTCCCCCAT","561307.5.peg.655","2083"
"29654",10,487,477,"GGACGATTTAATAAACCGAT","ACTTGCTATTTCCGGAGTAA","561307.5.peg.655","2083"
"29655",34,487,453,"TGTCATTGTTATTCCCCCAT","ACTTGCTATTTCCGGAGTAA","561307.5.peg.655","2083"
"29656",8,487,479,"ACGATTTAATAAACCGATGG","ACTTGCTATTTCCGGAGTAA","561307.5.peg.655","2083"
"29657",852,487,365,"TCGGCCTTACCAAGTAAATA","ACTTGCTATTTCCGGAGTAA","561307.5.peg.655","2083"
"29658",717,487,230,"TGAAATTCCCTGATAAATT","ACTTGCTATTTCCGGAGTAA","561307.5.peg.655","2083"
"29659",717,495,222,"TGAAATTCCCTGATAAATT","TTAACGTCACTTGCTATTTC","561307.5.peg.655","2083"
"29660",852,495,357,"TCGGCCTTACCAAGTAAATA","TTAACGTCACTTGCTATTTC","561307.5.peg.655","2083"
"29661",10,495,485,"GGACGATTTAATAAACCGAT","TTAACGTCACTTGCTATTTC","561307.5.peg.655","2083"
"29662",34,495,461,"TGTCATTGTTATTCCCCCAT","TTAACGTCACTTGCTATTTC","561307.5.peg.655","2083"
"29663",8,495,487,"ACGATTTAATAAACCGATGG","TTAACGTCACTTGCTATTTC","561307.5.peg.655","2083"
"29664",717,549,168,"TGAAATTCCCTGATAAATT","ATGACCCCTGATTTCTCTTG","561307.5.peg.655","2083"
"29665",8,549,541,"ACGATTTAATAAACCGATGG","ATGACCCCTGATTTCTCTTG","561307.5.peg.655","2083"
"29666",852,549,303,"TCGGCCTTACCAAGTAAATA","ATGACCCCTGATTTCTCTTG","561307.5.peg.655","2083"
"29667",10,549,539,"GGACGATTTAATAAACCGAT","ATGACCCCTGATTTCTCTTG","561307.5.peg.655","2083"
"29668",34,549,515,"TGTCATTGTTATTCCCCCAT","ATGACCCCTGATTTCTCTTG","561307.5.peg.655","2083"
"29669",8,717,709,"ACGATTTAATAAACCGATGG","TGAAATTCCCTGATAAATT","561307.5.peg.655","2083"
"29670",487,717,230,"ACTTGCTATTTCCGGAGTAA","TGAAATTCCCTGATAAATT","561307.5.peg.655","2083"
"29671",10,717,707,"GGACGATTTAATAAACCGAT","TGAAATTCCCTGATAAATT","561307.5.peg.655","2083"
"29672",495,717,222,"TTAACGTCACTTGCTATTTC","TGAAATTCCCTGATAAATT","561307.5.peg.655","2083"
"29673",852,717,135,"TCGGCCTTACCAAGTAAATA","TGAAATTCCCTGATAAATT","561307.5.peg.655","2083"
"29674",549,717,168,"ATGACCCCTGATTTCTCTTG","TGAAATTCCCTGATAAATT","561307.5.peg.655","2083"
"29675",34,717,683,"TGTCATTGTTATTCCCCCAT","TGAAATTCCCTGATAAATT","561307.5.peg.655","2083"
"29676",10,852,842,"GGACGATTTAATAAACCGAT","TCGGCCTTACCAAGTAAATA","561307.5.peg.655","2083"
"29677",34,852,818,"TGTCATTGTTATTCCCCCAT","TCGGCCTTACCAAGTAAATA","561307.5.peg.655","2083"
"29678",487,852,365,"ACTTGCTATTTCCGGAGTAA","TCGGCCTTACCAAGTAAATA","561307.5.peg.655","2083"
"29679",549,852,303,"ATGACCCCTGATTTCTCTTG","TCGGCCTTACCAAGTAAATA","561307.5.peg.655","2083"
"29680",8,852,844,"ACGATTTAATAAACCGATGG","TCGGCCTTACCAAGTAAATA","561307.5.peg.655","2083"
"29681",717,852,135,"TGAAATTCCCTGATAAATT","TCGGCCTTACCAAGTAAATA","561307.5.peg.655","2083"
"29682",495,852,357,"TTAACGTCACTTGCTATTTC","TCGGCCTTACCAAGTAAATA","561307.5.peg.655","2083"
"29683",378,179,199,"GTTTGTAAGTACGTCGTTCG","GTATTCATATAATGCTTTG","561307.5.peg.656","2084"
"29684",503,179,324,"ACACTAGATAATCCCACCGT","GTATTCATATAATGCTTTG","561307.5.peg.656","2084"
"29685",534,179,355,"GAAATATCGATGTCGAATA","GTATTCATATAATGCTTTG","561307.5.peg.656","2084"
"29686",528,179,349,"ATCGATGTCGAATATGGATT","GTATTCATATAATGCTTTG","561307.5.peg.656","2084"
"29687",528,263,265,"ATCGATGTCGAATATGGATT","CATATGGTACATTGTGCTGT","561307.5.peg.656","2084"
"29688",503,263,240,"ACACTAGATAATCCCACCGT","CATATGGTACATTGTGCTGT","561307.5.peg.656","2084"
"29689",378,263,115,"GTTTGTAAGTACGTCGTTCG","CATATGGTACATTGTGCTGT","561307.5.peg.656","2084"
"29690",534,263,271,"GAAATATCGATGTCGAATA","CATATGGTACATTGTGCTGT","561307.5.peg.656","2084"
"29691",179,378,199,"GTATTCATATAATGCTTTG","GTTTGTAAGTACGTCGTTCG","561307.5.peg.656","2084"
"29692",503,378,125,"ACACTAGATAATCCCACCGT","GTTTGTAAGTACGTCGTTCG","561307.5.peg.656","2084"
"29693",534,378,156,"GAAATATCGATGTCGAATA","GTTTGTAAGTACGTCGTTCG","561307.5.peg.656","2084"
"29694",263,378,115,"CATATGGTACATTGTGCTGT","GTTTGTAAGTACGTCGTTCG","561307.5.peg.656","2084"
"29695",528,378,150,"ATCGATGTCGAATATGGATT","GTTTGTAAGTACGTCGTTCG","561307.5.peg.656","2084"
"29696",179,503,324,"GTATTCATATAATGCTTTG","ACACTAGATAATCCCACCGT","561307.5.peg.656","2084"
"29697",263,503,240,"CATATGGTACATTGTGCTGT","ACACTAGATAATCCCACCGT","561307.5.peg.656","2084"
"29698",378,503,125,"GTTTGTAAGTACGTCGTTCG","ACACTAGATAATCCCACCGT","561307.5.peg.656","2084"
"29699",179,528,349,"GTATTCATATAATGCTTTG","ATCGATGTCGAATATGGATT","561307.5.peg.656","2084"
"29700",378,528,150,"GTTTGTAAGTACGTCGTTCG","ATCGATGTCGAATATGGATT","561307.5.peg.656","2084"
"29701",263,528,265,"CATATGGTACATTGTGCTGT","ATCGATGTCGAATATGGATT","561307.5.peg.656","2084"
"29702",378,534,156,"GTTTGTAAGTACGTCGTTCG","GAAATATCGATGTCGAATA","561307.5.peg.656","2084"
"29703",263,534,271,"CATATGGTACATTGTGCTGT","GAAATATCGATGTCGAATA","561307.5.peg.656","2084"
"29704",179,534,355,"GTATTCATATAATGCTTTG","GAAATATCGATGTCGAATA","561307.5.peg.656","2084"
"29705",169,9,160,"CCAGTATAATATCTTTGAT","GCGAATGCTATTATTCGAGG","561307.5.peg.658","2086"
"29706",438,9,429,"AATCAATATCATCAGGTAG","GCGAATGCTATTATTCGAGG","561307.5.peg.658","2086"
"29707",194,9,185,"GAGATAAGACATTCTCATCA","GCGAATGCTATTATTCGAGG","561307.5.peg.658","2086"
"29708",194,12,182,"GAGATAAGACATTCTCATCA","GTAGCGAATGCTATTATTCG","561307.5.peg.658","2086"
"29709",169,12,157,"CCAGTATAATATCTTTGAT","GTAGCGAATGCTATTATTCG","561307.5.peg.658","2086"
"29710",438,12,426,"AATCAATATCATCAGGTAG","GTAGCGAATGCTATTATTCG","561307.5.peg.658","2086"
"29711",194,81,113,"GAGATAAGACATTCTCATCA","ACGTAACTTCAAATTGTCT","561307.5.peg.658","2086"
"29712",438,81,357,"AATCAATATCATCAGGTAG","ACGTAACTTCAAATTGTCT","561307.5.peg.658","2086"
"29713",9,169,160,"GCGAATGCTATTATTCGAGG","CCAGTATAATATCTTTGAT","561307.5.peg.658","2086"
"29714",438,169,269,"AATCAATATCATCAGGTAG","CCAGTATAATATCTTTGAT","561307.5.peg.658","2086"
"29715",12,169,157,"GTAGCGAATGCTATTATTCG","CCAGTATAATATCTTTGAT","561307.5.peg.658","2086"
"29716",9,194,185,"GCGAATGCTATTATTCGAGG","GAGATAAGACATTCTCATCA","561307.5.peg.658","2086"
"29717",12,194,182,"GTAGCGAATGCTATTATTCG","GAGATAAGACATTCTCATCA","561307.5.peg.658","2086"
"29718",81,194,113,"ACGTAACTTCAAATTGTCT","GAGATAAGACATTCTCATCA","561307.5.peg.658","2086"
"29719",438,194,244,"AATCAATATCATCAGGTAG","GAGATAAGACATTCTCATCA","561307.5.peg.658","2086"
"29720",12,438,426,"GTAGCGAATGCTATTATTCG","AATCAATATCATCAGGTAG","561307.5.peg.658","2086"
"29721",169,438,269,"CCAGTATAATATCTTTGAT","AATCAATATCATCAGGTAG","561307.5.peg.658","2086"
"29722",9,438,429,"GCGAATGCTATTATTCGAGG","AATCAATATCATCAGGTAG","561307.5.peg.658","2086"
"29723",81,438,357,"ACGTAACTTCAAATTGTCT","AATCAATATCATCAGGTAG","561307.5.peg.658","2086"
"29724",194,438,244,"GAGATAAGACATTCTCATCA","AATCAATATCATCAGGTAG","561307.5.peg.658","2086"
"29725",489,363,126,"TAACATCGCTAGAAATTTC","TGTATTCTTCTTCTTGTTC","561307.5.peg.659","2087"
"29726",711,363,348,"TCAAAGTTTCCAGACATCGT","TGTATTCTTCTTCTTGTTC","561307.5.peg.659","2087"
"29727",521,363,158,"GAGTCGTTACAACAACATCA","TGTATTCTTCTTCTTGTTC","561307.5.peg.659","2087"
"29728",363,489,126,"TGTATTCTTCTTCTTGTTC","TAACATCGCTAGAAATTTC","561307.5.peg.659","2087"
"29729",711,489,222,"TCAAAGTTTCCAGACATCGT","TAACATCGCTAGAAATTTC","561307.5.peg.659","2087"
"29730",363,521,158,"TGTATTCTTCTTCTTGTTC","GAGTCGTTACAACAACATCA","561307.5.peg.659","2087"
"29731",711,521,190,"TCAAAGTTTCCAGACATCGT","GAGTCGTTACAACAACATCA","561307.5.peg.659","2087"
"29732",521,711,190,"GAGTCGTTACAACAACATCA","TCAAAGTTTCCAGACATCGT","561307.5.peg.659","2087"
"29733",489,711,222,"TAACATCGCTAGAAATTTC","TCAAAGTTTCCAGACATCGT","561307.5.peg.659","2087"
"29734",363,711,348,"TGTATTCTTCTTCTTGTTC","TCAAAGTTTCCAGACATCGT","561307.5.peg.659","2087"
"29735",264,5,259,"GCCACATTTCTAGGTTTACC","TATAGTAGTCAAAGTGGGAG","561307.5.peg.660","2089"
"29736",5,264,259,"TATAGTAGTCAAAGTGGGAG","GCCACATTTCTAGGTTTACC","561307.5.peg.660","2089"
"29737",243,10,233,"ATTTAGGATTTAACGAACC","TGTATACACTGGAAATGAGG","561307.5.peg.661","2090"
"29738",345,10,335,"TTCGATAACTTCGTCACATA","TGTATACACTGGAAATGAGG","561307.5.peg.661","2090"
"29739",243,13,230,"ATTTAGGATTTAACGAACC","ATTGTATACACTGGAAATG","561307.5.peg.661","2090"
"29740",345,13,332,"TTCGATAACTTCGTCACATA","ATTGTATACACTGGAAATG","561307.5.peg.661","2090"
"29741",10,243,233,"TGTATACACTGGAAATGAGG","ATTTAGGATTTAACGAACC","561307.5.peg.661","2090"
"29742",345,243,102,"TTCGATAACTTCGTCACATA","ATTTAGGATTTAACGAACC","561307.5.peg.661","2090"
"29743",13,243,230,"ATTGTATACACTGGAAATG","ATTTAGGATTTAACGAACC","561307.5.peg.661","2090"
"29744",13,345,332,"ATTGTATACACTGGAAATG","TTCGATAACTTCGTCACATA","561307.5.peg.661","2090"
"29745",10,345,335,"TGTATACACTGGAAATGAGG","TTCGATAACTTCGTCACATA","561307.5.peg.661","2090"
"29746",243,345,102,"ATTTAGGATTTAACGAACC","TTCGATAACTTCGTCACATA","561307.5.peg.661","2090"
"29747",568,106,462,"AACCGCATATGCTTTGTCGT","GGAATATTCATCAACACAT","561307.5.peg.662","2091"
"29748",106,568,462,"GGAATATTCATCAACACAT","AACCGCATATGCTTTGTCGT","561307.5.peg.662","2091"
"29749",302,8,294,"CAAATGCCTGTACTGCGTAT","TCCTTATGAAAGACAAGAGG","561307.5.peg.663","2092"
"29750",302,22,280,"CAAATGCCTGTACTGCGTAT","TCCTCCTCTTGTCTTTCATA","561307.5.peg.663","2092"
"29751",8,302,294,"TCCTTATGAAAGACAAGAGG","CAAATGCCTGTACTGCGTAT","561307.5.peg.663","2092"
"29752",22,302,280,"TCCTCCTCTTGTCTTTCATA","CAAATGCCTGTACTGCGTAT","561307.5.peg.663","2092"
"29753",153,3,150,"ACTGATGCAGGCATAGGAAT","AAATCAAACGTAGGAGGCAA","561307.5.peg.664","2093"
"29754",159,3,156,"CCGATTACTGATGCAGGCAT","AAATCAAACGTAGGAGGCAA","561307.5.peg.664","2093"
"29755",165,3,162,"ACTAAACCGATTACTGATGC","AAATCAAACGTAGGAGGCAA","561307.5.peg.664","2093"
"29756",153,9,144,"ACTGATGCAGGCATAGGAAT","TAGTTAAATCAAACGTAGG","561307.5.peg.664","2093"
"29757",159,9,150,"CCGATTACTGATGCAGGCAT","TAGTTAAATCAAACGTAGG","561307.5.peg.664","2093"
"29758",165,9,156,"ACTAAACCGATTACTGATGC","TAGTTAAATCAAACGTAGG","561307.5.peg.664","2093"
"29759",3,153,150,"AAATCAAACGTAGGAGGCAA","ACTGATGCAGGCATAGGAAT","561307.5.peg.664","2093"
"29760",9,153,144,"TAGTTAAATCAAACGTAGG","ACTGATGCAGGCATAGGAAT","561307.5.peg.664","2093"
"29761",3,159,156,"AAATCAAACGTAGGAGGCAA","CCGATTACTGATGCAGGCAT","561307.5.peg.664","2093"
"29762",9,159,150,"TAGTTAAATCAAACGTAGG","CCGATTACTGATGCAGGCAT","561307.5.peg.664","2093"
"29763",3,165,162,"AAATCAAACGTAGGAGGCAA","ACTAAACCGATTACTGATGC","561307.5.peg.664","2093"
"29764",9,165,156,"TAGTTAAATCAAACGTAGG","ACTAAACCGATTACTGATGC","561307.5.peg.664","2093"
"29765",165,59,106,"AATACCATACTGACAAATAG","AAGGTGTGTTTAGTGCTAAG","561307.5.peg.665","2094"
"29766",59,165,106,"AAGGTGTGTTTAGTGCTAAG","AATACCATACTGACAAATAG","561307.5.peg.665","2094"
"29767",114,9,105,"ACGCTTGGCAATTTATCACC","ATTACAGACAAAGTGAAACG","561307.5.peg.666","2095"
"29768",320,9,311,"CAAGTACCTTACTTGTCATT","ATTACAGACAAAGTGAAACG","561307.5.peg.666","2095"
"29769",366,9,357,"AGCTCATCTTGTACAGATTT","ATTACAGACAAAGTGAAACG","561307.5.peg.666","2095"
"29770",320,114,206,"CAAGTACCTTACTTGTCATT","ACGCTTGGCAATTTATCACC","561307.5.peg.666","2095"
"29771",9,114,105,"ATTACAGACAAAGTGAAACG","ACGCTTGGCAATTTATCACC","561307.5.peg.666","2095"
"29772",366,114,252,"AGCTCATCTTGTACAGATTT","ACGCTTGGCAATTTATCACC","561307.5.peg.666","2095"
"29773",9,320,311,"ATTACAGACAAAGTGAAACG","CAAGTACCTTACTTGTCATT","561307.5.peg.666","2095"
"29774",114,320,206,"ACGCTTGGCAATTTATCACC","CAAGTACCTTACTTGTCATT","561307.5.peg.666","2095"
"29775",114,366,252,"ACGCTTGGCAATTTATCACC","AGCTCATCTTGTACAGATTT","561307.5.peg.666","2095"
"29776",9,366,357,"ATTACAGACAAAGTGAAACG","AGCTCATCTTGTACAGATTT","561307.5.peg.666","2095"
"29777",700,207,493,"AAGACGAACTGCTAAAGCAC","GATTTGGATAATAGTGATT","561307.5.peg.668","2097"
"29778",738,207,531,"TTGTTCCAATCTTAAACTT","GATTTGGATAATAGTGATT","561307.5.peg.668","2097"
"29779",333,207,126,"GGCACATCTTCATCCCCATT","GATTTGGATAATAGTGATT","561307.5.peg.668","2097"
"29780",450,207,243,"AATGTTTCGCTAAATGAAG","GATTTGGATAATAGTGATT","561307.5.peg.668","2097"
"29781",420,207,213,"AAATGTGATAACGTCACAAC","GATTTGGATAATAGTGATT","561307.5.peg.668","2097"
"29782",207,333,126,"GATTTGGATAATAGTGATT","GGCACATCTTCATCCCCATT","561307.5.peg.668","2097"
"29783",700,333,367,"AAGACGAACTGCTAAAGCAC","GGCACATCTTCATCCCCATT","561307.5.peg.668","2097"
"29784",738,333,405,"TTGTTCCAATCTTAAACTT","GGCACATCTTCATCCCCATT","561307.5.peg.668","2097"
"29785",450,333,117,"AATGTTTCGCTAAATGAAG","GGCACATCTTCATCCCCATT","561307.5.peg.668","2097"
"29786",207,420,213,"GATTTGGATAATAGTGATT","AAATGTGATAACGTCACAAC","561307.5.peg.668","2097"
"29787",700,420,280,"AAGACGAACTGCTAAAGCAC","AAATGTGATAACGTCACAAC","561307.5.peg.668","2097"
"29788",738,420,318,"TTGTTCCAATCTTAAACTT","AAATGTGATAACGTCACAAC","561307.5.peg.668","2097"
"29789",207,450,243,"GATTTGGATAATAGTGATT","AATGTTTCGCTAAATGAAG","561307.5.peg.668","2097"
"29790",333,450,117,"GGCACATCTTCATCCCCATT","AATGTTTCGCTAAATGAAG","561307.5.peg.668","2097"
"29791",700,450,250,"AAGACGAACTGCTAAAGCAC","AATGTTTCGCTAAATGAAG","561307.5.peg.668","2097"
"29792",738,450,288,"TTGTTCCAATCTTAAACTT","AATGTTTCGCTAAATGAAG","561307.5.peg.668","2097"
"29793",207,700,493,"GATTTGGATAATAGTGATT","AAGACGAACTGCTAAAGCAC","561307.5.peg.668","2097"
"29794",450,700,250,"AATGTTTCGCTAAATGAAG","AAGACGAACTGCTAAAGCAC","561307.5.peg.668","2097"
"29795",420,700,280,"AAATGTGATAACGTCACAAC","AAGACGAACTGCTAAAGCAC","561307.5.peg.668","2097"
"29796",333,700,367,"GGCACATCTTCATCCCCATT","AAGACGAACTGCTAAAGCAC","561307.5.peg.668","2097"
"29797",333,738,405,"GGCACATCTTCATCCCCATT","TTGTTCCAATCTTAAACTT","561307.5.peg.668","2097"
"29798",420,738,318,"AAATGTGATAACGTCACAAC","TTGTTCCAATCTTAAACTT","561307.5.peg.668","2097"
"29799",450,738,288,"AATGTTTCGCTAAATGAAG","TTGTTCCAATCTTAAACTT","561307.5.peg.668","2097"
"29800",207,738,531,"GATTTGGATAATAGTGATT","TTGTTCCAATCTTAAACTT","561307.5.peg.668","2097"
"29801",348,107,241,"TCGAATTGATTGTCATCAAA","CTGTTGCTTCTTTACCACCG","561307.5.peg.669","2098"
"29802",348,109,239,"TCGAATTGATTGTCATCAAA","ATCTGTTGCTTCTTTACCAC","561307.5.peg.669","2098"
"29803",107,348,241,"CTGTTGCTTCTTTACCACCG","TCGAATTGATTGTCATCAAA","561307.5.peg.669","2098"
"29804",109,348,239,"ATCTGTTGCTTCTTTACCAC","TCGAATTGATTGTCATCAAA","561307.5.peg.669","2098"
"29805",579,357,222,"AAACGTTTGTAACGATCGAT","AACACTTTCACAAGTGCTAA","561307.5.peg.67","2099"
"29806",624,357,267,"TCACGATATTCATTGCCTGT","AACACTTTCACAAGTGCTAA","561307.5.peg.67","2099"
"29807",357,579,222,"AACACTTTCACAAGTGCTAA","AAACGTTTGTAACGATCGAT","561307.5.peg.67","2099"
"29808",357,624,267,"AACACTTTCACAAGTGCTAA","TCACGATATTCATTGCCTGT","561307.5.peg.67","2099"
"29809",335,181,154,"CATTCACAGTGATAAAGGCT","TGCAGTGGCAATAGCCTGGT","561307.5.peg.670","2100"
"29810",340,181,159,"TTCTGCATTCACAGTGATAA","TGCAGTGGCAATAGCCTGGT","561307.5.peg.670","2100"
"29811",373,181,192,"CGCACCACCATAAACATAGA","TGCAGTGGCAATAGCCTGGT","561307.5.peg.670","2100"
"29812",480,181,299,"GCAGATATAATAGCCGGGAT","TGCAGTGGCAATAGCCTGGT","561307.5.peg.670","2100"
"29813",335,185,150,"CATTCACAGTGATAAAGGCT","TGCGTGCAGTGGCAATAGCC","561307.5.peg.670","2100"
"29814",340,185,155,"TTCTGCATTCACAGTGATAA","TGCGTGCAGTGGCAATAGCC","561307.5.peg.670","2100"
"29815",373,185,188,"CGCACCACCATAAACATAGA","TGCGTGCAGTGGCAATAGCC","561307.5.peg.670","2100"
"29816",480,185,295,"GCAGATATAATAGCCGGGAT","TGCGTGCAGTGGCAATAGCC","561307.5.peg.670","2100"
"29817",340,196,144,"TTCTGCATTCACAGTGATAA","GTCTGCTTGCATGCGTGCAG","561307.5.peg.670","2100"
"29818",373,196,177,"CGCACCACCATAAACATAGA","GTCTGCTTGCATGCGTGCAG","561307.5.peg.670","2100"
"29819",480,196,284,"GCAGATATAATAGCCGGGAT","GTCTGCTTGCATGCGTGCAG","561307.5.peg.670","2100"
"29820",335,196,139,"CATTCACAGTGATAAAGGCT","GTCTGCTTGCATGCGTGCAG","561307.5.peg.670","2100"
"29821",181,335,154,"TGCAGTGGCAATAGCCTGGT","CATTCACAGTGATAAAGGCT","561307.5.peg.670","2100"
"29822",480,335,145,"GCAGATATAATAGCCGGGAT","CATTCACAGTGATAAAGGCT","561307.5.peg.670","2100"
"29823",185,335,150,"TGCGTGCAGTGGCAATAGCC","CATTCACAGTGATAAAGGCT","561307.5.peg.670","2100"
"29824",196,335,139,"GTCTGCTTGCATGCGTGCAG","CATTCACAGTGATAAAGGCT","561307.5.peg.670","2100"
"29825",181,340,159,"TGCAGTGGCAATAGCCTGGT","TTCTGCATTCACAGTGATAA","561307.5.peg.670","2100"
"29826",185,340,155,"TGCGTGCAGTGGCAATAGCC","TTCTGCATTCACAGTGATAA","561307.5.peg.670","2100"
"29827",196,340,144,"GTCTGCTTGCATGCGTGCAG","TTCTGCATTCACAGTGATAA","561307.5.peg.670","2100"
"29828",480,340,140,"GCAGATATAATAGCCGGGAT","TTCTGCATTCACAGTGATAA","561307.5.peg.670","2100"
"29829",181,373,192,"TGCAGTGGCAATAGCCTGGT","CGCACCACCATAAACATAGA","561307.5.peg.670","2100"
"29830",185,373,188,"TGCGTGCAGTGGCAATAGCC","CGCACCACCATAAACATAGA","561307.5.peg.670","2100"
"29831",196,373,177,"GTCTGCTTGCATGCGTGCAG","CGCACCACCATAAACATAGA","561307.5.peg.670","2100"
"29832",480,373,107,"GCAGATATAATAGCCGGGAT","CGCACCACCATAAACATAGA","561307.5.peg.670","2100"
"29833",181,480,299,"TGCAGTGGCAATAGCCTGGT","GCAGATATAATAGCCGGGAT","561307.5.peg.670","2100"
"29834",185,480,295,"TGCGTGCAGTGGCAATAGCC","GCAGATATAATAGCCGGGAT","561307.5.peg.670","2100"
"29835",196,480,284,"GTCTGCTTGCATGCGTGCAG","GCAGATATAATAGCCGGGAT","561307.5.peg.670","2100"
"29836",335,480,145,"CATTCACAGTGATAAAGGCT","GCAGATATAATAGCCGGGAT","561307.5.peg.670","2100"
"29837",340,480,140,"TTCTGCATTCACAGTGATAA","GCAGATATAATAGCCGGGAT","561307.5.peg.670","2100"
"29838",373,480,107,"CGCACCACCATAAACATAGA","GCAGATATAATAGCCGGGAT","561307.5.peg.670","2100"
"29839",195,8,187,"GCTAAGACATCAATAAAGCG","ATAAATACTGTAACAGAAG","561307.5.peg.671","2101"
"29840",8,195,187,"ATAAATACTGTAACAGAAG","GCTAAGACATCAATAAAGCG","561307.5.peg.671","2101"
"29841",218,83,135,"ATAGCAAATTGGTTCCAGTA","AGAAGCCCCAGCCAATTAAG","561307.5.peg.672","2102"
"29842",327,83,244,"AATTGGAATGCTGTTGTGAC","AGAAGCCCCAGCCAATTAAG","561307.5.peg.672","2102"
"29843",196,83,113,"GAAGCCACTTGATGTGACTA","AGAAGCCCCAGCCAATTAAG","561307.5.peg.672","2102"
"29844",229,83,146,"AATAAGGCGAATAGCAAAT","AGAAGCCCCAGCCAATTAAG","561307.5.peg.672","2102"
"29845",344,83,261,"TAAAGATGCGCCTAATAAT","AGAAGCCCCAGCCAATTAAG","561307.5.peg.672","2102"
"29846",322,83,239,"GAATGCTGTTGTGACTGGCA","AGAAGCCCCAGCCAATTAAG","561307.5.peg.672","2102"
"29847",196,85,111,"GAAGCCACTTGATGTGACTA","GAAGAAGCCCCAGCCAATTA","561307.5.peg.672","2102"
"29848",218,85,133,"ATAGCAAATTGGTTCCAGTA","GAAGAAGCCCCAGCCAATTA","561307.5.peg.672","2102"
"29849",229,85,144,"AATAAGGCGAATAGCAAAT","GAAGAAGCCCCAGCCAATTA","561307.5.peg.672","2102"
"29850",327,85,242,"AATTGGAATGCTGTTGTGAC","GAAGAAGCCCCAGCCAATTA","561307.5.peg.672","2102"
"29851",322,85,237,"GAATGCTGTTGTGACTGGCA","GAAGAAGCCCCAGCCAATTA","561307.5.peg.672","2102"
"29852",344,85,259,"TAAAGATGCGCCTAATAAT","GAAGAAGCCCCAGCCAATTA","561307.5.peg.672","2102"
"29853",218,107,111,"ATAGCAAATTGGTTCCAGTA","CAAACTTTGAAGCGACTGTT","561307.5.peg.672","2102"
"29854",344,107,237,"TAAAGATGCGCCTAATAAT","CAAACTTTGAAGCGACTGTT","561307.5.peg.672","2102"
"29855",327,107,220,"AATTGGAATGCTGTTGTGAC","CAAACTTTGAAGCGACTGTT","561307.5.peg.672","2102"
"29856",229,107,122,"AATAAGGCGAATAGCAAAT","CAAACTTTGAAGCGACTGTT","561307.5.peg.672","2102"
"29857",322,107,215,"GAATGCTGTTGTGACTGGCA","CAAACTTTGAAGCGACTGTT","561307.5.peg.672","2102"
"29858",327,138,189,"AATTGGAATGCTGTTGTGAC","GCACCGATAATTTGATGTAC","561307.5.peg.672","2102"
"29859",322,138,184,"GAATGCTGTTGTGACTGGCA","GCACCGATAATTTGATGTAC","561307.5.peg.672","2102"
"29860",344,138,206,"TAAAGATGCGCCTAATAAT","GCACCGATAATTTGATGTAC","561307.5.peg.672","2102"
"29861",83,196,113,"AGAAGCCCCAGCCAATTAAG","GAAGCCACTTGATGTGACTA","561307.5.peg.672","2102"
"29862",85,196,111,"GAAGAAGCCCCAGCCAATTA","GAAGCCACTTGATGTGACTA","561307.5.peg.672","2102"
"29863",327,196,131,"AATTGGAATGCTGTTGTGAC","GAAGCCACTTGATGTGACTA","561307.5.peg.672","2102"
"29864",322,196,126,"GAATGCTGTTGTGACTGGCA","GAAGCCACTTGATGTGACTA","561307.5.peg.672","2102"
"29865",344,196,148,"TAAAGATGCGCCTAATAAT","GAAGCCACTTGATGTGACTA","561307.5.peg.672","2102"
"29866",107,218,111,"CAAACTTTGAAGCGACTGTT","ATAGCAAATTGGTTCCAGTA","561307.5.peg.672","2102"
"29867",327,218,109,"AATTGGAATGCTGTTGTGAC","ATAGCAAATTGGTTCCAGTA","561307.5.peg.672","2102"
"29868",85,218,133,"GAAGAAGCCCCAGCCAATTA","ATAGCAAATTGGTTCCAGTA","561307.5.peg.672","2102"
"29869",83,218,135,"AGAAGCCCCAGCCAATTAAG","ATAGCAAATTGGTTCCAGTA","561307.5.peg.672","2102"
"29870",322,218,104,"GAATGCTGTTGTGACTGGCA","ATAGCAAATTGGTTCCAGTA","561307.5.peg.672","2102"
"29871",344,218,126,"TAAAGATGCGCCTAATAAT","ATAGCAAATTGGTTCCAGTA","561307.5.peg.672","2102"
"29872",85,229,144,"GAAGAAGCCCCAGCCAATTA","AATAAGGCGAATAGCAAAT","561307.5.peg.672","2102"
"29873",83,229,146,"AGAAGCCCCAGCCAATTAAG","AATAAGGCGAATAGCAAAT","561307.5.peg.672","2102"
"29874",344,229,115,"TAAAGATGCGCCTAATAAT","AATAAGGCGAATAGCAAAT","561307.5.peg.672","2102"
"29875",107,229,122,"CAAACTTTGAAGCGACTGTT","AATAAGGCGAATAGCAAAT","561307.5.peg.672","2102"
"29876",107,322,215,"CAAACTTTGAAGCGACTGTT","GAATGCTGTTGTGACTGGCA","561307.5.peg.672","2102"
"29877",85,322,237,"GAAGAAGCCCCAGCCAATTA","GAATGCTGTTGTGACTGGCA","561307.5.peg.672","2102"
"29878",83,322,239,"AGAAGCCCCAGCCAATTAAG","GAATGCTGTTGTGACTGGCA","561307.5.peg.672","2102"
"29879",138,322,184,"GCACCGATAATTTGATGTAC","GAATGCTGTTGTGACTGGCA","561307.5.peg.672","2102"
"29880",196,322,126,"GAAGCCACTTGATGTGACTA","GAATGCTGTTGTGACTGGCA","561307.5.peg.672","2102"
"29881",218,322,104,"ATAGCAAATTGGTTCCAGTA","GAATGCTGTTGTGACTGGCA","561307.5.peg.672","2102"
"29882",83,327,244,"AGAAGCCCCAGCCAATTAAG","AATTGGAATGCTGTTGTGAC","561307.5.peg.672","2102"
"29883",218,327,109,"ATAGCAAATTGGTTCCAGTA","AATTGGAATGCTGTTGTGAC","561307.5.peg.672","2102"
"29884",107,327,220,"CAAACTTTGAAGCGACTGTT","AATTGGAATGCTGTTGTGAC","561307.5.peg.672","2102"
"29885",138,327,189,"GCACCGATAATTTGATGTAC","AATTGGAATGCTGTTGTGAC","561307.5.peg.672","2102"
"29886",85,327,242,"GAAGAAGCCCCAGCCAATTA","AATTGGAATGCTGTTGTGAC","561307.5.peg.672","2102"
"29887",196,327,131,"GAAGCCACTTGATGTGACTA","AATTGGAATGCTGTTGTGAC","561307.5.peg.672","2102"
"29888",138,344,206,"GCACCGATAATTTGATGTAC","TAAAGATGCGCCTAATAAT","561307.5.peg.672","2102"
"29889",107,344,237,"CAAACTTTGAAGCGACTGTT","TAAAGATGCGCCTAATAAT","561307.5.peg.672","2102"
"29890",196,344,148,"GAAGCCACTTGATGTGACTA","TAAAGATGCGCCTAATAAT","561307.5.peg.672","2102"
"29891",83,344,261,"AGAAGCCCCAGCCAATTAAG","TAAAGATGCGCCTAATAAT","561307.5.peg.672","2102"
"29892",85,344,259,"GAAGAAGCCCCAGCCAATTA","TAAAGATGCGCCTAATAAT","561307.5.peg.672","2102"
"29893",229,344,115,"AATAAGGCGAATAGCAAAT","TAAAGATGCGCCTAATAAT","561307.5.peg.672","2102"
"29894",218,344,126,"ATAGCAAATTGGTTCCAGTA","TAAAGATGCGCCTAATAAT","561307.5.peg.672","2102"
"29895",430,308,122,"ATAGTTATTTAGGGCGTCCG","ATCAACATCAGATGGTTTA","561307.5.peg.673","2103"
"29896",432,308,124,"AGATAGTTATTTAGGGCGTC","ATCAACATCAGATGGTTTA","561307.5.peg.673","2103"
"29897",308,430,122,"ATCAACATCAGATGGTTTA","ATAGTTATTTAGGGCGTCCG","561307.5.peg.673","2103"
"29898",308,432,124,"ATCAACATCAGATGGTTTA","AGATAGTTATTTAGGGCGTC","561307.5.peg.673","2103"
"29899",385,206,179,"AGCAACTAGGGCAGCAATTG","TCATGAAGGCAAAGCGTGTT","561307.5.peg.676","2106"
"29900",397,206,191,"TGTTGGTAATATAGCAACTA","TCATGAAGGCAAAGCGTGTT","561307.5.peg.676","2106"
"29901",206,385,179,"TCATGAAGGCAAAGCGTGTT","AGCAACTAGGGCAGCAATTG","561307.5.peg.676","2106"
"29902",206,397,191,"TCATGAAGGCAAAGCGTGTT","TGTTGGTAATATAGCAACTA","561307.5.peg.676","2106"
"29903",435,284,151,"TCTGTCATCACTGTAGCAAC","ATTTGTCTAGTTTATCTGGG","561307.5.peg.678","2108"
"29904",393,284,109,"TCAGTTAGTACCGACATAAC","ATTTGTCTAGTTTATCTGGG","561307.5.peg.678","2108"
"29905",555,284,271,"CCTGTCACTTTAACTGTTGA","ATTTGTCTAGTTTATCTGGG","561307.5.peg.678","2108"
"29906",393,287,106,"TCAGTTAGTACCGACATAAC","ACATTTGTCTAGTTTATCT","561307.5.peg.678","2108"
"29907",555,287,268,"CCTGTCACTTTAACTGTTGA","ACATTTGTCTAGTTTATCT","561307.5.peg.678","2108"
"29908",435,287,148,"TCTGTCATCACTGTAGCAAC","ACATTTGTCTAGTTTATCT","561307.5.peg.678","2108"
"29909",284,393,109,"ATTTGTCTAGTTTATCTGGG","TCAGTTAGTACCGACATAAC","561307.5.peg.678","2108"
"29910",555,393,162,"CCTGTCACTTTAACTGTTGA","TCAGTTAGTACCGACATAAC","561307.5.peg.678","2108"
"29911",287,393,106,"ACATTTGTCTAGTTTATCT","TCAGTTAGTACCGACATAAC","561307.5.peg.678","2108"
"29912",284,435,151,"ATTTGTCTAGTTTATCTGGG","TCTGTCATCACTGTAGCAAC","561307.5.peg.678","2108"
"29913",555,435,120,"CCTGTCACTTTAACTGTTGA","TCTGTCATCACTGTAGCAAC","561307.5.peg.678","2108"
"29914",287,435,148,"ACATTTGTCTAGTTTATCT","TCTGTCATCACTGTAGCAAC","561307.5.peg.678","2108"
"29915",284,555,271,"ATTTGTCTAGTTTATCTGGG","CCTGTCACTTTAACTGTTGA","561307.5.peg.678","2108"
"29916",287,555,268,"ACATTTGTCTAGTTTATCT","CCTGTCACTTTAACTGTTGA","561307.5.peg.678","2108"
"29917",393,555,162,"TCAGTTAGTACCGACATAAC","CCTGTCACTTTAACTGTTGA","561307.5.peg.678","2108"
"29918",435,555,120,"TCTGTCATCACTGTAGCAAC","CCTGTCACTTTAACTGTTGA","561307.5.peg.678","2108"
"29919",590,267,323,"GTCGTCCTAATACTAAGCCA","ACCACTTGTGTTACGTTAGC","561307.5.peg.679","2109"
"29920",590,294,296,"GTCGTCCTAATACTAAGCCA","CTAGCTACTCTTAATGTGTC","561307.5.peg.679","2109"
"29921",590,345,245,"GTCGTCCTAATACTAAGCCA","AATGTCACTAACTGATGACT","561307.5.peg.679","2109"
"29922",267,590,323,"ACCACTTGTGTTACGTTAGC","GTCGTCCTAATACTAAGCCA","561307.5.peg.679","2109"
"29923",294,590,296,"CTAGCTACTCTTAATGTGTC","GTCGTCCTAATACTAAGCCA","561307.5.peg.679","2109"
"29924",345,590,245,"AATGTCACTAACTGATGACT","GTCGTCCTAATACTAAGCCA","561307.5.peg.679","2109"
"29925",279,96,183,"TCAGGAATTGAAGTGTCTAC","TGTCTAACAGCAATGCTTTG","561307.5.peg.68","2110"
"29926",253,96,157,"ATATCCACATCCTGCTTTAA","TGTCTAACAGCAATGCTTTG","561307.5.peg.68","2110"
"29927",639,96,543,"GTACCGCCTGATGCTAAACA","TGTCTAACAGCAATGCTTTG","561307.5.peg.68","2110"
"29928",729,96,633,"GTTGATACCCAAATGTTAAT","TGTCTAACAGCAATGCTTTG","561307.5.peg.68","2110"
"29929",225,96,129,"TCATCCCAACAATCATATA","TGTCTAACAGCAATGCTTTG","561307.5.peg.68","2110"
"29930",729,225,504,"GTTGATACCCAAATGTTAAT","TCATCCCAACAATCATATA","561307.5.peg.68","2110"
"29931",96,225,129,"TGTCTAACAGCAATGCTTTG","TCATCCCAACAATCATATA","561307.5.peg.68","2110"
"29932",639,225,414,"GTACCGCCTGATGCTAAACA","TCATCCCAACAATCATATA","561307.5.peg.68","2110"
"29933",96,253,157,"TGTCTAACAGCAATGCTTTG","ATATCCACATCCTGCTTTAA","561307.5.peg.68","2110"
"29934",729,253,476,"GTTGATACCCAAATGTTAAT","ATATCCACATCCTGCTTTAA","561307.5.peg.68","2110"
"29935",639,253,386,"GTACCGCCTGATGCTAAACA","ATATCCACATCCTGCTTTAA","561307.5.peg.68","2110"
"29936",639,279,360,"GTACCGCCTGATGCTAAACA","TCAGGAATTGAAGTGTCTAC","561307.5.peg.68","2110"
"29937",96,279,183,"TGTCTAACAGCAATGCTTTG","TCAGGAATTGAAGTGTCTAC","561307.5.peg.68","2110"
"29938",729,279,450,"GTTGATACCCAAATGTTAAT","TCAGGAATTGAAGTGTCTAC","561307.5.peg.68","2110"
"29939",96,639,543,"TGTCTAACAGCAATGCTTTG","GTACCGCCTGATGCTAAACA","561307.5.peg.68","2110"
"29940",253,639,386,"ATATCCACATCCTGCTTTAA","GTACCGCCTGATGCTAAACA","561307.5.peg.68","2110"
"29941",225,639,414,"TCATCCCAACAATCATATA","GTACCGCCTGATGCTAAACA","561307.5.peg.68","2110"
"29942",279,639,360,"TCAGGAATTGAAGTGTCTAC","GTACCGCCTGATGCTAAACA","561307.5.peg.68","2110"
"29943",225,729,504,"TCATCCCAACAATCATATA","GTTGATACCCAAATGTTAAT","561307.5.peg.68","2110"
"29944",96,729,633,"TGTCTAACAGCAATGCTTTG","GTTGATACCCAAATGTTAAT","561307.5.peg.68","2110"
"29945",253,729,476,"ATATCCACATCCTGCTTTAA","GTTGATACCCAAATGTTAAT","561307.5.peg.68","2110"
"29946",279,729,450,"TCAGGAATTGAAGTGTCTAC","GTTGATACCCAAATGTTAAT","561307.5.peg.68","2110"
"29947",476,30,446,"CAAATGGTTCTTTACCTACT","GCATCACAACTAACAGAT","561307.5.peg.681","2112"
"29948",542,30,512,"TACCAATTGGCCAATTCATA","GCATCACAACTAACAGAT","561307.5.peg.681","2112"
"29949",555,30,525,"AAACTTTGTCCCATACCAAT","GCATCACAACTAACAGAT","561307.5.peg.681","2112"
"29950",30,476,446,"GCATCACAACTAACAGAT","CAAATGGTTCTTTACCTACT","561307.5.peg.681","2112"
"29951",30,542,512,"GCATCACAACTAACAGAT","TACCAATTGGCCAATTCATA","561307.5.peg.681","2112"
"29952",30,555,525,"GCATCACAACTAACAGAT","AAACTTTGTCCCATACCAAT","561307.5.peg.681","2112"
"29953",552,92,460,"GTCTCTTTATCATGTTCTGA","AGAATTCACGACGCTTACGT","561307.5.peg.683","2114"
"29954",817,92,725,"TTCGCTATCACCATATGTAT","AGAATTCACGACGCTTACGT","561307.5.peg.683","2114"
"29955",885,92,793,"CTTTATCATCACTTATCGA","AGAATTCACGACGCTTACGT","561307.5.peg.683","2114"
"29956",552,116,436,"GTCTCTTTATCATGTTCTGA","TTTCTTCTCTGTCTTCGTTG","561307.5.peg.683","2114"
"29957",885,116,769,"CTTTATCATCACTTATCGA","TTTCTTCTCTGTCTTCGTTG","561307.5.peg.683","2114"
"29958",817,116,701,"TTCGCTATCACCATATGTAT","TTTCTTCTCTGTCTTCGTTG","561307.5.peg.683","2114"
"29959",92,552,460,"AGAATTCACGACGCTTACGT","GTCTCTTTATCATGTTCTGA","561307.5.peg.683","2114"
"29960",116,552,436,"TTTCTTCTCTGTCTTCGTTG","GTCTCTTTATCATGTTCTGA","561307.5.peg.683","2114"
"29961",817,552,265,"TTCGCTATCACCATATGTAT","GTCTCTTTATCATGTTCTGA","561307.5.peg.683","2114"
"29962",885,552,333,"CTTTATCATCACTTATCGA","GTCTCTTTATCATGTTCTGA","561307.5.peg.683","2114"
"29963",92,817,725,"AGAATTCACGACGCTTACGT","TTCGCTATCACCATATGTAT","561307.5.peg.683","2114"
"29964",116,817,701,"TTTCTTCTCTGTCTTCGTTG","TTCGCTATCACCATATGTAT","561307.5.peg.683","2114"
"29965",552,817,265,"GTCTCTTTATCATGTTCTGA","TTCGCTATCACCATATGTAT","561307.5.peg.683","2114"
"29966",92,885,793,"AGAATTCACGACGCTTACGT","CTTTATCATCACTTATCGA","561307.5.peg.683","2114"
"29967",552,885,333,"GTCTCTTTATCATGTTCTGA","CTTTATCATCACTTATCGA","561307.5.peg.683","2114"
"29968",116,885,769,"TTTCTTCTCTGTCTTCGTTG","CTTTATCATCACTTATCGA","561307.5.peg.683","2114"
"29969",214,86,128,"CAATCCAGTAACACTAATTC","ACAATACAATACCTTGTTGA","561307.5.peg.684","2115"
"29970",208,86,122,"AGTAACACTAATTCCGGATA","ACAATACAATACCTTGTTGA","561307.5.peg.684","2115"
"29971",565,86,479,"ATCTAATCCACCATTGGTAG","ACAATACAATACCTTGTTGA","561307.5.peg.684","2115"
"29972",240,86,154,"TAGGTATCGACAATACTTAT","ACAATACAATACCTTGTTGA","561307.5.peg.684","2115"
"29973",571,86,485,"GTAATATCTAATCCACCAT","ACAATACAATACCTTGTTGA","561307.5.peg.684","2115"
"29974",565,153,412,"ATCTAATCCACCATTGGTAG","ACACCTGGTTTATGAACATA","561307.5.peg.684","2115"
"29975",571,153,418,"GTAATATCTAATCCACCAT","ACACCTGGTTTATGAACATA","561307.5.peg.684","2115"
"29976",565,168,397,"ATCTAATCCACCATTGGTAG","ATTGGATTTACTTCTACACC","561307.5.peg.684","2115"
"29977",571,168,403,"GTAATATCTAATCCACCAT","ATTGGATTTACTTCTACACC","561307.5.peg.684","2115"
"29978",86,208,122,"ACAATACAATACCTTGTTGA","AGTAACACTAATTCCGGATA","561307.5.peg.684","2115"
"29979",571,208,363,"GTAATATCTAATCCACCAT","AGTAACACTAATTCCGGATA","561307.5.peg.684","2115"
"29980",565,208,357,"ATCTAATCCACCATTGGTAG","AGTAACACTAATTCCGGATA","561307.5.peg.684","2115"
"29981",86,214,128,"ACAATACAATACCTTGTTGA","CAATCCAGTAACACTAATTC","561307.5.peg.684","2115"
"29982",565,214,351,"ATCTAATCCACCATTGGTAG","CAATCCAGTAACACTAATTC","561307.5.peg.684","2115"
"29983",571,214,357,"GTAATATCTAATCCACCAT","CAATCCAGTAACACTAATTC","561307.5.peg.684","2115"
"29984",86,240,154,"ACAATACAATACCTTGTTGA","TAGGTATCGACAATACTTAT","561307.5.peg.684","2115"
"29985",571,240,331,"GTAATATCTAATCCACCAT","TAGGTATCGACAATACTTAT","561307.5.peg.684","2115"
"29986",565,240,325,"ATCTAATCCACCATTGGTAG","TAGGTATCGACAATACTTAT","561307.5.peg.684","2115"
"29987",86,565,479,"ACAATACAATACCTTGTTGA","ATCTAATCCACCATTGGTAG","561307.5.peg.684","2115"
"29988",208,565,357,"AGTAACACTAATTCCGGATA","ATCTAATCCACCATTGGTAG","561307.5.peg.684","2115"
"29989",168,565,397,"ATTGGATTTACTTCTACACC","ATCTAATCCACCATTGGTAG","561307.5.peg.684","2115"
"29990",153,565,412,"ACACCTGGTTTATGAACATA","ATCTAATCCACCATTGGTAG","561307.5.peg.684","2115"
"29991",214,565,351,"CAATCCAGTAACACTAATTC","ATCTAATCCACCATTGGTAG","561307.5.peg.684","2115"
"29992",240,565,325,"TAGGTATCGACAATACTTAT","ATCTAATCCACCATTGGTAG","561307.5.peg.684","2115"
"29993",86,571,485,"ACAATACAATACCTTGTTGA","GTAATATCTAATCCACCAT","561307.5.peg.684","2115"
"29994",214,571,357,"CAATCCAGTAACACTAATTC","GTAATATCTAATCCACCAT","561307.5.peg.684","2115"
"29995",153,571,418,"ACACCTGGTTTATGAACATA","GTAATATCTAATCCACCAT","561307.5.peg.684","2115"
"29996",168,571,403,"ATTGGATTTACTTCTACACC","GTAATATCTAATCCACCAT","561307.5.peg.684","2115"
"29997",240,571,331,"TAGGTATCGACAATACTTAT","GTAATATCTAATCCACCAT","561307.5.peg.684","2115"
"29998",208,571,363,"AGTAACACTAATTCCGGATA","GTAATATCTAATCCACCAT","561307.5.peg.684","2115"
"29999",324,10,314,"AACCAAACTTGAATTCACT","GGTAAACTAGTAACAATGAG","561307.5.peg.685","2116"
"30000",590,10,580,"AATCTGGCTCTTCAACTTCA","GGTAAACTAGTAACAATGAG","561307.5.peg.685","2116"
"30001",384,10,374,"CAATATTTGCTGATAACCA","GGTAAACTAGTAACAATGAG","561307.5.peg.685","2116"
"30002",10,324,314,"GGTAAACTAGTAACAATGAG","AACCAAACTTGAATTCACT","561307.5.peg.685","2116"
"30003",590,324,266,"AATCTGGCTCTTCAACTTCA","AACCAAACTTGAATTCACT","561307.5.peg.685","2116"
"30004",10,384,374,"GGTAAACTAGTAACAATGAG","CAATATTTGCTGATAACCA","561307.5.peg.685","2116"
"30005",590,384,206,"AATCTGGCTCTTCAACTTCA","CAATATTTGCTGATAACCA","561307.5.peg.685","2116"
"30006",384,590,206,"CAATATTTGCTGATAACCA","AATCTGGCTCTTCAACTTCA","561307.5.peg.685","2116"
"30007",324,590,266,"AACCAAACTTGAATTCACT","AATCTGGCTCTTCAACTTCA","561307.5.peg.685","2116"
"30008",10,590,580,"GGTAAACTAGTAACAATGAG","AATCTGGCTCTTCAACTTCA","561307.5.peg.685","2116"
"30009",254,102,152,"TACTAGAAATGCCAGTAATG","TGATCGTCATCATCAAATGC","561307.5.peg.686","2117"
"30010",102,254,152,"TGATCGTCATCATCAAATGC","TACTAGAAATGCCAGTAATG","561307.5.peg.686","2117"
"30011",514,161,353,"CATTTGTTTAATGACACCAA","TCCAGTCAGTTACCGCTATA","561307.5.peg.691","2123"
"30012",161,514,353,"TCCAGTCAGTTACCGCTATA","CATTTGTTTAATGACACCAA","561307.5.peg.691","2123"
"30013",354,8,346,"TACTTATCACTTCCATATT","TTCTACTAAAGTTGTTTGG","561307.5.peg.698","2130"
"30014",348,8,340,"ATCACTTCCATATTCGGTTG","TTCTACTAAAGTTGTTTGG","561307.5.peg.698","2130"
"30015",258,8,250,"CCATCATCTGCAATACCAAC","TTCTACTAAAGTTGTTTGG","561307.5.peg.698","2130"
"30016",450,8,442,"CCGCTAACTAACATGATTGT","TTCTACTAAAGTTGTTTGG","561307.5.peg.698","2130"
"30017",384,8,376,"ACATCTGCAATGATCAAATC","TTCTACTAAAGTTGTTTGG","561307.5.peg.698","2130"
"30018",8,258,250,"TTCTACTAAAGTTGTTTGG","CCATCATCTGCAATACCAAC","561307.5.peg.698","2130"
"30019",450,258,192,"CCGCTAACTAACATGATTGT","CCATCATCTGCAATACCAAC","561307.5.peg.698","2130"
"30020",384,258,126,"ACATCTGCAATGATCAAATC","CCATCATCTGCAATACCAAC","561307.5.peg.698","2130"
"30021",8,348,340,"TTCTACTAAAGTTGTTTGG","ATCACTTCCATATTCGGTTG","561307.5.peg.698","2130"
"30022",450,348,102,"CCGCTAACTAACATGATTGT","ATCACTTCCATATTCGGTTG","561307.5.peg.698","2130"
"30023",8,354,346,"TTCTACTAAAGTTGTTTGG","TACTTATCACTTCCATATT","561307.5.peg.698","2130"
"30024",8,384,376,"TTCTACTAAAGTTGTTTGG","ACATCTGCAATGATCAAATC","561307.5.peg.698","2130"
"30025",258,384,126,"CCATCATCTGCAATACCAAC","ACATCTGCAATGATCAAATC","561307.5.peg.698","2130"
"30026",8,450,442,"TTCTACTAAAGTTGTTTGG","CCGCTAACTAACATGATTGT","561307.5.peg.698","2130"
"30027",258,450,192,"CCATCATCTGCAATACCAAC","CCGCTAACTAACATGATTGT","561307.5.peg.698","2130"
"30028",348,450,102,"ATCACTTCCATATTCGGTTG","CCGCTAACTAACATGATTGT","561307.5.peg.698","2130"
"30029",234,9,225,"ACCCATCTAATGTATTGATG","GTTTCTACGTAGATAAAGT","561307.5.peg.7","2132"
"30030",9,234,225,"GTTTCTACGTAGATAAAGT","ACCCATCTAATGTATTGATG","561307.5.peg.7","2132"
"30031",322,203,119,"GCTCATACCGTTGCGAACAA","CTAGTAACATGGCAATGAAT","561307.5.peg.702","2136"
"30032",344,203,141,"CTAATCGTAGCACAAGCTCT","CTAGTAACATGGCAATGAAT","561307.5.peg.702","2136"
"30033",485,203,282,"GCGTCCATGAAATAGGGAAA","CTAGTAACATGGCAATGAAT","561307.5.peg.702","2136"
"30034",438,203,235,"GCCATACATACTAATCCAAC","CTAGTAACATGGCAATGAAT","561307.5.peg.702","2136"
"30035",491,203,288,"CGAAAGGCGTCCATGAAATA","CTAGTAACATGGCAATGAAT","561307.5.peg.702","2136"
"30036",491,287,204,"CGAAAGGCGTCCATGAAATA","CTACAGATTCATGATCATCG","561307.5.peg.702","2136"
"30037",485,287,198,"GCGTCCATGAAATAGGGAAA","CTACAGATTCATGATCATCG","561307.5.peg.702","2136"
"30038",438,287,151,"GCCATACATACTAATCCAAC","CTACAGATTCATGATCATCG","561307.5.peg.702","2136"
"30039",485,322,163,"GCGTCCATGAAATAGGGAAA","GCTCATACCGTTGCGAACAA","561307.5.peg.702","2136"
"30040",203,322,119,"CTAGTAACATGGCAATGAAT","GCTCATACCGTTGCGAACAA","561307.5.peg.702","2136"
"30041",491,322,169,"CGAAAGGCGTCCATGAAATA","GCTCATACCGTTGCGAACAA","561307.5.peg.702","2136"
"30042",438,322,116,"GCCATACATACTAATCCAAC","GCTCATACCGTTGCGAACAA","561307.5.peg.702","2136"
"30043",203,344,141,"CTAGTAACATGGCAATGAAT","CTAATCGTAGCACAAGCTCT","561307.5.peg.702","2136"
"30044",485,344,141,"GCGTCCATGAAATAGGGAAA","CTAATCGTAGCACAAGCTCT","561307.5.peg.702","2136"
"30045",491,344,147,"CGAAAGGCGTCCATGAAATA","CTAATCGTAGCACAAGCTCT","561307.5.peg.702","2136"
"30046",203,438,235,"CTAGTAACATGGCAATGAAT","GCCATACATACTAATCCAAC","561307.5.peg.702","2136"
"30047",322,438,116,"GCTCATACCGTTGCGAACAA","GCCATACATACTAATCCAAC","561307.5.peg.702","2136"
"30048",287,438,151,"CTACAGATTCATGATCATCG","GCCATACATACTAATCCAAC","561307.5.peg.702","2136"
"30049",203,485,282,"CTAGTAACATGGCAATGAAT","GCGTCCATGAAATAGGGAAA","561307.5.peg.702","2136"
"30050",322,485,163,"GCTCATACCGTTGCGAACAA","GCGTCCATGAAATAGGGAAA","561307.5.peg.702","2136"
"30051",287,485,198,"CTACAGATTCATGATCATCG","GCGTCCATGAAATAGGGAAA","561307.5.peg.702","2136"
"30052",344,485,141,"CTAATCGTAGCACAAGCTCT","GCGTCCATGAAATAGGGAAA","561307.5.peg.702","2136"
"30053",203,491,288,"CTAGTAACATGGCAATGAAT","CGAAAGGCGTCCATGAAATA","561307.5.peg.702","2136"
"30054",287,491,204,"CTACAGATTCATGATCATCG","CGAAAGGCGTCCATGAAATA","561307.5.peg.702","2136"
"30055",344,491,147,"CTAATCGTAGCACAAGCTCT","CGAAAGGCGTCCATGAAATA","561307.5.peg.702","2136"
"30056",322,491,169,"GCTCATACCGTTGCGAACAA","CGAAAGGCGTCCATGAAATA","561307.5.peg.702","2136"
"30057",183,14,169,"AGATGATGTTTCTCAGATTG","CATCTCACTGACAATGAGGC","561307.5.peg.703","2137"
"30058",14,183,169,"CATCTCACTGACAATGAGGC","AGATGATGTTTCTCAGATTG","561307.5.peg.703","2137"
"30059",211,7,204,"AAACGCTGCACTTCGCTCAT","TCATCATAGGTGTGAACTTA","561307.5.peg.704","2138"
"30060",819,7,812,"CATATGTACAGATAACATT","TCATCATAGGTGTGAACTTA","561307.5.peg.704","2138"
"30061",570,7,563,"GGTGTTAACGGATCTCTAAA","TCATCATAGGTGTGAACTTA","561307.5.peg.704","2138"
"30062",267,7,260,"GACGTACATAATATAGCGAC","TCATCATAGGTGTGAACTTA","561307.5.peg.704","2138"
"30063",591,7,584,"ATTCTGTTGCATTCAAATC","TCATCATAGGTGTGAACTTA","561307.5.peg.704","2138"
"30064",159,7,152,"GCTTCAAATGCAAGTGCAAG","TCATCATAGGTGTGAACTTA","561307.5.peg.704","2138"
"30065",375,7,368,"CCTACACTTCTTAATTCATG","TCATCATAGGTGTGAACTTA","561307.5.peg.704","2138"
"30066",141,7,134,"AGTGGCGTTGAGCGTGATCC","TCATCATAGGTGTGAACTTA","561307.5.peg.704","2138"
"30067",462,7,455,"TCTTTACTATCATCCGCAAT","TCATCATAGGTGTGAACTTA","561307.5.peg.704","2138"
"30068",582,7,575,"GCATTCAAATCAGGTGTTAA","TCATCATAGGTGTGAACTTA","561307.5.peg.704","2138"
"30069",371,7,364,"CACTTCTTAATTCATGCGGA","TCATCATAGGTGTGAACTTA","561307.5.peg.704","2138"
"30070",540,7,533,"AAATGAATTGGCCCTTTATG","TCATCATAGGTGTGAACTTA","561307.5.peg.704","2138"
"30071",209,7,202,"ACGCTGCACTTCGCTCATCG","TCATCATAGGTGTGAACTTA","561307.5.peg.704","2138"
"30072",540,12,528,"AAATGAATTGGCCCTTTATG","ACACCTATGATGAATGCATT","561307.5.peg.704","2138"
"30073",141,12,129,"AGTGGCGTTGAGCGTGATCC","ACACCTATGATGAATGCATT","561307.5.peg.704","2138"
"30074",211,12,199,"AAACGCTGCACTTCGCTCAT","ACACCTATGATGAATGCATT","561307.5.peg.704","2138"
"30075",819,12,807,"CATATGTACAGATAACATT","ACACCTATGATGAATGCATT","561307.5.peg.704","2138"
"30076",159,12,147,"GCTTCAAATGCAAGTGCAAG","ACACCTATGATGAATGCATT","561307.5.peg.704","2138"
"30077",582,12,570,"GCATTCAAATCAGGTGTTAA","ACACCTATGATGAATGCATT","561307.5.peg.704","2138"
"30078",371,12,359,"CACTTCTTAATTCATGCGGA","ACACCTATGATGAATGCATT","561307.5.peg.704","2138"
"30079",375,12,363,"CCTACACTTCTTAATTCATG","ACACCTATGATGAATGCATT","561307.5.peg.704","2138"
"30080",209,12,197,"ACGCTGCACTTCGCTCATCG","ACACCTATGATGAATGCATT","561307.5.peg.704","2138"
"30081",591,12,579,"ATTCTGTTGCATTCAAATC","ACACCTATGATGAATGCATT","561307.5.peg.704","2138"
"30082",462,12,450,"TCTTTACTATCATCCGCAAT","ACACCTATGATGAATGCATT","561307.5.peg.704","2138"
"30083",570,12,558,"GGTGTTAACGGATCTCTAAA","ACACCTATGATGAATGCATT","561307.5.peg.704","2138"
"30084",267,12,255,"GACGTACATAATATAGCGAC","ACACCTATGATGAATGCATT","561307.5.peg.704","2138"
"30085",462,20,442,"TCTTTACTATCATCCGCAAT","ACTCCTAATGCATTCATCAT","561307.5.peg.704","2138"
"30086",570,20,550,"GGTGTTAACGGATCTCTAAA","ACTCCTAATGCATTCATCAT","561307.5.peg.704","2138"
"30087",141,20,121,"AGTGGCGTTGAGCGTGATCC","ACTCCTAATGCATTCATCAT","561307.5.peg.704","2138"
"30088",591,20,571,"ATTCTGTTGCATTCAAATC","ACTCCTAATGCATTCATCAT","561307.5.peg.704","2138"
"30089",540,20,520,"AAATGAATTGGCCCTTTATG","ACTCCTAATGCATTCATCAT","561307.5.peg.704","2138"
"30090",371,20,351,"CACTTCTTAATTCATGCGGA","ACTCCTAATGCATTCATCAT","561307.5.peg.704","2138"
"30091",211,20,191,"AAACGCTGCACTTCGCTCAT","ACTCCTAATGCATTCATCAT","561307.5.peg.704","2138"
"30092",159,20,139,"GCTTCAAATGCAAGTGCAAG","ACTCCTAATGCATTCATCAT","561307.5.peg.704","2138"
"30093",209,20,189,"ACGCTGCACTTCGCTCATCG","ACTCCTAATGCATTCATCAT","561307.5.peg.704","2138"
"30094",819,20,799,"CATATGTACAGATAACATT","ACTCCTAATGCATTCATCAT","561307.5.peg.704","2138"
"30095",375,20,355,"CCTACACTTCTTAATTCATG","ACTCCTAATGCATTCATCAT","561307.5.peg.704","2138"
"30096",582,20,562,"GCATTCAAATCAGGTGTTAA","ACTCCTAATGCATTCATCAT","561307.5.peg.704","2138"
"30097",267,20,247,"GACGTACATAATATAGCGAC","ACTCCTAATGCATTCATCAT","561307.5.peg.704","2138"
"30098",462,141,321,"TCTTTACTATCATCCGCAAT","AGTGGCGTTGAGCGTGATCC","561307.5.peg.704","2138"
"30099",375,141,234,"CCTACACTTCTTAATTCATG","AGTGGCGTTGAGCGTGATCC","561307.5.peg.704","2138"
"30100",20,141,121,"ACTCCTAATGCATTCATCAT","AGTGGCGTTGAGCGTGATCC","561307.5.peg.704","2138"
"30101",819,141,678,"CATATGTACAGATAACATT","AGTGGCGTTGAGCGTGATCC","561307.5.peg.704","2138"
"30102",570,141,429,"GGTGTTAACGGATCTCTAAA","AGTGGCGTTGAGCGTGATCC","561307.5.peg.704","2138"
"30103",267,141,126,"GACGTACATAATATAGCGAC","AGTGGCGTTGAGCGTGATCC","561307.5.peg.704","2138"
"30104",591,141,450,"ATTCTGTTGCATTCAAATC","AGTGGCGTTGAGCGTGATCC","561307.5.peg.704","2138"
"30105",582,141,441,"GCATTCAAATCAGGTGTTAA","AGTGGCGTTGAGCGTGATCC","561307.5.peg.704","2138"
"30106",12,141,129,"ACACCTATGATGAATGCATT","AGTGGCGTTGAGCGTGATCC","561307.5.peg.704","2138"
"30107",7,141,134,"TCATCATAGGTGTGAACTTA","AGTGGCGTTGAGCGTGATCC","561307.5.peg.704","2138"
"30108",371,141,230,"CACTTCTTAATTCATGCGGA","AGTGGCGTTGAGCGTGATCC","561307.5.peg.704","2138"
"30109",540,141,399,"AAATGAATTGGCCCTTTATG","AGTGGCGTTGAGCGTGATCC","561307.5.peg.704","2138"
"30110",819,159,660,"CATATGTACAGATAACATT","GCTTCAAATGCAAGTGCAAG","561307.5.peg.704","2138"
"30111",20,159,139,"ACTCCTAATGCATTCATCAT","GCTTCAAATGCAAGTGCAAG","561307.5.peg.704","2138"
"30112",7,159,152,"TCATCATAGGTGTGAACTTA","GCTTCAAATGCAAGTGCAAG","561307.5.peg.704","2138"
"30113",12,159,147,"ACACCTATGATGAATGCATT","GCTTCAAATGCAAGTGCAAG","561307.5.peg.704","2138"
"30114",462,159,303,"TCTTTACTATCATCCGCAAT","GCTTCAAATGCAAGTGCAAG","561307.5.peg.704","2138"
"30115",570,159,411,"GGTGTTAACGGATCTCTAAA","GCTTCAAATGCAAGTGCAAG","561307.5.peg.704","2138"
"30116",267,159,108,"GACGTACATAATATAGCGAC","GCTTCAAATGCAAGTGCAAG","561307.5.peg.704","2138"
"30117",371,159,212,"CACTTCTTAATTCATGCGGA","GCTTCAAATGCAAGTGCAAG","561307.5.peg.704","2138"
"30118",375,159,216,"CCTACACTTCTTAATTCATG","GCTTCAAATGCAAGTGCAAG","561307.5.peg.704","2138"
"30119",540,159,381,"AAATGAATTGGCCCTTTATG","GCTTCAAATGCAAGTGCAAG","561307.5.peg.704","2138"
"30120",591,159,432,"ATTCTGTTGCATTCAAATC","GCTTCAAATGCAAGTGCAAG","561307.5.peg.704","2138"
"30121",582,159,423,"GCATTCAAATCAGGTGTTAA","GCTTCAAATGCAAGTGCAAG","561307.5.peg.704","2138"
"30122",375,209,166,"CCTACACTTCTTAATTCATG","ACGCTGCACTTCGCTCATCG","561307.5.peg.704","2138"
"30123",591,209,382,"ATTCTGTTGCATTCAAATC","ACGCTGCACTTCGCTCATCG","561307.5.peg.704","2138"
"30124",582,209,373,"GCATTCAAATCAGGTGTTAA","ACGCTGCACTTCGCTCATCG","561307.5.peg.704","2138"
"30125",462,209,253,"TCTTTACTATCATCCGCAAT","ACGCTGCACTTCGCTCATCG","561307.5.peg.704","2138"
"30126",20,209,189,"ACTCCTAATGCATTCATCAT","ACGCTGCACTTCGCTCATCG","561307.5.peg.704","2138"
"30127",819,209,610,"CATATGTACAGATAACATT","ACGCTGCACTTCGCTCATCG","561307.5.peg.704","2138"
"30128",371,209,162,"CACTTCTTAATTCATGCGGA","ACGCTGCACTTCGCTCATCG","561307.5.peg.704","2138"
"30129",540,209,331,"AAATGAATTGGCCCTTTATG","ACGCTGCACTTCGCTCATCG","561307.5.peg.704","2138"
"30130",570,209,361,"GGTGTTAACGGATCTCTAAA","ACGCTGCACTTCGCTCATCG","561307.5.peg.704","2138"
"30131",7,209,202,"TCATCATAGGTGTGAACTTA","ACGCTGCACTTCGCTCATCG","561307.5.peg.704","2138"
"30132",12,209,197,"ACACCTATGATGAATGCATT","ACGCTGCACTTCGCTCATCG","561307.5.peg.704","2138"
"30133",819,211,608,"CATATGTACAGATAACATT","AAACGCTGCACTTCGCTCAT","561307.5.peg.704","2138"
"30134",7,211,204,"TCATCATAGGTGTGAACTTA","AAACGCTGCACTTCGCTCAT","561307.5.peg.704","2138"
"30135",462,211,251,"TCTTTACTATCATCCGCAAT","AAACGCTGCACTTCGCTCAT","561307.5.peg.704","2138"
"30136",540,211,329,"AAATGAATTGGCCCTTTATG","AAACGCTGCACTTCGCTCAT","561307.5.peg.704","2138"
"30137",591,211,380,"ATTCTGTTGCATTCAAATC","AAACGCTGCACTTCGCTCAT","561307.5.peg.704","2138"
"30138",20,211,191,"ACTCCTAATGCATTCATCAT","AAACGCTGCACTTCGCTCAT","561307.5.peg.704","2138"
"30139",12,211,199,"ACACCTATGATGAATGCATT","AAACGCTGCACTTCGCTCAT","561307.5.peg.704","2138"
"30140",375,211,164,"CCTACACTTCTTAATTCATG","AAACGCTGCACTTCGCTCAT","561307.5.peg.704","2138"
"30141",582,211,371,"GCATTCAAATCAGGTGTTAA","AAACGCTGCACTTCGCTCAT","561307.5.peg.704","2138"
"30142",570,211,359,"GGTGTTAACGGATCTCTAAA","AAACGCTGCACTTCGCTCAT","561307.5.peg.704","2138"
"30143",371,211,160,"CACTTCTTAATTCATGCGGA","AAACGCTGCACTTCGCTCAT","561307.5.peg.704","2138"
"30144",819,267,552,"CATATGTACAGATAACATT","GACGTACATAATATAGCGAC","561307.5.peg.704","2138"
"30145",375,267,108,"CCTACACTTCTTAATTCATG","GACGTACATAATATAGCGAC","561307.5.peg.704","2138"
"30146",462,267,195,"TCTTTACTATCATCCGCAAT","GACGTACATAATATAGCGAC","561307.5.peg.704","2138"
"30147",12,267,255,"ACACCTATGATGAATGCATT","GACGTACATAATATAGCGAC","561307.5.peg.704","2138"
"30148",141,267,126,"AGTGGCGTTGAGCGTGATCC","GACGTACATAATATAGCGAC","561307.5.peg.704","2138"
"30149",591,267,324,"ATTCTGTTGCATTCAAATC","GACGTACATAATATAGCGAC","561307.5.peg.704","2138"
"30150",570,267,303,"GGTGTTAACGGATCTCTAAA","GACGTACATAATATAGCGAC","561307.5.peg.704","2138"
"30151",540,267,273,"AAATGAATTGGCCCTTTATG","GACGTACATAATATAGCGAC","561307.5.peg.704","2138"
"30152",7,267,260,"TCATCATAGGTGTGAACTTA","GACGTACATAATATAGCGAC","561307.5.peg.704","2138"
"30153",159,267,108,"GCTTCAAATGCAAGTGCAAG","GACGTACATAATATAGCGAC","561307.5.peg.704","2138"
"30154",371,267,104,"CACTTCTTAATTCATGCGGA","GACGTACATAATATAGCGAC","561307.5.peg.704","2138"
"30155",582,267,315,"GCATTCAAATCAGGTGTTAA","GACGTACATAATATAGCGAC","561307.5.peg.704","2138"
"30156",20,267,247,"ACTCCTAATGCATTCATCAT","GACGTACATAATATAGCGAC","561307.5.peg.704","2138"
"30157",209,371,162,"ACGCTGCACTTCGCTCATCG","CACTTCTTAATTCATGCGGA","561307.5.peg.704","2138"
"30158",211,371,160,"AAACGCTGCACTTCGCTCAT","CACTTCTTAATTCATGCGGA","561307.5.peg.704","2138"
"30159",591,371,220,"ATTCTGTTGCATTCAAATC","CACTTCTTAATTCATGCGGA","561307.5.peg.704","2138"
"30160",582,371,211,"GCATTCAAATCAGGTGTTAA","CACTTCTTAATTCATGCGGA","561307.5.peg.704","2138"
"30161",267,371,104,"GACGTACATAATATAGCGAC","CACTTCTTAATTCATGCGGA","561307.5.peg.704","2138"
"30162",570,371,199,"GGTGTTAACGGATCTCTAAA","CACTTCTTAATTCATGCGGA","561307.5.peg.704","2138"
"30163",12,371,359,"ACACCTATGATGAATGCATT","CACTTCTTAATTCATGCGGA","561307.5.peg.704","2138"
"30164",159,371,212,"GCTTCAAATGCAAGTGCAAG","CACTTCTTAATTCATGCGGA","561307.5.peg.704","2138"
"30165",141,371,230,"AGTGGCGTTGAGCGTGATCC","CACTTCTTAATTCATGCGGA","561307.5.peg.704","2138"
"30166",20,371,351,"ACTCCTAATGCATTCATCAT","CACTTCTTAATTCATGCGGA","561307.5.peg.704","2138"
"30167",7,371,364,"TCATCATAGGTGTGAACTTA","CACTTCTTAATTCATGCGGA","561307.5.peg.704","2138"
"30168",819,371,448,"CATATGTACAGATAACATT","CACTTCTTAATTCATGCGGA","561307.5.peg.704","2138"
"30169",540,371,169,"AAATGAATTGGCCCTTTATG","CACTTCTTAATTCATGCGGA","561307.5.peg.704","2138"
"30170",540,375,165,"AAATGAATTGGCCCTTTATG","CCTACACTTCTTAATTCATG","561307.5.peg.704","2138"
"30171",20,375,355,"ACTCCTAATGCATTCATCAT","CCTACACTTCTTAATTCATG","561307.5.peg.704","2138"
"30172",570,375,195,"GGTGTTAACGGATCTCTAAA","CCTACACTTCTTAATTCATG","561307.5.peg.704","2138"
"30173",582,375,207,"GCATTCAAATCAGGTGTTAA","CCTACACTTCTTAATTCATG","561307.5.peg.704","2138"
"30174",12,375,363,"ACACCTATGATGAATGCATT","CCTACACTTCTTAATTCATG","561307.5.peg.704","2138"
"30175",591,375,216,"ATTCTGTTGCATTCAAATC","CCTACACTTCTTAATTCATG","561307.5.peg.704","2138"
"30176",141,375,234,"AGTGGCGTTGAGCGTGATCC","CCTACACTTCTTAATTCATG","561307.5.peg.704","2138"
"30177",7,375,368,"TCATCATAGGTGTGAACTTA","CCTACACTTCTTAATTCATG","561307.5.peg.704","2138"
"30178",267,375,108,"GACGTACATAATATAGCGAC","CCTACACTTCTTAATTCATG","561307.5.peg.704","2138"
"30179",159,375,216,"GCTTCAAATGCAAGTGCAAG","CCTACACTTCTTAATTCATG","561307.5.peg.704","2138"
"30180",211,375,164,"AAACGCTGCACTTCGCTCAT","CCTACACTTCTTAATTCATG","561307.5.peg.704","2138"
"30181",209,375,166,"ACGCTGCACTTCGCTCATCG","CCTACACTTCTTAATTCATG","561307.5.peg.704","2138"
"30182",819,375,444,"CATATGTACAGATAACATT","CCTACACTTCTTAATTCATG","561307.5.peg.704","2138"
"30183",591,462,129,"ATTCTGTTGCATTCAAATC","TCTTTACTATCATCCGCAAT","561307.5.peg.704","2138"
"30184",141,462,321,"AGTGGCGTTGAGCGTGATCC","TCTTTACTATCATCCGCAAT","561307.5.peg.704","2138"
"30185",20,462,442,"ACTCCTAATGCATTCATCAT","TCTTTACTATCATCCGCAAT","561307.5.peg.704","2138"
"30186",12,462,450,"ACACCTATGATGAATGCATT","TCTTTACTATCATCCGCAAT","561307.5.peg.704","2138"
"30187",209,462,253,"ACGCTGCACTTCGCTCATCG","TCTTTACTATCATCCGCAAT","561307.5.peg.704","2138"
"30188",570,462,108,"GGTGTTAACGGATCTCTAAA","TCTTTACTATCATCCGCAAT","561307.5.peg.704","2138"
"30189",7,462,455,"TCATCATAGGTGTGAACTTA","TCTTTACTATCATCCGCAAT","561307.5.peg.704","2138"
"30190",159,462,303,"GCTTCAAATGCAAGTGCAAG","TCTTTACTATCATCCGCAAT","561307.5.peg.704","2138"
"30191",211,462,251,"AAACGCTGCACTTCGCTCAT","TCTTTACTATCATCCGCAAT","561307.5.peg.704","2138"
"30192",819,462,357,"CATATGTACAGATAACATT","TCTTTACTATCATCCGCAAT","561307.5.peg.704","2138"
"30193",582,462,120,"GCATTCAAATCAGGTGTTAA","TCTTTACTATCATCCGCAAT","561307.5.peg.704","2138"
"30194",267,462,195,"GACGTACATAATATAGCGAC","TCTTTACTATCATCCGCAAT","561307.5.peg.704","2138"
"30195",375,540,165,"CCTACACTTCTTAATTCATG","AAATGAATTGGCCCTTTATG","561307.5.peg.704","2138"
"30196",12,540,528,"ACACCTATGATGAATGCATT","AAATGAATTGGCCCTTTATG","561307.5.peg.704","2138"
"30197",159,540,381,"GCTTCAAATGCAAGTGCAAG","AAATGAATTGGCCCTTTATG","561307.5.peg.704","2138"
"30198",371,540,169,"CACTTCTTAATTCATGCGGA","AAATGAATTGGCCCTTTATG","561307.5.peg.704","2138"
"30199",20,540,520,"ACTCCTAATGCATTCATCAT","AAATGAATTGGCCCTTTATG","561307.5.peg.704","2138"
"30200",209,540,331,"ACGCTGCACTTCGCTCATCG","AAATGAATTGGCCCTTTATG","561307.5.peg.704","2138"
"30201",267,540,273,"GACGTACATAATATAGCGAC","AAATGAATTGGCCCTTTATG","561307.5.peg.704","2138"
"30202",211,540,329,"AAACGCTGCACTTCGCTCAT","AAATGAATTGGCCCTTTATG","561307.5.peg.704","2138"
"30203",819,540,279,"CATATGTACAGATAACATT","AAATGAATTGGCCCTTTATG","561307.5.peg.704","2138"
"30204",141,540,399,"AGTGGCGTTGAGCGTGATCC","AAATGAATTGGCCCTTTATG","561307.5.peg.704","2138"
"30205",7,540,533,"TCATCATAGGTGTGAACTTA","AAATGAATTGGCCCTTTATG","561307.5.peg.704","2138"
"30206",209,570,361,"ACGCTGCACTTCGCTCATCG","GGTGTTAACGGATCTCTAAA","561307.5.peg.704","2138"
"30207",819,570,249,"CATATGTACAGATAACATT","GGTGTTAACGGATCTCTAAA","561307.5.peg.704","2138"
"30208",159,570,411,"GCTTCAAATGCAAGTGCAAG","GGTGTTAACGGATCTCTAAA","561307.5.peg.704","2138"
"30209",371,570,199,"CACTTCTTAATTCATGCGGA","GGTGTTAACGGATCTCTAAA","561307.5.peg.704","2138"
"30210",211,570,359,"AAACGCTGCACTTCGCTCAT","GGTGTTAACGGATCTCTAAA","561307.5.peg.704","2138"
"30211",12,570,558,"ACACCTATGATGAATGCATT","GGTGTTAACGGATCTCTAAA","561307.5.peg.704","2138"
"30212",267,570,303,"GACGTACATAATATAGCGAC","GGTGTTAACGGATCTCTAAA","561307.5.peg.704","2138"
"30213",141,570,429,"AGTGGCGTTGAGCGTGATCC","GGTGTTAACGGATCTCTAAA","561307.5.peg.704","2138"
"30214",7,570,563,"TCATCATAGGTGTGAACTTA","GGTGTTAACGGATCTCTAAA","561307.5.peg.704","2138"
"30215",20,570,550,"ACTCCTAATGCATTCATCAT","GGTGTTAACGGATCTCTAAA","561307.5.peg.704","2138"
"30216",462,570,108,"TCTTTACTATCATCCGCAAT","GGTGTTAACGGATCTCTAAA","561307.5.peg.704","2138"
"30217",375,570,195,"CCTACACTTCTTAATTCATG","GGTGTTAACGGATCTCTAAA","561307.5.peg.704","2138"
"30218",462,582,120,"TCTTTACTATCATCCGCAAT","GCATTCAAATCAGGTGTTAA","561307.5.peg.704","2138"
"30219",375,582,207,"CCTACACTTCTTAATTCATG","GCATTCAAATCAGGTGTTAA","561307.5.peg.704","2138"
"30220",159,582,423,"GCTTCAAATGCAAGTGCAAG","GCATTCAAATCAGGTGTTAA","561307.5.peg.704","2138"
"30221",209,582,373,"ACGCTGCACTTCGCTCATCG","GCATTCAAATCAGGTGTTAA","561307.5.peg.704","2138"
"30222",211,582,371,"AAACGCTGCACTTCGCTCAT","GCATTCAAATCAGGTGTTAA","561307.5.peg.704","2138"
"30223",20,582,562,"ACTCCTAATGCATTCATCAT","GCATTCAAATCAGGTGTTAA","561307.5.peg.704","2138"
"30224",371,582,211,"CACTTCTTAATTCATGCGGA","GCATTCAAATCAGGTGTTAA","561307.5.peg.704","2138"
"30225",7,582,575,"TCATCATAGGTGTGAACTTA","GCATTCAAATCAGGTGTTAA","561307.5.peg.704","2138"
"30226",12,582,570,"ACACCTATGATGAATGCATT","GCATTCAAATCAGGTGTTAA","561307.5.peg.704","2138"
"30227",141,582,441,"AGTGGCGTTGAGCGTGATCC","GCATTCAAATCAGGTGTTAA","561307.5.peg.704","2138"
"30228",819,582,237,"CATATGTACAGATAACATT","GCATTCAAATCAGGTGTTAA","561307.5.peg.704","2138"
"30229",267,582,315,"GACGTACATAATATAGCGAC","GCATTCAAATCAGGTGTTAA","561307.5.peg.704","2138"
"30230",7,591,584,"TCATCATAGGTGTGAACTTA","ATTCTGTTGCATTCAAATC","561307.5.peg.704","2138"
"30231",211,591,380,"AAACGCTGCACTTCGCTCAT","ATTCTGTTGCATTCAAATC","561307.5.peg.704","2138"
"30232",375,591,216,"CCTACACTTCTTAATTCATG","ATTCTGTTGCATTCAAATC","561307.5.peg.704","2138"
"30233",819,591,228,"CATATGTACAGATAACATT","ATTCTGTTGCATTCAAATC","561307.5.peg.704","2138"
"30234",159,591,432,"GCTTCAAATGCAAGTGCAAG","ATTCTGTTGCATTCAAATC","561307.5.peg.704","2138"
"30235",267,591,324,"GACGTACATAATATAGCGAC","ATTCTGTTGCATTCAAATC","561307.5.peg.704","2138"
"30236",209,591,382,"ACGCTGCACTTCGCTCATCG","ATTCTGTTGCATTCAAATC","561307.5.peg.704","2138"
"30237",141,591,450,"AGTGGCGTTGAGCGTGATCC","ATTCTGTTGCATTCAAATC","561307.5.peg.704","2138"
"30238",20,591,571,"ACTCCTAATGCATTCATCAT","ATTCTGTTGCATTCAAATC","561307.5.peg.704","2138"
"30239",371,591,220,"CACTTCTTAATTCATGCGGA","ATTCTGTTGCATTCAAATC","561307.5.peg.704","2138"
"30240",462,591,129,"TCTTTACTATCATCCGCAAT","ATTCTGTTGCATTCAAATC","561307.5.peg.704","2138"
"30241",12,591,579,"ACACCTATGATGAATGCATT","ATTCTGTTGCATTCAAATC","561307.5.peg.704","2138"
"30242",540,819,279,"AAATGAATTGGCCCTTTATG","CATATGTACAGATAACATT","561307.5.peg.704","2138"
"30243",12,819,807,"ACACCTATGATGAATGCATT","CATATGTACAGATAACATT","561307.5.peg.704","2138"
"30244",209,819,610,"ACGCTGCACTTCGCTCATCG","CATATGTACAGATAACATT","561307.5.peg.704","2138"
"30245",211,819,608,"AAACGCTGCACTTCGCTCAT","CATATGTACAGATAACATT","561307.5.peg.704","2138"
"30246",375,819,444,"CCTACACTTCTTAATTCATG","CATATGTACAGATAACATT","561307.5.peg.704","2138"
"30247",591,819,228,"ATTCTGTTGCATTCAAATC","CATATGTACAGATAACATT","561307.5.peg.704","2138"
"30248",7,819,812,"TCATCATAGGTGTGAACTTA","CATATGTACAGATAACATT","561307.5.peg.704","2138"
"30249",141,819,678,"AGTGGCGTTGAGCGTGATCC","CATATGTACAGATAACATT","561307.5.peg.704","2138"
"30250",570,819,249,"GGTGTTAACGGATCTCTAAA","CATATGTACAGATAACATT","561307.5.peg.704","2138"
"30251",159,819,660,"GCTTCAAATGCAAGTGCAAG","CATATGTACAGATAACATT","561307.5.peg.704","2138"
"30252",582,819,237,"GCATTCAAATCAGGTGTTAA","CATATGTACAGATAACATT","561307.5.peg.704","2138"
"30253",267,819,552,"GACGTACATAATATAGCGAC","CATATGTACAGATAACATT","561307.5.peg.704","2138"
"30254",462,819,357,"TCTTTACTATCATCCGCAAT","CATATGTACAGATAACATT","561307.5.peg.704","2138"
"30255",20,819,799,"ACTCCTAATGCATTCATCAT","CATATGTACAGATAACATT","561307.5.peg.704","2138"
"30256",371,819,448,"CACTTCTTAATTCATGCGGA","CATATGTACAGATAACATT","561307.5.peg.704","2138"
"30257",278,140,138,"CACCATGTCCACGTTTCTTC","TAAACGCATTGCGTACTTCA","561307.5.peg.706","2140"
"30258",317,140,177,"ATACATTTAAGCGAGGGATT","TAAACGCATTGCGTACTTCA","561307.5.peg.706","2140"
"30259",323,140,183,"ATCTAATACATTTAAGCGA","TAAACGCATTGCGTACTTCA","561307.5.peg.706","2140"
"30260",140,278,138,"TAAACGCATTGCGTACTTCA","CACCATGTCCACGTTTCTTC","561307.5.peg.706","2140"
"30261",140,317,177,"TAAACGCATTGCGTACTTCA","ATACATTTAAGCGAGGGATT","561307.5.peg.706","2140"
"30262",140,323,183,"TAAACGCATTGCGTACTTCA","ATCTAATACATTTAAGCGA","561307.5.peg.706","2140"
"30263",452,228,224,"TGTCTTGGTTAATTGCAGAA","GCGTGTTCACGTTGTTCTAA","561307.5.peg.709","2143"
"30264",364,228,136,"ATCTTTACCTACAACTACAC","GCGTGTTCACGTTGTTCTAA","561307.5.peg.709","2143"
"30265",467,228,239,"CACCATTTGGATAATTGTCT","GCGTGTTCACGTTGTTCTAA","561307.5.peg.709","2143"
"30266",480,228,252,"TCAGCAGTGAAACCACCATT","GCGTGTTCACGTTGTTCTAA","561307.5.peg.709","2143"
"30267",467,281,186,"CACCATTTGGATAATTGTCT","CATTCGTTGTATCTGTGATT","561307.5.peg.709","2143"
"30268",452,281,171,"TGTCTTGGTTAATTGCAGAA","CATTCGTTGTATCTGTGATT","561307.5.peg.709","2143"
"30269",480,281,199,"TCAGCAGTGAAACCACCATT","CATTCGTTGTATCTGTGATT","561307.5.peg.709","2143"
"30270",480,315,165,"TCAGCAGTGAAACCACCATT","CAACTTGAATATAAGTTAC","561307.5.peg.709","2143"
"30271",467,315,152,"CACCATTTGGATAATTGTCT","CAACTTGAATATAAGTTAC","561307.5.peg.709","2143"
"30272",452,315,137,"TGTCTTGGTTAATTGCAGAA","CAACTTGAATATAAGTTAC","561307.5.peg.709","2143"
"30273",228,364,136,"GCGTGTTCACGTTGTTCTAA","ATCTTTACCTACAACTACAC","561307.5.peg.709","2143"
"30274",480,364,116,"TCAGCAGTGAAACCACCATT","ATCTTTACCTACAACTACAC","561307.5.peg.709","2143"
"30275",467,364,103,"CACCATTTGGATAATTGTCT","ATCTTTACCTACAACTACAC","561307.5.peg.709","2143"
"30276",228,452,224,"GCGTGTTCACGTTGTTCTAA","TGTCTTGGTTAATTGCAGAA","561307.5.peg.709","2143"
"30277",281,452,171,"CATTCGTTGTATCTGTGATT","TGTCTTGGTTAATTGCAGAA","561307.5.peg.709","2143"
"30278",315,452,137,"CAACTTGAATATAAGTTAC","TGTCTTGGTTAATTGCAGAA","561307.5.peg.709","2143"
"30279",228,467,239,"GCGTGTTCACGTTGTTCTAA","CACCATTTGGATAATTGTCT","561307.5.peg.709","2143"
"30280",315,467,152,"CAACTTGAATATAAGTTAC","CACCATTTGGATAATTGTCT","561307.5.peg.709","2143"
"30281",281,467,186,"CATTCGTTGTATCTGTGATT","CACCATTTGGATAATTGTCT","561307.5.peg.709","2143"
"30282",364,467,103,"ATCTTTACCTACAACTACAC","CACCATTTGGATAATTGTCT","561307.5.peg.709","2143"
"30283",315,480,165,"CAACTTGAATATAAGTTAC","TCAGCAGTGAAACCACCATT","561307.5.peg.709","2143"
"30284",281,480,199,"CATTCGTTGTATCTGTGATT","TCAGCAGTGAAACCACCATT","561307.5.peg.709","2143"
"30285",364,480,116,"ATCTTTACCTACAACTACAC","TCAGCAGTGAAACCACCATT","561307.5.peg.709","2143"
"30286",228,480,252,"GCGTGTTCACGTTGTTCTAA","TCAGCAGTGAAACCACCATT","561307.5.peg.709","2143"
"30287",355,246,109,"TTTAATGACAAGTCCCGCTT","GCTGACGTTACAACCTCTTC","561307.5.peg.71","2144"
"30288",246,355,109,"GCTGACGTTACAACCTCTTC","TTTAATGACAAGTCCCGCTT","561307.5.peg.71","2144"
"30289",408,158,250,"GGTATGTAGCCTGCATAAAT","CAGGCATCGGGAAGTCTGGT","561307.5.peg.710","2145"
"30290",402,158,244,"TAGCCTGCATAAATTGGTCC","CAGGCATCGGGAAGTCTGGT","561307.5.peg.710","2145"
"30291",555,158,397,"ACTACGCCAGTTGGATTAGT","CAGGCATCGGGAAGTCTGGT","561307.5.peg.710","2145"
"30292",429,158,271,"CCACCTAGTACTTCGATGAG","CAGGCATCGGGAAGTCTGGT","561307.5.peg.710","2145"
"30293",158,402,244,"CAGGCATCGGGAAGTCTGGT","TAGCCTGCATAAATTGGTCC","561307.5.peg.710","2145"
"30294",555,402,153,"ACTACGCCAGTTGGATTAGT","TAGCCTGCATAAATTGGTCC","561307.5.peg.710","2145"
"30295",158,408,250,"CAGGCATCGGGAAGTCTGGT","GGTATGTAGCCTGCATAAAT","561307.5.peg.710","2145"
"30296",555,408,147,"ACTACGCCAGTTGGATTAGT","GGTATGTAGCCTGCATAAAT","561307.5.peg.710","2145"
"30297",158,429,271,"CAGGCATCGGGAAGTCTGGT","CCACCTAGTACTTCGATGAG","561307.5.peg.710","2145"
"30298",555,429,126,"ACTACGCCAGTTGGATTAGT","CCACCTAGTACTTCGATGAG","561307.5.peg.710","2145"
"30299",158,555,397,"CAGGCATCGGGAAGTCTGGT","ACTACGCCAGTTGGATTAGT","561307.5.peg.710","2145"
"30300",402,555,153,"TAGCCTGCATAAATTGGTCC","ACTACGCCAGTTGGATTAGT","561307.5.peg.710","2145"
"30301",408,555,147,"GGTATGTAGCCTGCATAAAT","ACTACGCCAGTTGGATTAGT","561307.5.peg.710","2145"
"30302",429,555,126,"CCACCTAGTACTTCGATGAG","ACTACGCCAGTTGGATTAGT","561307.5.peg.710","2145"
"30303",138,10,128,"TATTTATCGCCACTAGTGTA","AAGAGTCTTATGGACATAA","561307.5.peg.711","2146"
"30304",10,138,128,"AAGAGTCTTATGGACATAA","TATTTATCGCCACTAGTGTA","561307.5.peg.711","2146"
"30305",546,177,369,"TGGATGACGATTTCCCCATT","TCGCATATGTGTATGAATA","561307.5.peg.715","2150"
"30306",177,546,369,"TCGCATATGTGTATGAATA","TGGATGACGATTTCCCCATT","561307.5.peg.715","2150"
"30307",276,147,129,"CAATACGACAACCAGTCAAA","GACAGAAATACACATTGCGC","561307.5.peg.716","2151"
"30308",756,147,609,"GCTACTACTGGGATTGACTC","GACAGAAATACACATTGCGC","561307.5.peg.716","2151"
"30309",767,147,620,"TGTGAAGCACAGCTACTACT","GACAGAAATACACATTGCGC","561307.5.peg.716","2151"
"30310",756,276,480,"GCTACTACTGGGATTGACTC","CAATACGACAACCAGTCAAA","561307.5.peg.716","2151"
"30311",147,276,129,"GACAGAAATACACATTGCGC","CAATACGACAACCAGTCAAA","561307.5.peg.716","2151"
"30312",767,276,491,"TGTGAAGCACAGCTACTACT","CAATACGACAACCAGTCAAA","561307.5.peg.716","2151"
"30313",147,756,609,"GACAGAAATACACATTGCGC","GCTACTACTGGGATTGACTC","561307.5.peg.716","2151"
"30314",276,756,480,"CAATACGACAACCAGTCAAA","GCTACTACTGGGATTGACTC","561307.5.peg.716","2151"
"30315",276,767,491,"CAATACGACAACCAGTCAAA","TGTGAAGCACAGCTACTACT","561307.5.peg.716","2151"
"30316",147,767,620,"GACAGAAATACACATTGCGC","TGTGAAGCACAGCTACTACT","561307.5.peg.716","2151"
"30317",462,7,455,"CTGCTTTAATATTTGTGGT","TCACTTTAAATCTTAACGG","561307.5.peg.717","2152"
"30318",129,7,122,"GTCATTTCGTTCTTAGTAGT","TCACTTTAAATCTTAACGG","561307.5.peg.717","2152"
"30319",236,7,229,"ATGTGCCAGCTGTTTGATAC","TCACTTTAAATCTTAACGG","561307.5.peg.717","2152"
"30320",221,7,214,"GATACTGGTCAACAAGTACA","TCACTTTAAATCTTAACGG","561307.5.peg.717","2152"
"30321",308,7,301,"TTCAACACTTTCGATTATA","TCACTTTAAATCTTAACGG","561307.5.peg.717","2152"
"30322",111,7,104,"GTAGGTTTCGTGCCTTCAAT","TCACTTTAAATCTTAACGG","561307.5.peg.717","2152"
"30323",308,103,205,"TTCAACACTTTCGATTATA","CGTGCCTTCAATAGGATCTA","561307.5.peg.717","2152"
"30324",236,103,133,"ATGTGCCAGCTGTTTGATAC","CGTGCCTTCAATAGGATCTA","561307.5.peg.717","2152"
"30325",221,103,118,"GATACTGGTCAACAAGTACA","CGTGCCTTCAATAGGATCTA","561307.5.peg.717","2152"
"30326",462,103,359,"CTGCTTTAATATTTGTGGT","CGTGCCTTCAATAGGATCTA","561307.5.peg.717","2152"
"30327",221,111,110,"GATACTGGTCAACAAGTACA","GTAGGTTTCGTGCCTTCAAT","561307.5.peg.717","2152"
"30328",308,111,197,"TTCAACACTTTCGATTATA","GTAGGTTTCGTGCCTTCAAT","561307.5.peg.717","2152"
"30329",7,111,104,"TCACTTTAAATCTTAACGG","GTAGGTTTCGTGCCTTCAAT","561307.5.peg.717","2152"
"30330",236,111,125,"ATGTGCCAGCTGTTTGATAC","GTAGGTTTCGTGCCTTCAAT","561307.5.peg.717","2152"
"30331",462,111,351,"CTGCTTTAATATTTGTGGT","GTAGGTTTCGTGCCTTCAAT","561307.5.peg.717","2152"
"30332",7,129,122,"TCACTTTAAATCTTAACGG","GTCATTTCGTTCTTAGTAGT","561307.5.peg.717","2152"
"30333",308,129,179,"TTCAACACTTTCGATTATA","GTCATTTCGTTCTTAGTAGT","561307.5.peg.717","2152"
"30334",462,129,333,"CTGCTTTAATATTTGTGGT","GTCATTTCGTTCTTAGTAGT","561307.5.peg.717","2152"
"30335",236,129,107,"ATGTGCCAGCTGTTTGATAC","GTCATTTCGTTCTTAGTAGT","561307.5.peg.717","2152"
"30336",103,221,118,"CGTGCCTTCAATAGGATCTA","GATACTGGTCAACAAGTACA","561307.5.peg.717","2152"
"30337",111,221,110,"GTAGGTTTCGTGCCTTCAAT","GATACTGGTCAACAAGTACA","561307.5.peg.717","2152"
"30338",462,221,241,"CTGCTTTAATATTTGTGGT","GATACTGGTCAACAAGTACA","561307.5.peg.717","2152"
"30339",7,221,214,"TCACTTTAAATCTTAACGG","GATACTGGTCAACAAGTACA","561307.5.peg.717","2152"
"30340",111,236,125,"GTAGGTTTCGTGCCTTCAAT","ATGTGCCAGCTGTTTGATAC","561307.5.peg.717","2152"
"30341",103,236,133,"CGTGCCTTCAATAGGATCTA","ATGTGCCAGCTGTTTGATAC","561307.5.peg.717","2152"
"30342",7,236,229,"TCACTTTAAATCTTAACGG","ATGTGCCAGCTGTTTGATAC","561307.5.peg.717","2152"
"30343",462,236,226,"CTGCTTTAATATTTGTGGT","ATGTGCCAGCTGTTTGATAC","561307.5.peg.717","2152"
"30344",129,236,107,"GTCATTTCGTTCTTAGTAGT","ATGTGCCAGCTGTTTGATAC","561307.5.peg.717","2152"
"30345",7,308,301,"TCACTTTAAATCTTAACGG","TTCAACACTTTCGATTATA","561307.5.peg.717","2152"
"30346",129,308,179,"GTCATTTCGTTCTTAGTAGT","TTCAACACTTTCGATTATA","561307.5.peg.717","2152"
"30347",111,308,197,"GTAGGTTTCGTGCCTTCAAT","TTCAACACTTTCGATTATA","561307.5.peg.717","2152"
"30348",103,308,205,"CGTGCCTTCAATAGGATCTA","TTCAACACTTTCGATTATA","561307.5.peg.717","2152"
"30349",462,308,154,"CTGCTTTAATATTTGTGGT","TTCAACACTTTCGATTATA","561307.5.peg.717","2152"
"30350",7,462,455,"TCACTTTAAATCTTAACGG","CTGCTTTAATATTTGTGGT","561307.5.peg.717","2152"
"30351",103,462,359,"CGTGCCTTCAATAGGATCTA","CTGCTTTAATATTTGTGGT","561307.5.peg.717","2152"
"30352",129,462,333,"GTCATTTCGTTCTTAGTAGT","CTGCTTTAATATTTGTGGT","561307.5.peg.717","2152"
"30353",111,462,351,"GTAGGTTTCGTGCCTTCAAT","CTGCTTTAATATTTGTGGT","561307.5.peg.717","2152"
"30354",236,462,226,"ATGTGCCAGCTGTTTGATAC","CTGCTTTAATATTTGTGGT","561307.5.peg.717","2152"
"30355",221,462,241,"GATACTGGTCAACAAGTACA","CTGCTTTAATATTTGTGGT","561307.5.peg.717","2152"
"30356",308,462,154,"TTCAACACTTTCGATTATA","CTGCTTTAATATTTGTGGT","561307.5.peg.717","2152"
"30357",204,11,193,"GATTCGCGTGTTGCAAATGG","GCGACCATTTAATTTATAG","561307.5.peg.718","2153"
"30358",231,11,220,"AGTTCACGCTCACGAATACT","GCGACCATTTAATTTATAG","561307.5.peg.718","2153"
"30359",172,11,161,"ATTTCTGCCCATTTGTCCTA","GCGACCATTTAATTTATAG","561307.5.peg.718","2153"
"30360",330,11,319,"TACCATCTATATGTTCATA","GCGACCATTTAATTTATAG","561307.5.peg.718","2153"
"30361",231,90,141,"AGTTCACGCTCACGAATACT","GATGAGAAGGTTTCATCATC","561307.5.peg.718","2153"
"30362",330,90,240,"TACCATCTATATGTTCATA","GATGAGAAGGTTTCATCATC","561307.5.peg.718","2153"
"30363",204,90,114,"GATTCGCGTGTTGCAAATGG","GATGAGAAGGTTTCATCATC","561307.5.peg.718","2153"
"30364",231,103,128,"AGTTCACGCTCACGAATACT","TAATGTGCCTGCAGATGAGA","561307.5.peg.718","2153"
"30365",204,103,101,"GATTCGCGTGTTGCAAATGG","TAATGTGCCTGCAGATGAGA","561307.5.peg.718","2153"
"30366",330,103,227,"TACCATCTATATGTTCATA","TAATGTGCCTGCAGATGAGA","561307.5.peg.718","2153"
"30367",11,172,161,"GCGACCATTTAATTTATAG","ATTTCTGCCCATTTGTCCTA","561307.5.peg.718","2153"
"30368",330,172,158,"TACCATCTATATGTTCATA","ATTTCTGCCCATTTGTCCTA","561307.5.peg.718","2153"
"30369",11,204,193,"GCGACCATTTAATTTATAG","GATTCGCGTGTTGCAAATGG","561307.5.peg.718","2153"
"30370",103,204,101,"TAATGTGCCTGCAGATGAGA","GATTCGCGTGTTGCAAATGG","561307.5.peg.718","2153"
"30371",90,204,114,"GATGAGAAGGTTTCATCATC","GATTCGCGTGTTGCAAATGG","561307.5.peg.718","2153"
"30372",330,204,126,"TACCATCTATATGTTCATA","GATTCGCGTGTTGCAAATGG","561307.5.peg.718","2153"
"30373",90,231,141,"GATGAGAAGGTTTCATCATC","AGTTCACGCTCACGAATACT","561307.5.peg.718","2153"
"30374",11,231,220,"GCGACCATTTAATTTATAG","AGTTCACGCTCACGAATACT","561307.5.peg.718","2153"
"30375",103,231,128,"TAATGTGCCTGCAGATGAGA","AGTTCACGCTCACGAATACT","561307.5.peg.718","2153"
"30376",103,330,227,"TAATGTGCCTGCAGATGAGA","TACCATCTATATGTTCATA","561307.5.peg.718","2153"
"30377",90,330,240,"GATGAGAAGGTTTCATCATC","TACCATCTATATGTTCATA","561307.5.peg.718","2153"
"30378",11,330,319,"GCGACCATTTAATTTATAG","TACCATCTATATGTTCATA","561307.5.peg.718","2153"
"30379",172,330,158,"ATTTCTGCCCATTTGTCCTA","TACCATCTATATGTTCATA","561307.5.peg.718","2153"
"30380",204,330,126,"GATTCGCGTGTTGCAAATGG","TACCATCTATATGTTCATA","561307.5.peg.718","2153"
"30381",270,2,268,"ACATCATTCGACTTAATCGC","CATTGTTTCGCAGCTTCTAC","561307.5.peg.722","2158"
"30382",2,270,268,"CATTGTTTCGCAGCTTCTAC","ACATCATTCGACTTAATCGC","561307.5.peg.722","2158"
"30383",367,106,261,"ATAGCTTGGCAATAATCCAA","ACCGATACCGGTTGCAACAA","561307.5.peg.724","2160"
"30384",638,106,532,"GGAATAAACCGAGTAAGAAT","ACCGATACCGGTTGCAACAA","561307.5.peg.724","2160"
"30385",490,106,384,"ACGCTTATCTGGAGATGATT","ACCGATACCGGTTGCAACAA","561307.5.peg.724","2160"
"30386",659,106,553,"ATATAAGCCGAATAATCCT","ACCGATACCGGTTGCAACAA","561307.5.peg.724","2160"
"30387",501,106,395,"AATGAGTTACGACGCTTATC","ACCGATACCGGTTGCAACAA","561307.5.peg.724","2160"
"30388",270,106,164,"CCAAATACGACACCACCAAT","ACCGATACCGGTTGCAACAA","561307.5.peg.724","2160"
"30389",638,118,520,"GGAATAAACCGAGTAAGAAT","TTCCATTGCATTACCGATAC","561307.5.peg.724","2160"
"30390",490,118,372,"ACGCTTATCTGGAGATGATT","TTCCATTGCATTACCGATAC","561307.5.peg.724","2160"
"30391",659,118,541,"ATATAAGCCGAATAATCCT","TTCCATTGCATTACCGATAC","561307.5.peg.724","2160"
"30392",501,118,383,"AATGAGTTACGACGCTTATC","TTCCATTGCATTACCGATAC","561307.5.peg.724","2160"
"30393",270,118,152,"CCAAATACGACACCACCAAT","TTCCATTGCATTACCGATAC","561307.5.peg.724","2160"
"30394",367,118,249,"ATAGCTTGGCAATAATCCAA","TTCCATTGCATTACCGATAC","561307.5.peg.724","2160"
"30395",638,201,437,"GGAATAAACCGAGTAAGAAT","CGAATGTCTGCATTCTCTAC","561307.5.peg.724","2160"
"30396",501,201,300,"AATGAGTTACGACGCTTATC","CGAATGTCTGCATTCTCTAC","561307.5.peg.724","2160"
"30397",367,201,166,"ATAGCTTGGCAATAATCCAA","CGAATGTCTGCATTCTCTAC","561307.5.peg.724","2160"
"30398",490,201,289,"ACGCTTATCTGGAGATGATT","CGAATGTCTGCATTCTCTAC","561307.5.peg.724","2160"
"30399",659,201,458,"ATATAAGCCGAATAATCCT","CGAATGTCTGCATTCTCTAC","561307.5.peg.724","2160"
"30400",490,270,220,"ACGCTTATCTGGAGATGATT","CCAAATACGACACCACCAAT","561307.5.peg.724","2160"
"30401",106,270,164,"ACCGATACCGGTTGCAACAA","CCAAATACGACACCACCAAT","561307.5.peg.724","2160"
"30402",659,270,389,"ATATAAGCCGAATAATCCT","CCAAATACGACACCACCAAT","561307.5.peg.724","2160"
"30403",501,270,231,"AATGAGTTACGACGCTTATC","CCAAATACGACACCACCAAT","561307.5.peg.724","2160"
"30404",118,270,152,"TTCCATTGCATTACCGATAC","CCAAATACGACACCACCAAT","561307.5.peg.724","2160"
"30405",638,270,368,"GGAATAAACCGAGTAAGAAT","CCAAATACGACACCACCAAT","561307.5.peg.724","2160"
"30406",201,367,166,"CGAATGTCTGCATTCTCTAC","ATAGCTTGGCAATAATCCAA","561307.5.peg.724","2160"
"30407",106,367,261,"ACCGATACCGGTTGCAACAA","ATAGCTTGGCAATAATCCAA","561307.5.peg.724","2160"
"30408",118,367,249,"TTCCATTGCATTACCGATAC","ATAGCTTGGCAATAATCCAA","561307.5.peg.724","2160"
"30409",638,367,271,"GGAATAAACCGAGTAAGAAT","ATAGCTTGGCAATAATCCAA","561307.5.peg.724","2160"
"30410",501,367,134,"AATGAGTTACGACGCTTATC","ATAGCTTGGCAATAATCCAA","561307.5.peg.724","2160"
"30411",490,367,123,"ACGCTTATCTGGAGATGATT","ATAGCTTGGCAATAATCCAA","561307.5.peg.724","2160"
"30412",659,367,292,"ATATAAGCCGAATAATCCT","ATAGCTTGGCAATAATCCAA","561307.5.peg.724","2160"
"30413",659,490,169,"ATATAAGCCGAATAATCCT","ACGCTTATCTGGAGATGATT","561307.5.peg.724","2160"
"30414",638,490,148,"GGAATAAACCGAGTAAGAAT","ACGCTTATCTGGAGATGATT","561307.5.peg.724","2160"
"30415",367,490,123,"ATAGCTTGGCAATAATCCAA","ACGCTTATCTGGAGATGATT","561307.5.peg.724","2160"
"30416",106,490,384,"ACCGATACCGGTTGCAACAA","ACGCTTATCTGGAGATGATT","561307.5.peg.724","2160"
"30417",118,490,372,"TTCCATTGCATTACCGATAC","ACGCTTATCTGGAGATGATT","561307.5.peg.724","2160"
"30418",270,490,220,"CCAAATACGACACCACCAAT","ACGCTTATCTGGAGATGATT","561307.5.peg.724","2160"
"30419",201,490,289,"CGAATGTCTGCATTCTCTAC","ACGCTTATCTGGAGATGATT","561307.5.peg.724","2160"
"30420",106,501,395,"ACCGATACCGGTTGCAACAA","AATGAGTTACGACGCTTATC","561307.5.peg.724","2160"
"30421",270,501,231,"CCAAATACGACACCACCAAT","AATGAGTTACGACGCTTATC","561307.5.peg.724","2160"
"30422",638,501,137,"GGAATAAACCGAGTAAGAAT","AATGAGTTACGACGCTTATC","561307.5.peg.724","2160"
"30423",201,501,300,"CGAATGTCTGCATTCTCTAC","AATGAGTTACGACGCTTATC","561307.5.peg.724","2160"
"30424",659,501,158,"ATATAAGCCGAATAATCCT","AATGAGTTACGACGCTTATC","561307.5.peg.724","2160"
"30425",367,501,134,"ATAGCTTGGCAATAATCCAA","AATGAGTTACGACGCTTATC","561307.5.peg.724","2160"
"30426",118,501,383,"TTCCATTGCATTACCGATAC","AATGAGTTACGACGCTTATC","561307.5.peg.724","2160"
"30427",201,638,437,"CGAATGTCTGCATTCTCTAC","GGAATAAACCGAGTAAGAAT","561307.5.peg.724","2160"
"30428",118,638,520,"TTCCATTGCATTACCGATAC","GGAATAAACCGAGTAAGAAT","561307.5.peg.724","2160"
"30429",490,638,148,"ACGCTTATCTGGAGATGATT","GGAATAAACCGAGTAAGAAT","561307.5.peg.724","2160"
"30430",270,638,368,"CCAAATACGACACCACCAAT","GGAATAAACCGAGTAAGAAT","561307.5.peg.724","2160"
"30431",106,638,532,"ACCGATACCGGTTGCAACAA","GGAATAAACCGAGTAAGAAT","561307.5.peg.724","2160"
"30432",501,638,137,"AATGAGTTACGACGCTTATC","GGAATAAACCGAGTAAGAAT","561307.5.peg.724","2160"
"30433",367,638,271,"ATAGCTTGGCAATAATCCAA","GGAATAAACCGAGTAAGAAT","561307.5.peg.724","2160"
"30434",106,659,553,"ACCGATACCGGTTGCAACAA","ATATAAGCCGAATAATCCT","561307.5.peg.724","2160"
"30435",270,659,389,"CCAAATACGACACCACCAAT","ATATAAGCCGAATAATCCT","561307.5.peg.724","2160"
"30436",201,659,458,"CGAATGTCTGCATTCTCTAC","ATATAAGCCGAATAATCCT","561307.5.peg.724","2160"
"30437",501,659,158,"AATGAGTTACGACGCTTATC","ATATAAGCCGAATAATCCT","561307.5.peg.724","2160"
"30438",118,659,541,"TTCCATTGCATTACCGATAC","ATATAAGCCGAATAATCCT","561307.5.peg.724","2160"
"30439",490,659,169,"ACGCTTATCTGGAGATGATT","ATATAAGCCGAATAATCCT","561307.5.peg.724","2160"
"30440",367,659,292,"ATAGCTTGGCAATAATCCAA","ATATAAGCCGAATAATCCT","561307.5.peg.724","2160"
"30441",200,7,193,"TCATATTAATAGCAACGACA","TAAAGTTTACATTGAGTGA","561307.5.peg.725","2161"
"30442",154,7,147,"TTCAACTGCGCTAGTGATGC","TAAAGTTTACATTGAGTGA","561307.5.peg.725","2161"
"30443",279,7,272,"CATTTACCTTCCATCATCAT","TAAAGTTTACATTGAGTGA","561307.5.peg.725","2161"
"30444",228,7,221,"AACAAATAATACTTTGCAC","TAAAGTTTACATTGAGTGA","561307.5.peg.725","2161"
"30445",564,7,557,"AACGAGTGCGATAGTGGTCC","TAAAGTTTACATTGAGTGA","561307.5.peg.725","2161"
"30446",562,7,555,"CGAGTGCGATAGTGGTCCAG","TAAAGTTTACATTGAGTGA","561307.5.peg.725","2161"
"30447",570,7,563,"AATGTTAACGAGTGCGATAG","TAAAGTTTACATTGAGTGA","561307.5.peg.725","2161"
"30448",564,154,410,"AACGAGTGCGATAGTGGTCC","TTCAACTGCGCTAGTGATGC","561307.5.peg.725","2161"
"30449",562,154,408,"CGAGTGCGATAGTGGTCCAG","TTCAACTGCGCTAGTGATGC","561307.5.peg.725","2161"
"30450",7,154,147,"TAAAGTTTACATTGAGTGA","TTCAACTGCGCTAGTGATGC","561307.5.peg.725","2161"
"30451",570,154,416,"AATGTTAACGAGTGCGATAG","TTCAACTGCGCTAGTGATGC","561307.5.peg.725","2161"
"30452",279,154,125,"CATTTACCTTCCATCATCAT","TTCAACTGCGCTAGTGATGC","561307.5.peg.725","2161"
"30453",7,200,193,"TAAAGTTTACATTGAGTGA","TCATATTAATAGCAACGACA","561307.5.peg.725","2161"
"30454",562,200,362,"CGAGTGCGATAGTGGTCCAG","TCATATTAATAGCAACGACA","561307.5.peg.725","2161"
"30455",564,200,364,"AACGAGTGCGATAGTGGTCC","TCATATTAATAGCAACGACA","561307.5.peg.725","2161"
"30456",570,200,370,"AATGTTAACGAGTGCGATAG","TCATATTAATAGCAACGACA","561307.5.peg.725","2161"
"30457",564,228,336,"AACGAGTGCGATAGTGGTCC","AACAAATAATACTTTGCAC","561307.5.peg.725","2161"
"30458",562,228,334,"CGAGTGCGATAGTGGTCCAG","AACAAATAATACTTTGCAC","561307.5.peg.725","2161"
"30459",570,228,342,"AATGTTAACGAGTGCGATAG","AACAAATAATACTTTGCAC","561307.5.peg.725","2161"
"30460",7,228,221,"TAAAGTTTACATTGAGTGA","AACAAATAATACTTTGCAC","561307.5.peg.725","2161"
"30461",570,279,291,"AATGTTAACGAGTGCGATAG","CATTTACCTTCCATCATCAT","561307.5.peg.725","2161"
"30462",7,279,272,"TAAAGTTTACATTGAGTGA","CATTTACCTTCCATCATCAT","561307.5.peg.725","2161"
"30463",564,279,285,"AACGAGTGCGATAGTGGTCC","CATTTACCTTCCATCATCAT","561307.5.peg.725","2161"
"30464",154,279,125,"TTCAACTGCGCTAGTGATGC","CATTTACCTTCCATCATCAT","561307.5.peg.725","2161"
"30465",562,279,283,"CGAGTGCGATAGTGGTCCAG","CATTTACCTTCCATCATCAT","561307.5.peg.725","2161"
"30466",279,562,283,"CATTTACCTTCCATCATCAT","CGAGTGCGATAGTGGTCCAG","561307.5.peg.725","2161"
"30467",228,562,334,"AACAAATAATACTTTGCAC","CGAGTGCGATAGTGGTCCAG","561307.5.peg.725","2161"
"30468",200,562,362,"TCATATTAATAGCAACGACA","CGAGTGCGATAGTGGTCCAG","561307.5.peg.725","2161"
"30469",7,562,555,"TAAAGTTTACATTGAGTGA","CGAGTGCGATAGTGGTCCAG","561307.5.peg.725","2161"
"30470",154,562,408,"TTCAACTGCGCTAGTGATGC","CGAGTGCGATAGTGGTCCAG","561307.5.peg.725","2161"
"30471",200,564,364,"TCATATTAATAGCAACGACA","AACGAGTGCGATAGTGGTCC","561307.5.peg.725","2161"
"30472",228,564,336,"AACAAATAATACTTTGCAC","AACGAGTGCGATAGTGGTCC","561307.5.peg.725","2161"
"30473",154,564,410,"TTCAACTGCGCTAGTGATGC","AACGAGTGCGATAGTGGTCC","561307.5.peg.725","2161"
"30474",7,564,557,"TAAAGTTTACATTGAGTGA","AACGAGTGCGATAGTGGTCC","561307.5.peg.725","2161"
"30475",279,564,285,"CATTTACCTTCCATCATCAT","AACGAGTGCGATAGTGGTCC","561307.5.peg.725","2161"
"30476",7,570,563,"TAAAGTTTACATTGAGTGA","AATGTTAACGAGTGCGATAG","561307.5.peg.725","2161"
"30477",279,570,291,"CATTTACCTTCCATCATCAT","AATGTTAACGAGTGCGATAG","561307.5.peg.725","2161"
"30478",154,570,416,"TTCAACTGCGCTAGTGATGC","AATGTTAACGAGTGCGATAG","561307.5.peg.725","2161"
"30479",200,570,370,"TCATATTAATAGCAACGACA","AATGTTAACGAGTGCGATAG","561307.5.peg.725","2161"
"30480",228,570,342,"AACAAATAATACTTTGCAC","AATGTTAACGAGTGCGATAG","561307.5.peg.725","2161"
"30481",426,282,144,"GCTGTTTCGTACACAGAATG","TGCCGATCGATTGTGACGCC","561307.5.peg.726","2162"
"30482",483,282,201,"ATTGATGGGTCGCTCATTTC","TGCCGATCGATTGTGACGCC","561307.5.peg.726","2162"
"30483",497,282,215,"CAGCACCTTGAATCATTGAT","TGCCGATCGATTGTGACGCC","561307.5.peg.726","2162"
"30484",529,282,247,"CTTGAAACATCATACATCT","TGCCGATCGATTGTGACGCC","561307.5.peg.726","2162"
"30485",483,350,133,"ATTGATGGGTCGCTCATTTC","ATACCTTGCCAGCTCCGGCT","561307.5.peg.726","2162"
"30486",529,350,179,"CTTGAAACATCATACATCT","ATACCTTGCCAGCTCCGGCT","561307.5.peg.726","2162"
"30487",497,350,147,"CAGCACCTTGAATCATTGAT","ATACCTTGCCAGCTCCGGCT","561307.5.peg.726","2162"
"30488",529,355,174,"CTTGAAACATCATACATCT","AATATATACCTTGCCAGCTC","561307.5.peg.726","2162"
"30489",483,355,128,"ATTGATGGGTCGCTCATTTC","AATATATACCTTGCCAGCTC","561307.5.peg.726","2162"
"30490",497,355,142,"CAGCACCTTGAATCATTGAT","AATATATACCTTGCCAGCTC","561307.5.peg.726","2162"
"30491",282,426,144,"TGCCGATCGATTGTGACGCC","GCTGTTTCGTACACAGAATG","561307.5.peg.726","2162"
"30492",529,426,103,"CTTGAAACATCATACATCT","GCTGTTTCGTACACAGAATG","561307.5.peg.726","2162"
"30493",282,483,201,"TGCCGATCGATTGTGACGCC","ATTGATGGGTCGCTCATTTC","561307.5.peg.726","2162"
"30494",355,483,128,"AATATATACCTTGCCAGCTC","ATTGATGGGTCGCTCATTTC","561307.5.peg.726","2162"
"30495",350,483,133,"ATACCTTGCCAGCTCCGGCT","ATTGATGGGTCGCTCATTTC","561307.5.peg.726","2162"
"30496",355,497,142,"AATATATACCTTGCCAGCTC","CAGCACCTTGAATCATTGAT","561307.5.peg.726","2162"
"30497",282,497,215,"TGCCGATCGATTGTGACGCC","CAGCACCTTGAATCATTGAT","561307.5.peg.726","2162"
"30498",350,497,147,"ATACCTTGCCAGCTCCGGCT","CAGCACCTTGAATCATTGAT","561307.5.peg.726","2162"
"30499",282,529,247,"TGCCGATCGATTGTGACGCC","CTTGAAACATCATACATCT","561307.5.peg.726","2162"
"30500",350,529,179,"ATACCTTGCCAGCTCCGGCT","CTTGAAACATCATACATCT","561307.5.peg.726","2162"
"30501",426,529,103,"GCTGTTTCGTACACAGAATG","CTTGAAACATCATACATCT","561307.5.peg.726","2162"
"30502",355,529,174,"AATATATACCTTGCCAGCTC","CTTGAAACATCATACATCT","561307.5.peg.726","2162"
"30503",159,3,156,"AATGACGCACACATTAATGG","ATGGGGATAGGGGGAGGTCT","561307.5.peg.727","2163"
"30504",162,3,159,"CATAATGACGCACACATTAA","ATGGGGATAGGGGGAGGTCT","561307.5.peg.727","2163"
"30505",159,9,150,"AATGACGCACACATTAATGG","GCATCTATGGGGATAGGGGG","561307.5.peg.727","2163"
"30506",162,9,153,"CATAATGACGCACACATTAA","GCATCTATGGGGATAGGGGG","561307.5.peg.727","2163"
"30507",159,12,147,"AATGACGCACACATTAATGG","ATTGCATCTATGGGGATAGG","561307.5.peg.727","2163"
"30508",162,12,150,"CATAATGACGCACACATTAA","ATTGCATCTATGGGGATAGG","561307.5.peg.727","2163"
"30509",159,20,139,"AATGACGCACACATTAATGG","AGACTATGATTGCATCTATG","561307.5.peg.727","2163"
"30510",162,20,142,"CATAATGACGCACACATTAA","AGACTATGATTGCATCTATG","561307.5.peg.727","2163"
"30511",3,159,156,"ATGGGGATAGGGGGAGGTCT","AATGACGCACACATTAATGG","561307.5.peg.727","2163"
"30512",9,159,150,"GCATCTATGGGGATAGGGGG","AATGACGCACACATTAATGG","561307.5.peg.727","2163"
"30513",12,159,147,"ATTGCATCTATGGGGATAGG","AATGACGCACACATTAATGG","561307.5.peg.727","2163"
"30514",20,159,139,"AGACTATGATTGCATCTATG","AATGACGCACACATTAATGG","561307.5.peg.727","2163"
"30515",3,162,159,"ATGGGGATAGGGGGAGGTCT","CATAATGACGCACACATTAA","561307.5.peg.727","2163"
"30516",9,162,153,"GCATCTATGGGGATAGGGGG","CATAATGACGCACACATTAA","561307.5.peg.727","2163"
"30517",12,162,150,"ATTGCATCTATGGGGATAGG","CATAATGACGCACACATTAA","561307.5.peg.727","2163"
"30518",20,162,142,"AGACTATGATTGCATCTATG","CATAATGACGCACACATTAA","561307.5.peg.727","2163"
"30519",213,79,134,"CAAATACATCCATTGGTAA","GCCAGCACTTGTGTCAGAAC","561307.5.peg.730","2167"
"30520",405,79,326,"ATCATCGCCTCAGTATTTCC","GCCAGCACTTGTGTCAGAAC","561307.5.peg.730","2167"
"30521",405,169,236,"ATCATCGCCTCAGTATTTCC","TCTTTATCCATAGTAACGA","561307.5.peg.730","2167"
"30522",79,213,134,"GCCAGCACTTGTGTCAGAAC","CAAATACATCCATTGGTAA","561307.5.peg.730","2167"
"30523",405,213,192,"ATCATCGCCTCAGTATTTCC","CAAATACATCCATTGGTAA","561307.5.peg.730","2167"
"30524",79,405,326,"GCCAGCACTTGTGTCAGAAC","ATCATCGCCTCAGTATTTCC","561307.5.peg.730","2167"
"30525",169,405,236,"TCTTTATCCATAGTAACGA","ATCATCGCCTCAGTATTTCC","561307.5.peg.730","2167"
"30526",213,405,192,"CAAATACATCCATTGGTAA","ATCATCGCCTCAGTATTTCC","561307.5.peg.730","2167"
"30527",227,35,192,"CTTGGTTTGGACCATGATAC","ATTCCATTCAATCTCACCTC","561307.5.peg.731","2168"
"30528",240,35,205,"GCTAATCCATGTGCTTGGTT","ATTCCATTCAATCTCACCTC","561307.5.peg.731","2168"
"30529",290,35,255,"ACATATTACGTAAAGATGGA","ATTCCATTCAATCTCACCTC","561307.5.peg.731","2168"
"30530",35,227,192,"ATTCCATTCAATCTCACCTC","CTTGGTTTGGACCATGATAC","561307.5.peg.731","2168"
"30531",35,240,205,"ATTCCATTCAATCTCACCTC","GCTAATCCATGTGCTTGGTT","561307.5.peg.731","2168"
"30532",35,290,255,"ATTCCATTCAATCTCACCTC","ACATATTACGTAAAGATGGA","561307.5.peg.731","2168"
"30533",457,14,443,"ATAAACGTCCCAGCCCGCAA","TTGGGTATAGAATACCTTCG","561307.5.peg.734","2171"
"30534",279,14,265,"GCAAACGCGCCCCCTGATAC","TTGGGTATAGAATACCTTCG","561307.5.peg.734","2171"
"30535",709,14,695,"AACATATGCCCATGGTGCCA","TTGGGTATAGAATACCTTCG","561307.5.peg.734","2171"
"30536",192,14,178,"ATACCAATTGATGCTGCAAT","TTGGGTATAGAATACCTTCG","561307.5.peg.734","2171"
"30537",669,14,655,"GACACTAACCATCCTTTGCT","TTGGGTATAGAATACCTTCG","561307.5.peg.734","2171"
"30538",394,14,380,"TTAACTAGTAAACTGAATG","TTGGGTATAGAATACCTTCG","561307.5.peg.734","2171"
"30539",426,14,412,"TCCCATTATTTAAGACATC","TTGGGTATAGAATACCTTCG","561307.5.peg.734","2171"
"30540",165,14,151,"GACTGCTTAATCCAGTCTCC","TTGGGTATAGAATACCTTCG","561307.5.peg.734","2171"
"30541",301,14,287,"GCCGAAACTTAAGAAACTAA","TTGGGTATAGAATACCTTCG","561307.5.peg.734","2171"
"30542",657,14,643,"CCTTTGCTAGGTTCAGCTAA","TTGGGTATAGAATACCTTCG","561307.5.peg.734","2171"
"30543",717,14,703,"TCAAATCCAACATATGCCCA","TTGGGTATAGAATACCTTCG","561307.5.peg.734","2171"
"30544",394,165,229,"TTAACTAGTAAACTGAATG","GACTGCTTAATCCAGTCTCC","561307.5.peg.734","2171"
"30545",301,165,136,"GCCGAAACTTAAGAAACTAA","GACTGCTTAATCCAGTCTCC","561307.5.peg.734","2171"
"30546",14,165,151,"TTGGGTATAGAATACCTTCG","GACTGCTTAATCCAGTCTCC","561307.5.peg.734","2171"
"30547",279,165,114,"GCAAACGCGCCCCCTGATAC","GACTGCTTAATCCAGTCTCC","561307.5.peg.734","2171"
"30548",426,165,261,"TCCCATTATTTAAGACATC","GACTGCTTAATCCAGTCTCC","561307.5.peg.734","2171"
"30549",657,165,492,"CCTTTGCTAGGTTCAGCTAA","GACTGCTTAATCCAGTCTCC","561307.5.peg.734","2171"
"30550",669,165,504,"GACACTAACCATCCTTTGCT","GACTGCTTAATCCAGTCTCC","561307.5.peg.734","2171"
"30551",709,165,544,"AACATATGCCCATGGTGCCA","GACTGCTTAATCCAGTCTCC","561307.5.peg.734","2171"
"30552",457,165,292,"ATAAACGTCCCAGCCCGCAA","GACTGCTTAATCCAGTCTCC","561307.5.peg.734","2171"
"30553",717,165,552,"TCAAATCCAACATATGCCCA","GACTGCTTAATCCAGTCTCC","561307.5.peg.734","2171"
"30554",669,192,477,"GACACTAACCATCCTTTGCT","ATACCAATTGATGCTGCAAT","561307.5.peg.734","2171"
"30555",426,192,234,"TCCCATTATTTAAGACATC","ATACCAATTGATGCTGCAAT","561307.5.peg.734","2171"
"30556",709,192,517,"AACATATGCCCATGGTGCCA","ATACCAATTGATGCTGCAAT","561307.5.peg.734","2171"
"30557",457,192,265,"ATAAACGTCCCAGCCCGCAA","ATACCAATTGATGCTGCAAT","561307.5.peg.734","2171"
"30558",14,192,178,"TTGGGTATAGAATACCTTCG","ATACCAATTGATGCTGCAAT","561307.5.peg.734","2171"
"30559",301,192,109,"GCCGAAACTTAAGAAACTAA","ATACCAATTGATGCTGCAAT","561307.5.peg.734","2171"
"30560",394,192,202,"TTAACTAGTAAACTGAATG","ATACCAATTGATGCTGCAAT","561307.5.peg.734","2171"
"30561",717,192,525,"TCAAATCCAACATATGCCCA","ATACCAATTGATGCTGCAAT","561307.5.peg.734","2171"
"30562",657,192,465,"CCTTTGCTAGGTTCAGCTAA","ATACCAATTGATGCTGCAAT","561307.5.peg.734","2171"
"30563",657,279,378,"CCTTTGCTAGGTTCAGCTAA","GCAAACGCGCCCCCTGATAC","561307.5.peg.734","2171"
"30564",669,279,390,"GACACTAACCATCCTTTGCT","GCAAACGCGCCCCCTGATAC","561307.5.peg.734","2171"
"30565",14,279,265,"TTGGGTATAGAATACCTTCG","GCAAACGCGCCCCCTGATAC","561307.5.peg.734","2171"
"30566",165,279,114,"GACTGCTTAATCCAGTCTCC","GCAAACGCGCCCCCTGATAC","561307.5.peg.734","2171"
"30567",426,279,147,"TCCCATTATTTAAGACATC","GCAAACGCGCCCCCTGATAC","561307.5.peg.734","2171"
"30568",394,279,115,"TTAACTAGTAAACTGAATG","GCAAACGCGCCCCCTGATAC","561307.5.peg.734","2171"
"30569",709,279,430,"AACATATGCCCATGGTGCCA","GCAAACGCGCCCCCTGATAC","561307.5.peg.734","2171"
"30570",457,279,178,"ATAAACGTCCCAGCCCGCAA","GCAAACGCGCCCCCTGATAC","561307.5.peg.734","2171"
"30571",717,279,438,"TCAAATCCAACATATGCCCA","GCAAACGCGCCCCCTGATAC","561307.5.peg.734","2171"
"30572",717,301,416,"TCAAATCCAACATATGCCCA","GCCGAAACTTAAGAAACTAA","561307.5.peg.734","2171"
"30573",165,301,136,"GACTGCTTAATCCAGTCTCC","GCCGAAACTTAAGAAACTAA","561307.5.peg.734","2171"
"30574",657,301,356,"CCTTTGCTAGGTTCAGCTAA","GCCGAAACTTAAGAAACTAA","561307.5.peg.734","2171"
"30575",669,301,368,"GACACTAACCATCCTTTGCT","GCCGAAACTTAAGAAACTAA","561307.5.peg.734","2171"
"30576",709,301,408,"AACATATGCCCATGGTGCCA","GCCGAAACTTAAGAAACTAA","561307.5.peg.734","2171"
"30577",14,301,287,"TTGGGTATAGAATACCTTCG","GCCGAAACTTAAGAAACTAA","561307.5.peg.734","2171"
"30578",426,301,125,"TCCCATTATTTAAGACATC","GCCGAAACTTAAGAAACTAA","561307.5.peg.734","2171"
"30579",192,301,109,"ATACCAATTGATGCTGCAAT","GCCGAAACTTAAGAAACTAA","561307.5.peg.734","2171"
"30580",457,301,156,"ATAAACGTCCCAGCCCGCAA","GCCGAAACTTAAGAAACTAA","561307.5.peg.734","2171"
"30581",14,394,380,"TTGGGTATAGAATACCTTCG","TTAACTAGTAAACTGAATG","561307.5.peg.734","2171"
"30582",279,394,115,"GCAAACGCGCCCCCTGATAC","TTAACTAGTAAACTGAATG","561307.5.peg.734","2171"
"30583",669,394,275,"GACACTAACCATCCTTTGCT","TTAACTAGTAAACTGAATG","561307.5.peg.734","2171"
"30584",657,394,263,"CCTTTGCTAGGTTCAGCTAA","TTAACTAGTAAACTGAATG","561307.5.peg.734","2171"
"30585",192,394,202,"ATACCAATTGATGCTGCAAT","TTAACTAGTAAACTGAATG","561307.5.peg.734","2171"
"30586",709,394,315,"AACATATGCCCATGGTGCCA","TTAACTAGTAAACTGAATG","561307.5.peg.734","2171"
"30587",717,394,323,"TCAAATCCAACATATGCCCA","TTAACTAGTAAACTGAATG","561307.5.peg.734","2171"
"30588",165,394,229,"GACTGCTTAATCCAGTCTCC","TTAACTAGTAAACTGAATG","561307.5.peg.734","2171"
"30589",14,426,412,"TTGGGTATAGAATACCTTCG","TCCCATTATTTAAGACATC","561307.5.peg.734","2171"
"30590",165,426,261,"GACTGCTTAATCCAGTCTCC","TCCCATTATTTAAGACATC","561307.5.peg.734","2171"
"30591",657,426,231,"CCTTTGCTAGGTTCAGCTAA","TCCCATTATTTAAGACATC","561307.5.peg.734","2171"
"30592",301,426,125,"GCCGAAACTTAAGAAACTAA","TCCCATTATTTAAGACATC","561307.5.peg.734","2171"
"30593",669,426,243,"GACACTAACCATCCTTTGCT","TCCCATTATTTAAGACATC","561307.5.peg.734","2171"
"30594",717,426,291,"TCAAATCCAACATATGCCCA","TCCCATTATTTAAGACATC","561307.5.peg.734","2171"
"30595",192,426,234,"ATACCAATTGATGCTGCAAT","TCCCATTATTTAAGACATC","561307.5.peg.734","2171"
"30596",279,426,147,"GCAAACGCGCCCCCTGATAC","TCCCATTATTTAAGACATC","561307.5.peg.734","2171"
"30597",709,426,283,"AACATATGCCCATGGTGCCA","TCCCATTATTTAAGACATC","561307.5.peg.734","2171"
"30598",14,457,443,"TTGGGTATAGAATACCTTCG","ATAAACGTCCCAGCCCGCAA","561307.5.peg.734","2171"
"30599",165,457,292,"GACTGCTTAATCCAGTCTCC","ATAAACGTCCCAGCCCGCAA","561307.5.peg.734","2171"
"30600",301,457,156,"GCCGAAACTTAAGAAACTAA","ATAAACGTCCCAGCCCGCAA","561307.5.peg.734","2171"
"30601",709,457,252,"AACATATGCCCATGGTGCCA","ATAAACGTCCCAGCCCGCAA","561307.5.peg.734","2171"
"30602",669,457,212,"GACACTAACCATCCTTTGCT","ATAAACGTCCCAGCCCGCAA","561307.5.peg.734","2171"
"30603",717,457,260,"TCAAATCCAACATATGCCCA","ATAAACGTCCCAGCCCGCAA","561307.5.peg.734","2171"
"30604",279,457,178,"GCAAACGCGCCCCCTGATAC","ATAAACGTCCCAGCCCGCAA","561307.5.peg.734","2171"
"30605",657,457,200,"CCTTTGCTAGGTTCAGCTAA","ATAAACGTCCCAGCCCGCAA","561307.5.peg.734","2171"
"30606",192,457,265,"ATACCAATTGATGCTGCAAT","ATAAACGTCCCAGCCCGCAA","561307.5.peg.734","2171"
"30607",192,657,465,"ATACCAATTGATGCTGCAAT","CCTTTGCTAGGTTCAGCTAA","561307.5.peg.734","2171"
"30608",301,657,356,"GCCGAAACTTAAGAAACTAA","CCTTTGCTAGGTTCAGCTAA","561307.5.peg.734","2171"
"30609",279,657,378,"GCAAACGCGCCCCCTGATAC","CCTTTGCTAGGTTCAGCTAA","561307.5.peg.734","2171"
"30610",457,657,200,"ATAAACGTCCCAGCCCGCAA","CCTTTGCTAGGTTCAGCTAA","561307.5.peg.734","2171"
"30611",394,657,263,"TTAACTAGTAAACTGAATG","CCTTTGCTAGGTTCAGCTAA","561307.5.peg.734","2171"
"30612",14,657,643,"TTGGGTATAGAATACCTTCG","CCTTTGCTAGGTTCAGCTAA","561307.5.peg.734","2171"
"30613",426,657,231,"TCCCATTATTTAAGACATC","CCTTTGCTAGGTTCAGCTAA","561307.5.peg.734","2171"
"30614",165,657,492,"GACTGCTTAATCCAGTCTCC","CCTTTGCTAGGTTCAGCTAA","561307.5.peg.734","2171"
"30615",394,669,275,"TTAACTAGTAAACTGAATG","GACACTAACCATCCTTTGCT","561307.5.peg.734","2171"
"30616",14,669,655,"TTGGGTATAGAATACCTTCG","GACACTAACCATCCTTTGCT","561307.5.peg.734","2171"
"30617",165,669,504,"GACTGCTTAATCCAGTCTCC","GACACTAACCATCCTTTGCT","561307.5.peg.734","2171"
"30618",457,669,212,"ATAAACGTCCCAGCCCGCAA","GACACTAACCATCCTTTGCT","561307.5.peg.734","2171"
"30619",279,669,390,"GCAAACGCGCCCCCTGATAC","GACACTAACCATCCTTTGCT","561307.5.peg.734","2171"
"30620",192,669,477,"ATACCAATTGATGCTGCAAT","GACACTAACCATCCTTTGCT","561307.5.peg.734","2171"
"30621",426,669,243,"TCCCATTATTTAAGACATC","GACACTAACCATCCTTTGCT","561307.5.peg.734","2171"
"30622",301,669,368,"GCCGAAACTTAAGAAACTAA","GACACTAACCATCCTTTGCT","561307.5.peg.734","2171"
"30623",192,709,517,"ATACCAATTGATGCTGCAAT","AACATATGCCCATGGTGCCA","561307.5.peg.734","2171"
"30624",394,709,315,"TTAACTAGTAAACTGAATG","AACATATGCCCATGGTGCCA","561307.5.peg.734","2171"
"30625",301,709,408,"GCCGAAACTTAAGAAACTAA","AACATATGCCCATGGTGCCA","561307.5.peg.734","2171"
"30626",457,709,252,"ATAAACGTCCCAGCCCGCAA","AACATATGCCCATGGTGCCA","561307.5.peg.734","2171"
"30627",14,709,695,"TTGGGTATAGAATACCTTCG","AACATATGCCCATGGTGCCA","561307.5.peg.734","2171"
"30628",426,709,283,"TCCCATTATTTAAGACATC","AACATATGCCCATGGTGCCA","561307.5.peg.734","2171"
"30629",165,709,544,"GACTGCTTAATCCAGTCTCC","AACATATGCCCATGGTGCCA","561307.5.peg.734","2171"
"30630",279,709,430,"GCAAACGCGCCCCCTGATAC","AACATATGCCCATGGTGCCA","561307.5.peg.734","2171"
"30631",192,717,525,"ATACCAATTGATGCTGCAAT","TCAAATCCAACATATGCCCA","561307.5.peg.734","2171"
"30632",457,717,260,"ATAAACGTCCCAGCCCGCAA","TCAAATCCAACATATGCCCA","561307.5.peg.734","2171"
"30633",14,717,703,"TTGGGTATAGAATACCTTCG","TCAAATCCAACATATGCCCA","561307.5.peg.734","2171"
"30634",394,717,323,"TTAACTAGTAAACTGAATG","TCAAATCCAACATATGCCCA","561307.5.peg.734","2171"
"30635",426,717,291,"TCCCATTATTTAAGACATC","TCAAATCCAACATATGCCCA","561307.5.peg.734","2171"
"30636",165,717,552,"GACTGCTTAATCCAGTCTCC","TCAAATCCAACATATGCCCA","561307.5.peg.734","2171"
"30637",301,717,416,"GCCGAAACTTAAGAAACTAA","TCAAATCCAACATATGCCCA","561307.5.peg.734","2171"
"30638",279,717,438,"GCAAACGCGCCCCCTGATAC","TCAAATCCAACATATGCCCA","561307.5.peg.734","2171"
"30639",298,155,143,"ATGTGGGAGTACAACGGCCA","TCCATTTCGCACTATACGGT","561307.5.peg.737","2174"
"30640",304,155,149,"TACACCATGTGGGAGTACAA","TCCATTTCGCACTATACGGT","561307.5.peg.737","2174"
"30641",332,155,177,"TGACACCTTCTGCAGCACCT","TCCATTTCGCACTATACGGT","561307.5.peg.737","2174"
"30642",298,159,139,"ATGTGGGAGTACAACGGCCA","GCAGTCCATTTCGCACTATA","561307.5.peg.737","2174"
"30643",304,159,145,"TACACCATGTGGGAGTACAA","GCAGTCCATTTCGCACTATA","561307.5.peg.737","2174"
"30644",332,159,173,"TGACACCTTCTGCAGCACCT","GCAGTCCATTTCGCACTATA","561307.5.peg.737","2174"
"30645",155,298,143,"TCCATTTCGCACTATACGGT","ATGTGGGAGTACAACGGCCA","561307.5.peg.737","2174"
"30646",159,298,139,"GCAGTCCATTTCGCACTATA","ATGTGGGAGTACAACGGCCA","561307.5.peg.737","2174"
"30647",155,304,149,"TCCATTTCGCACTATACGGT","TACACCATGTGGGAGTACAA","561307.5.peg.737","2174"
"30648",159,304,145,"GCAGTCCATTTCGCACTATA","TACACCATGTGGGAGTACAA","561307.5.peg.737","2174"
"30649",155,332,177,"TCCATTTCGCACTATACGGT","TGACACCTTCTGCAGCACCT","561307.5.peg.737","2174"
"30650",159,332,173,"GCAGTCCATTTCGCACTATA","TGACACCTTCTGCAGCACCT","561307.5.peg.737","2174"
"30651",183,78,105,"AACTGTCCGGATATTGTTAA","AACCCTGGGAACCTCAATTC","561307.5.peg.738","2175"
"30652",196,78,118,"ATCAATTAAACCTAACTGTC","AACCCTGGGAACCTCAATTC","561307.5.peg.738","2175"
"30653",78,183,105,"AACCCTGGGAACCTCAATTC","AACTGTCCGGATATTGTTAA","561307.5.peg.738","2175"
"30654",78,196,118,"AACCCTGGGAACCTCAATTC","ATCAATTAAACCTAACTGTC","561307.5.peg.738","2175"
"30655",489,294,195,"TCTTCATCGTCACCTAAATA","CCTTGTATAGAAGTATCACC","561307.5.peg.740","2178"
"30656",294,489,195,"CCTTGTATAGAAGTATCACC","TCTTCATCGTCACCTAAATA","561307.5.peg.740","2178"
"30657",197,3,194,"AATCCTCGAGATTCTTAATA","TCATCTTCATCTACCTTCGC","561307.5.peg.743","2181"
"30658",197,10,187,"AATCCTCGAGATTCTTAATA","AAGATGATGAATGATGAGGA","561307.5.peg.743","2181"
"30659",3,197,194,"TCATCTTCATCTACCTTCGC","AATCCTCGAGATTCTTAATA","561307.5.peg.743","2181"
"30660",10,197,187,"AAGATGATGAATGATGAGGA","AATCCTCGAGATTCTTAATA","561307.5.peg.743","2181"
"30661",388,32,356,"TTAACTGTTTCCAAAGCAT","TCAACATTCTCACCTTCAGA","561307.5.peg.745","2183"
"30662",585,32,553,"GGATTATAAACCACAATGTT","TCAACATTCTCACCTTCAGA","561307.5.peg.745","2183"
"30663",606,32,574,"CTAGTTATAGAAATAGGAGC","TCAACATTCTCACCTTCAGA","561307.5.peg.745","2183"
"30664",585,388,197,"GGATTATAAACCACAATGTT","TTAACTGTTTCCAAAGCAT","561307.5.peg.745","2183"
"30665",32,388,356,"TCAACATTCTCACCTTCAGA","TTAACTGTTTCCAAAGCAT","561307.5.peg.745","2183"
"30666",606,388,218,"CTAGTTATAGAAATAGGAGC","TTAACTGTTTCCAAAGCAT","561307.5.peg.745","2183"
"30667",32,585,553,"TCAACATTCTCACCTTCAGA","GGATTATAAACCACAATGTT","561307.5.peg.745","2183"
"30668",388,585,197,"TTAACTGTTTCCAAAGCAT","GGATTATAAACCACAATGTT","561307.5.peg.745","2183"
"30669",388,606,218,"TTAACTGTTTCCAAAGCAT","CTAGTTATAGAAATAGGAGC","561307.5.peg.745","2183"
"30670",32,606,574,"TCAACATTCTCACCTTCAGA","CTAGTTATAGAAATAGGAGC","561307.5.peg.745","2183"
"30671",369,63,306,"TATGAGAAAGTTTGTGCAAC","TAACCACTTAATACCGTAAC","561307.5.peg.749","2187"
"30672",431,63,368,"CTGTAACCATTGTATCTAAA","TAACCACTTAATACCGTAAC","561307.5.peg.749","2187"
"30673",467,63,404,"AGTTGATGTCATGTACGAAG","TAACCACTTAATACCGTAAC","561307.5.peg.749","2187"
"30674",63,369,306,"TAACCACTTAATACCGTAAC","TATGAGAAAGTTTGTGCAAC","561307.5.peg.749","2187"
"30675",63,431,368,"TAACCACTTAATACCGTAAC","CTGTAACCATTGTATCTAAA","561307.5.peg.749","2187"
"30676",63,467,404,"TAACCACTTAATACCGTAAC","AGTTGATGTCATGTACGAAG","561307.5.peg.749","2187"
"30677",247,12,235,"ACGACAAGCTCTTGTACATA","TAAAGATACACTTAACAGGA","561307.5.peg.75","2188"
"30678",477,12,465,"TAGTCCCCGCCCATATCTGA","TAAAGATACACTTAACAGGA","561307.5.peg.75","2188"
"30679",318,12,306,"ACTGATTCAGCTACACGTTC","TAAAGATACACTTAACAGGA","561307.5.peg.75","2188"
"30680",12,247,235,"TAAAGATACACTTAACAGGA","ACGACAAGCTCTTGTACATA","561307.5.peg.75","2188"
"30681",477,247,230,"TAGTCCCCGCCCATATCTGA","ACGACAAGCTCTTGTACATA","561307.5.peg.75","2188"
"30682",12,318,306,"TAAAGATACACTTAACAGGA","ACTGATTCAGCTACACGTTC","561307.5.peg.75","2188"
"30683",477,318,159,"TAGTCCCCGCCCATATCTGA","ACTGATTCAGCTACACGTTC","561307.5.peg.75","2188"
"30684",318,477,159,"ACTGATTCAGCTACACGTTC","TAGTCCCCGCCCATATCTGA","561307.5.peg.75","2188"
"30685",247,477,230,"ACGACAAGCTCTTGTACATA","TAGTCCCCGCCCATATCTGA","561307.5.peg.75","2188"
"30686",12,477,465,"TAAAGATACACTTAACAGGA","TAGTCCCCGCCCATATCTGA","561307.5.peg.75","2188"
"30687",360,8,352,"GACGTAATCGCAGTGAACAA","GCGAGAGATTAGAAATAAGG","561307.5.peg.751","2190"
"30688",720,8,712,"ATAATTGCCGATACTGGCGT","GCGAGAGATTAGAAATAAGG","561307.5.peg.751","2190"
"30689",495,8,487,"GATAATTTCGCAGACTCACG","GCGAGAGATTAGAAATAAGG","561307.5.peg.751","2190"
"30690",726,8,718,"GCATGCATAATTGCCGATAC","GCGAGAGATTAGAAATAAGG","561307.5.peg.751","2190"
"30691",618,8,610,"TTCGTCAACAATGACCATGT","GCGAGAGATTAGAAATAAGG","561307.5.peg.751","2190"
"30692",132,8,124,"TATATCTCATTGGCATAAC","GCGAGAGATTAGAAATAAGG","561307.5.peg.751","2190"
"30693",600,8,592,"GTCGGATGAACTATATGTTG","GCGAGAGATTAGAAATAAGG","561307.5.peg.751","2190"
"30694",8,132,124,"GCGAGAGATTAGAAATAAGG","TATATCTCATTGGCATAAC","561307.5.peg.751","2190"
"30695",495,132,363,"GATAATTTCGCAGACTCACG","TATATCTCATTGGCATAAC","561307.5.peg.751","2190"
"30696",720,132,588,"ATAATTGCCGATACTGGCGT","TATATCTCATTGGCATAAC","561307.5.peg.751","2190"
"30697",360,132,228,"GACGTAATCGCAGTGAACAA","TATATCTCATTGGCATAAC","561307.5.peg.751","2190"
"30698",726,132,594,"GCATGCATAATTGCCGATAC","TATATCTCATTGGCATAAC","561307.5.peg.751","2190"
"30699",600,132,468,"GTCGGATGAACTATATGTTG","TATATCTCATTGGCATAAC","561307.5.peg.751","2190"
"30700",618,132,486,"TTCGTCAACAATGACCATGT","TATATCTCATTGGCATAAC","561307.5.peg.751","2190"
"30701",132,360,228,"TATATCTCATTGGCATAAC","GACGTAATCGCAGTGAACAA","561307.5.peg.751","2190"
"30702",495,360,135,"GATAATTTCGCAGACTCACG","GACGTAATCGCAGTGAACAA","561307.5.peg.751","2190"
"30703",8,360,352,"GCGAGAGATTAGAAATAAGG","GACGTAATCGCAGTGAACAA","561307.5.peg.751","2190"
"30704",618,360,258,"TTCGTCAACAATGACCATGT","GACGTAATCGCAGTGAACAA","561307.5.peg.751","2190"
"30705",726,360,366,"GCATGCATAATTGCCGATAC","GACGTAATCGCAGTGAACAA","561307.5.peg.751","2190"
"30706",720,360,360,"ATAATTGCCGATACTGGCGT","GACGTAATCGCAGTGAACAA","561307.5.peg.751","2190"
"30707",600,360,240,"GTCGGATGAACTATATGTTG","GACGTAATCGCAGTGAACAA","561307.5.peg.751","2190"
"30708",360,495,135,"GACGTAATCGCAGTGAACAA","GATAATTTCGCAGACTCACG","561307.5.peg.751","2190"
"30709",720,495,225,"ATAATTGCCGATACTGGCGT","GATAATTTCGCAGACTCACG","561307.5.peg.751","2190"
"30710",132,495,363,"TATATCTCATTGGCATAAC","GATAATTTCGCAGACTCACG","561307.5.peg.751","2190"
"30711",600,495,105,"GTCGGATGAACTATATGTTG","GATAATTTCGCAGACTCACG","561307.5.peg.751","2190"
"30712",618,495,123,"TTCGTCAACAATGACCATGT","GATAATTTCGCAGACTCACG","561307.5.peg.751","2190"
"30713",8,495,487,"GCGAGAGATTAGAAATAAGG","GATAATTTCGCAGACTCACG","561307.5.peg.751","2190"
"30714",726,495,231,"GCATGCATAATTGCCGATAC","GATAATTTCGCAGACTCACG","561307.5.peg.751","2190"
"30715",8,600,592,"GCGAGAGATTAGAAATAAGG","GTCGGATGAACTATATGTTG","561307.5.peg.751","2190"
"30716",132,600,468,"TATATCTCATTGGCATAAC","GTCGGATGAACTATATGTTG","561307.5.peg.751","2190"
"30717",726,600,126,"GCATGCATAATTGCCGATAC","GTCGGATGAACTATATGTTG","561307.5.peg.751","2190"
"30718",720,600,120,"ATAATTGCCGATACTGGCGT","GTCGGATGAACTATATGTTG","561307.5.peg.751","2190"
"30719",495,600,105,"GATAATTTCGCAGACTCACG","GTCGGATGAACTATATGTTG","561307.5.peg.751","2190"
"30720",360,600,240,"GACGTAATCGCAGTGAACAA","GTCGGATGAACTATATGTTG","561307.5.peg.751","2190"
"30721",8,618,610,"GCGAGAGATTAGAAATAAGG","TTCGTCAACAATGACCATGT","561307.5.peg.751","2190"
"30722",360,618,258,"GACGTAATCGCAGTGAACAA","TTCGTCAACAATGACCATGT","561307.5.peg.751","2190"
"30723",495,618,123,"GATAATTTCGCAGACTCACG","TTCGTCAACAATGACCATGT","561307.5.peg.751","2190"
"30724",720,618,102,"ATAATTGCCGATACTGGCGT","TTCGTCAACAATGACCATGT","561307.5.peg.751","2190"
"30725",132,618,486,"TATATCTCATTGGCATAAC","TTCGTCAACAATGACCATGT","561307.5.peg.751","2190"
"30726",726,618,108,"GCATGCATAATTGCCGATAC","TTCGTCAACAATGACCATGT","561307.5.peg.751","2190"
"30727",8,720,712,"GCGAGAGATTAGAAATAAGG","ATAATTGCCGATACTGGCGT","561307.5.peg.751","2190"
"30728",618,720,102,"TTCGTCAACAATGACCATGT","ATAATTGCCGATACTGGCGT","561307.5.peg.751","2190"
"30729",360,720,360,"GACGTAATCGCAGTGAACAA","ATAATTGCCGATACTGGCGT","561307.5.peg.751","2190"
"30730",600,720,120,"GTCGGATGAACTATATGTTG","ATAATTGCCGATACTGGCGT","561307.5.peg.751","2190"
"30731",132,720,588,"TATATCTCATTGGCATAAC","ATAATTGCCGATACTGGCGT","561307.5.peg.751","2190"
"30732",495,720,225,"GATAATTTCGCAGACTCACG","ATAATTGCCGATACTGGCGT","561307.5.peg.751","2190"
"30733",132,726,594,"TATATCTCATTGGCATAAC","GCATGCATAATTGCCGATAC","561307.5.peg.751","2190"
"30734",8,726,718,"GCGAGAGATTAGAAATAAGG","GCATGCATAATTGCCGATAC","561307.5.peg.751","2190"
"30735",600,726,126,"GTCGGATGAACTATATGTTG","GCATGCATAATTGCCGATAC","561307.5.peg.751","2190"
"30736",360,726,366,"GACGTAATCGCAGTGAACAA","GCATGCATAATTGCCGATAC","561307.5.peg.751","2190"
"30737",495,726,231,"GATAATTTCGCAGACTCACG","GCATGCATAATTGCCGATAC","561307.5.peg.751","2190"
"30738",618,726,108,"TTCGTCAACAATGACCATGT","GCATGCATAATTGCCGATAC","561307.5.peg.751","2190"
"30739",144,2,142,"TCCGCTTCTAATCCTTCCCA","AGTATTTATAGGAGGTGAA","561307.5.peg.752","2191"
"30740",699,2,697,"ATCGTCATTTCAGGATCATT","AGTATTTATAGGAGGTGAA","561307.5.peg.752","2191"
"30741",680,2,678,"TGGGTAAGCCTTTAATCACT","AGTATTTATAGGAGGTGAA","561307.5.peg.752","2191"
"30742",522,2,520,"CGATTCACTTGTTCGCTAAG","AGTATTTATAGGAGGTGAA","561307.5.peg.752","2191"
"30743",326,2,324,"AAAGATTGATGTAGTGTTGC","AGTATTTATAGGAGGTGAA","561307.5.peg.752","2191"
"30744",626,2,624,"GCGCTAAATGCAACCATGCA","AGTATTTATAGGAGGTGAA","561307.5.peg.752","2191"
"30745",708,2,706,"ACTGACTCTATCGTCATTTC","AGTATTTATAGGAGGTGAA","561307.5.peg.752","2191"
"30746",1002,2,1000,"TGTTGTAGTAATACATCGCT","AGTATTTATAGGAGGTGAA","561307.5.peg.752","2191"
"30747",798,2,796,"TACAACATACCTGCCCAACC","AGTATTTATAGGAGGTGAA","561307.5.peg.752","2191"
"30748",824,2,822,"CAAAGTGATGCTGTTGTGAA","AGTATTTATAGGAGGTGAA","561307.5.peg.752","2191"
"30749",1371,2,1369,"GCAATACCAATCGTTTCAAA","AGTATTTATAGGAGGTGAA","561307.5.peg.752","2191"
"30750",1105,2,1103,"AGATTCGTATGTCATTTCCC","AGTATTTATAGGAGGTGAA","561307.5.peg.752","2191"
"30751",764,2,762,"GATGTCCTTCAACATAAGCT","AGTATTTATAGGAGGTGAA","561307.5.peg.752","2191"
"30752",1341,2,1339,"GCTTCGATATGTCTACGAAA","AGTATTTATAGGAGGTGAA","561307.5.peg.752","2191"
"30753",486,2,484,"TCTATTATTGCATCACTCAT","AGTATTTATAGGAGGTGAA","561307.5.peg.752","2191"
"30754",798,144,654,"TACAACATACCTGCCCAACC","TCCGCTTCTAATCCTTCCCA","561307.5.peg.752","2191"
"30755",824,144,680,"CAAAGTGATGCTGTTGTGAA","TCCGCTTCTAATCCTTCCCA","561307.5.peg.752","2191"
"30756",326,144,182,"AAAGATTGATGTAGTGTTGC","TCCGCTTCTAATCCTTCCCA","561307.5.peg.752","2191"
"30757",626,144,482,"GCGCTAAATGCAACCATGCA","TCCGCTTCTAATCCTTCCCA","561307.5.peg.752","2191"
"30758",1002,144,858,"TGTTGTAGTAATACATCGCT","TCCGCTTCTAATCCTTCCCA","561307.5.peg.752","2191"
"30759",522,144,378,"CGATTCACTTGTTCGCTAAG","TCCGCTTCTAATCCTTCCCA","561307.5.peg.752","2191"
"30760",764,144,620,"GATGTCCTTCAACATAAGCT","TCCGCTTCTAATCCTTCCCA","561307.5.peg.752","2191"
"30761",1371,144,1227,"GCAATACCAATCGTTTCAAA","TCCGCTTCTAATCCTTCCCA","561307.5.peg.752","2191"
"30762",1341,144,1197,"GCTTCGATATGTCTACGAAA","TCCGCTTCTAATCCTTCCCA","561307.5.peg.752","2191"
"30763",1105,144,961,"AGATTCGTATGTCATTTCCC","TCCGCTTCTAATCCTTCCCA","561307.5.peg.752","2191"
"30764",486,144,342,"TCTATTATTGCATCACTCAT","TCCGCTTCTAATCCTTCCCA","561307.5.peg.752","2191"
"30765",680,144,536,"TGGGTAAGCCTTTAATCACT","TCCGCTTCTAATCCTTCCCA","561307.5.peg.752","2191"
"30766",699,144,555,"ATCGTCATTTCAGGATCATT","TCCGCTTCTAATCCTTCCCA","561307.5.peg.752","2191"
"30767",2,144,142,"AGTATTTATAGGAGGTGAA","TCCGCTTCTAATCCTTCCCA","561307.5.peg.752","2191"
"30768",708,144,564,"ACTGACTCTATCGTCATTTC","TCCGCTTCTAATCCTTCCCA","561307.5.peg.752","2191"
"30769",486,326,160,"TCTATTATTGCATCACTCAT","AAAGATTGATGTAGTGTTGC","561307.5.peg.752","2191"
"30770",1002,326,676,"TGTTGTAGTAATACATCGCT","AAAGATTGATGTAGTGTTGC","561307.5.peg.752","2191"
"30771",1105,326,779,"AGATTCGTATGTCATTTCCC","AAAGATTGATGTAGTGTTGC","561307.5.peg.752","2191"
"30772",680,326,354,"TGGGTAAGCCTTTAATCACT","AAAGATTGATGTAGTGTTGC","561307.5.peg.752","2191"
"30773",824,326,498,"CAAAGTGATGCTGTTGTGAA","AAAGATTGATGTAGTGTTGC","561307.5.peg.752","2191"
"30774",798,326,472,"TACAACATACCTGCCCAACC","AAAGATTGATGTAGTGTTGC","561307.5.peg.752","2191"
"30775",144,326,182,"TCCGCTTCTAATCCTTCCCA","AAAGATTGATGTAGTGTTGC","561307.5.peg.752","2191"
"30776",1341,326,1015,"GCTTCGATATGTCTACGAAA","AAAGATTGATGTAGTGTTGC","561307.5.peg.752","2191"
"30777",626,326,300,"GCGCTAAATGCAACCATGCA","AAAGATTGATGTAGTGTTGC","561307.5.peg.752","2191"
"30778",708,326,382,"ACTGACTCTATCGTCATTTC","AAAGATTGATGTAGTGTTGC","561307.5.peg.752","2191"
"30779",522,326,196,"CGATTCACTTGTTCGCTAAG","AAAGATTGATGTAGTGTTGC","561307.5.peg.752","2191"
"30780",1371,326,1045,"GCAATACCAATCGTTTCAAA","AAAGATTGATGTAGTGTTGC","561307.5.peg.752","2191"
"30781",699,326,373,"ATCGTCATTTCAGGATCATT","AAAGATTGATGTAGTGTTGC","561307.5.peg.752","2191"
"30782",764,326,438,"GATGTCCTTCAACATAAGCT","AAAGATTGATGTAGTGTTGC","561307.5.peg.752","2191"
"30783",2,326,324,"AGTATTTATAGGAGGTGAA","AAAGATTGATGTAGTGTTGC","561307.5.peg.752","2191"
"30784",2,486,484,"AGTATTTATAGGAGGTGAA","TCTATTATTGCATCACTCAT","561307.5.peg.752","2191"
"30785",764,486,278,"GATGTCCTTCAACATAAGCT","TCTATTATTGCATCACTCAT","561307.5.peg.752","2191"
"30786",626,486,140,"GCGCTAAATGCAACCATGCA","TCTATTATTGCATCACTCAT","561307.5.peg.752","2191"
"30787",1105,486,619,"AGATTCGTATGTCATTTCCC","TCTATTATTGCATCACTCAT","561307.5.peg.752","2191"
"30788",326,486,160,"AAAGATTGATGTAGTGTTGC","TCTATTATTGCATCACTCAT","561307.5.peg.752","2191"
"30789",1371,486,885,"GCAATACCAATCGTTTCAAA","TCTATTATTGCATCACTCAT","561307.5.peg.752","2191"
"30790",798,486,312,"TACAACATACCTGCCCAACC","TCTATTATTGCATCACTCAT","561307.5.peg.752","2191"
"30791",699,486,213,"ATCGTCATTTCAGGATCATT","TCTATTATTGCATCACTCAT","561307.5.peg.752","2191"
"30792",680,486,194,"TGGGTAAGCCTTTAATCACT","TCTATTATTGCATCACTCAT","561307.5.peg.752","2191"
"30793",824,486,338,"CAAAGTGATGCTGTTGTGAA","TCTATTATTGCATCACTCAT","561307.5.peg.752","2191"
"30794",1002,486,516,"TGTTGTAGTAATACATCGCT","TCTATTATTGCATCACTCAT","561307.5.peg.752","2191"
"30795",1341,486,855,"GCTTCGATATGTCTACGAAA","TCTATTATTGCATCACTCAT","561307.5.peg.752","2191"
"30796",144,486,342,"TCCGCTTCTAATCCTTCCCA","TCTATTATTGCATCACTCAT","561307.5.peg.752","2191"
"30797",708,486,222,"ACTGACTCTATCGTCATTTC","TCTATTATTGCATCACTCAT","561307.5.peg.752","2191"
"30798",326,522,196,"AAAGATTGATGTAGTGTTGC","CGATTCACTTGTTCGCTAAG","561307.5.peg.752","2191"
"30799",680,522,158,"TGGGTAAGCCTTTAATCACT","CGATTCACTTGTTCGCTAAG","561307.5.peg.752","2191"
"30800",708,522,186,"ACTGACTCTATCGTCATTTC","CGATTCACTTGTTCGCTAAG","561307.5.peg.752","2191"
"30801",1002,522,480,"TGTTGTAGTAATACATCGCT","CGATTCACTTGTTCGCTAAG","561307.5.peg.752","2191"
"30802",1371,522,849,"GCAATACCAATCGTTTCAAA","CGATTCACTTGTTCGCTAAG","561307.5.peg.752","2191"
"30803",824,522,302,"CAAAGTGATGCTGTTGTGAA","CGATTCACTTGTTCGCTAAG","561307.5.peg.752","2191"
"30804",798,522,276,"TACAACATACCTGCCCAACC","CGATTCACTTGTTCGCTAAG","561307.5.peg.752","2191"
"30805",764,522,242,"GATGTCCTTCAACATAAGCT","CGATTCACTTGTTCGCTAAG","561307.5.peg.752","2191"
"30806",1341,522,819,"GCTTCGATATGTCTACGAAA","CGATTCACTTGTTCGCTAAG","561307.5.peg.752","2191"
"30807",626,522,104,"GCGCTAAATGCAACCATGCA","CGATTCACTTGTTCGCTAAG","561307.5.peg.752","2191"
"30808",144,522,378,"TCCGCTTCTAATCCTTCCCA","CGATTCACTTGTTCGCTAAG","561307.5.peg.752","2191"
"30809",1105,522,583,"AGATTCGTATGTCATTTCCC","CGATTCACTTGTTCGCTAAG","561307.5.peg.752","2191"
"30810",699,522,177,"ATCGTCATTTCAGGATCATT","CGATTCACTTGTTCGCTAAG","561307.5.peg.752","2191"
"30811",2,522,520,"AGTATTTATAGGAGGTGAA","CGATTCACTTGTTCGCTAAG","561307.5.peg.752","2191"
"30812",326,626,300,"AAAGATTGATGTAGTGTTGC","GCGCTAAATGCAACCATGCA","561307.5.peg.752","2191"
"30813",522,626,104,"CGATTCACTTGTTCGCTAAG","GCGCTAAATGCAACCATGCA","561307.5.peg.752","2191"
"30814",144,626,482,"TCCGCTTCTAATCCTTCCCA","GCGCTAAATGCAACCATGCA","561307.5.peg.752","2191"
"30815",798,626,172,"TACAACATACCTGCCCAACC","GCGCTAAATGCAACCATGCA","561307.5.peg.752","2191"
"30816",764,626,138,"GATGTCCTTCAACATAAGCT","GCGCTAAATGCAACCATGCA","561307.5.peg.752","2191"
"30817",1105,626,479,"AGATTCGTATGTCATTTCCC","GCGCTAAATGCAACCATGCA","561307.5.peg.752","2191"
"30818",1341,626,715,"GCTTCGATATGTCTACGAAA","GCGCTAAATGCAACCATGCA","561307.5.peg.752","2191"
"30819",2,626,624,"AGTATTTATAGGAGGTGAA","GCGCTAAATGCAACCATGCA","561307.5.peg.752","2191"
"30820",486,626,140,"TCTATTATTGCATCACTCAT","GCGCTAAATGCAACCATGCA","561307.5.peg.752","2191"
"30821",824,626,198,"CAAAGTGATGCTGTTGTGAA","GCGCTAAATGCAACCATGCA","561307.5.peg.752","2191"
"30822",1002,626,376,"TGTTGTAGTAATACATCGCT","GCGCTAAATGCAACCATGCA","561307.5.peg.752","2191"
"30823",1371,626,745,"GCAATACCAATCGTTTCAAA","GCGCTAAATGCAACCATGCA","561307.5.peg.752","2191"
"30824",798,680,118,"TACAACATACCTGCCCAACC","TGGGTAAGCCTTTAATCACT","561307.5.peg.752","2191"
"30825",2,680,678,"AGTATTTATAGGAGGTGAA","TGGGTAAGCCTTTAATCACT","561307.5.peg.752","2191"
"30826",486,680,194,"TCTATTATTGCATCACTCAT","TGGGTAAGCCTTTAATCACT","561307.5.peg.752","2191"
"30827",326,680,354,"AAAGATTGATGTAGTGTTGC","TGGGTAAGCCTTTAATCACT","561307.5.peg.752","2191"
"30828",1105,680,425,"AGATTCGTATGTCATTTCCC","TGGGTAAGCCTTTAATCACT","561307.5.peg.752","2191"
"30829",1002,680,322,"TGTTGTAGTAATACATCGCT","TGGGTAAGCCTTTAATCACT","561307.5.peg.752","2191"
"30830",522,680,158,"CGATTCACTTGTTCGCTAAG","TGGGTAAGCCTTTAATCACT","561307.5.peg.752","2191"
"30831",144,680,536,"TCCGCTTCTAATCCTTCCCA","TGGGTAAGCCTTTAATCACT","561307.5.peg.752","2191"
"30832",1371,680,691,"GCAATACCAATCGTTTCAAA","TGGGTAAGCCTTTAATCACT","561307.5.peg.752","2191"
"30833",824,680,144,"CAAAGTGATGCTGTTGTGAA","TGGGTAAGCCTTTAATCACT","561307.5.peg.752","2191"
"30834",1341,680,661,"GCTTCGATATGTCTACGAAA","TGGGTAAGCCTTTAATCACT","561307.5.peg.752","2191"
"30835",326,699,373,"AAAGATTGATGTAGTGTTGC","ATCGTCATTTCAGGATCATT","561307.5.peg.752","2191"
"30836",824,699,125,"CAAAGTGATGCTGTTGTGAA","ATCGTCATTTCAGGATCATT","561307.5.peg.752","2191"
"30837",522,699,177,"CGATTCACTTGTTCGCTAAG","ATCGTCATTTCAGGATCATT","561307.5.peg.752","2191"
"30838",1002,699,303,"TGTTGTAGTAATACATCGCT","ATCGTCATTTCAGGATCATT","561307.5.peg.752","2191"
"30839",1105,699,406,"AGATTCGTATGTCATTTCCC","ATCGTCATTTCAGGATCATT","561307.5.peg.752","2191"
"30840",1371,699,672,"GCAATACCAATCGTTTCAAA","ATCGTCATTTCAGGATCATT","561307.5.peg.752","2191"
"30841",486,699,213,"TCTATTATTGCATCACTCAT","ATCGTCATTTCAGGATCATT","561307.5.peg.752","2191"
"30842",2,699,697,"AGTATTTATAGGAGGTGAA","ATCGTCATTTCAGGATCATT","561307.5.peg.752","2191"
"30843",144,699,555,"TCCGCTTCTAATCCTTCCCA","ATCGTCATTTCAGGATCATT","561307.5.peg.752","2191"
"30844",1341,699,642,"GCTTCGATATGTCTACGAAA","ATCGTCATTTCAGGATCATT","561307.5.peg.752","2191"
"30845",1002,708,294,"TGTTGTAGTAATACATCGCT","ACTGACTCTATCGTCATTTC","561307.5.peg.752","2191"
"30846",1341,708,633,"GCTTCGATATGTCTACGAAA","ACTGACTCTATCGTCATTTC","561307.5.peg.752","2191"
"30847",144,708,564,"TCCGCTTCTAATCCTTCCCA","ACTGACTCTATCGTCATTTC","561307.5.peg.752","2191"
"30848",1371,708,663,"GCAATACCAATCGTTTCAAA","ACTGACTCTATCGTCATTTC","561307.5.peg.752","2191"
"30849",326,708,382,"AAAGATTGATGTAGTGTTGC","ACTGACTCTATCGTCATTTC","561307.5.peg.752","2191"
"30850",824,708,116,"CAAAGTGATGCTGTTGTGAA","ACTGACTCTATCGTCATTTC","561307.5.peg.752","2191"
"30851",486,708,222,"TCTATTATTGCATCACTCAT","ACTGACTCTATCGTCATTTC","561307.5.peg.752","2191"
"30852",2,708,706,"AGTATTTATAGGAGGTGAA","ACTGACTCTATCGTCATTTC","561307.5.peg.752","2191"
"30853",1105,708,397,"AGATTCGTATGTCATTTCCC","ACTGACTCTATCGTCATTTC","561307.5.peg.752","2191"
"30854",522,708,186,"CGATTCACTTGTTCGCTAAG","ACTGACTCTATCGTCATTTC","561307.5.peg.752","2191"
"30855",1105,764,341,"AGATTCGTATGTCATTTCCC","GATGTCCTTCAACATAAGCT","561307.5.peg.752","2191"
"30856",486,764,278,"TCTATTATTGCATCACTCAT","GATGTCCTTCAACATAAGCT","561307.5.peg.752","2191"
"30857",626,764,138,"GCGCTAAATGCAACCATGCA","GATGTCCTTCAACATAAGCT","561307.5.peg.752","2191"
"30858",144,764,620,"TCCGCTTCTAATCCTTCCCA","GATGTCCTTCAACATAAGCT","561307.5.peg.752","2191"
"30859",1002,764,238,"TGTTGTAGTAATACATCGCT","GATGTCCTTCAACATAAGCT","561307.5.peg.752","2191"
"30860",1341,764,577,"GCTTCGATATGTCTACGAAA","GATGTCCTTCAACATAAGCT","561307.5.peg.752","2191"
"30861",1371,764,607,"GCAATACCAATCGTTTCAAA","GATGTCCTTCAACATAAGCT","561307.5.peg.752","2191"
"30862",522,764,242,"CGATTCACTTGTTCGCTAAG","GATGTCCTTCAACATAAGCT","561307.5.peg.752","2191"
"30863",326,764,438,"AAAGATTGATGTAGTGTTGC","GATGTCCTTCAACATAAGCT","561307.5.peg.752","2191"
"30864",2,764,762,"AGTATTTATAGGAGGTGAA","GATGTCCTTCAACATAAGCT","561307.5.peg.752","2191"
"30865",680,798,118,"TGGGTAAGCCTTTAATCACT","TACAACATACCTGCCCAACC","561307.5.peg.752","2191"
"30866",1341,798,543,"GCTTCGATATGTCTACGAAA","TACAACATACCTGCCCAACC","561307.5.peg.752","2191"
"30867",1371,798,573,"GCAATACCAATCGTTTCAAA","TACAACATACCTGCCCAACC","561307.5.peg.752","2191"
"30868",626,798,172,"GCGCTAAATGCAACCATGCA","TACAACATACCTGCCCAACC","561307.5.peg.752","2191"
"30869",486,798,312,"TCTATTATTGCATCACTCAT","TACAACATACCTGCCCAACC","561307.5.peg.752","2191"
"30870",1105,798,307,"AGATTCGTATGTCATTTCCC","TACAACATACCTGCCCAACC","561307.5.peg.752","2191"
"30871",2,798,796,"AGTATTTATAGGAGGTGAA","TACAACATACCTGCCCAACC","561307.5.peg.752","2191"
"30872",522,798,276,"CGATTCACTTGTTCGCTAAG","TACAACATACCTGCCCAACC","561307.5.peg.752","2191"
"30873",326,798,472,"AAAGATTGATGTAGTGTTGC","TACAACATACCTGCCCAACC","561307.5.peg.752","2191"
"30874",144,798,654,"TCCGCTTCTAATCCTTCCCA","TACAACATACCTGCCCAACC","561307.5.peg.752","2191"
"30875",1002,798,204,"TGTTGTAGTAATACATCGCT","TACAACATACCTGCCCAACC","561307.5.peg.752","2191"
"30876",680,824,144,"TGGGTAAGCCTTTAATCACT","CAAAGTGATGCTGTTGTGAA","561307.5.peg.752","2191"
"30877",708,824,116,"ACTGACTCTATCGTCATTTC","CAAAGTGATGCTGTTGTGAA","561307.5.peg.752","2191"
"30878",522,824,302,"CGATTCACTTGTTCGCTAAG","CAAAGTGATGCTGTTGTGAA","561307.5.peg.752","2191"
"30879",2,824,822,"AGTATTTATAGGAGGTGAA","CAAAGTGATGCTGTTGTGAA","561307.5.peg.752","2191"
"30880",1371,824,547,"GCAATACCAATCGTTTCAAA","CAAAGTGATGCTGTTGTGAA","561307.5.peg.752","2191"
"30881",1105,824,281,"AGATTCGTATGTCATTTCCC","CAAAGTGATGCTGTTGTGAA","561307.5.peg.752","2191"
"30882",626,824,198,"GCGCTAAATGCAACCATGCA","CAAAGTGATGCTGTTGTGAA","561307.5.peg.752","2191"
"30883",1002,824,178,"TGTTGTAGTAATACATCGCT","CAAAGTGATGCTGTTGTGAA","561307.5.peg.752","2191"
"30884",1341,824,517,"GCTTCGATATGTCTACGAAA","CAAAGTGATGCTGTTGTGAA","561307.5.peg.752","2191"
"30885",326,824,498,"AAAGATTGATGTAGTGTTGC","CAAAGTGATGCTGTTGTGAA","561307.5.peg.752","2191"
"30886",144,824,680,"TCCGCTTCTAATCCTTCCCA","CAAAGTGATGCTGTTGTGAA","561307.5.peg.752","2191"
"30887",486,824,338,"TCTATTATTGCATCACTCAT","CAAAGTGATGCTGTTGTGAA","561307.5.peg.752","2191"
"30888",699,824,125,"ATCGTCATTTCAGGATCATT","CAAAGTGATGCTGTTGTGAA","561307.5.peg.752","2191"
"30889",144,1002,858,"TCCGCTTCTAATCCTTCCCA","TGTTGTAGTAATACATCGCT","561307.5.peg.752","2191"
"30890",522,1002,480,"CGATTCACTTGTTCGCTAAG","TGTTGTAGTAATACATCGCT","561307.5.peg.752","2191"
"30891",1105,1002,103,"AGATTCGTATGTCATTTCCC","TGTTGTAGTAATACATCGCT","561307.5.peg.752","2191"
"30892",680,1002,322,"TGGGTAAGCCTTTAATCACT","TGTTGTAGTAATACATCGCT","561307.5.peg.752","2191"
"30893",764,1002,238,"GATGTCCTTCAACATAAGCT","TGTTGTAGTAATACATCGCT","561307.5.peg.752","2191"
"30894",2,1002,1000,"AGTATTTATAGGAGGTGAA","TGTTGTAGTAATACATCGCT","561307.5.peg.752","2191"
"30895",824,1002,178,"CAAAGTGATGCTGTTGTGAA","TGTTGTAGTAATACATCGCT","561307.5.peg.752","2191"
"30896",1371,1002,369,"GCAATACCAATCGTTTCAAA","TGTTGTAGTAATACATCGCT","561307.5.peg.752","2191"
"30897",699,1002,303,"ATCGTCATTTCAGGATCATT","TGTTGTAGTAATACATCGCT","561307.5.peg.752","2191"
"30898",708,1002,294,"ACTGACTCTATCGTCATTTC","TGTTGTAGTAATACATCGCT","561307.5.peg.752","2191"
"30899",326,1002,676,"AAAGATTGATGTAGTGTTGC","TGTTGTAGTAATACATCGCT","561307.5.peg.752","2191"
"30900",486,1002,516,"TCTATTATTGCATCACTCAT","TGTTGTAGTAATACATCGCT","561307.5.peg.752","2191"
"30901",1341,1002,339,"GCTTCGATATGTCTACGAAA","TGTTGTAGTAATACATCGCT","561307.5.peg.752","2191"
"30902",626,1002,376,"GCGCTAAATGCAACCATGCA","TGTTGTAGTAATACATCGCT","561307.5.peg.752","2191"
"30903",798,1002,204,"TACAACATACCTGCCCAACC","TGTTGTAGTAATACATCGCT","561307.5.peg.752","2191"
"30904",798,1105,307,"TACAACATACCTGCCCAACC","AGATTCGTATGTCATTTCCC","561307.5.peg.752","2191"
"30905",2,1105,1103,"AGTATTTATAGGAGGTGAA","AGATTCGTATGTCATTTCCC","561307.5.peg.752","2191"
"30906",326,1105,779,"AAAGATTGATGTAGTGTTGC","AGATTCGTATGTCATTTCCC","561307.5.peg.752","2191"
"30907",1371,1105,266,"GCAATACCAATCGTTTCAAA","AGATTCGTATGTCATTTCCC","561307.5.peg.752","2191"
"30908",522,1105,583,"CGATTCACTTGTTCGCTAAG","AGATTCGTATGTCATTTCCC","561307.5.peg.752","2191"
"30909",1341,1105,236,"GCTTCGATATGTCTACGAAA","AGATTCGTATGTCATTTCCC","561307.5.peg.752","2191"
"30910",1002,1105,103,"TGTTGTAGTAATACATCGCT","AGATTCGTATGTCATTTCCC","561307.5.peg.752","2191"
"30911",486,1105,619,"TCTATTATTGCATCACTCAT","AGATTCGTATGTCATTTCCC","561307.5.peg.752","2191"
"30912",708,1105,397,"ACTGACTCTATCGTCATTTC","AGATTCGTATGTCATTTCCC","561307.5.peg.752","2191"
"30913",699,1105,406,"ATCGTCATTTCAGGATCATT","AGATTCGTATGTCATTTCCC","561307.5.peg.752","2191"
"30914",680,1105,425,"TGGGTAAGCCTTTAATCACT","AGATTCGTATGTCATTTCCC","561307.5.peg.752","2191"
"30915",626,1105,479,"GCGCTAAATGCAACCATGCA","AGATTCGTATGTCATTTCCC","561307.5.peg.752","2191"
"30916",144,1105,961,"TCCGCTTCTAATCCTTCCCA","AGATTCGTATGTCATTTCCC","561307.5.peg.752","2191"
"30917",764,1105,341,"GATGTCCTTCAACATAAGCT","AGATTCGTATGTCATTTCCC","561307.5.peg.752","2191"
"30918",824,1105,281,"CAAAGTGATGCTGTTGTGAA","AGATTCGTATGTCATTTCCC","561307.5.peg.752","2191"
"30919",798,1341,543,"TACAACATACCTGCCCAACC","GCTTCGATATGTCTACGAAA","561307.5.peg.752","2191"
"30920",824,1341,517,"CAAAGTGATGCTGTTGTGAA","GCTTCGATATGTCTACGAAA","561307.5.peg.752","2191"
"30921",1105,1341,236,"AGATTCGTATGTCATTTCCC","GCTTCGATATGTCTACGAAA","561307.5.peg.752","2191"
"30922",486,1341,855,"TCTATTATTGCATCACTCAT","GCTTCGATATGTCTACGAAA","561307.5.peg.752","2191"
"30923",1002,1341,339,"TGTTGTAGTAATACATCGCT","GCTTCGATATGTCTACGAAA","561307.5.peg.752","2191"
"30924",699,1341,642,"ATCGTCATTTCAGGATCATT","GCTTCGATATGTCTACGAAA","561307.5.peg.752","2191"
"30925",708,1341,633,"ACTGACTCTATCGTCATTTC","GCTTCGATATGTCTACGAAA","561307.5.peg.752","2191"
"30926",680,1341,661,"TGGGTAAGCCTTTAATCACT","GCTTCGATATGTCTACGAAA","561307.5.peg.752","2191"
"30927",144,1341,1197,"TCCGCTTCTAATCCTTCCCA","GCTTCGATATGTCTACGAAA","561307.5.peg.752","2191"
"30928",626,1341,715,"GCGCTAAATGCAACCATGCA","GCTTCGATATGTCTACGAAA","561307.5.peg.752","2191"
"30929",2,1341,1339,"AGTATTTATAGGAGGTGAA","GCTTCGATATGTCTACGAAA","561307.5.peg.752","2191"
"30930",326,1341,1015,"AAAGATTGATGTAGTGTTGC","GCTTCGATATGTCTACGAAA","561307.5.peg.752","2191"
"30931",522,1341,819,"CGATTCACTTGTTCGCTAAG","GCTTCGATATGTCTACGAAA","561307.5.peg.752","2191"
"30932",764,1341,577,"GATGTCCTTCAACATAAGCT","GCTTCGATATGTCTACGAAA","561307.5.peg.752","2191"
"30933",326,1371,1045,"AAAGATTGATGTAGTGTTGC","GCAATACCAATCGTTTCAAA","561307.5.peg.752","2191"
"30934",486,1371,885,"TCTATTATTGCATCACTCAT","GCAATACCAATCGTTTCAAA","561307.5.peg.752","2191"
"30935",798,1371,573,"TACAACATACCTGCCCAACC","GCAATACCAATCGTTTCAAA","561307.5.peg.752","2191"
"30936",2,1371,1369,"AGTATTTATAGGAGGTGAA","GCAATACCAATCGTTTCAAA","561307.5.peg.752","2191"
"30937",144,1371,1227,"TCCGCTTCTAATCCTTCCCA","GCAATACCAATCGTTTCAAA","561307.5.peg.752","2191"
"30938",522,1371,849,"CGATTCACTTGTTCGCTAAG","GCAATACCAATCGTTTCAAA","561307.5.peg.752","2191"
"30939",764,1371,607,"GATGTCCTTCAACATAAGCT","GCAATACCAATCGTTTCAAA","561307.5.peg.752","2191"
"30940",1002,1371,369,"TGTTGTAGTAATACATCGCT","GCAATACCAATCGTTTCAAA","561307.5.peg.752","2191"
"30941",708,1371,663,"ACTGACTCTATCGTCATTTC","GCAATACCAATCGTTTCAAA","561307.5.peg.752","2191"
"30942",1105,1371,266,"AGATTCGTATGTCATTTCCC","GCAATACCAATCGTTTCAAA","561307.5.peg.752","2191"
"30943",680,1371,691,"TGGGTAAGCCTTTAATCACT","GCAATACCAATCGTTTCAAA","561307.5.peg.752","2191"
"30944",824,1371,547,"CAAAGTGATGCTGTTGTGAA","GCAATACCAATCGTTTCAAA","561307.5.peg.752","2191"
"30945",626,1371,745,"GCGCTAAATGCAACCATGCA","GCAATACCAATCGTTTCAAA","561307.5.peg.752","2191"
"30946",699,1371,672,"ATCGTCATTTCAGGATCATT","GCAATACCAATCGTTTCAAA","561307.5.peg.752","2191"
"30947",195,12,183,"AAACCATGACCTGGATAATT","AACATCTTTAGACATAGTGG","561307.5.peg.756","2195"
"30948",204,12,192,"TTCAACAATAAACCATGACC","AACATCTTTAGACATAGTGG","561307.5.peg.756","2195"
"30949",173,12,161,"GTGCATAACAACTAAATCCT","AACATCTTTAGACATAGTGG","561307.5.peg.756","2195"
"30950",372,12,360,"ATGACAGCGATACGTTTCAA","AACATCTTTAGACATAGTGG","561307.5.peg.756","2195"
"30951",204,15,189,"TTCAACAATAAACCATGACC","GCAAACATCTTTAGACATAG","561307.5.peg.756","2195"
"30952",173,15,158,"GTGCATAACAACTAAATCCT","GCAAACATCTTTAGACATAG","561307.5.peg.756","2195"
"30953",372,15,357,"ATGACAGCGATACGTTTCAA","GCAAACATCTTTAGACATAG","561307.5.peg.756","2195"
"30954",195,15,180,"AAACCATGACCTGGATAATT","GCAAACATCTTTAGACATAG","561307.5.peg.756","2195"
"30955",15,173,158,"GCAAACATCTTTAGACATAG","GTGCATAACAACTAAATCCT","561307.5.peg.756","2195"
"30956",12,173,161,"AACATCTTTAGACATAGTGG","GTGCATAACAACTAAATCCT","561307.5.peg.756","2195"
"30957",372,173,199,"ATGACAGCGATACGTTTCAA","GTGCATAACAACTAAATCCT","561307.5.peg.756","2195"
"30958",15,195,180,"GCAAACATCTTTAGACATAG","AAACCATGACCTGGATAATT","561307.5.peg.756","2195"
"30959",12,195,183,"AACATCTTTAGACATAGTGG","AAACCATGACCTGGATAATT","561307.5.peg.756","2195"
"30960",372,195,177,"ATGACAGCGATACGTTTCAA","AAACCATGACCTGGATAATT","561307.5.peg.756","2195"
"30961",12,204,192,"AACATCTTTAGACATAGTGG","TTCAACAATAAACCATGACC","561307.5.peg.756","2195"
"30962",15,204,189,"GCAAACATCTTTAGACATAG","TTCAACAATAAACCATGACC","561307.5.peg.756","2195"
"30963",372,204,168,"ATGACAGCGATACGTTTCAA","TTCAACAATAAACCATGACC","561307.5.peg.756","2195"
"30964",12,372,360,"AACATCTTTAGACATAGTGG","ATGACAGCGATACGTTTCAA","561307.5.peg.756","2195"
"30965",15,372,357,"GCAAACATCTTTAGACATAG","ATGACAGCGATACGTTTCAA","561307.5.peg.756","2195"
"30966",204,372,168,"TTCAACAATAAACCATGACC","ATGACAGCGATACGTTTCAA","561307.5.peg.756","2195"
"30967",173,372,199,"GTGCATAACAACTAAATCCT","ATGACAGCGATACGTTTCAA","561307.5.peg.756","2195"
"30968",195,372,177,"AAACCATGACCTGGATAATT","ATGACAGCGATACGTTTCAA","561307.5.peg.756","2195"
"30969",490,133,357,"GAATATACCTTGCCCTAGAA","CATATATGGGAATTTCCACA","561307.5.peg.758","2197"
"30970",480,133,347,"TGCCCTAGAACGGTTAACCA","CATATATGGGAATTTCCACA","561307.5.peg.758","2197"
"30971",672,133,539,"GCAGTAATCTCTGATACTCT","CATATATGGGAATTTCCACA","561307.5.peg.758","2197"
"30972",480,146,334,"TGCCCTAGAACGGTTAACCA","CATAAATCCCTGCCATATAT","561307.5.peg.758","2197"
"30973",672,146,526,"GCAGTAATCTCTGATACTCT","CATAAATCCCTGCCATATAT","561307.5.peg.758","2197"
"30974",490,146,344,"GAATATACCTTGCCCTAGAA","CATAAATCCCTGCCATATAT","561307.5.peg.758","2197"
"30975",133,480,347,"CATATATGGGAATTTCCACA","TGCCCTAGAACGGTTAACCA","561307.5.peg.758","2197"
"30976",672,480,192,"GCAGTAATCTCTGATACTCT","TGCCCTAGAACGGTTAACCA","561307.5.peg.758","2197"
"30977",146,480,334,"CATAAATCCCTGCCATATAT","TGCCCTAGAACGGTTAACCA","561307.5.peg.758","2197"
"30978",133,490,357,"CATATATGGGAATTTCCACA","GAATATACCTTGCCCTAGAA","561307.5.peg.758","2197"
"30979",672,490,182,"GCAGTAATCTCTGATACTCT","GAATATACCTTGCCCTAGAA","561307.5.peg.758","2197"
"30980",146,490,344,"CATAAATCCCTGCCATATAT","GAATATACCTTGCCCTAGAA","561307.5.peg.758","2197"
"30981",133,672,539,"CATATATGGGAATTTCCACA","GCAGTAATCTCTGATACTCT","561307.5.peg.758","2197"
"30982",146,672,526,"CATAAATCCCTGCCATATAT","GCAGTAATCTCTGATACTCT","561307.5.peg.758","2197"
"30983",480,672,192,"TGCCCTAGAACGGTTAACCA","GCAGTAATCTCTGATACTCT","561307.5.peg.758","2197"
"30984",490,672,182,"GAATATACCTTGCCCTAGAA","GCAGTAATCTCTGATACTCT","561307.5.peg.758","2197"
"30985",150,8,142,"CTGTCTTTAACACTGCCTCC","TTGATCGGCATGTCAGATGA","561307.5.peg.759","2198"
"30986",130,8,122,"AGGATTCCATTGTTCAAGCT","TTGATCGGCATGTCAGATGA","561307.5.peg.759","2198"
"30987",472,8,464,"ATATGTATCCGGATTATGTT","TTGATCGGCATGTCAGATGA","561307.5.peg.759","2198"
"30988",130,23,107,"AGGATTCCATTGTTCAAGCT","AAGGTTTCATTCATTTGAT","561307.5.peg.759","2198"
"30989",472,23,449,"ATATGTATCCGGATTATGTT","AAGGTTTCATTCATTTGAT","561307.5.peg.759","2198"
"30990",150,23,127,"CTGTCTTTAACACTGCCTCC","AAGGTTTCATTCATTTGAT","561307.5.peg.759","2198"
"30991",8,130,122,"TTGATCGGCATGTCAGATGA","AGGATTCCATTGTTCAAGCT","561307.5.peg.759","2198"
"30992",472,130,342,"ATATGTATCCGGATTATGTT","AGGATTCCATTGTTCAAGCT","561307.5.peg.759","2198"
"30993",23,130,107,"AAGGTTTCATTCATTTGAT","AGGATTCCATTGTTCAAGCT","561307.5.peg.759","2198"
"30994",8,150,142,"TTGATCGGCATGTCAGATGA","CTGTCTTTAACACTGCCTCC","561307.5.peg.759","2198"
"30995",472,150,322,"ATATGTATCCGGATTATGTT","CTGTCTTTAACACTGCCTCC","561307.5.peg.759","2198"
"30996",23,150,127,"AAGGTTTCATTCATTTGAT","CTGTCTTTAACACTGCCTCC","561307.5.peg.759","2198"
"30997",8,472,464,"TTGATCGGCATGTCAGATGA","ATATGTATCCGGATTATGTT","561307.5.peg.759","2198"
"30998",23,472,449,"AAGGTTTCATTCATTTGAT","ATATGTATCCGGATTATGTT","561307.5.peg.759","2198"
"30999",130,472,342,"AGGATTCCATTGTTCAAGCT","ATATGTATCCGGATTATGTT","561307.5.peg.759","2198"
"31000",150,472,322,"CTGTCTTTAACACTGCCTCC","ATATGTATCCGGATTATGTT","561307.5.peg.759","2198"
"31001",489,201,288,"TGTCAGTAACACGTAATAA","CTTTCTACAGAACTTCTTGT","561307.5.peg.760","2200"
"31002",201,489,288,"CTTTCTACAGAACTTCTTGT","TGTCAGTAACACGTAATAA","561307.5.peg.760","2200"
"31003",223,3,220,"TACAATCACTTGTCCATTCG","TAATAAGAATTTGTAGGAG","561307.5.peg.761","2201"
"31004",465,3,462,"TGCCCACCAGATAATTCATC","TAATAAGAATTTGTAGGAG","561307.5.peg.761","2201"
"31005",539,3,536,"CGCTTGTTGCTTCATCGCAT","TAATAAGAATTTGTAGGAG","561307.5.peg.761","2201"
"31006",223,27,196,"TACAATCACTTGTCCATTCG","ATAATGCTCTTATTCCTAG","561307.5.peg.761","2201"
"31007",539,27,512,"CGCTTGTTGCTTCATCGCAT","ATAATGCTCTTATTCCTAG","561307.5.peg.761","2201"
"31008",465,27,438,"TGCCCACCAGATAATTCATC","ATAATGCTCTTATTCCTAG","561307.5.peg.761","2201"
"31009",3,223,220,"TAATAAGAATTTGTAGGAG","TACAATCACTTGTCCATTCG","561307.5.peg.761","2201"
"31010",27,223,196,"ATAATGCTCTTATTCCTAG","TACAATCACTTGTCCATTCG","561307.5.peg.761","2201"
"31011",465,223,242,"TGCCCACCAGATAATTCATC","TACAATCACTTGTCCATTCG","561307.5.peg.761","2201"
"31012",539,223,316,"CGCTTGTTGCTTCATCGCAT","TACAATCACTTGTCCATTCG","561307.5.peg.761","2201"
"31013",3,465,462,"TAATAAGAATTTGTAGGAG","TGCCCACCAGATAATTCATC","561307.5.peg.761","2201"
"31014",27,465,438,"ATAATGCTCTTATTCCTAG","TGCCCACCAGATAATTCATC","561307.5.peg.761","2201"
"31015",223,465,242,"TACAATCACTTGTCCATTCG","TGCCCACCAGATAATTCATC","561307.5.peg.761","2201"
"31016",3,539,536,"TAATAAGAATTTGTAGGAG","CGCTTGTTGCTTCATCGCAT","561307.5.peg.761","2201"
"31017",223,539,316,"TACAATCACTTGTCCATTCG","CGCTTGTTGCTTCATCGCAT","561307.5.peg.761","2201"
"31018",27,539,512,"ATAATGCTCTTATTCCTAG","CGCTTGTTGCTTCATCGCAT","561307.5.peg.761","2201"
"31019",147,12,135,"ATTGCCCACACTGATTCACC","TGTTAGGAAAGTTAAGCAAG","561307.5.peg.764","2204"
"31020",12,147,135,"TGTTAGGAAAGTTAAGCAAG","ATTGCCCACACTGATTCACC","561307.5.peg.764","2204"
"31021",201,6,195,"CTGCCATCCATTACAACGAT","GTTTGGATTGAAACTTATGG","561307.5.peg.767","2207"
"31022",201,23,178,"CTGCCATCCATTACAACGAT","TTGCGCCTGCTGTCAAAGTT","561307.5.peg.767","2207"
"31023",201,67,134,"CTGCCATCCATTACAACGAT","GACATAATGTCGTAACATGA","561307.5.peg.767","2207"
"31024",201,89,112,"CTGCCATCCATTACAACGAT","CTAACATCGAATAATCTTGT","561307.5.peg.767","2207"
"31025",6,201,195,"GTTTGGATTGAAACTTATGG","CTGCCATCCATTACAACGAT","561307.5.peg.767","2207"
"31026",23,201,178,"TTGCGCCTGCTGTCAAAGTT","CTGCCATCCATTACAACGAT","561307.5.peg.767","2207"
"31027",67,201,134,"GACATAATGTCGTAACATGA","CTGCCATCCATTACAACGAT","561307.5.peg.767","2207"
"31028",89,201,112,"CTAACATCGAATAATCTTGT","CTGCCATCCATTACAACGAT","561307.5.peg.767","2207"
"31029",373,195,178,"TATGTTTCATCTTGTTGTT","AAGAATGTGACGACATAAAT","561307.5.peg.768","2208"
"31030",195,373,178,"AAGAATGTGACGACATAAAT","TATGTTTCATCTTGTTGTT","561307.5.peg.768","2208"
"31031",321,144,177,"AAGGACCCAAGCAATGAACC","ACACCGAGGTAAACCATTGT","561307.5.peg.77","2210"
"31032",321,158,163,"AAGGACCCAAGCAATGAACC","GTAATCCATGTTCAACACCG","561307.5.peg.77","2210"
"31033",144,321,177,"ACACCGAGGTAAACCATTGT","AAGGACCCAAGCAATGAACC","561307.5.peg.77","2210"
"31034",158,321,163,"GTAATCCATGTTCAACACCG","AAGGACCCAAGCAATGAACC","561307.5.peg.77","2210"
"31035",1599,299,1300,"TCACGATACGCATCAATTGG","CGGCATATTCACCTTCACCT","561307.5.peg.771","2212"
"31036",1326,299,1027,"TATCAATCCACGCTTTATA","CGGCATATTCACCTTCACCT","561307.5.peg.771","2212"
"31037",1826,299,1527,"TTACAGCATTCACTGCTTCT","CGGCATATTCACCTTCACCT","561307.5.peg.771","2212"
"31038",1914,299,1615,"TGACTTATTGCGAGTAACAT","CGGCATATTCACCTTCACCT","561307.5.peg.771","2212"
"31039",2061,299,1762,"ACTGTACGTTGCGCTAGGTA","CGGCATATTCACCTTCACCT","561307.5.peg.771","2212"
"31040",1497,299,1198,"TCATATCCCATTGCACCGAT","CGGCATATTCACCTTCACCT","561307.5.peg.771","2212"
"31041",756,299,457,"TATGCATTAACATACGGTT","CGGCATATTCACCTTCACCT","561307.5.peg.771","2212"
"31042",2066,299,1767,"GTTCAACTGTACGTTGCGCT","CGGCATATTCACCTTCACCT","561307.5.peg.771","2212"
"31043",1716,299,1417,"AAGTGTGATTCATTCAATAC","CGGCATATTCACCTTCACCT","561307.5.peg.771","2212"
"31044",474,299,175,"TAAACACTTGTTGAATGAC","CGGCATATTCACCTTCACCT","561307.5.peg.771","2212"
"31045",1137,299,838,"TTAGTAATCGTATAACGACC","CGGCATATTCACCTTCACCT","561307.5.peg.771","2212"
"31046",910,299,611,"CTCTAGCGCATTATCTACAA","CGGCATATTCACCTTCACCT","561307.5.peg.771","2212"
"31047",987,299,688,"TCGCTTCATTATATAACCA","CGGCATATTCACCTTCACCT","561307.5.peg.771","2212"
"31048",2119,299,1820,"TGTCTTAACATTATCGACAA","CGGCATATTCACCTTCACCT","561307.5.peg.771","2212"
"31049",981,299,682,"CATTATATAACCAAGGTTC","CGGCATATTCACCTTCACCT","561307.5.peg.771","2212"
"31050",1059,299,760,"ATCATTGTAGGACCATCCCA","CGGCATATTCACCTTCACCT","561307.5.peg.771","2212"
"31051",1524,299,1225,"CGCTCGTTCAACACTGCAAT","CGGCATATTCACCTTCACCT","561307.5.peg.771","2212"
"31052",299,474,175,"CGGCATATTCACCTTCACCT","TAAACACTTGTTGAATGAC","561307.5.peg.771","2212"
"31053",1599,474,1125,"TCACGATACGCATCAATTGG","TAAACACTTGTTGAATGAC","561307.5.peg.771","2212"
"31054",1826,474,1352,"TTACAGCATTCACTGCTTCT","TAAACACTTGTTGAATGAC","561307.5.peg.771","2212"
"31055",1716,474,1242,"AAGTGTGATTCATTCAATAC","TAAACACTTGTTGAATGAC","561307.5.peg.771","2212"
"31056",1326,474,852,"TATCAATCCACGCTTTATA","TAAACACTTGTTGAATGAC","561307.5.peg.771","2212"
"31057",2119,474,1645,"TGTCTTAACATTATCGACAA","TAAACACTTGTTGAATGAC","561307.5.peg.771","2212"
"31058",981,474,507,"CATTATATAACCAAGGTTC","TAAACACTTGTTGAATGAC","561307.5.peg.771","2212"
"31059",756,474,282,"TATGCATTAACATACGGTT","TAAACACTTGTTGAATGAC","561307.5.peg.771","2212"
"31060",1524,474,1050,"CGCTCGTTCAACACTGCAAT","TAAACACTTGTTGAATGAC","561307.5.peg.771","2212"
"31061",987,474,513,"TCGCTTCATTATATAACCA","TAAACACTTGTTGAATGAC","561307.5.peg.771","2212"
"31062",1137,474,663,"TTAGTAATCGTATAACGACC","TAAACACTTGTTGAATGAC","561307.5.peg.771","2212"
"31063",2061,474,1587,"ACTGTACGTTGCGCTAGGTA","TAAACACTTGTTGAATGAC","561307.5.peg.771","2212"
"31064",2066,474,1592,"GTTCAACTGTACGTTGCGCT","TAAACACTTGTTGAATGAC","561307.5.peg.771","2212"
"31065",910,474,436,"CTCTAGCGCATTATCTACAA","TAAACACTTGTTGAATGAC","561307.5.peg.771","2212"
"31066",1497,474,1023,"TCATATCCCATTGCACCGAT","TAAACACTTGTTGAATGAC","561307.5.peg.771","2212"
"31067",1059,474,585,"ATCATTGTAGGACCATCCCA","TAAACACTTGTTGAATGAC","561307.5.peg.771","2212"
"31068",1914,474,1440,"TGACTTATTGCGAGTAACAT","TAAACACTTGTTGAATGAC","561307.5.peg.771","2212"
"31069",1059,756,303,"ATCATTGTAGGACCATCCCA","TATGCATTAACATACGGTT","561307.5.peg.771","2212"
"31070",1716,756,960,"AAGTGTGATTCATTCAATAC","TATGCATTAACATACGGTT","561307.5.peg.771","2212"
"31071",981,756,225,"CATTATATAACCAAGGTTC","TATGCATTAACATACGGTT","561307.5.peg.771","2212"
"31072",1497,756,741,"TCATATCCCATTGCACCGAT","TATGCATTAACATACGGTT","561307.5.peg.771","2212"
"31073",1914,756,1158,"TGACTTATTGCGAGTAACAT","TATGCATTAACATACGGTT","561307.5.peg.771","2212"
"31074",2066,756,1310,"GTTCAACTGTACGTTGCGCT","TATGCATTAACATACGGTT","561307.5.peg.771","2212"
"31075",1599,756,843,"TCACGATACGCATCAATTGG","TATGCATTAACATACGGTT","561307.5.peg.771","2212"
"31076",299,756,457,"CGGCATATTCACCTTCACCT","TATGCATTAACATACGGTT","561307.5.peg.771","2212"
"31077",474,756,282,"TAAACACTTGTTGAATGAC","TATGCATTAACATACGGTT","561307.5.peg.771","2212"
"31078",2061,756,1305,"ACTGTACGTTGCGCTAGGTA","TATGCATTAACATACGGTT","561307.5.peg.771","2212"
"31079",987,756,231,"TCGCTTCATTATATAACCA","TATGCATTAACATACGGTT","561307.5.peg.771","2212"
"31080",1524,756,768,"CGCTCGTTCAACACTGCAAT","TATGCATTAACATACGGTT","561307.5.peg.771","2212"
"31081",1137,756,381,"TTAGTAATCGTATAACGACC","TATGCATTAACATACGGTT","561307.5.peg.771","2212"
"31082",1826,756,1070,"TTACAGCATTCACTGCTTCT","TATGCATTAACATACGGTT","561307.5.peg.771","2212"
"31083",2119,756,1363,"TGTCTTAACATTATCGACAA","TATGCATTAACATACGGTT","561307.5.peg.771","2212"
"31084",910,756,154,"CTCTAGCGCATTATCTACAA","TATGCATTAACATACGGTT","561307.5.peg.771","2212"
"31085",1326,756,570,"TATCAATCCACGCTTTATA","TATGCATTAACATACGGTT","561307.5.peg.771","2212"
"31086",1059,910,149,"ATCATTGTAGGACCATCCCA","CTCTAGCGCATTATCTACAA","561307.5.peg.771","2212"
"31087",1599,910,689,"TCACGATACGCATCAATTGG","CTCTAGCGCATTATCTACAA","561307.5.peg.771","2212"
"31088",299,910,611,"CGGCATATTCACCTTCACCT","CTCTAGCGCATTATCTACAA","561307.5.peg.771","2212"
"31089",1326,910,416,"TATCAATCCACGCTTTATA","CTCTAGCGCATTATCTACAA","561307.5.peg.771","2212"
"31090",2119,910,1209,"TGTCTTAACATTATCGACAA","CTCTAGCGCATTATCTACAA","561307.5.peg.771","2212"
"31091",2066,910,1156,"GTTCAACTGTACGTTGCGCT","CTCTAGCGCATTATCTACAA","561307.5.peg.771","2212"
"31092",756,910,154,"TATGCATTAACATACGGTT","CTCTAGCGCATTATCTACAA","561307.5.peg.771","2212"
"31093",1826,910,916,"TTACAGCATTCACTGCTTCT","CTCTAGCGCATTATCTACAA","561307.5.peg.771","2212"
"31094",474,910,436,"TAAACACTTGTTGAATGAC","CTCTAGCGCATTATCTACAA","561307.5.peg.771","2212"
"31095",1524,910,614,"CGCTCGTTCAACACTGCAAT","CTCTAGCGCATTATCTACAA","561307.5.peg.771","2212"
"31096",1497,910,587,"TCATATCCCATTGCACCGAT","CTCTAGCGCATTATCTACAA","561307.5.peg.771","2212"
"31097",1716,910,806,"AAGTGTGATTCATTCAATAC","CTCTAGCGCATTATCTACAA","561307.5.peg.771","2212"
"31098",2061,910,1151,"ACTGTACGTTGCGCTAGGTA","CTCTAGCGCATTATCTACAA","561307.5.peg.771","2212"
"31099",1137,910,227,"TTAGTAATCGTATAACGACC","CTCTAGCGCATTATCTACAA","561307.5.peg.771","2212"
"31100",1914,910,1004,"TGACTTATTGCGAGTAACAT","CTCTAGCGCATTATCTACAA","561307.5.peg.771","2212"
"31101",474,981,507,"TAAACACTTGTTGAATGAC","CATTATATAACCAAGGTTC","561307.5.peg.771","2212"
"31102",1137,981,156,"TTAGTAATCGTATAACGACC","CATTATATAACCAAGGTTC","561307.5.peg.771","2212"
"31103",2066,981,1085,"GTTCAACTGTACGTTGCGCT","CATTATATAACCAAGGTTC","561307.5.peg.771","2212"
"31104",756,981,225,"TATGCATTAACATACGGTT","CATTATATAACCAAGGTTC","561307.5.peg.771","2212"
"31105",1914,981,933,"TGACTTATTGCGAGTAACAT","CATTATATAACCAAGGTTC","561307.5.peg.771","2212"
"31106",2061,981,1080,"ACTGTACGTTGCGCTAGGTA","CATTATATAACCAAGGTTC","561307.5.peg.771","2212"
"31107",2119,981,1138,"TGTCTTAACATTATCGACAA","CATTATATAACCAAGGTTC","561307.5.peg.771","2212"
"31108",1326,981,345,"TATCAATCCACGCTTTATA","CATTATATAACCAAGGTTC","561307.5.peg.771","2212"
"31109",1826,981,845,"TTACAGCATTCACTGCTTCT","CATTATATAACCAAGGTTC","561307.5.peg.771","2212"
"31110",1497,981,516,"TCATATCCCATTGCACCGAT","CATTATATAACCAAGGTTC","561307.5.peg.771","2212"
"31111",299,981,682,"CGGCATATTCACCTTCACCT","CATTATATAACCAAGGTTC","561307.5.peg.771","2212"
"31112",1599,981,618,"TCACGATACGCATCAATTGG","CATTATATAACCAAGGTTC","561307.5.peg.771","2212"
"31113",1716,981,735,"AAGTGTGATTCATTCAATAC","CATTATATAACCAAGGTTC","561307.5.peg.771","2212"
"31114",1524,981,543,"CGCTCGTTCAACACTGCAAT","CATTATATAACCAAGGTTC","561307.5.peg.771","2212"
"31115",1826,987,839,"TTACAGCATTCACTGCTTCT","TCGCTTCATTATATAACCA","561307.5.peg.771","2212"
"31116",1497,987,510,"TCATATCCCATTGCACCGAT","TCGCTTCATTATATAACCA","561307.5.peg.771","2212"
"31117",474,987,513,"TAAACACTTGTTGAATGAC","TCGCTTCATTATATAACCA","561307.5.peg.771","2212"
"31118",1326,987,339,"TATCAATCCACGCTTTATA","TCGCTTCATTATATAACCA","561307.5.peg.771","2212"
"31119",1599,987,612,"TCACGATACGCATCAATTGG","TCGCTTCATTATATAACCA","561307.5.peg.771","2212"
"31120",2061,987,1074,"ACTGTACGTTGCGCTAGGTA","TCGCTTCATTATATAACCA","561307.5.peg.771","2212"
"31121",1914,987,927,"TGACTTATTGCGAGTAACAT","TCGCTTCATTATATAACCA","561307.5.peg.771","2212"
"31122",2119,987,1132,"TGTCTTAACATTATCGACAA","TCGCTTCATTATATAACCA","561307.5.peg.771","2212"
"31123",2066,987,1079,"GTTCAACTGTACGTTGCGCT","TCGCTTCATTATATAACCA","561307.5.peg.771","2212"
"31124",1137,987,150,"TTAGTAATCGTATAACGACC","TCGCTTCATTATATAACCA","561307.5.peg.771","2212"
"31125",299,987,688,"CGGCATATTCACCTTCACCT","TCGCTTCATTATATAACCA","561307.5.peg.771","2212"
"31126",1716,987,729,"AAGTGTGATTCATTCAATAC","TCGCTTCATTATATAACCA","561307.5.peg.771","2212"
"31127",1524,987,537,"CGCTCGTTCAACACTGCAAT","TCGCTTCATTATATAACCA","561307.5.peg.771","2212"
"31128",756,987,231,"TATGCATTAACATACGGTT","TCGCTTCATTATATAACCA","561307.5.peg.771","2212"
"31129",756,1059,303,"TATGCATTAACATACGGTT","ATCATTGTAGGACCATCCCA","561307.5.peg.771","2212"
"31130",1524,1059,465,"CGCTCGTTCAACACTGCAAT","ATCATTGTAGGACCATCCCA","561307.5.peg.771","2212"
"31131",1326,1059,267,"TATCAATCCACGCTTTATA","ATCATTGTAGGACCATCCCA","561307.5.peg.771","2212"
"31132",299,1059,760,"CGGCATATTCACCTTCACCT","ATCATTGTAGGACCATCCCA","561307.5.peg.771","2212"
"31133",474,1059,585,"TAAACACTTGTTGAATGAC","ATCATTGTAGGACCATCCCA","561307.5.peg.771","2212"
"31134",2066,1059,1007,"GTTCAACTGTACGTTGCGCT","ATCATTGTAGGACCATCCCA","561307.5.peg.771","2212"
"31135",1716,1059,657,"AAGTGTGATTCATTCAATAC","ATCATTGTAGGACCATCCCA","561307.5.peg.771","2212"
"31136",1599,1059,540,"TCACGATACGCATCAATTGG","ATCATTGTAGGACCATCCCA","561307.5.peg.771","2212"
"31137",1914,1059,855,"TGACTTATTGCGAGTAACAT","ATCATTGTAGGACCATCCCA","561307.5.peg.771","2212"
"31138",910,1059,149,"CTCTAGCGCATTATCTACAA","ATCATTGTAGGACCATCCCA","561307.5.peg.771","2212"
"31139",2061,1059,1002,"ACTGTACGTTGCGCTAGGTA","ATCATTGTAGGACCATCCCA","561307.5.peg.771","2212"
"31140",1826,1059,767,"TTACAGCATTCACTGCTTCT","ATCATTGTAGGACCATCCCA","561307.5.peg.771","2212"
"31141",2119,1059,1060,"TGTCTTAACATTATCGACAA","ATCATTGTAGGACCATCCCA","561307.5.peg.771","2212"
"31142",1497,1059,438,"TCATATCCCATTGCACCGAT","ATCATTGTAGGACCATCCCA","561307.5.peg.771","2212"
"31143",299,1137,838,"CGGCATATTCACCTTCACCT","TTAGTAATCGTATAACGACC","561307.5.peg.771","2212"
"31144",1914,1137,777,"TGACTTATTGCGAGTAACAT","TTAGTAATCGTATAACGACC","561307.5.peg.771","2212"
"31145",1524,1137,387,"CGCTCGTTCAACACTGCAAT","TTAGTAATCGTATAACGACC","561307.5.peg.771","2212"
"31146",1599,1137,462,"TCACGATACGCATCAATTGG","TTAGTAATCGTATAACGACC","561307.5.peg.771","2212"
"31147",2066,1137,929,"GTTCAACTGTACGTTGCGCT","TTAGTAATCGTATAACGACC","561307.5.peg.771","2212"
"31148",981,1137,156,"CATTATATAACCAAGGTTC","TTAGTAATCGTATAACGACC","561307.5.peg.771","2212"
"31149",1326,1137,189,"TATCAATCCACGCTTTATA","TTAGTAATCGTATAACGACC","561307.5.peg.771","2212"
"31150",474,1137,663,"TAAACACTTGTTGAATGAC","TTAGTAATCGTATAACGACC","561307.5.peg.771","2212"
"31151",1497,1137,360,"TCATATCCCATTGCACCGAT","TTAGTAATCGTATAACGACC","561307.5.peg.771","2212"
"31152",987,1137,150,"TCGCTTCATTATATAACCA","TTAGTAATCGTATAACGACC","561307.5.peg.771","2212"
"31153",910,1137,227,"CTCTAGCGCATTATCTACAA","TTAGTAATCGTATAACGACC","561307.5.peg.771","2212"
"31154",2119,1137,982,"TGTCTTAACATTATCGACAA","TTAGTAATCGTATAACGACC","561307.5.peg.771","2212"
"31155",2061,1137,924,"ACTGTACGTTGCGCTAGGTA","TTAGTAATCGTATAACGACC","561307.5.peg.771","2212"
"31156",756,1137,381,"TATGCATTAACATACGGTT","TTAGTAATCGTATAACGACC","561307.5.peg.771","2212"
"31157",1716,1137,579,"AAGTGTGATTCATTCAATAC","TTAGTAATCGTATAACGACC","561307.5.peg.771","2212"
"31158",1826,1137,689,"TTACAGCATTCACTGCTTCT","TTAGTAATCGTATAACGACC","561307.5.peg.771","2212"
"31159",1914,1326,588,"TGACTTATTGCGAGTAACAT","TATCAATCCACGCTTTATA","561307.5.peg.771","2212"
"31160",1497,1326,171,"TCATATCCCATTGCACCGAT","TATCAATCCACGCTTTATA","561307.5.peg.771","2212"
"31161",299,1326,1027,"CGGCATATTCACCTTCACCT","TATCAATCCACGCTTTATA","561307.5.peg.771","2212"
"31162",2119,1326,793,"TGTCTTAACATTATCGACAA","TATCAATCCACGCTTTATA","561307.5.peg.771","2212"
"31163",1524,1326,198,"CGCTCGTTCAACACTGCAAT","TATCAATCCACGCTTTATA","561307.5.peg.771","2212"
"31164",2061,1326,735,"ACTGTACGTTGCGCTAGGTA","TATCAATCCACGCTTTATA","561307.5.peg.771","2212"
"31165",1826,1326,500,"TTACAGCATTCACTGCTTCT","TATCAATCCACGCTTTATA","561307.5.peg.771","2212"
"31166",756,1326,570,"TATGCATTAACATACGGTT","TATCAATCCACGCTTTATA","561307.5.peg.771","2212"
"31167",1137,1326,189,"TTAGTAATCGTATAACGACC","TATCAATCCACGCTTTATA","561307.5.peg.771","2212"
"31168",987,1326,339,"TCGCTTCATTATATAACCA","TATCAATCCACGCTTTATA","561307.5.peg.771","2212"
"31169",981,1326,345,"CATTATATAACCAAGGTTC","TATCAATCCACGCTTTATA","561307.5.peg.771","2212"
"31170",910,1326,416,"CTCTAGCGCATTATCTACAA","TATCAATCCACGCTTTATA","561307.5.peg.771","2212"
"31171",474,1326,852,"TAAACACTTGTTGAATGAC","TATCAATCCACGCTTTATA","561307.5.peg.771","2212"
"31172",1599,1326,273,"TCACGATACGCATCAATTGG","TATCAATCCACGCTTTATA","561307.5.peg.771","2212"
"31173",1716,1326,390,"AAGTGTGATTCATTCAATAC","TATCAATCCACGCTTTATA","561307.5.peg.771","2212"
"31174",1059,1326,267,"ATCATTGTAGGACCATCCCA","TATCAATCCACGCTTTATA","561307.5.peg.771","2212"
"31175",2066,1326,740,"GTTCAACTGTACGTTGCGCT","TATCAATCCACGCTTTATA","561307.5.peg.771","2212"
"31176",1326,1497,171,"TATCAATCCACGCTTTATA","TCATATCCCATTGCACCGAT","561307.5.peg.771","2212"
"31177",1716,1497,219,"AAGTGTGATTCATTCAATAC","TCATATCCCATTGCACCGAT","561307.5.peg.771","2212"
"31178",981,1497,516,"CATTATATAACCAAGGTTC","TCATATCCCATTGCACCGAT","561307.5.peg.771","2212"
"31179",987,1497,510,"TCGCTTCATTATATAACCA","TCATATCCCATTGCACCGAT","561307.5.peg.771","2212"
"31180",756,1497,741,"TATGCATTAACATACGGTT","TCATATCCCATTGCACCGAT","561307.5.peg.771","2212"
"31181",910,1497,587,"CTCTAGCGCATTATCTACAA","TCATATCCCATTGCACCGAT","561307.5.peg.771","2212"
"31182",2066,1497,569,"GTTCAACTGTACGTTGCGCT","TCATATCCCATTGCACCGAT","561307.5.peg.771","2212"
"31183",474,1497,1023,"TAAACACTTGTTGAATGAC","TCATATCCCATTGCACCGAT","561307.5.peg.771","2212"
"31184",2061,1497,564,"ACTGTACGTTGCGCTAGGTA","TCATATCCCATTGCACCGAT","561307.5.peg.771","2212"
"31185",1914,1497,417,"TGACTTATTGCGAGTAACAT","TCATATCCCATTGCACCGAT","561307.5.peg.771","2212"
"31186",1137,1497,360,"TTAGTAATCGTATAACGACC","TCATATCCCATTGCACCGAT","561307.5.peg.771","2212"
"31187",299,1497,1198,"CGGCATATTCACCTTCACCT","TCATATCCCATTGCACCGAT","561307.5.peg.771","2212"
"31188",1059,1497,438,"ATCATTGTAGGACCATCCCA","TCATATCCCATTGCACCGAT","561307.5.peg.771","2212"
"31189",1599,1497,102,"TCACGATACGCATCAATTGG","TCATATCCCATTGCACCGAT","561307.5.peg.771","2212"
"31190",2119,1497,622,"TGTCTTAACATTATCGACAA","TCATATCCCATTGCACCGAT","561307.5.peg.771","2212"
"31191",1826,1497,329,"TTACAGCATTCACTGCTTCT","TCATATCCCATTGCACCGAT","561307.5.peg.771","2212"
"31192",1716,1524,192,"AAGTGTGATTCATTCAATAC","CGCTCGTTCAACACTGCAAT","561307.5.peg.771","2212"
"31193",2066,1524,542,"GTTCAACTGTACGTTGCGCT","CGCTCGTTCAACACTGCAAT","561307.5.peg.771","2212"
"31194",1914,1524,390,"TGACTTATTGCGAGTAACAT","CGCTCGTTCAACACTGCAAT","561307.5.peg.771","2212"
"31195",1059,1524,465,"ATCATTGTAGGACCATCCCA","CGCTCGTTCAACACTGCAAT","561307.5.peg.771","2212"
"31196",2119,1524,595,"TGTCTTAACATTATCGACAA","CGCTCGTTCAACACTGCAAT","561307.5.peg.771","2212"
"31197",1137,1524,387,"TTAGTAATCGTATAACGACC","CGCTCGTTCAACACTGCAAT","561307.5.peg.771","2212"
"31198",981,1524,543,"CATTATATAACCAAGGTTC","CGCTCGTTCAACACTGCAAT","561307.5.peg.771","2212"
"31199",474,1524,1050,"TAAACACTTGTTGAATGAC","CGCTCGTTCAACACTGCAAT","561307.5.peg.771","2212"
"31200",2061,1524,537,"ACTGTACGTTGCGCTAGGTA","CGCTCGTTCAACACTGCAAT","561307.5.peg.771","2212"
"31201",1826,1524,302,"TTACAGCATTCACTGCTTCT","CGCTCGTTCAACACTGCAAT","561307.5.peg.771","2212"
"31202",1326,1524,198,"TATCAATCCACGCTTTATA","CGCTCGTTCAACACTGCAAT","561307.5.peg.771","2212"
"31203",299,1524,1225,"CGGCATATTCACCTTCACCT","CGCTCGTTCAACACTGCAAT","561307.5.peg.771","2212"
"31204",756,1524,768,"TATGCATTAACATACGGTT","CGCTCGTTCAACACTGCAAT","561307.5.peg.771","2212"
"31205",987,1524,537,"TCGCTTCATTATATAACCA","CGCTCGTTCAACACTGCAAT","561307.5.peg.771","2212"
"31206",910,1524,614,"CTCTAGCGCATTATCTACAA","CGCTCGTTCAACACTGCAAT","561307.5.peg.771","2212"
"31207",1326,1599,273,"TATCAATCCACGCTTTATA","TCACGATACGCATCAATTGG","561307.5.peg.771","2212"
"31208",1826,1599,227,"TTACAGCATTCACTGCTTCT","TCACGATACGCATCAATTGG","561307.5.peg.771","2212"
"31209",1059,1599,540,"ATCATTGTAGGACCATCCCA","TCACGATACGCATCAATTGG","561307.5.peg.771","2212"
"31210",1716,1599,117,"AAGTGTGATTCATTCAATAC","TCACGATACGCATCAATTGG","561307.5.peg.771","2212"
"31211",756,1599,843,"TATGCATTAACATACGGTT","TCACGATACGCATCAATTGG","561307.5.peg.771","2212"
"31212",2119,1599,520,"TGTCTTAACATTATCGACAA","TCACGATACGCATCAATTGG","561307.5.peg.771","2212"
"31213",2066,1599,467,"GTTCAACTGTACGTTGCGCT","TCACGATACGCATCAATTGG","561307.5.peg.771","2212"
"31214",987,1599,612,"TCGCTTCATTATATAACCA","TCACGATACGCATCAATTGG","561307.5.peg.771","2212"
"31215",1914,1599,315,"TGACTTATTGCGAGTAACAT","TCACGATACGCATCAATTGG","561307.5.peg.771","2212"
"31216",299,1599,1300,"CGGCATATTCACCTTCACCT","TCACGATACGCATCAATTGG","561307.5.peg.771","2212"
"31217",474,1599,1125,"TAAACACTTGTTGAATGAC","TCACGATACGCATCAATTGG","561307.5.peg.771","2212"
"31218",981,1599,618,"CATTATATAACCAAGGTTC","TCACGATACGCATCAATTGG","561307.5.peg.771","2212"
"31219",1137,1599,462,"TTAGTAATCGTATAACGACC","TCACGATACGCATCAATTGG","561307.5.peg.771","2212"
"31220",2061,1599,462,"ACTGTACGTTGCGCTAGGTA","TCACGATACGCATCAATTGG","561307.5.peg.771","2212"
"31221",910,1599,689,"CTCTAGCGCATTATCTACAA","TCACGATACGCATCAATTGG","561307.5.peg.771","2212"
"31222",1497,1599,102,"TCATATCCCATTGCACCGAT","TCACGATACGCATCAATTGG","561307.5.peg.771","2212"
"31223",987,1716,729,"TCGCTTCATTATATAACCA","AAGTGTGATTCATTCAATAC","561307.5.peg.771","2212"
"31224",1137,1716,579,"TTAGTAATCGTATAACGACC","AAGTGTGATTCATTCAATAC","561307.5.peg.771","2212"
"31225",756,1716,960,"TATGCATTAACATACGGTT","AAGTGTGATTCATTCAATAC","561307.5.peg.771","2212"
"31226",1326,1716,390,"TATCAATCCACGCTTTATA","AAGTGTGATTCATTCAATAC","561307.5.peg.771","2212"
"31227",1497,1716,219,"TCATATCCCATTGCACCGAT","AAGTGTGATTCATTCAATAC","561307.5.peg.771","2212"
"31228",2066,1716,350,"GTTCAACTGTACGTTGCGCT","AAGTGTGATTCATTCAATAC","561307.5.peg.771","2212"
"31229",1059,1716,657,"ATCATTGTAGGACCATCCCA","AAGTGTGATTCATTCAATAC","561307.5.peg.771","2212"
"31230",910,1716,806,"CTCTAGCGCATTATCTACAA","AAGTGTGATTCATTCAATAC","561307.5.peg.771","2212"
"31231",1826,1716,110,"TTACAGCATTCACTGCTTCT","AAGTGTGATTCATTCAATAC","561307.5.peg.771","2212"
"31232",2061,1716,345,"ACTGTACGTTGCGCTAGGTA","AAGTGTGATTCATTCAATAC","561307.5.peg.771","2212"
"31233",299,1716,1417,"CGGCATATTCACCTTCACCT","AAGTGTGATTCATTCAATAC","561307.5.peg.771","2212"
"31234",474,1716,1242,"TAAACACTTGTTGAATGAC","AAGTGTGATTCATTCAATAC","561307.5.peg.771","2212"
"31235",1599,1716,117,"TCACGATACGCATCAATTGG","AAGTGTGATTCATTCAATAC","561307.5.peg.771","2212"
"31236",1914,1716,198,"TGACTTATTGCGAGTAACAT","AAGTGTGATTCATTCAATAC","561307.5.peg.771","2212"
"31237",2119,1716,403,"TGTCTTAACATTATCGACAA","AAGTGTGATTCATTCAATAC","561307.5.peg.771","2212"
"31238",981,1716,735,"CATTATATAACCAAGGTTC","AAGTGTGATTCATTCAATAC","561307.5.peg.771","2212"
"31239",1524,1716,192,"CGCTCGTTCAACACTGCAAT","AAGTGTGATTCATTCAATAC","561307.5.peg.771","2212"
"31240",1059,1826,767,"ATCATTGTAGGACCATCCCA","TTACAGCATTCACTGCTTCT","561307.5.peg.771","2212"
"31241",1716,1826,110,"AAGTGTGATTCATTCAATAC","TTACAGCATTCACTGCTTCT","561307.5.peg.771","2212"
"31242",987,1826,839,"TCGCTTCATTATATAACCA","TTACAGCATTCACTGCTTCT","561307.5.peg.771","2212"
"31243",1524,1826,302,"CGCTCGTTCAACACTGCAAT","TTACAGCATTCACTGCTTCT","561307.5.peg.771","2212"
"31244",1137,1826,689,"TTAGTAATCGTATAACGACC","TTACAGCATTCACTGCTTCT","561307.5.peg.771","2212"
"31245",2119,1826,293,"TGTCTTAACATTATCGACAA","TTACAGCATTCACTGCTTCT","561307.5.peg.771","2212"
"31246",981,1826,845,"CATTATATAACCAAGGTTC","TTACAGCATTCACTGCTTCT","561307.5.peg.771","2212"
"31247",910,1826,916,"CTCTAGCGCATTATCTACAA","TTACAGCATTCACTGCTTCT","561307.5.peg.771","2212"
"31248",299,1826,1527,"CGGCATATTCACCTTCACCT","TTACAGCATTCACTGCTTCT","561307.5.peg.771","2212"
"31249",1326,1826,500,"TATCAATCCACGCTTTATA","TTACAGCATTCACTGCTTCT","561307.5.peg.771","2212"
"31250",2061,1826,235,"ACTGTACGTTGCGCTAGGTA","TTACAGCATTCACTGCTTCT","561307.5.peg.771","2212"
"31251",1599,1826,227,"TCACGATACGCATCAATTGG","TTACAGCATTCACTGCTTCT","561307.5.peg.771","2212"
"31252",1497,1826,329,"TCATATCCCATTGCACCGAT","TTACAGCATTCACTGCTTCT","561307.5.peg.771","2212"
"31253",474,1826,1352,"TAAACACTTGTTGAATGAC","TTACAGCATTCACTGCTTCT","561307.5.peg.771","2212"
"31254",2066,1826,240,"GTTCAACTGTACGTTGCGCT","TTACAGCATTCACTGCTTCT","561307.5.peg.771","2212"
"31255",756,1826,1070,"TATGCATTAACATACGGTT","TTACAGCATTCACTGCTTCT","561307.5.peg.771","2212"
"31256",2066,1914,152,"GTTCAACTGTACGTTGCGCT","TGACTTATTGCGAGTAACAT","561307.5.peg.771","2212"
"31257",987,1914,927,"TCGCTTCATTATATAACCA","TGACTTATTGCGAGTAACAT","561307.5.peg.771","2212"
"31258",2061,1914,147,"ACTGTACGTTGCGCTAGGTA","TGACTTATTGCGAGTAACAT","561307.5.peg.771","2212"
"31259",1137,1914,777,"TTAGTAATCGTATAACGACC","TGACTTATTGCGAGTAACAT","561307.5.peg.771","2212"
"31260",474,1914,1440,"TAAACACTTGTTGAATGAC","TGACTTATTGCGAGTAACAT","561307.5.peg.771","2212"
"31261",1599,1914,315,"TCACGATACGCATCAATTGG","TGACTTATTGCGAGTAACAT","561307.5.peg.771","2212"
"31262",299,1914,1615,"CGGCATATTCACCTTCACCT","TGACTTATTGCGAGTAACAT","561307.5.peg.771","2212"
"31263",1716,1914,198,"AAGTGTGATTCATTCAATAC","TGACTTATTGCGAGTAACAT","561307.5.peg.771","2212"
"31264",756,1914,1158,"TATGCATTAACATACGGTT","TGACTTATTGCGAGTAACAT","561307.5.peg.771","2212"
"31265",910,1914,1004,"CTCTAGCGCATTATCTACAA","TGACTTATTGCGAGTAACAT","561307.5.peg.771","2212"
"31266",1059,1914,855,"ATCATTGTAGGACCATCCCA","TGACTTATTGCGAGTAACAT","561307.5.peg.771","2212"
"31267",1326,1914,588,"TATCAATCCACGCTTTATA","TGACTTATTGCGAGTAACAT","561307.5.peg.771","2212"
"31268",1497,1914,417,"TCATATCCCATTGCACCGAT","TGACTTATTGCGAGTAACAT","561307.5.peg.771","2212"
"31269",1524,1914,390,"CGCTCGTTCAACACTGCAAT","TGACTTATTGCGAGTAACAT","561307.5.peg.771","2212"
"31270",2119,1914,205,"TGTCTTAACATTATCGACAA","TGACTTATTGCGAGTAACAT","561307.5.peg.771","2212"
"31271",981,1914,933,"CATTATATAACCAAGGTTC","TGACTTATTGCGAGTAACAT","561307.5.peg.771","2212"
"31272",1524,2061,537,"CGCTCGTTCAACACTGCAAT","ACTGTACGTTGCGCTAGGTA","561307.5.peg.771","2212"
"31273",1716,2061,345,"AAGTGTGATTCATTCAATAC","ACTGTACGTTGCGCTAGGTA","561307.5.peg.771","2212"
"31274",1914,2061,147,"TGACTTATTGCGAGTAACAT","ACTGTACGTTGCGCTAGGTA","561307.5.peg.771","2212"
"31275",1826,2061,235,"TTACAGCATTCACTGCTTCT","ACTGTACGTTGCGCTAGGTA","561307.5.peg.771","2212"
"31276",1326,2061,735,"TATCAATCCACGCTTTATA","ACTGTACGTTGCGCTAGGTA","561307.5.peg.771","2212"
"31277",1599,2061,462,"TCACGATACGCATCAATTGG","ACTGTACGTTGCGCTAGGTA","561307.5.peg.771","2212"
"31278",1497,2061,564,"TCATATCCCATTGCACCGAT","ACTGTACGTTGCGCTAGGTA","561307.5.peg.771","2212"
"31279",1059,2061,1002,"ATCATTGTAGGACCATCCCA","ACTGTACGTTGCGCTAGGTA","561307.5.peg.771","2212"
"31280",1137,2061,924,"TTAGTAATCGTATAACGACC","ACTGTACGTTGCGCTAGGTA","561307.5.peg.771","2212"
"31281",910,2061,1151,"CTCTAGCGCATTATCTACAA","ACTGTACGTTGCGCTAGGTA","561307.5.peg.771","2212"
"31282",474,2061,1587,"TAAACACTTGTTGAATGAC","ACTGTACGTTGCGCTAGGTA","561307.5.peg.771","2212"
"31283",299,2061,1762,"CGGCATATTCACCTTCACCT","ACTGTACGTTGCGCTAGGTA","561307.5.peg.771","2212"
"31284",981,2061,1080,"CATTATATAACCAAGGTTC","ACTGTACGTTGCGCTAGGTA","561307.5.peg.771","2212"
"31285",987,2061,1074,"TCGCTTCATTATATAACCA","ACTGTACGTTGCGCTAGGTA","561307.5.peg.771","2212"
"31286",756,2061,1305,"TATGCATTAACATACGGTT","ACTGTACGTTGCGCTAGGTA","561307.5.peg.771","2212"
"31287",987,2066,1079,"TCGCTTCATTATATAACCA","GTTCAACTGTACGTTGCGCT","561307.5.peg.771","2212"
"31288",1326,2066,740,"TATCAATCCACGCTTTATA","GTTCAACTGTACGTTGCGCT","561307.5.peg.771","2212"
"31289",1716,2066,350,"AAGTGTGATTCATTCAATAC","GTTCAACTGTACGTTGCGCT","561307.5.peg.771","2212"
"31290",474,2066,1592,"TAAACACTTGTTGAATGAC","GTTCAACTGTACGTTGCGCT","561307.5.peg.771","2212"
"31291",1914,2066,152,"TGACTTATTGCGAGTAACAT","GTTCAACTGTACGTTGCGCT","561307.5.peg.771","2212"
"31292",1059,2066,1007,"ATCATTGTAGGACCATCCCA","GTTCAACTGTACGTTGCGCT","561307.5.peg.771","2212"
"31293",1524,2066,542,"CGCTCGTTCAACACTGCAAT","GTTCAACTGTACGTTGCGCT","561307.5.peg.771","2212"
"31294",1826,2066,240,"TTACAGCATTCACTGCTTCT","GTTCAACTGTACGTTGCGCT","561307.5.peg.771","2212"
"31295",1599,2066,467,"TCACGATACGCATCAATTGG","GTTCAACTGTACGTTGCGCT","561307.5.peg.771","2212"
"31296",910,2066,1156,"CTCTAGCGCATTATCTACAA","GTTCAACTGTACGTTGCGCT","561307.5.peg.771","2212"
"31297",299,2066,1767,"CGGCATATTCACCTTCACCT","GTTCAACTGTACGTTGCGCT","561307.5.peg.771","2212"
"31298",1497,2066,569,"TCATATCCCATTGCACCGAT","GTTCAACTGTACGTTGCGCT","561307.5.peg.771","2212"
"31299",756,2066,1310,"TATGCATTAACATACGGTT","GTTCAACTGTACGTTGCGCT","561307.5.peg.771","2212"
"31300",1137,2066,929,"TTAGTAATCGTATAACGACC","GTTCAACTGTACGTTGCGCT","561307.5.peg.771","2212"
"31301",981,2066,1085,"CATTATATAACCAAGGTTC","GTTCAACTGTACGTTGCGCT","561307.5.peg.771","2212"
"31302",1326,2119,793,"TATCAATCCACGCTTTATA","TGTCTTAACATTATCGACAA","561307.5.peg.771","2212"
"31303",299,2119,1820,"CGGCATATTCACCTTCACCT","TGTCTTAACATTATCGACAA","561307.5.peg.771","2212"
"31304",1716,2119,403,"AAGTGTGATTCATTCAATAC","TGTCTTAACATTATCGACAA","561307.5.peg.771","2212"
"31305",987,2119,1132,"TCGCTTCATTATATAACCA","TGTCTTAACATTATCGACAA","561307.5.peg.771","2212"
"31306",1914,2119,205,"TGACTTATTGCGAGTAACAT","TGTCTTAACATTATCGACAA","561307.5.peg.771","2212"
"31307",981,2119,1138,"CATTATATAACCAAGGTTC","TGTCTTAACATTATCGACAA","561307.5.peg.771","2212"
"31308",1524,2119,595,"CGCTCGTTCAACACTGCAAT","TGTCTTAACATTATCGACAA","561307.5.peg.771","2212"
"31309",1059,2119,1060,"ATCATTGTAGGACCATCCCA","TGTCTTAACATTATCGACAA","561307.5.peg.771","2212"
"31310",756,2119,1363,"TATGCATTAACATACGGTT","TGTCTTAACATTATCGACAA","561307.5.peg.771","2212"
"31311",1826,2119,293,"TTACAGCATTCACTGCTTCT","TGTCTTAACATTATCGACAA","561307.5.peg.771","2212"
"31312",1137,2119,982,"TTAGTAATCGTATAACGACC","TGTCTTAACATTATCGACAA","561307.5.peg.771","2212"
"31313",910,2119,1209,"CTCTAGCGCATTATCTACAA","TGTCTTAACATTATCGACAA","561307.5.peg.771","2212"
"31314",1497,2119,622,"TCATATCCCATTGCACCGAT","TGTCTTAACATTATCGACAA","561307.5.peg.771","2212"
"31315",1599,2119,520,"TCACGATACGCATCAATTGG","TGTCTTAACATTATCGACAA","561307.5.peg.771","2212"
"31316",474,2119,1645,"TAAACACTTGTTGAATGAC","TGTCTTAACATTATCGACAA","561307.5.peg.771","2212"
"31317",270,8,262,"TACACTAAGTCGTTCCATTC","CGTTGTGTATTAAGGAAAGG","561307.5.peg.772","2213"
"31318",534,8,526,"TCAGCAGCAGCTAATCCTGC","CGTTGTGTATTAAGGAAAGG","561307.5.peg.772","2213"
"31319",217,8,209,"TTCCCTACCATACTGTTGTC","CGTTGTGTATTAAGGAAAGG","561307.5.peg.772","2213"
"31320",166,8,158,"ACATCGTGCACCTTGGATAG","CGTTGTGTATTAAGGAAAGG","561307.5.peg.772","2213"
"31321",116,8,108,"ATGCTTTATGATGCTTCAAA","CGTTGTGTATTAAGGAAAGG","561307.5.peg.772","2213"
"31322",173,8,165,"AATCCATACATCGTGCACCT","CGTTGTGTATTAAGGAAAGG","561307.5.peg.772","2213"
"31323",369,8,361,"CAAGCACTTTCGCATGGTGC","CGTTGTGTATTAAGGAAAGG","561307.5.peg.772","2213"
"31324",345,8,337,"CATACACGCCCTGTAAAGTC","CGTTGTGTATTAAGGAAAGG","561307.5.peg.772","2213"
"31325",480,8,472,"CTACGGCGACTCGGAACTTT","CGTTGTGTATTAAGGAAAGG","561307.5.peg.772","2213"
"31326",252,8,244,"TCAGGAATGTAGTTTCCAAT","CGTTGTGTATTAAGGAAAGG","561307.5.peg.772","2213"
"31327",375,8,367,"ATCACACAAGCACTTTCGCA","CGTTGTGTATTAAGGAAAGG","561307.5.peg.772","2213"
"31328",217,10,207,"TTCCCTACCATACTGTTGTC","GCCGTTGTGTATTAAGGAAA","561307.5.peg.772","2213"
"31329",345,10,335,"CATACACGCCCTGTAAAGTC","GCCGTTGTGTATTAAGGAAA","561307.5.peg.772","2213"
"31330",375,10,365,"ATCACACAAGCACTTTCGCA","GCCGTTGTGTATTAAGGAAA","561307.5.peg.772","2213"
"31331",534,10,524,"TCAGCAGCAGCTAATCCTGC","GCCGTTGTGTATTAAGGAAA","561307.5.peg.772","2213"
"31332",116,10,106,"ATGCTTTATGATGCTTCAAA","GCCGTTGTGTATTAAGGAAA","561307.5.peg.772","2213"
"31333",369,10,359,"CAAGCACTTTCGCATGGTGC","GCCGTTGTGTATTAAGGAAA","561307.5.peg.772","2213"
"31334",480,10,470,"CTACGGCGACTCGGAACTTT","GCCGTTGTGTATTAAGGAAA","561307.5.peg.772","2213"
"31335",166,10,156,"ACATCGTGCACCTTGGATAG","GCCGTTGTGTATTAAGGAAA","561307.5.peg.772","2213"
"31336",173,10,163,"AATCCATACATCGTGCACCT","GCCGTTGTGTATTAAGGAAA","561307.5.peg.772","2213"
"31337",252,10,242,"TCAGGAATGTAGTTTCCAAT","GCCGTTGTGTATTAAGGAAA","561307.5.peg.772","2213"
"31338",270,10,260,"TACACTAAGTCGTTCCATTC","GCCGTTGTGTATTAAGGAAA","561307.5.peg.772","2213"
"31339",534,16,518,"TCAGCAGCAGCTAATCCTGC","TTTCCTTAATACACAACGGC","561307.5.peg.772","2213"
"31340",534,16,518,"TCAGCAGCAGCTAATCCTGC","AAACCAGCCGTTGTGTATTA","561307.5.peg.772","2213"
"31341",270,16,254,"TACACTAAGTCGTTCCATTC","TTTCCTTAATACACAACGGC","561307.5.peg.772","2213"
"31342",270,16,254,"TACACTAAGTCGTTCCATTC","AAACCAGCCGTTGTGTATTA","561307.5.peg.772","2213"
"31343",166,16,150,"ACATCGTGCACCTTGGATAG","TTTCCTTAATACACAACGGC","561307.5.peg.772","2213"
"31344",166,16,150,"ACATCGTGCACCTTGGATAG","AAACCAGCCGTTGTGTATTA","561307.5.peg.772","2213"
"31345",345,16,329,"CATACACGCCCTGTAAAGTC","TTTCCTTAATACACAACGGC","561307.5.peg.772","2213"
"31346",345,16,329,"CATACACGCCCTGTAAAGTC","AAACCAGCCGTTGTGTATTA","561307.5.peg.772","2213"
"31347",252,16,236,"TCAGGAATGTAGTTTCCAAT","TTTCCTTAATACACAACGGC","561307.5.peg.772","2213"
"31348",252,16,236,"TCAGGAATGTAGTTTCCAAT","AAACCAGCCGTTGTGTATTA","561307.5.peg.772","2213"
"31349",369,16,353,"CAAGCACTTTCGCATGGTGC","TTTCCTTAATACACAACGGC","561307.5.peg.772","2213"
"31350",369,16,353,"CAAGCACTTTCGCATGGTGC","AAACCAGCCGTTGTGTATTA","561307.5.peg.772","2213"
"31351",369,16,353,"CAAGCACTTTCGCATGGTGC","TTTCCTTAATACACAACGGC","561307.5.peg.772","2213"
"31352",369,16,353,"CAAGCACTTTCGCATGGTGC","AAACCAGCCGTTGTGTATTA","561307.5.peg.772","2213"
"31353",116,16,100,"ATGCTTTATGATGCTTCAAA","TTTCCTTAATACACAACGGC","561307.5.peg.772","2213"
"31354",116,16,100,"ATGCTTTATGATGCTTCAAA","AAACCAGCCGTTGTGTATTA","561307.5.peg.772","2213"
"31355",166,16,150,"ACATCGTGCACCTTGGATAG","TTTCCTTAATACACAACGGC","561307.5.peg.772","2213"
"31356",166,16,150,"ACATCGTGCACCTTGGATAG","AAACCAGCCGTTGTGTATTA","561307.5.peg.772","2213"
"31357",375,16,359,"ATCACACAAGCACTTTCGCA","TTTCCTTAATACACAACGGC","561307.5.peg.772","2213"
"31358",375,16,359,"ATCACACAAGCACTTTCGCA","AAACCAGCCGTTGTGTATTA","561307.5.peg.772","2213"
"31359",217,16,201,"TTCCCTACCATACTGTTGTC","TTTCCTTAATACACAACGGC","561307.5.peg.772","2213"
"31360",217,16,201,"TTCCCTACCATACTGTTGTC","AAACCAGCCGTTGTGTATTA","561307.5.peg.772","2213"
"31361",252,16,236,"TCAGGAATGTAGTTTCCAAT","TTTCCTTAATACACAACGGC","561307.5.peg.772","2213"
"31362",252,16,236,"TCAGGAATGTAGTTTCCAAT","AAACCAGCCGTTGTGTATTA","561307.5.peg.772","2213"
"31363",116,16,100,"ATGCTTTATGATGCTTCAAA","TTTCCTTAATACACAACGGC","561307.5.peg.772","2213"
"31364",116,16,100,"ATGCTTTATGATGCTTCAAA","AAACCAGCCGTTGTGTATTA","561307.5.peg.772","2213"
"31365",480,16,464,"CTACGGCGACTCGGAACTTT","TTTCCTTAATACACAACGGC","561307.5.peg.772","2213"
"31366",480,16,464,"CTACGGCGACTCGGAACTTT","AAACCAGCCGTTGTGTATTA","561307.5.peg.772","2213"
"31367",173,16,157,"AATCCATACATCGTGCACCT","TTTCCTTAATACACAACGGC","561307.5.peg.772","2213"
"31368",173,16,157,"AATCCATACATCGTGCACCT","AAACCAGCCGTTGTGTATTA","561307.5.peg.772","2213"
"31369",375,16,359,"ATCACACAAGCACTTTCGCA","TTTCCTTAATACACAACGGC","561307.5.peg.772","2213"
"31370",375,16,359,"ATCACACAAGCACTTTCGCA","AAACCAGCCGTTGTGTATTA","561307.5.peg.772","2213"
"31371",173,16,157,"AATCCATACATCGTGCACCT","TTTCCTTAATACACAACGGC","561307.5.peg.772","2213"
"31372",173,16,157,"AATCCATACATCGTGCACCT","AAACCAGCCGTTGTGTATTA","561307.5.peg.772","2213"
"31373",217,16,201,"TTCCCTACCATACTGTTGTC","TTTCCTTAATACACAACGGC","561307.5.peg.772","2213"
"31374",217,16,201,"TTCCCTACCATACTGTTGTC","AAACCAGCCGTTGTGTATTA","561307.5.peg.772","2213"
"31375",534,16,518,"TCAGCAGCAGCTAATCCTGC","TTTCCTTAATACACAACGGC","561307.5.peg.772","2213"
"31376",534,16,518,"TCAGCAGCAGCTAATCCTGC","AAACCAGCCGTTGTGTATTA","561307.5.peg.772","2213"
"31377",270,16,254,"TACACTAAGTCGTTCCATTC","TTTCCTTAATACACAACGGC","561307.5.peg.772","2213"
"31378",270,16,254,"TACACTAAGTCGTTCCATTC","AAACCAGCCGTTGTGTATTA","561307.5.peg.772","2213"
"31379",480,16,464,"CTACGGCGACTCGGAACTTT","TTTCCTTAATACACAACGGC","561307.5.peg.772","2213"
"31380",480,16,464,"CTACGGCGACTCGGAACTTT","AAACCAGCCGTTGTGTATTA","561307.5.peg.772","2213"
"31381",345,16,329,"CATACACGCCCTGTAAAGTC","TTTCCTTAATACACAACGGC","561307.5.peg.772","2213"
"31382",345,16,329,"CATACACGCCCTGTAAAGTC","AAACCAGCCGTTGTGTATTA","561307.5.peg.772","2213"
"31383",270,20,250,"TACACTAAGTCGTTCCATTC","CCCCTTTCCTTAATACACAA","561307.5.peg.772","2213"
"31384",217,20,197,"TTCCCTACCATACTGTTGTC","CCCCTTTCCTTAATACACAA","561307.5.peg.772","2213"
"31385",369,20,349,"CAAGCACTTTCGCATGGTGC","CCCCTTTCCTTAATACACAA","561307.5.peg.772","2213"
"31386",345,20,325,"CATACACGCCCTGTAAAGTC","CCCCTTTCCTTAATACACAA","561307.5.peg.772","2213"
"31387",166,20,146,"ACATCGTGCACCTTGGATAG","CCCCTTTCCTTAATACACAA","561307.5.peg.772","2213"
"31388",173,20,153,"AATCCATACATCGTGCACCT","CCCCTTTCCTTAATACACAA","561307.5.peg.772","2213"
"31389",534,20,514,"TCAGCAGCAGCTAATCCTGC","CCCCTTTCCTTAATACACAA","561307.5.peg.772","2213"
"31390",480,20,460,"CTACGGCGACTCGGAACTTT","CCCCTTTCCTTAATACACAA","561307.5.peg.772","2213"
"31391",252,20,232,"TCAGGAATGTAGTTTCCAAT","CCCCTTTCCTTAATACACAA","561307.5.peg.772","2213"
"31392",375,20,355,"ATCACACAAGCACTTTCGCA","CCCCTTTCCTTAATACACAA","561307.5.peg.772","2213"
"31393",16,116,100,"TTTCCTTAATACACAACGGC","ATGCTTTATGATGCTTCAAA","561307.5.peg.772","2213"
"31394",369,116,253,"CAAGCACTTTCGCATGGTGC","ATGCTTTATGATGCTTCAAA","561307.5.peg.772","2213"
"31395",534,116,418,"TCAGCAGCAGCTAATCCTGC","ATGCTTTATGATGCTTCAAA","561307.5.peg.772","2213"
"31396",217,116,101,"TTCCCTACCATACTGTTGTC","ATGCTTTATGATGCTTCAAA","561307.5.peg.772","2213"
"31397",8,116,108,"CGTTGTGTATTAAGGAAAGG","ATGCTTTATGATGCTTCAAA","561307.5.peg.772","2213"
"31398",480,116,364,"CTACGGCGACTCGGAACTTT","ATGCTTTATGATGCTTCAAA","561307.5.peg.772","2213"
"31399",375,116,259,"ATCACACAAGCACTTTCGCA","ATGCTTTATGATGCTTCAAA","561307.5.peg.772","2213"
"31400",16,116,100,"AAACCAGCCGTTGTGTATTA","ATGCTTTATGATGCTTCAAA","561307.5.peg.772","2213"
"31401",345,116,229,"CATACACGCCCTGTAAAGTC","ATGCTTTATGATGCTTCAAA","561307.5.peg.772","2213"
"31402",16,116,100,"AAACCAGCCGTTGTGTATTA","ATGCTTTATGATGCTTCAAA","561307.5.peg.772","2213"
"31403",252,116,136,"TCAGGAATGTAGTTTCCAAT","ATGCTTTATGATGCTTCAAA","561307.5.peg.772","2213"
"31404",10,116,106,"GCCGTTGTGTATTAAGGAAA","ATGCTTTATGATGCTTCAAA","561307.5.peg.772","2213"
"31405",16,116,100,"TTTCCTTAATACACAACGGC","ATGCTTTATGATGCTTCAAA","561307.5.peg.772","2213"
"31406",270,116,154,"TACACTAAGTCGTTCCATTC","ATGCTTTATGATGCTTCAAA","561307.5.peg.772","2213"
"31407",16,166,150,"AAACCAGCCGTTGTGTATTA","ACATCGTGCACCTTGGATAG","561307.5.peg.772","2213"
"31408",369,166,203,"CAAGCACTTTCGCATGGTGC","ACATCGTGCACCTTGGATAG","561307.5.peg.772","2213"
"31409",8,166,158,"CGTTGTGTATTAAGGAAAGG","ACATCGTGCACCTTGGATAG","561307.5.peg.772","2213"
"31410",20,166,146,"CCCCTTTCCTTAATACACAA","ACATCGTGCACCTTGGATAG","561307.5.peg.772","2213"
"31411",16,166,150,"TTTCCTTAATACACAACGGC","ACATCGTGCACCTTGGATAG","561307.5.peg.772","2213"
"31412",270,166,104,"TACACTAAGTCGTTCCATTC","ACATCGTGCACCTTGGATAG","561307.5.peg.772","2213"
"31413",16,166,150,"AAACCAGCCGTTGTGTATTA","ACATCGTGCACCTTGGATAG","561307.5.peg.772","2213"
"31414",480,166,314,"CTACGGCGACTCGGAACTTT","ACATCGTGCACCTTGGATAG","561307.5.peg.772","2213"
"31415",10,166,156,"GCCGTTGTGTATTAAGGAAA","ACATCGTGCACCTTGGATAG","561307.5.peg.772","2213"
"31416",16,166,150,"TTTCCTTAATACACAACGGC","ACATCGTGCACCTTGGATAG","561307.5.peg.772","2213"
"31417",375,166,209,"ATCACACAAGCACTTTCGCA","ACATCGTGCACCTTGGATAG","561307.5.peg.772","2213"
"31418",345,166,179,"CATACACGCCCTGTAAAGTC","ACATCGTGCACCTTGGATAG","561307.5.peg.772","2213"
"31419",534,166,368,"TCAGCAGCAGCTAATCCTGC","ACATCGTGCACCTTGGATAG","561307.5.peg.772","2213"
"31420",20,173,153,"CCCCTTTCCTTAATACACAA","AATCCATACATCGTGCACCT","561307.5.peg.772","2213"
"31421",8,173,165,"CGTTGTGTATTAAGGAAAGG","AATCCATACATCGTGCACCT","561307.5.peg.772","2213"
"31422",16,173,157,"AAACCAGCCGTTGTGTATTA","AATCCATACATCGTGCACCT","561307.5.peg.772","2213"
"31423",16,173,157,"AAACCAGCCGTTGTGTATTA","AATCCATACATCGTGCACCT","561307.5.peg.772","2213"
"31424",534,173,361,"TCAGCAGCAGCTAATCCTGC","AATCCATACATCGTGCACCT","561307.5.peg.772","2213"
"31425",10,173,163,"GCCGTTGTGTATTAAGGAAA","AATCCATACATCGTGCACCT","561307.5.peg.772","2213"
"31426",345,173,172,"CATACACGCCCTGTAAAGTC","AATCCATACATCGTGCACCT","561307.5.peg.772","2213"
"31427",16,173,157,"TTTCCTTAATACACAACGGC","AATCCATACATCGTGCACCT","561307.5.peg.772","2213"
"31428",480,173,307,"CTACGGCGACTCGGAACTTT","AATCCATACATCGTGCACCT","561307.5.peg.772","2213"
"31429",375,173,202,"ATCACACAAGCACTTTCGCA","AATCCATACATCGTGCACCT","561307.5.peg.772","2213"
"31430",16,173,157,"TTTCCTTAATACACAACGGC","AATCCATACATCGTGCACCT","561307.5.peg.772","2213"
"31431",369,173,196,"CAAGCACTTTCGCATGGTGC","AATCCATACATCGTGCACCT","561307.5.peg.772","2213"
"31432",116,217,101,"ATGCTTTATGATGCTTCAAA","TTCCCTACCATACTGTTGTC","561307.5.peg.772","2213"
"31433",369,217,152,"CAAGCACTTTCGCATGGTGC","TTCCCTACCATACTGTTGTC","561307.5.peg.772","2213"
"31434",375,217,158,"ATCACACAAGCACTTTCGCA","TTCCCTACCATACTGTTGTC","561307.5.peg.772","2213"
"31435",16,217,201,"AAACCAGCCGTTGTGTATTA","TTCCCTACCATACTGTTGTC","561307.5.peg.772","2213"
"31436",16,217,201,"TTTCCTTAATACACAACGGC","TTCCCTACCATACTGTTGTC","561307.5.peg.772","2213"
"31437",20,217,197,"CCCCTTTCCTTAATACACAA","TTCCCTACCATACTGTTGTC","561307.5.peg.772","2213"
"31438",534,217,317,"TCAGCAGCAGCTAATCCTGC","TTCCCTACCATACTGTTGTC","561307.5.peg.772","2213"
"31439",480,217,263,"CTACGGCGACTCGGAACTTT","TTCCCTACCATACTGTTGTC","561307.5.peg.772","2213"
"31440",16,217,201,"TTTCCTTAATACACAACGGC","TTCCCTACCATACTGTTGTC","561307.5.peg.772","2213"
"31441",345,217,128,"CATACACGCCCTGTAAAGTC","TTCCCTACCATACTGTTGTC","561307.5.peg.772","2213"
"31442",10,217,207,"GCCGTTGTGTATTAAGGAAA","TTCCCTACCATACTGTTGTC","561307.5.peg.772","2213"
"31443",8,217,209,"CGTTGTGTATTAAGGAAAGG","TTCCCTACCATACTGTTGTC","561307.5.peg.772","2213"
"31444",16,217,201,"AAACCAGCCGTTGTGTATTA","TTCCCTACCATACTGTTGTC","561307.5.peg.772","2213"
"31445",8,252,244,"CGTTGTGTATTAAGGAAAGG","TCAGGAATGTAGTTTCCAAT","561307.5.peg.772","2213"
"31446",534,252,282,"TCAGCAGCAGCTAATCCTGC","TCAGGAATGTAGTTTCCAAT","561307.5.peg.772","2213"
"31447",16,252,236,"AAACCAGCCGTTGTGTATTA","TCAGGAATGTAGTTTCCAAT","561307.5.peg.772","2213"
"31448",480,252,228,"CTACGGCGACTCGGAACTTT","TCAGGAATGTAGTTTCCAAT","561307.5.peg.772","2213"
"31449",10,252,242,"GCCGTTGTGTATTAAGGAAA","TCAGGAATGTAGTTTCCAAT","561307.5.peg.772","2213"
"31450",369,252,117,"CAAGCACTTTCGCATGGTGC","TCAGGAATGTAGTTTCCAAT","561307.5.peg.772","2213"
"31451",16,252,236,"TTTCCTTAATACACAACGGC","TCAGGAATGTAGTTTCCAAT","561307.5.peg.772","2213"
"31452",116,252,136,"ATGCTTTATGATGCTTCAAA","TCAGGAATGTAGTTTCCAAT","561307.5.peg.772","2213"
"31453",16,252,236,"TTTCCTTAATACACAACGGC","TCAGGAATGTAGTTTCCAAT","561307.5.peg.772","2213"
"31454",375,252,123,"ATCACACAAGCACTTTCGCA","TCAGGAATGTAGTTTCCAAT","561307.5.peg.772","2213"
"31455",16,252,236,"AAACCAGCCGTTGTGTATTA","TCAGGAATGTAGTTTCCAAT","561307.5.peg.772","2213"
"31456",20,252,232,"CCCCTTTCCTTAATACACAA","TCAGGAATGTAGTTTCCAAT","561307.5.peg.772","2213"
"31457",16,270,254,"AAACCAGCCGTTGTGTATTA","TACACTAAGTCGTTCCATTC","561307.5.peg.772","2213"
"31458",480,270,210,"CTACGGCGACTCGGAACTTT","TACACTAAGTCGTTCCATTC","561307.5.peg.772","2213"
"31459",375,270,105,"ATCACACAAGCACTTTCGCA","TACACTAAGTCGTTCCATTC","561307.5.peg.772","2213"
"31460",16,270,254,"TTTCCTTAATACACAACGGC","TACACTAAGTCGTTCCATTC","561307.5.peg.772","2213"
"31461",534,270,264,"TCAGCAGCAGCTAATCCTGC","TACACTAAGTCGTTCCATTC","561307.5.peg.772","2213"
"31462",10,270,260,"GCCGTTGTGTATTAAGGAAA","TACACTAAGTCGTTCCATTC","561307.5.peg.772","2213"
"31463",16,270,254,"AAACCAGCCGTTGTGTATTA","TACACTAAGTCGTTCCATTC","561307.5.peg.772","2213"
"31464",166,270,104,"ACATCGTGCACCTTGGATAG","TACACTAAGTCGTTCCATTC","561307.5.peg.772","2213"
"31465",20,270,250,"CCCCTTTCCTTAATACACAA","TACACTAAGTCGTTCCATTC","561307.5.peg.772","2213"
"31466",16,270,254,"TTTCCTTAATACACAACGGC","TACACTAAGTCGTTCCATTC","561307.5.peg.772","2213"
"31467",116,270,154,"ATGCTTTATGATGCTTCAAA","TACACTAAGTCGTTCCATTC","561307.5.peg.772","2213"
"31468",8,270,262,"CGTTGTGTATTAAGGAAAGG","TACACTAAGTCGTTCCATTC","561307.5.peg.772","2213"
"31469",8,345,337,"CGTTGTGTATTAAGGAAAGG","CATACACGCCCTGTAAAGTC","561307.5.peg.772","2213"
"31470",16,345,329,"AAACCAGCCGTTGTGTATTA","CATACACGCCCTGTAAAGTC","561307.5.peg.772","2213"
"31471",16,345,329,"TTTCCTTAATACACAACGGC","CATACACGCCCTGTAAAGTC","561307.5.peg.772","2213"
"31472",16,345,329,"AAACCAGCCGTTGTGTATTA","CATACACGCCCTGTAAAGTC","561307.5.peg.772","2213"
"31473",16,345,329,"TTTCCTTAATACACAACGGC","CATACACGCCCTGTAAAGTC","561307.5.peg.772","2213"
"31474",116,345,229,"ATGCTTTATGATGCTTCAAA","CATACACGCCCTGTAAAGTC","561307.5.peg.772","2213"
"31475",217,345,128,"TTCCCTACCATACTGTTGTC","CATACACGCCCTGTAAAGTC","561307.5.peg.772","2213"
"31476",173,345,172,"AATCCATACATCGTGCACCT","CATACACGCCCTGTAAAGTC","561307.5.peg.772","2213"
"31477",10,345,335,"GCCGTTGTGTATTAAGGAAA","CATACACGCCCTGTAAAGTC","561307.5.peg.772","2213"
"31478",480,345,135,"CTACGGCGACTCGGAACTTT","CATACACGCCCTGTAAAGTC","561307.5.peg.772","2213"
"31479",166,345,179,"ACATCGTGCACCTTGGATAG","CATACACGCCCTGTAAAGTC","561307.5.peg.772","2213"
"31480",20,345,325,"CCCCTTTCCTTAATACACAA","CATACACGCCCTGTAAAGTC","561307.5.peg.772","2213"
"31481",534,345,189,"TCAGCAGCAGCTAATCCTGC","CATACACGCCCTGTAAAGTC","561307.5.peg.772","2213"
"31482",16,369,353,"TTTCCTTAATACACAACGGC","CAAGCACTTTCGCATGGTGC","561307.5.peg.772","2213"
"31483",16,369,353,"TTTCCTTAATACACAACGGC","CAAGCACTTTCGCATGGTGC","561307.5.peg.772","2213"
"31484",480,369,111,"CTACGGCGACTCGGAACTTT","CAAGCACTTTCGCATGGTGC","561307.5.peg.772","2213"
"31485",16,369,353,"AAACCAGCCGTTGTGTATTA","CAAGCACTTTCGCATGGTGC","561307.5.peg.772","2213"
"31486",217,369,152,"TTCCCTACCATACTGTTGTC","CAAGCACTTTCGCATGGTGC","561307.5.peg.772","2213"
"31487",10,369,359,"GCCGTTGTGTATTAAGGAAA","CAAGCACTTTCGCATGGTGC","561307.5.peg.772","2213"
"31488",252,369,117,"TCAGGAATGTAGTTTCCAAT","CAAGCACTTTCGCATGGTGC","561307.5.peg.772","2213"
"31489",166,369,203,"ACATCGTGCACCTTGGATAG","CAAGCACTTTCGCATGGTGC","561307.5.peg.772","2213"
"31490",116,369,253,"ATGCTTTATGATGCTTCAAA","CAAGCACTTTCGCATGGTGC","561307.5.peg.772","2213"
"31491",8,369,361,"CGTTGTGTATTAAGGAAAGG","CAAGCACTTTCGCATGGTGC","561307.5.peg.772","2213"
"31492",534,369,165,"TCAGCAGCAGCTAATCCTGC","CAAGCACTTTCGCATGGTGC","561307.5.peg.772","2213"
"31493",173,369,196,"AATCCATACATCGTGCACCT","CAAGCACTTTCGCATGGTGC","561307.5.peg.772","2213"
"31494",16,369,353,"AAACCAGCCGTTGTGTATTA","CAAGCACTTTCGCATGGTGC","561307.5.peg.772","2213"
"31495",20,369,349,"CCCCTTTCCTTAATACACAA","CAAGCACTTTCGCATGGTGC","561307.5.peg.772","2213"
"31496",10,375,365,"GCCGTTGTGTATTAAGGAAA","ATCACACAAGCACTTTCGCA","561307.5.peg.772","2213"
"31497",217,375,158,"TTCCCTACCATACTGTTGTC","ATCACACAAGCACTTTCGCA","561307.5.peg.772","2213"
"31498",16,375,359,"AAACCAGCCGTTGTGTATTA","ATCACACAAGCACTTTCGCA","561307.5.peg.772","2213"
"31499",480,375,105,"CTACGGCGACTCGGAACTTT","ATCACACAAGCACTTTCGCA","561307.5.peg.772","2213"
"31500",166,375,209,"ACATCGTGCACCTTGGATAG","ATCACACAAGCACTTTCGCA","561307.5.peg.772","2213"
"31501",252,375,123,"TCAGGAATGTAGTTTCCAAT","ATCACACAAGCACTTTCGCA","561307.5.peg.772","2213"
"31502",16,375,359,"AAACCAGCCGTTGTGTATTA","ATCACACAAGCACTTTCGCA","561307.5.peg.772","2213"
"31503",20,375,355,"CCCCTTTCCTTAATACACAA","ATCACACAAGCACTTTCGCA","561307.5.peg.772","2213"
"31504",173,375,202,"AATCCATACATCGTGCACCT","ATCACACAAGCACTTTCGCA","561307.5.peg.772","2213"
"31505",8,375,367,"CGTTGTGTATTAAGGAAAGG","ATCACACAAGCACTTTCGCA","561307.5.peg.772","2213"
"31506",116,375,259,"ATGCTTTATGATGCTTCAAA","ATCACACAAGCACTTTCGCA","561307.5.peg.772","2213"
"31507",16,375,359,"TTTCCTTAATACACAACGGC","ATCACACAAGCACTTTCGCA","561307.5.peg.772","2213"
"31508",16,375,359,"TTTCCTTAATACACAACGGC","ATCACACAAGCACTTTCGCA","561307.5.peg.772","2213"
"31509",534,375,159,"TCAGCAGCAGCTAATCCTGC","ATCACACAAGCACTTTCGCA","561307.5.peg.772","2213"
"31510",270,375,105,"TACACTAAGTCGTTCCATTC","ATCACACAAGCACTTTCGCA","561307.5.peg.772","2213"
"31511",369,480,111,"CAAGCACTTTCGCATGGTGC","CTACGGCGACTCGGAACTTT","561307.5.peg.772","2213"
"31512",16,480,464,"TTTCCTTAATACACAACGGC","CTACGGCGACTCGGAACTTT","561307.5.peg.772","2213"
"31513",270,480,210,"TACACTAAGTCGTTCCATTC","CTACGGCGACTCGGAACTTT","561307.5.peg.772","2213"
"31514",16,480,464,"AAACCAGCCGTTGTGTATTA","CTACGGCGACTCGGAACTTT","561307.5.peg.772","2213"
"31515",345,480,135,"CATACACGCCCTGTAAAGTC","CTACGGCGACTCGGAACTTT","561307.5.peg.772","2213"
"31516",252,480,228,"TCAGGAATGTAGTTTCCAAT","CTACGGCGACTCGGAACTTT","561307.5.peg.772","2213"
"31517",16,480,464,"TTTCCTTAATACACAACGGC","CTACGGCGACTCGGAACTTT","561307.5.peg.772","2213"
"31518",173,480,307,"AATCCATACATCGTGCACCT","CTACGGCGACTCGGAACTTT","561307.5.peg.772","2213"
"31519",16,480,464,"AAACCAGCCGTTGTGTATTA","CTACGGCGACTCGGAACTTT","561307.5.peg.772","2213"
"31520",8,480,472,"CGTTGTGTATTAAGGAAAGG","CTACGGCGACTCGGAACTTT","561307.5.peg.772","2213"
"31521",20,480,460,"CCCCTTTCCTTAATACACAA","CTACGGCGACTCGGAACTTT","561307.5.peg.772","2213"
"31522",10,480,470,"GCCGTTGTGTATTAAGGAAA","CTACGGCGACTCGGAACTTT","561307.5.peg.772","2213"
"31523",375,480,105,"ATCACACAAGCACTTTCGCA","CTACGGCGACTCGGAACTTT","561307.5.peg.772","2213"
"31524",166,480,314,"ACATCGTGCACCTTGGATAG","CTACGGCGACTCGGAACTTT","561307.5.peg.772","2213"
"31525",217,480,263,"TTCCCTACCATACTGTTGTC","CTACGGCGACTCGGAACTTT","561307.5.peg.772","2213"
"31526",116,480,364,"ATGCTTTATGATGCTTCAAA","CTACGGCGACTCGGAACTTT","561307.5.peg.772","2213"
"31527",116,534,418,"ATGCTTTATGATGCTTCAAA","TCAGCAGCAGCTAATCCTGC","561307.5.peg.772","2213"
"31528",16,534,518,"AAACCAGCCGTTGTGTATTA","TCAGCAGCAGCTAATCCTGC","561307.5.peg.772","2213"
"31529",16,534,518,"AAACCAGCCGTTGTGTATTA","TCAGCAGCAGCTAATCCTGC","561307.5.peg.772","2213"
"31530",10,534,524,"GCCGTTGTGTATTAAGGAAA","TCAGCAGCAGCTAATCCTGC","561307.5.peg.772","2213"
"31531",270,534,264,"TACACTAAGTCGTTCCATTC","TCAGCAGCAGCTAATCCTGC","561307.5.peg.772","2213"
"31532",369,534,165,"CAAGCACTTTCGCATGGTGC","TCAGCAGCAGCTAATCCTGC","561307.5.peg.772","2213"
"31533",16,534,518,"TTTCCTTAATACACAACGGC","TCAGCAGCAGCTAATCCTGC","561307.5.peg.772","2213"
"31534",173,534,361,"AATCCATACATCGTGCACCT","TCAGCAGCAGCTAATCCTGC","561307.5.peg.772","2213"
"31535",8,534,526,"CGTTGTGTATTAAGGAAAGG","TCAGCAGCAGCTAATCCTGC","561307.5.peg.772","2213"
"31536",217,534,317,"TTCCCTACCATACTGTTGTC","TCAGCAGCAGCTAATCCTGC","561307.5.peg.772","2213"
"31537",375,534,159,"ATCACACAAGCACTTTCGCA","TCAGCAGCAGCTAATCCTGC","561307.5.peg.772","2213"
"31538",345,534,189,"CATACACGCCCTGTAAAGTC","TCAGCAGCAGCTAATCCTGC","561307.5.peg.772","2213"
"31539",252,534,282,"TCAGGAATGTAGTTTCCAAT","TCAGCAGCAGCTAATCCTGC","561307.5.peg.772","2213"
"31540",20,534,514,"CCCCTTTCCTTAATACACAA","TCAGCAGCAGCTAATCCTGC","561307.5.peg.772","2213"
"31541",166,534,368,"ACATCGTGCACCTTGGATAG","TCAGCAGCAGCTAATCCTGC","561307.5.peg.772","2213"
"31542",16,534,518,"TTTCCTTAATACACAACGGC","TCAGCAGCAGCTAATCCTGC","561307.5.peg.772","2213"
"31543",339,125,214,"TCTTTATCAAGACGACCAAC","CTTGTTCGTTGACATTTACA","561307.5.peg.774","2215"
"31544",125,339,214,"CTTGTTCGTTGACATTTACA","TCTTTATCAAGACGACCAAC","561307.5.peg.774","2215"
"31545",518,180,338,"GCCCCATAGATTTATAACCT","GGTGCATAAGCGTATGTGAA","561307.5.peg.775","2216"
"31546",540,180,360,"GTTACTTCTGACACTGCTGT","GGTGCATAAGCGTATGTGAA","561307.5.peg.775","2216"
"31547",489,180,309,"CCTCTCCATGTCGCTAATAC","GGTGCATAAGCGTATGTGAA","561307.5.peg.775","2216"
"31548",816,180,636,"TCAAACTTACAATAACGAA","GGTGCATAAGCGTATGTGAA","561307.5.peg.775","2216"
"31549",540,240,300,"GTTACTTCTGACACTGCTGT","ACATATTTCGAAGCTGCTAA","561307.5.peg.775","2216"
"31550",489,240,249,"CCTCTCCATGTCGCTAATAC","ACATATTTCGAAGCTGCTAA","561307.5.peg.775","2216"
"31551",816,240,576,"TCAAACTTACAATAACGAA","ACATATTTCGAAGCTGCTAA","561307.5.peg.775","2216"
"31552",518,240,278,"GCCCCATAGATTTATAACCT","ACATATTTCGAAGCTGCTAA","561307.5.peg.775","2216"
"31553",240,489,249,"ACATATTTCGAAGCTGCTAA","CCTCTCCATGTCGCTAATAC","561307.5.peg.775","2216"
"31554",180,489,309,"GGTGCATAAGCGTATGTGAA","CCTCTCCATGTCGCTAATAC","561307.5.peg.775","2216"
"31555",816,489,327,"TCAAACTTACAATAACGAA","CCTCTCCATGTCGCTAATAC","561307.5.peg.775","2216"
"31556",240,518,278,"ACATATTTCGAAGCTGCTAA","GCCCCATAGATTTATAACCT","561307.5.peg.775","2216"
"31557",180,518,338,"GGTGCATAAGCGTATGTGAA","GCCCCATAGATTTATAACCT","561307.5.peg.775","2216"
"31558",816,518,298,"TCAAACTTACAATAACGAA","GCCCCATAGATTTATAACCT","561307.5.peg.775","2216"
"31559",180,540,360,"GGTGCATAAGCGTATGTGAA","GTTACTTCTGACACTGCTGT","561307.5.peg.775","2216"
"31560",240,540,300,"ACATATTTCGAAGCTGCTAA","GTTACTTCTGACACTGCTGT","561307.5.peg.775","2216"
"31561",816,540,276,"TCAAACTTACAATAACGAA","GTTACTTCTGACACTGCTGT","561307.5.peg.775","2216"
"31562",180,816,636,"GGTGCATAAGCGTATGTGAA","TCAAACTTACAATAACGAA","561307.5.peg.775","2216"
"31563",240,816,576,"ACATATTTCGAAGCTGCTAA","TCAAACTTACAATAACGAA","561307.5.peg.775","2216"
"31564",540,816,276,"GTTACTTCTGACACTGCTGT","TCAAACTTACAATAACGAA","561307.5.peg.775","2216"
"31565",489,816,327,"CCTCTCCATGTCGCTAATAC","TCAAACTTACAATAACGAA","561307.5.peg.775","2216"
"31566",518,816,298,"GCCCCATAGATTTATAACCT","TCAAACTTACAATAACGAA","561307.5.peg.775","2216"
"31567",604,9,595,"GGTCGGGAATAACTCAGTAA","ATGTCCAGTAACAAATTTGG","561307.5.peg.776","2217"
"31568",625,9,616,"AGCTGATGTAATTGGAACTT","ATGTCCAGTAACAAATTTGG","561307.5.peg.776","2217"
"31569",357,9,348,"TCTTGTGCTTTGTTGGAAAC","ATGTCCAGTAACAAATTTGG","561307.5.peg.776","2217"
"31570",548,9,539,"CACCAGTTGAACCAGTTTGA","ATGTCCAGTAACAAATTTGG","561307.5.peg.776","2217"
"31571",364,9,355,"AACCACGTCTTGTGCTTTGT","ATGTCCAGTAACAAATTTGG","561307.5.peg.776","2217"
"31572",512,9,503,"CTGTAGCAATCACTAGCGAA","ATGTCCAGTAACAAATTTGG","561307.5.peg.776","2217"
"31573",470,9,461,"GAGTATGTACAGTGAAAGTT","ATGTCCAGTAACAAATTTGG","561307.5.peg.776","2217"
"31574",620,9,611,"ATGTAATTGGAACTTCGGTC","ATGTCCAGTAACAAATTTGG","561307.5.peg.776","2217"
"31575",357,12,345,"TCTTGTGCTTTGTTGGAAAC","GAATGTCCAGTAACAAATT","561307.5.peg.776","2217"
"31576",620,12,608,"ATGTAATTGGAACTTCGGTC","GAATGTCCAGTAACAAATT","561307.5.peg.776","2217"
"31577",512,12,500,"CTGTAGCAATCACTAGCGAA","GAATGTCCAGTAACAAATT","561307.5.peg.776","2217"
"31578",364,12,352,"AACCACGTCTTGTGCTTTGT","GAATGTCCAGTAACAAATT","561307.5.peg.776","2217"
"31579",604,12,592,"GGTCGGGAATAACTCAGTAA","GAATGTCCAGTAACAAATT","561307.5.peg.776","2217"
"31580",625,12,613,"AGCTGATGTAATTGGAACTT","GAATGTCCAGTAACAAATT","561307.5.peg.776","2217"
"31581",548,12,536,"CACCAGTTGAACCAGTTTGA","GAATGTCCAGTAACAAATT","561307.5.peg.776","2217"
"31582",470,12,458,"GAGTATGTACAGTGAAAGTT","GAATGTCCAGTAACAAATT","561307.5.peg.776","2217"
"31583",357,24,333,"TCTTGTGCTTTGTTGGAAAC","GCTTCCTCCAAATTTGTTAC","561307.5.peg.776","2217"
"31584",620,24,596,"ATGTAATTGGAACTTCGGTC","GCTTCCTCCAAATTTGTTAC","561307.5.peg.776","2217"
"31585",364,24,340,"AACCACGTCTTGTGCTTTGT","GCTTCCTCCAAATTTGTTAC","561307.5.peg.776","2217"
"31586",604,24,580,"GGTCGGGAATAACTCAGTAA","GCTTCCTCCAAATTTGTTAC","561307.5.peg.776","2217"
"31587",625,24,601,"AGCTGATGTAATTGGAACTT","GCTTCCTCCAAATTTGTTAC","561307.5.peg.776","2217"
"31588",470,24,446,"GAGTATGTACAGTGAAAGTT","GCTTCCTCCAAATTTGTTAC","561307.5.peg.776","2217"
"31589",512,24,488,"CTGTAGCAATCACTAGCGAA","GCTTCCTCCAAATTTGTTAC","561307.5.peg.776","2217"
"31590",548,24,524,"CACCAGTTGAACCAGTTTGA","GCTTCCTCCAAATTTGTTAC","561307.5.peg.776","2217"
"31591",357,81,276,"TCTTGTGCTTTGTTGGAAAC","ACTGCCGCCATTAAGCCGCT","561307.5.peg.776","2217"
"31592",364,81,283,"AACCACGTCTTGTGCTTTGT","ACTGCCGCCATTAAGCCGCT","561307.5.peg.776","2217"
"31593",625,81,544,"AGCTGATGTAATTGGAACTT","ACTGCCGCCATTAAGCCGCT","561307.5.peg.776","2217"
"31594",470,81,389,"GAGTATGTACAGTGAAAGTT","ACTGCCGCCATTAAGCCGCT","561307.5.peg.776","2217"
"31595",512,81,431,"CTGTAGCAATCACTAGCGAA","ACTGCCGCCATTAAGCCGCT","561307.5.peg.776","2217"
"31596",604,81,523,"GGTCGGGAATAACTCAGTAA","ACTGCCGCCATTAAGCCGCT","561307.5.peg.776","2217"
"31597",620,81,539,"ATGTAATTGGAACTTCGGTC","ACTGCCGCCATTAAGCCGCT","561307.5.peg.776","2217"
"31598",548,81,467,"CACCAGTTGAACCAGTTTGA","ACTGCCGCCATTAAGCCGCT","561307.5.peg.776","2217"
"31599",9,357,348,"ATGTCCAGTAACAAATTTGG","TCTTGTGCTTTGTTGGAAAC","561307.5.peg.776","2217"
"31600",548,357,191,"CACCAGTTGAACCAGTTTGA","TCTTGTGCTTTGTTGGAAAC","561307.5.peg.776","2217"
"31601",604,357,247,"GGTCGGGAATAACTCAGTAA","TCTTGTGCTTTGTTGGAAAC","561307.5.peg.776","2217"
"31602",24,357,333,"GCTTCCTCCAAATTTGTTAC","TCTTGTGCTTTGTTGGAAAC","561307.5.peg.776","2217"
"31603",625,357,268,"AGCTGATGTAATTGGAACTT","TCTTGTGCTTTGTTGGAAAC","561307.5.peg.776","2217"
"31604",81,357,276,"ACTGCCGCCATTAAGCCGCT","TCTTGTGCTTTGTTGGAAAC","561307.5.peg.776","2217"
"31605",470,357,113,"GAGTATGTACAGTGAAAGTT","TCTTGTGCTTTGTTGGAAAC","561307.5.peg.776","2217"
"31606",512,357,155,"CTGTAGCAATCACTAGCGAA","TCTTGTGCTTTGTTGGAAAC","561307.5.peg.776","2217"
"31607",12,357,345,"GAATGTCCAGTAACAAATT","TCTTGTGCTTTGTTGGAAAC","561307.5.peg.776","2217"
"31608",620,357,263,"ATGTAATTGGAACTTCGGTC","TCTTGTGCTTTGTTGGAAAC","561307.5.peg.776","2217"
"31609",12,364,352,"GAATGTCCAGTAACAAATT","AACCACGTCTTGTGCTTTGT","561307.5.peg.776","2217"
"31610",24,364,340,"GCTTCCTCCAAATTTGTTAC","AACCACGTCTTGTGCTTTGT","561307.5.peg.776","2217"
"31611",625,364,261,"AGCTGATGTAATTGGAACTT","AACCACGTCTTGTGCTTTGT","561307.5.peg.776","2217"
"31612",9,364,355,"ATGTCCAGTAACAAATTTGG","AACCACGTCTTGTGCTTTGT","561307.5.peg.776","2217"
"31613",620,364,256,"ATGTAATTGGAACTTCGGTC","AACCACGTCTTGTGCTTTGT","561307.5.peg.776","2217"
"31614",604,364,240,"GGTCGGGAATAACTCAGTAA","AACCACGTCTTGTGCTTTGT","561307.5.peg.776","2217"
"31615",81,364,283,"ACTGCCGCCATTAAGCCGCT","AACCACGTCTTGTGCTTTGT","561307.5.peg.776","2217"
"31616",512,364,148,"CTGTAGCAATCACTAGCGAA","AACCACGTCTTGTGCTTTGT","561307.5.peg.776","2217"
"31617",470,364,106,"GAGTATGTACAGTGAAAGTT","AACCACGTCTTGTGCTTTGT","561307.5.peg.776","2217"
"31618",548,364,184,"CACCAGTTGAACCAGTTTGA","AACCACGTCTTGTGCTTTGT","561307.5.peg.776","2217"
"31619",9,470,461,"ATGTCCAGTAACAAATTTGG","GAGTATGTACAGTGAAAGTT","561307.5.peg.776","2217"
"31620",12,470,458,"GAATGTCCAGTAACAAATT","GAGTATGTACAGTGAAAGTT","561307.5.peg.776","2217"
"31621",364,470,106,"AACCACGTCTTGTGCTTTGT","GAGTATGTACAGTGAAAGTT","561307.5.peg.776","2217"
"31622",625,470,155,"AGCTGATGTAATTGGAACTT","GAGTATGTACAGTGAAAGTT","561307.5.peg.776","2217"
"31623",604,470,134,"GGTCGGGAATAACTCAGTAA","GAGTATGTACAGTGAAAGTT","561307.5.peg.776","2217"
"31624",24,470,446,"GCTTCCTCCAAATTTGTTAC","GAGTATGTACAGTGAAAGTT","561307.5.peg.776","2217"
"31625",357,470,113,"TCTTGTGCTTTGTTGGAAAC","GAGTATGTACAGTGAAAGTT","561307.5.peg.776","2217"
"31626",81,470,389,"ACTGCCGCCATTAAGCCGCT","GAGTATGTACAGTGAAAGTT","561307.5.peg.776","2217"
"31627",620,470,150,"ATGTAATTGGAACTTCGGTC","GAGTATGTACAGTGAAAGTT","561307.5.peg.776","2217"
"31628",81,512,431,"ACTGCCGCCATTAAGCCGCT","CTGTAGCAATCACTAGCGAA","561307.5.peg.776","2217"
"31629",620,512,108,"ATGTAATTGGAACTTCGGTC","CTGTAGCAATCACTAGCGAA","561307.5.peg.776","2217"
"31630",9,512,503,"ATGTCCAGTAACAAATTTGG","CTGTAGCAATCACTAGCGAA","561307.5.peg.776","2217"
"31631",364,512,148,"AACCACGTCTTGTGCTTTGT","CTGTAGCAATCACTAGCGAA","561307.5.peg.776","2217"
"31632",12,512,500,"GAATGTCCAGTAACAAATT","CTGTAGCAATCACTAGCGAA","561307.5.peg.776","2217"
"31633",625,512,113,"AGCTGATGTAATTGGAACTT","CTGTAGCAATCACTAGCGAA","561307.5.peg.776","2217"
"31634",24,512,488,"GCTTCCTCCAAATTTGTTAC","CTGTAGCAATCACTAGCGAA","561307.5.peg.776","2217"
"31635",357,512,155,"TCTTGTGCTTTGTTGGAAAC","CTGTAGCAATCACTAGCGAA","561307.5.peg.776","2217"
"31636",357,548,191,"TCTTGTGCTTTGTTGGAAAC","CACCAGTTGAACCAGTTTGA","561307.5.peg.776","2217"
"31637",24,548,524,"GCTTCCTCCAAATTTGTTAC","CACCAGTTGAACCAGTTTGA","561307.5.peg.776","2217"
"31638",9,548,539,"ATGTCCAGTAACAAATTTGG","CACCAGTTGAACCAGTTTGA","561307.5.peg.776","2217"
"31639",12,548,536,"GAATGTCCAGTAACAAATT","CACCAGTTGAACCAGTTTGA","561307.5.peg.776","2217"
"31640",364,548,184,"AACCACGTCTTGTGCTTTGT","CACCAGTTGAACCAGTTTGA","561307.5.peg.776","2217"
"31641",81,548,467,"ACTGCCGCCATTAAGCCGCT","CACCAGTTGAACCAGTTTGA","561307.5.peg.776","2217"
"31642",9,604,595,"ATGTCCAGTAACAAATTTGG","GGTCGGGAATAACTCAGTAA","561307.5.peg.776","2217"
"31643",12,604,592,"GAATGTCCAGTAACAAATT","GGTCGGGAATAACTCAGTAA","561307.5.peg.776","2217"
"31644",81,604,523,"ACTGCCGCCATTAAGCCGCT","GGTCGGGAATAACTCAGTAA","561307.5.peg.776","2217"
"31645",24,604,580,"GCTTCCTCCAAATTTGTTAC","GGTCGGGAATAACTCAGTAA","561307.5.peg.776","2217"
"31646",470,604,134,"GAGTATGTACAGTGAAAGTT","GGTCGGGAATAACTCAGTAA","561307.5.peg.776","2217"
"31647",364,604,240,"AACCACGTCTTGTGCTTTGT","GGTCGGGAATAACTCAGTAA","561307.5.peg.776","2217"
"31648",357,604,247,"TCTTGTGCTTTGTTGGAAAC","GGTCGGGAATAACTCAGTAA","561307.5.peg.776","2217"
"31649",12,620,608,"GAATGTCCAGTAACAAATT","ATGTAATTGGAACTTCGGTC","561307.5.peg.776","2217"
"31650",364,620,256,"AACCACGTCTTGTGCTTTGT","ATGTAATTGGAACTTCGGTC","561307.5.peg.776","2217"
"31651",9,620,611,"ATGTCCAGTAACAAATTTGG","ATGTAATTGGAACTTCGGTC","561307.5.peg.776","2217"
"31652",357,620,263,"TCTTGTGCTTTGTTGGAAAC","ATGTAATTGGAACTTCGGTC","561307.5.peg.776","2217"
"31653",81,620,539,"ACTGCCGCCATTAAGCCGCT","ATGTAATTGGAACTTCGGTC","561307.5.peg.776","2217"
"31654",470,620,150,"GAGTATGTACAGTGAAAGTT","ATGTAATTGGAACTTCGGTC","561307.5.peg.776","2217"
"31655",512,620,108,"CTGTAGCAATCACTAGCGAA","ATGTAATTGGAACTTCGGTC","561307.5.peg.776","2217"
"31656",24,620,596,"GCTTCCTCCAAATTTGTTAC","ATGTAATTGGAACTTCGGTC","561307.5.peg.776","2217"
"31657",9,625,616,"ATGTCCAGTAACAAATTTGG","AGCTGATGTAATTGGAACTT","561307.5.peg.776","2217"
"31658",12,625,613,"GAATGTCCAGTAACAAATT","AGCTGATGTAATTGGAACTT","561307.5.peg.776","2217"
"31659",81,625,544,"ACTGCCGCCATTAAGCCGCT","AGCTGATGTAATTGGAACTT","561307.5.peg.776","2217"
"31660",364,625,261,"AACCACGTCTTGTGCTTTGT","AGCTGATGTAATTGGAACTT","561307.5.peg.776","2217"
"31661",470,625,155,"GAGTATGTACAGTGAAAGTT","AGCTGATGTAATTGGAACTT","561307.5.peg.776","2217"
"31662",512,625,113,"CTGTAGCAATCACTAGCGAA","AGCTGATGTAATTGGAACTT","561307.5.peg.776","2217"
"31663",24,625,601,"GCTTCCTCCAAATTTGTTAC","AGCTGATGTAATTGGAACTT","561307.5.peg.776","2217"
"31664",357,625,268,"TCTTGTGCTTTGTTGGAAAC","AGCTGATGTAATTGGAACTT","561307.5.peg.776","2217"
"31665",817,9,808,"TACTGTTGGCACAGAACGGT","GCAGAGAACAGACAACCAGG","561307.5.peg.777","2218"
"31666",771,9,762,"TCAAATGACAGCACTTCGTT","GCAGAGAACAGACAACCAGG","561307.5.peg.777","2218"
"31667",143,9,134,"TTAAGGCTTGTGCACCATTT","GCAGAGAACAGACAACCAGG","561307.5.peg.777","2218"
"31668",2662,9,2653,"GGCATTTAGACCATCTCCTT","GCAGAGAACAGACAACCAGG","561307.5.peg.777","2218"
"31669",1698,9,1689,"CGTTAAATGTTACTGTTCT","GCAGAGAACAGACAACCAGG","561307.5.peg.777","2218"
"31670",2244,9,2235,"TTAGCATTTGGTTTAACAAC","GCAGAGAACAGACAACCAGG","561307.5.peg.777","2218"
"31671",1203,9,1194,"TGAGATTTCTCACATTATC","GCAGAGAACAGACAACCAGG","561307.5.peg.777","2218"
"31672",2691,9,2682,"ACAACAGTTACAGGAGCAAT","GCAGAGAACAGACAACCAGG","561307.5.peg.777","2218"
"31673",810,9,801,"GGCACAGAACGGTTGGTACT","GCAGAGAACAGACAACCAGG","561307.5.peg.777","2218"
"31674",720,9,711,"GGATCAGTTGTTGGCGTATA","GCAGAGAACAGACAACCAGG","561307.5.peg.777","2218"
"31675",2221,9,2212,"TGTTGCAGTATCCCCACTTA","GCAGAGAACAGACAACCAGG","561307.5.peg.777","2218"
"31676",2319,9,2310,"ATCTCGTCTTCAGTAGCATC","GCAGAGAACAGACAACCAGG","561307.5.peg.777","2218"
"31677",858,9,849,"CCATTGATTAGTGTGAAGCC","GCAGAGAACAGACAACCAGG","561307.5.peg.777","2218"
"31678",648,9,639,"GGATCTGCTGGAGTTGCATT","GCAGAGAACAGACAACCAGG","561307.5.peg.777","2218"
"31679",669,9,660,"TTTCCTACCGCTGCAGCCGC","GCAGAGAACAGACAACCAGG","561307.5.peg.777","2218"
"31680",741,9,732,"TGTCCTGCATTATTGGCATT","GCAGAGAACAGACAACCAGG","561307.5.peg.777","2218"
"31681",357,9,348,"GTACTTGATTGCACTGATGT","GCAGAGAACAGACAACCAGG","561307.5.peg.777","2218"
"31682",2683,9,2674,"TACAGGAGCAATTGGATTAA","GCAGAGAACAGACAACCAGG","561307.5.peg.777","2218"
"31683",292,9,283,"TGCTTGATTCGTTGCTTGAT","GCAGAGAACAGACAACCAGG","561307.5.peg.777","2218"
"31684",1524,9,1515,"TCAACGCCTGAATTGTTACT","GCAGAGAACAGACAACCAGG","561307.5.peg.777","2218"
"31685",639,9,630,"GGAGTTGCATTAGGATCTGC","GCAGAGAACAGACAACCAGG","561307.5.peg.777","2218"
"31686",2171,9,2162,"TAACGCCATCATCAGTCGTT","GCAGAGAACAGACAACCAGG","561307.5.peg.777","2218"
"31687",1837,9,1828,"TTGAATACGTCTGTCAACTT","GCAGAGAACAGACAACCAGG","561307.5.peg.777","2218"
"31688",573,9,564,"TCAGCAATTGCAACTAGCTC","GCAGAGAACAGACAACCAGG","561307.5.peg.777","2218"
"31689",273,9,264,"TTGGTTGTTGCAGATTGATT","GCAGAGAACAGACAACCAGG","561307.5.peg.777","2218"
"31690",1692,9,1683,"AATGTTACTGTTCTTGGTGT","GCAGAGAACAGACAACCAGG","561307.5.peg.777","2218"
"31691",2734,9,2725,"TTGTTGTGCATCATGTGATA","GCAGAGAACAGACAACCAGG","561307.5.peg.777","2218"
"31692",1629,9,1620,"TTATCAGGCATAAGTCGTGC","GCAGAGAACAGACAACCAGG","561307.5.peg.777","2218"
"31693",660,9,651,"GCTGCAGCCGCTGGATCTGC","GCAGAGAACAGACAACCAGG","561307.5.peg.777","2218"
"31694",2605,9,2596,"GATTTGTTCTAAAGCATGGT","GCAGAGAACAGACAACCAGG","561307.5.peg.777","2218"
"31695",2781,9,2772,"CTTTCTTCTTGAGTCGCATC","GCAGAGAACAGACAACCAGG","561307.5.peg.777","2218"
"31696",771,12,759,"TCAAATGACAGCACTTCGTT","ACAGCAGAGAACAGACAACC","561307.5.peg.777","2218"
"31697",1698,12,1686,"CGTTAAATGTTACTGTTCT","ACAGCAGAGAACAGACAACC","561307.5.peg.777","2218"
"31698",669,12,657,"TTTCCTACCGCTGCAGCCGC","ACAGCAGAGAACAGACAACC","561307.5.peg.777","2218"
"31699",2605,12,2593,"GATTTGTTCTAAAGCATGGT","ACAGCAGAGAACAGACAACC","561307.5.peg.777","2218"
"31700",1524,12,1512,"TCAACGCCTGAATTGTTACT","ACAGCAGAGAACAGACAACC","561307.5.peg.777","2218"
"31701",660,12,648,"GCTGCAGCCGCTGGATCTGC","ACAGCAGAGAACAGACAACC","561307.5.peg.777","2218"
"31702",741,12,729,"TGTCCTGCATTATTGGCATT","ACAGCAGAGAACAGACAACC","561307.5.peg.777","2218"
"31703",292,12,280,"TGCTTGATTCGTTGCTTGAT","ACAGCAGAGAACAGACAACC","561307.5.peg.777","2218"
"31704",2734,12,2722,"TTGTTGTGCATCATGTGATA","ACAGCAGAGAACAGACAACC","561307.5.peg.777","2218"
"31705",1629,12,1617,"TTATCAGGCATAAGTCGTGC","ACAGCAGAGAACAGACAACC","561307.5.peg.777","2218"
"31706",639,12,627,"GGAGTTGCATTAGGATCTGC","ACAGCAGAGAACAGACAACC","561307.5.peg.777","2218"
"31707",143,12,131,"TTAAGGCTTGTGCACCATTT","ACAGCAGAGAACAGACAACC","561307.5.peg.777","2218"
"31708",2683,12,2671,"TACAGGAGCAATTGGATTAA","ACAGCAGAGAACAGACAACC","561307.5.peg.777","2218"
"31709",2171,12,2159,"TAACGCCATCATCAGTCGTT","ACAGCAGAGAACAGACAACC","561307.5.peg.777","2218"
"31710",648,12,636,"GGATCTGCTGGAGTTGCATT","ACAGCAGAGAACAGACAACC","561307.5.peg.777","2218"
"31711",810,12,798,"GGCACAGAACGGTTGGTACT","ACAGCAGAGAACAGACAACC","561307.5.peg.777","2218"
"31712",2244,12,2232,"TTAGCATTTGGTTTAACAAC","ACAGCAGAGAACAGACAACC","561307.5.peg.777","2218"
"31713",573,12,561,"TCAGCAATTGCAACTAGCTC","ACAGCAGAGAACAGACAACC","561307.5.peg.777","2218"
"31714",2691,12,2679,"ACAACAGTTACAGGAGCAAT","ACAGCAGAGAACAGACAACC","561307.5.peg.777","2218"
"31715",2319,12,2307,"ATCTCGTCTTCAGTAGCATC","ACAGCAGAGAACAGACAACC","561307.5.peg.777","2218"
"31716",273,12,261,"TTGGTTGTTGCAGATTGATT","ACAGCAGAGAACAGACAACC","561307.5.peg.777","2218"
"31717",858,12,846,"CCATTGATTAGTGTGAAGCC","ACAGCAGAGAACAGACAACC","561307.5.peg.777","2218"
"31718",2781,12,2769,"CTTTCTTCTTGAGTCGCATC","ACAGCAGAGAACAGACAACC","561307.5.peg.777","2218"
"31719",1203,12,1191,"TGAGATTTCTCACATTATC","ACAGCAGAGAACAGACAACC","561307.5.peg.777","2218"
"31720",720,12,708,"GGATCAGTTGTTGGCGTATA","ACAGCAGAGAACAGACAACC","561307.5.peg.777","2218"
"31721",2221,12,2209,"TGTTGCAGTATCCCCACTTA","ACAGCAGAGAACAGACAACC","561307.5.peg.777","2218"
"31722",1837,12,1825,"TTGAATACGTCTGTCAACTT","ACAGCAGAGAACAGACAACC","561307.5.peg.777","2218"
"31723",817,12,805,"TACTGTTGGCACAGAACGGT","ACAGCAGAGAACAGACAACC","561307.5.peg.777","2218"
"31724",2662,12,2650,"GGCATTTAGACCATCTCCTT","ACAGCAGAGAACAGACAACC","561307.5.peg.777","2218"
"31725",357,12,345,"GTACTTGATTGCACTGATGT","ACAGCAGAGAACAGACAACC","561307.5.peg.777","2218"
"31726",1692,12,1680,"AATGTTACTGTTCTTGGTGT","ACAGCAGAGAACAGACAACC","561307.5.peg.777","2218"
"31727",648,143,505,"GGATCTGCTGGAGTTGCATT","TTAAGGCTTGTGCACCATTT","561307.5.peg.777","2218"
"31728",2244,143,2101,"TTAGCATTTGGTTTAACAAC","TTAAGGCTTGTGCACCATTT","561307.5.peg.777","2218"
"31729",1203,143,1060,"TGAGATTTCTCACATTATC","TTAAGGCTTGTGCACCATTT","561307.5.peg.777","2218"
"31730",2662,143,2519,"GGCATTTAGACCATCTCCTT","TTAAGGCTTGTGCACCATTT","561307.5.peg.777","2218"
"31731",720,143,577,"GGATCAGTTGTTGGCGTATA","TTAAGGCTTGTGCACCATTT","561307.5.peg.777","2218"
"31732",12,143,131,"ACAGCAGAGAACAGACAACC","TTAAGGCTTGTGCACCATTT","561307.5.peg.777","2218"
"31733",2683,143,2540,"TACAGGAGCAATTGGATTAA","TTAAGGCTTGTGCACCATTT","561307.5.peg.777","2218"
"31734",1698,143,1555,"CGTTAAATGTTACTGTTCT","TTAAGGCTTGTGCACCATTT","561307.5.peg.777","2218"
"31735",639,143,496,"GGAGTTGCATTAGGATCTGC","TTAAGGCTTGTGCACCATTT","561307.5.peg.777","2218"
"31736",2734,143,2591,"TTGTTGTGCATCATGTGATA","TTAAGGCTTGTGCACCATTT","561307.5.peg.777","2218"
"31737",1629,143,1486,"TTATCAGGCATAAGTCGTGC","TTAAGGCTTGTGCACCATTT","561307.5.peg.777","2218"
"31738",1692,143,1549,"AATGTTACTGTTCTTGGTGT","TTAAGGCTTGTGCACCATTT","561307.5.peg.777","2218"
"31739",2781,143,2638,"CTTTCTTCTTGAGTCGCATC","TTAAGGCTTGTGCACCATTT","561307.5.peg.777","2218"
"31740",573,143,430,"TCAGCAATTGCAACTAGCTC","TTAAGGCTTGTGCACCATTT","561307.5.peg.777","2218"
"31741",273,143,130,"TTGGTTGTTGCAGATTGATT","TTAAGGCTTGTGCACCATTT","561307.5.peg.777","2218"
"31742",2691,143,2548,"ACAACAGTTACAGGAGCAAT","TTAAGGCTTGTGCACCATTT","561307.5.peg.777","2218"
"31743",292,143,149,"TGCTTGATTCGTTGCTTGAT","TTAAGGCTTGTGCACCATTT","561307.5.peg.777","2218"
"31744",1524,143,1381,"TCAACGCCTGAATTGTTACT","TTAAGGCTTGTGCACCATTT","561307.5.peg.777","2218"
"31745",858,143,715,"CCATTGATTAGTGTGAAGCC","TTAAGGCTTGTGCACCATTT","561307.5.peg.777","2218"
"31746",9,143,134,"GCAGAGAACAGACAACCAGG","TTAAGGCTTGTGCACCATTT","561307.5.peg.777","2218"
"31747",2605,143,2462,"GATTTGTTCTAAAGCATGGT","TTAAGGCTTGTGCACCATTT","561307.5.peg.777","2218"
"31748",1837,143,1694,"TTGAATACGTCTGTCAACTT","TTAAGGCTTGTGCACCATTT","561307.5.peg.777","2218"
"31749",2319,143,2176,"ATCTCGTCTTCAGTAGCATC","TTAAGGCTTGTGCACCATTT","561307.5.peg.777","2218"
"31750",2171,143,2028,"TAACGCCATCATCAGTCGTT","TTAAGGCTTGTGCACCATTT","561307.5.peg.777","2218"
"31751",357,143,214,"GTACTTGATTGCACTGATGT","TTAAGGCTTGTGCACCATTT","561307.5.peg.777","2218"
"31752",660,143,517,"GCTGCAGCCGCTGGATCTGC","TTAAGGCTTGTGCACCATTT","561307.5.peg.777","2218"
"31753",2221,143,2078,"TGTTGCAGTATCCCCACTTA","TTAAGGCTTGTGCACCATTT","561307.5.peg.777","2218"
"31754",810,143,667,"GGCACAGAACGGTTGGTACT","TTAAGGCTTGTGCACCATTT","561307.5.peg.777","2218"
"31755",817,143,674,"TACTGTTGGCACAGAACGGT","TTAAGGCTTGTGCACCATTT","561307.5.peg.777","2218"
"31756",669,143,526,"TTTCCTACCGCTGCAGCCGC","TTAAGGCTTGTGCACCATTT","561307.5.peg.777","2218"
"31757",771,143,628,"TCAAATGACAGCACTTCGTT","TTAAGGCTTGTGCACCATTT","561307.5.peg.777","2218"
"31758",741,143,598,"TGTCCTGCATTATTGGCATT","TTAAGGCTTGTGCACCATTT","561307.5.peg.777","2218"
"31759",858,273,585,"CCATTGATTAGTGTGAAGCC","TTGGTTGTTGCAGATTGATT","561307.5.peg.777","2218"
"31760",1629,273,1356,"TTATCAGGCATAAGTCGTGC","TTGGTTGTTGCAGATTGATT","561307.5.peg.777","2218"
"31761",639,273,366,"GGAGTTGCATTAGGATCTGC","TTGGTTGTTGCAGATTGATT","561307.5.peg.777","2218"
"31762",143,273,130,"TTAAGGCTTGTGCACCATTT","TTGGTTGTTGCAGATTGATT","561307.5.peg.777","2218"
"31763",9,273,264,"GCAGAGAACAGACAACCAGG","TTGGTTGTTGCAGATTGATT","561307.5.peg.777","2218"
"31764",771,273,498,"TCAAATGACAGCACTTCGTT","TTGGTTGTTGCAGATTGATT","561307.5.peg.777","2218"
"31765",2221,273,1948,"TGTTGCAGTATCCCCACTTA","TTGGTTGTTGCAGATTGATT","561307.5.peg.777","2218"
"31766",12,273,261,"ACAGCAGAGAACAGACAACC","TTGGTTGTTGCAGATTGATT","561307.5.peg.777","2218"
"31767",669,273,396,"TTTCCTACCGCTGCAGCCGC","TTGGTTGTTGCAGATTGATT","561307.5.peg.777","2218"
"31768",1837,273,1564,"TTGAATACGTCTGTCAACTT","TTGGTTGTTGCAGATTGATT","561307.5.peg.777","2218"
"31769",2781,273,2508,"CTTTCTTCTTGAGTCGCATC","TTGGTTGTTGCAGATTGATT","561307.5.peg.777","2218"
"31770",2319,273,2046,"ATCTCGTCTTCAGTAGCATC","TTGGTTGTTGCAGATTGATT","561307.5.peg.777","2218"
"31771",1692,273,1419,"AATGTTACTGTTCTTGGTGT","TTGGTTGTTGCAGATTGATT","561307.5.peg.777","2218"
"31772",2734,273,2461,"TTGTTGTGCATCATGTGATA","TTGGTTGTTGCAGATTGATT","561307.5.peg.777","2218"
"31773",2691,273,2418,"ACAACAGTTACAGGAGCAAT","TTGGTTGTTGCAGATTGATT","561307.5.peg.777","2218"
"31774",660,273,387,"GCTGCAGCCGCTGGATCTGC","TTGGTTGTTGCAGATTGATT","561307.5.peg.777","2218"
"31775",2683,273,2410,"TACAGGAGCAATTGGATTAA","TTGGTTGTTGCAGATTGATT","561307.5.peg.777","2218"
"31776",741,273,468,"TGTCCTGCATTATTGGCATT","TTGGTTGTTGCAGATTGATT","561307.5.peg.777","2218"
"31777",817,273,544,"TACTGTTGGCACAGAACGGT","TTGGTTGTTGCAGATTGATT","561307.5.peg.777","2218"
"31778",1203,273,930,"TGAGATTTCTCACATTATC","TTGGTTGTTGCAGATTGATT","561307.5.peg.777","2218"
"31779",573,273,300,"TCAGCAATTGCAACTAGCTC","TTGGTTGTTGCAGATTGATT","561307.5.peg.777","2218"
"31780",648,273,375,"GGATCTGCTGGAGTTGCATT","TTGGTTGTTGCAGATTGATT","561307.5.peg.777","2218"
"31781",2662,273,2389,"GGCATTTAGACCATCTCCTT","TTGGTTGTTGCAGATTGATT","561307.5.peg.777","2218"
"31782",1698,273,1425,"CGTTAAATGTTACTGTTCT","TTGGTTGTTGCAGATTGATT","561307.5.peg.777","2218"
"31783",1524,273,1251,"TCAACGCCTGAATTGTTACT","TTGGTTGTTGCAGATTGATT","561307.5.peg.777","2218"
"31784",720,273,447,"GGATCAGTTGTTGGCGTATA","TTGGTTGTTGCAGATTGATT","561307.5.peg.777","2218"
"31785",2244,273,1971,"TTAGCATTTGGTTTAACAAC","TTGGTTGTTGCAGATTGATT","561307.5.peg.777","2218"
"31786",810,273,537,"GGCACAGAACGGTTGGTACT","TTGGTTGTTGCAGATTGATT","561307.5.peg.777","2218"
"31787",2605,273,2332,"GATTTGTTCTAAAGCATGGT","TTGGTTGTTGCAGATTGATT","561307.5.peg.777","2218"
"31788",2171,273,1898,"TAACGCCATCATCAGTCGTT","TTGGTTGTTGCAGATTGATT","561307.5.peg.777","2218"
"31789",2781,292,2489,"CTTTCTTCTTGAGTCGCATC","TGCTTGATTCGTTGCTTGAT","561307.5.peg.777","2218"
"31790",1203,292,911,"TGAGATTTCTCACATTATC","TGCTTGATTCGTTGCTTGAT","561307.5.peg.777","2218"
"31791",720,292,428,"GGATCAGTTGTTGGCGTATA","TGCTTGATTCGTTGCTTGAT","561307.5.peg.777","2218"
"31792",810,292,518,"GGCACAGAACGGTTGGTACT","TGCTTGATTCGTTGCTTGAT","561307.5.peg.777","2218"
"31793",1629,292,1337,"TTATCAGGCATAAGTCGTGC","TGCTTGATTCGTTGCTTGAT","561307.5.peg.777","2218"
"31794",2605,292,2313,"GATTTGTTCTAAAGCATGGT","TGCTTGATTCGTTGCTTGAT","561307.5.peg.777","2218"
"31795",573,292,281,"TCAGCAATTGCAACTAGCTC","TGCTTGATTCGTTGCTTGAT","561307.5.peg.777","2218"
"31796",2683,292,2391,"TACAGGAGCAATTGGATTAA","TGCTTGATTCGTTGCTTGAT","561307.5.peg.777","2218"
"31797",817,292,525,"TACTGTTGGCACAGAACGGT","TGCTTGATTCGTTGCTTGAT","561307.5.peg.777","2218"
"31798",669,292,377,"TTTCCTACCGCTGCAGCCGC","TGCTTGATTCGTTGCTTGAT","561307.5.peg.777","2218"
"31799",2171,292,1879,"TAACGCCATCATCAGTCGTT","TGCTTGATTCGTTGCTTGAT","561307.5.peg.777","2218"
"31800",648,292,356,"GGATCTGCTGGAGTTGCATT","TGCTTGATTCGTTGCTTGAT","561307.5.peg.777","2218"
"31801",1524,292,1232,"TCAACGCCTGAATTGTTACT","TGCTTGATTCGTTGCTTGAT","561307.5.peg.777","2218"
"31802",9,292,283,"GCAGAGAACAGACAACCAGG","TGCTTGATTCGTTGCTTGAT","561307.5.peg.777","2218"
"31803",2319,292,2027,"ATCTCGTCTTCAGTAGCATC","TGCTTGATTCGTTGCTTGAT","561307.5.peg.777","2218"
"31804",2662,292,2370,"GGCATTTAGACCATCTCCTT","TGCTTGATTCGTTGCTTGAT","561307.5.peg.777","2218"
"31805",741,292,449,"TGTCCTGCATTATTGGCATT","TGCTTGATTCGTTGCTTGAT","561307.5.peg.777","2218"
"31806",1692,292,1400,"AATGTTACTGTTCTTGGTGT","TGCTTGATTCGTTGCTTGAT","561307.5.peg.777","2218"
"31807",858,292,566,"CCATTGATTAGTGTGAAGCC","TGCTTGATTCGTTGCTTGAT","561307.5.peg.777","2218"
"31808",2734,292,2442,"TTGTTGTGCATCATGTGATA","TGCTTGATTCGTTGCTTGAT","561307.5.peg.777","2218"
"31809",639,292,347,"GGAGTTGCATTAGGATCTGC","TGCTTGATTCGTTGCTTGAT","561307.5.peg.777","2218"
"31810",12,292,280,"ACAGCAGAGAACAGACAACC","TGCTTGATTCGTTGCTTGAT","561307.5.peg.777","2218"
"31811",2244,292,1952,"TTAGCATTTGGTTTAACAAC","TGCTTGATTCGTTGCTTGAT","561307.5.peg.777","2218"
"31812",1698,292,1406,"CGTTAAATGTTACTGTTCT","TGCTTGATTCGTTGCTTGAT","561307.5.peg.777","2218"
"31813",2691,292,2399,"ACAACAGTTACAGGAGCAAT","TGCTTGATTCGTTGCTTGAT","561307.5.peg.777","2218"
"31814",2221,292,1929,"TGTTGCAGTATCCCCACTTA","TGCTTGATTCGTTGCTTGAT","561307.5.peg.777","2218"
"31815",1837,292,1545,"TTGAATACGTCTGTCAACTT","TGCTTGATTCGTTGCTTGAT","561307.5.peg.777","2218"
"31816",660,292,368,"GCTGCAGCCGCTGGATCTGC","TGCTTGATTCGTTGCTTGAT","561307.5.peg.777","2218"
"31817",143,292,149,"TTAAGGCTTGTGCACCATTT","TGCTTGATTCGTTGCTTGAT","561307.5.peg.777","2218"
"31818",771,292,479,"TCAAATGACAGCACTTCGTT","TGCTTGATTCGTTGCTTGAT","561307.5.peg.777","2218"
"31819",9,357,348,"GCAGAGAACAGACAACCAGG","GTACTTGATTGCACTGATGT","561307.5.peg.777","2218"
"31820",2683,357,2326,"TACAGGAGCAATTGGATTAA","GTACTTGATTGCACTGATGT","561307.5.peg.777","2218"
"31821",2691,357,2334,"ACAACAGTTACAGGAGCAAT","GTACTTGATTGCACTGATGT","561307.5.peg.777","2218"
"31822",12,357,345,"ACAGCAGAGAACAGACAACC","GTACTTGATTGCACTGATGT","561307.5.peg.777","2218"
"31823",143,357,214,"TTAAGGCTTGTGCACCATTT","GTACTTGATTGCACTGATGT","561307.5.peg.777","2218"
"31824",660,357,303,"GCTGCAGCCGCTGGATCTGC","GTACTTGATTGCACTGATGT","561307.5.peg.777","2218"
"31825",1692,357,1335,"AATGTTACTGTTCTTGGTGT","GTACTTGATTGCACTGATGT","561307.5.peg.777","2218"
"31826",771,357,414,"TCAAATGACAGCACTTCGTT","GTACTTGATTGCACTGATGT","561307.5.peg.777","2218"
"31827",810,357,453,"GGCACAGAACGGTTGGTACT","GTACTTGATTGCACTGATGT","561307.5.peg.777","2218"
"31828",648,357,291,"GGATCTGCTGGAGTTGCATT","GTACTTGATTGCACTGATGT","561307.5.peg.777","2218"
"31829",720,357,363,"GGATCAGTTGTTGGCGTATA","GTACTTGATTGCACTGATGT","561307.5.peg.777","2218"
"31830",1837,357,1480,"TTGAATACGTCTGTCAACTT","GTACTTGATTGCACTGATGT","561307.5.peg.777","2218"
"31831",1203,357,846,"TGAGATTTCTCACATTATC","GTACTTGATTGCACTGATGT","561307.5.peg.777","2218"
"31832",817,357,460,"TACTGTTGGCACAGAACGGT","GTACTTGATTGCACTGATGT","561307.5.peg.777","2218"
"31833",669,357,312,"TTTCCTACCGCTGCAGCCGC","GTACTTGATTGCACTGATGT","561307.5.peg.777","2218"
"31834",741,357,384,"TGTCCTGCATTATTGGCATT","GTACTTGATTGCACTGATGT","561307.5.peg.777","2218"
"31835",2734,357,2377,"TTGTTGTGCATCATGTGATA","GTACTTGATTGCACTGATGT","561307.5.peg.777","2218"
"31836",1524,357,1167,"TCAACGCCTGAATTGTTACT","GTACTTGATTGCACTGATGT","561307.5.peg.777","2218"
"31837",2319,357,1962,"ATCTCGTCTTCAGTAGCATC","GTACTTGATTGCACTGATGT","561307.5.peg.777","2218"
"31838",573,357,216,"TCAGCAATTGCAACTAGCTC","GTACTTGATTGCACTGATGT","561307.5.peg.777","2218"
"31839",2244,357,1887,"TTAGCATTTGGTTTAACAAC","GTACTTGATTGCACTGATGT","561307.5.peg.777","2218"
"31840",1698,357,1341,"CGTTAAATGTTACTGTTCT","GTACTTGATTGCACTGATGT","561307.5.peg.777","2218"
"31841",2171,357,1814,"TAACGCCATCATCAGTCGTT","GTACTTGATTGCACTGATGT","561307.5.peg.777","2218"
"31842",1629,357,1272,"TTATCAGGCATAAGTCGTGC","GTACTTGATTGCACTGATGT","561307.5.peg.777","2218"
"31843",639,357,282,"GGAGTTGCATTAGGATCTGC","GTACTTGATTGCACTGATGT","561307.5.peg.777","2218"
"31844",2781,357,2424,"CTTTCTTCTTGAGTCGCATC","GTACTTGATTGCACTGATGT","561307.5.peg.777","2218"
"31845",2221,357,1864,"TGTTGCAGTATCCCCACTTA","GTACTTGATTGCACTGATGT","561307.5.peg.777","2218"
"31846",2605,357,2248,"GATTTGTTCTAAAGCATGGT","GTACTTGATTGCACTGATGT","561307.5.peg.777","2218"
"31847",858,357,501,"CCATTGATTAGTGTGAAGCC","GTACTTGATTGCACTGATGT","561307.5.peg.777","2218"
"31848",2662,357,2305,"GGCATTTAGACCATCTCCTT","GTACTTGATTGCACTGATGT","561307.5.peg.777","2218"
"31849",2662,573,2089,"GGCATTTAGACCATCTCCTT","TCAGCAATTGCAACTAGCTC","561307.5.peg.777","2218"
"31850",858,573,285,"CCATTGATTAGTGTGAAGCC","TCAGCAATTGCAACTAGCTC","561307.5.peg.777","2218"
"31851",2683,573,2110,"TACAGGAGCAATTGGATTAA","TCAGCAATTGCAACTAGCTC","561307.5.peg.777","2218"
"31852",2221,573,1648,"TGTTGCAGTATCCCCACTTA","TCAGCAATTGCAACTAGCTC","561307.5.peg.777","2218"
"31853",810,573,237,"GGCACAGAACGGTTGGTACT","TCAGCAATTGCAACTAGCTC","561307.5.peg.777","2218"
"31854",2244,573,1671,"TTAGCATTTGGTTTAACAAC","TCAGCAATTGCAACTAGCTC","561307.5.peg.777","2218"
"31855",2319,573,1746,"ATCTCGTCTTCAGTAGCATC","TCAGCAATTGCAACTAGCTC","561307.5.peg.777","2218"
"31856",2781,573,2208,"CTTTCTTCTTGAGTCGCATC","TCAGCAATTGCAACTAGCTC","561307.5.peg.777","2218"
"31857",1837,573,1264,"TTGAATACGTCTGTCAACTT","TCAGCAATTGCAACTAGCTC","561307.5.peg.777","2218"
"31858",1692,573,1119,"AATGTTACTGTTCTTGGTGT","TCAGCAATTGCAACTAGCTC","561307.5.peg.777","2218"
"31859",12,573,561,"ACAGCAGAGAACAGACAACC","TCAGCAATTGCAACTAGCTC","561307.5.peg.777","2218"
"31860",2605,573,2032,"GATTTGTTCTAAAGCATGGT","TCAGCAATTGCAACTAGCTC","561307.5.peg.777","2218"
"31861",1629,573,1056,"TTATCAGGCATAAGTCGTGC","TCAGCAATTGCAACTAGCTC","561307.5.peg.777","2218"
"31862",2691,573,2118,"ACAACAGTTACAGGAGCAAT","TCAGCAATTGCAACTAGCTC","561307.5.peg.777","2218"
"31863",1524,573,951,"TCAACGCCTGAATTGTTACT","TCAGCAATTGCAACTAGCTC","561307.5.peg.777","2218"
"31864",292,573,281,"TGCTTGATTCGTTGCTTGAT","TCAGCAATTGCAACTAGCTC","561307.5.peg.777","2218"
"31865",273,573,300,"TTGGTTGTTGCAGATTGATT","TCAGCAATTGCAACTAGCTC","561307.5.peg.777","2218"
"31866",817,573,244,"TACTGTTGGCACAGAACGGT","TCAGCAATTGCAACTAGCTC","561307.5.peg.777","2218"
"31867",1698,573,1125,"CGTTAAATGTTACTGTTCT","TCAGCAATTGCAACTAGCTC","561307.5.peg.777","2218"
"31868",2171,573,1598,"TAACGCCATCATCAGTCGTT","TCAGCAATTGCAACTAGCTC","561307.5.peg.777","2218"
"31869",720,573,147,"GGATCAGTTGTTGGCGTATA","TCAGCAATTGCAACTAGCTC","561307.5.peg.777","2218"
"31870",143,573,430,"TTAAGGCTTGTGCACCATTT","TCAGCAATTGCAACTAGCTC","561307.5.peg.777","2218"
"31871",1203,573,630,"TGAGATTTCTCACATTATC","TCAGCAATTGCAACTAGCTC","561307.5.peg.777","2218"
"31872",2734,573,2161,"TTGTTGTGCATCATGTGATA","TCAGCAATTGCAACTAGCTC","561307.5.peg.777","2218"
"31873",771,573,198,"TCAAATGACAGCACTTCGTT","TCAGCAATTGCAACTAGCTC","561307.5.peg.777","2218"
"31874",741,573,168,"TGTCCTGCATTATTGGCATT","TCAGCAATTGCAACTAGCTC","561307.5.peg.777","2218"
"31875",357,573,216,"GTACTTGATTGCACTGATGT","TCAGCAATTGCAACTAGCTC","561307.5.peg.777","2218"
"31876",9,573,564,"GCAGAGAACAGACAACCAGG","TCAGCAATTGCAACTAGCTC","561307.5.peg.777","2218"
"31877",1203,639,564,"TGAGATTTCTCACATTATC","GGAGTTGCATTAGGATCTGC","561307.5.peg.777","2218"
"31878",2605,639,1966,"GATTTGTTCTAAAGCATGGT","GGAGTTGCATTAGGATCTGC","561307.5.peg.777","2218"
"31879",771,639,132,"TCAAATGACAGCACTTCGTT","GGAGTTGCATTAGGATCTGC","561307.5.peg.777","2218"
"31880",1698,639,1059,"CGTTAAATGTTACTGTTCT","GGAGTTGCATTAGGATCTGC","561307.5.peg.777","2218"
"31881",1524,639,885,"TCAACGCCTGAATTGTTACT","GGAGTTGCATTAGGATCTGC","561307.5.peg.777","2218"
"31882",2171,639,1532,"TAACGCCATCATCAGTCGTT","GGAGTTGCATTAGGATCTGC","561307.5.peg.777","2218"
"31883",1692,639,1053,"AATGTTACTGTTCTTGGTGT","GGAGTTGCATTAGGATCTGC","561307.5.peg.777","2218"
"31884",2781,639,2142,"CTTTCTTCTTGAGTCGCATC","GGAGTTGCATTAGGATCTGC","561307.5.peg.777","2218"
"31885",741,639,102,"TGTCCTGCATTATTGGCATT","GGAGTTGCATTAGGATCTGC","561307.5.peg.777","2218"
"31886",2319,639,1680,"ATCTCGTCTTCAGTAGCATC","GGAGTTGCATTAGGATCTGC","561307.5.peg.777","2218"
"31887",2691,639,2052,"ACAACAGTTACAGGAGCAAT","GGAGTTGCATTAGGATCTGC","561307.5.peg.777","2218"
"31888",12,639,627,"ACAGCAGAGAACAGACAACC","GGAGTTGCATTAGGATCTGC","561307.5.peg.777","2218"
"31889",292,639,347,"TGCTTGATTCGTTGCTTGAT","GGAGTTGCATTAGGATCTGC","561307.5.peg.777","2218"
"31890",2734,639,2095,"TTGTTGTGCATCATGTGATA","GGAGTTGCATTAGGATCTGC","561307.5.peg.777","2218"
"31891",1837,639,1198,"TTGAATACGTCTGTCAACTT","GGAGTTGCATTAGGATCTGC","561307.5.peg.777","2218"
"31892",1629,639,990,"TTATCAGGCATAAGTCGTGC","GGAGTTGCATTAGGATCTGC","561307.5.peg.777","2218"
"31893",810,639,171,"GGCACAGAACGGTTGGTACT","GGAGTTGCATTAGGATCTGC","561307.5.peg.777","2218"
"31894",9,639,630,"GCAGAGAACAGACAACCAGG","GGAGTTGCATTAGGATCTGC","561307.5.peg.777","2218"
"31895",2221,639,1582,"TGTTGCAGTATCCCCACTTA","GGAGTTGCATTAGGATCTGC","561307.5.peg.777","2218"
"31896",2683,639,2044,"TACAGGAGCAATTGGATTAA","GGAGTTGCATTAGGATCTGC","561307.5.peg.777","2218"
"31897",858,639,219,"CCATTGATTAGTGTGAAGCC","GGAGTTGCATTAGGATCTGC","561307.5.peg.777","2218"
"31898",273,639,366,"TTGGTTGTTGCAGATTGATT","GGAGTTGCATTAGGATCTGC","561307.5.peg.777","2218"
"31899",357,639,282,"GTACTTGATTGCACTGATGT","GGAGTTGCATTAGGATCTGC","561307.5.peg.777","2218"
"31900",2244,639,1605,"TTAGCATTTGGTTTAACAAC","GGAGTTGCATTAGGATCTGC","561307.5.peg.777","2218"
"31901",817,639,178,"TACTGTTGGCACAGAACGGT","GGAGTTGCATTAGGATCTGC","561307.5.peg.777","2218"
"31902",143,639,496,"TTAAGGCTTGTGCACCATTT","GGAGTTGCATTAGGATCTGC","561307.5.peg.777","2218"
"31903",2662,639,2023,"GGCATTTAGACCATCTCCTT","GGAGTTGCATTAGGATCTGC","561307.5.peg.777","2218"
"31904",2683,648,2035,"TACAGGAGCAATTGGATTAA","GGATCTGCTGGAGTTGCATT","561307.5.peg.777","2218"
"31905",357,648,291,"GTACTTGATTGCACTGATGT","GGATCTGCTGGAGTTGCATT","561307.5.peg.777","2218"
"31906",2662,648,2014,"GGCATTTAGACCATCTCCTT","GGATCTGCTGGAGTTGCATT","561307.5.peg.777","2218"
"31907",1629,648,981,"TTATCAGGCATAAGTCGTGC","GGATCTGCTGGAGTTGCATT","561307.5.peg.777","2218"
"31908",2319,648,1671,"ATCTCGTCTTCAGTAGCATC","GGATCTGCTGGAGTTGCATT","561307.5.peg.777","2218"
"31909",12,648,636,"ACAGCAGAGAACAGACAACC","GGATCTGCTGGAGTTGCATT","561307.5.peg.777","2218"
"31910",2734,648,2086,"TTGTTGTGCATCATGTGATA","GGATCTGCTGGAGTTGCATT","561307.5.peg.777","2218"
"31911",1837,648,1189,"TTGAATACGTCTGTCAACTT","GGATCTGCTGGAGTTGCATT","561307.5.peg.777","2218"
"31912",2221,648,1573,"TGTTGCAGTATCCCCACTTA","GGATCTGCTGGAGTTGCATT","561307.5.peg.777","2218"
"31913",817,648,169,"TACTGTTGGCACAGAACGGT","GGATCTGCTGGAGTTGCATT","561307.5.peg.777","2218"
"31914",810,648,162,"GGCACAGAACGGTTGGTACT","GGATCTGCTGGAGTTGCATT","561307.5.peg.777","2218"
"31915",143,648,505,"TTAAGGCTTGTGCACCATTT","GGATCTGCTGGAGTTGCATT","561307.5.peg.777","2218"
"31916",1203,648,555,"TGAGATTTCTCACATTATC","GGATCTGCTGGAGTTGCATT","561307.5.peg.777","2218"
"31917",9,648,639,"GCAGAGAACAGACAACCAGG","GGATCTGCTGGAGTTGCATT","561307.5.peg.777","2218"
"31918",2244,648,1596,"TTAGCATTTGGTTTAACAAC","GGATCTGCTGGAGTTGCATT","561307.5.peg.777","2218"
"31919",1524,648,876,"TCAACGCCTGAATTGTTACT","GGATCTGCTGGAGTTGCATT","561307.5.peg.777","2218"
"31920",2171,648,1523,"TAACGCCATCATCAGTCGTT","GGATCTGCTGGAGTTGCATT","561307.5.peg.777","2218"
"31921",1698,648,1050,"CGTTAAATGTTACTGTTCT","GGATCTGCTGGAGTTGCATT","561307.5.peg.777","2218"
"31922",858,648,210,"CCATTGATTAGTGTGAAGCC","GGATCTGCTGGAGTTGCATT","561307.5.peg.777","2218"
"31923",273,648,375,"TTGGTTGTTGCAGATTGATT","GGATCTGCTGGAGTTGCATT","561307.5.peg.777","2218"
"31924",2781,648,2133,"CTTTCTTCTTGAGTCGCATC","GGATCTGCTGGAGTTGCATT","561307.5.peg.777","2218"
"31925",292,648,356,"TGCTTGATTCGTTGCTTGAT","GGATCTGCTGGAGTTGCATT","561307.5.peg.777","2218"
"31926",771,648,123,"TCAAATGACAGCACTTCGTT","GGATCTGCTGGAGTTGCATT","561307.5.peg.777","2218"
"31927",2605,648,1957,"GATTTGTTCTAAAGCATGGT","GGATCTGCTGGAGTTGCATT","561307.5.peg.777","2218"
"31928",1692,648,1044,"AATGTTACTGTTCTTGGTGT","GGATCTGCTGGAGTTGCATT","561307.5.peg.777","2218"
"31929",2691,648,2043,"ACAACAGTTACAGGAGCAAT","GGATCTGCTGGAGTTGCATT","561307.5.peg.777","2218"
"31930",2244,660,1584,"TTAGCATTTGGTTTAACAAC","GCTGCAGCCGCTGGATCTGC","561307.5.peg.777","2218"
"31931",12,660,648,"ACAGCAGAGAACAGACAACC","GCTGCAGCCGCTGGATCTGC","561307.5.peg.777","2218"
"31932",810,660,150,"GGCACAGAACGGTTGGTACT","GCTGCAGCCGCTGGATCTGC","561307.5.peg.777","2218"
"31933",357,660,303,"GTACTTGATTGCACTGATGT","GCTGCAGCCGCTGGATCTGC","561307.5.peg.777","2218"
"31934",1629,660,969,"TTATCAGGCATAAGTCGTGC","GCTGCAGCCGCTGGATCTGC","561307.5.peg.777","2218"
"31935",771,660,111,"TCAAATGACAGCACTTCGTT","GCTGCAGCCGCTGGATCTGC","561307.5.peg.777","2218"
"31936",2319,660,1659,"ATCTCGTCTTCAGTAGCATC","GCTGCAGCCGCTGGATCTGC","561307.5.peg.777","2218"
"31937",2734,660,2074,"TTGTTGTGCATCATGTGATA","GCTGCAGCCGCTGGATCTGC","561307.5.peg.777","2218"
"31938",1524,660,864,"TCAACGCCTGAATTGTTACT","GCTGCAGCCGCTGGATCTGC","561307.5.peg.777","2218"
"31939",2781,660,2121,"CTTTCTTCTTGAGTCGCATC","GCTGCAGCCGCTGGATCTGC","561307.5.peg.777","2218"
"31940",2221,660,1561,"TGTTGCAGTATCCCCACTTA","GCTGCAGCCGCTGGATCTGC","561307.5.peg.777","2218"
"31941",2605,660,1945,"GATTTGTTCTAAAGCATGGT","GCTGCAGCCGCTGGATCTGC","561307.5.peg.777","2218"
"31942",2691,660,2031,"ACAACAGTTACAGGAGCAAT","GCTGCAGCCGCTGGATCTGC","561307.5.peg.777","2218"
"31943",817,660,157,"TACTGTTGGCACAGAACGGT","GCTGCAGCCGCTGGATCTGC","561307.5.peg.777","2218"
"31944",292,660,368,"TGCTTGATTCGTTGCTTGAT","GCTGCAGCCGCTGGATCTGC","561307.5.peg.777","2218"
"31945",858,660,198,"CCATTGATTAGTGTGAAGCC","GCTGCAGCCGCTGGATCTGC","561307.5.peg.777","2218"
"31946",1203,660,543,"TGAGATTTCTCACATTATC","GCTGCAGCCGCTGGATCTGC","561307.5.peg.777","2218"
"31947",1692,660,1032,"AATGTTACTGTTCTTGGTGT","GCTGCAGCCGCTGGATCTGC","561307.5.peg.777","2218"
"31948",143,660,517,"TTAAGGCTTGTGCACCATTT","GCTGCAGCCGCTGGATCTGC","561307.5.peg.777","2218"
"31949",2662,660,2002,"GGCATTTAGACCATCTCCTT","GCTGCAGCCGCTGGATCTGC","561307.5.peg.777","2218"
"31950",9,660,651,"GCAGAGAACAGACAACCAGG","GCTGCAGCCGCTGGATCTGC","561307.5.peg.777","2218"
"31951",1698,660,1038,"CGTTAAATGTTACTGTTCT","GCTGCAGCCGCTGGATCTGC","561307.5.peg.777","2218"
"31952",2683,660,2023,"TACAGGAGCAATTGGATTAA","GCTGCAGCCGCTGGATCTGC","561307.5.peg.777","2218"
"31953",1837,660,1177,"TTGAATACGTCTGTCAACTT","GCTGCAGCCGCTGGATCTGC","561307.5.peg.777","2218"
"31954",273,660,387,"TTGGTTGTTGCAGATTGATT","GCTGCAGCCGCTGGATCTGC","561307.5.peg.777","2218"
"31955",2171,660,1511,"TAACGCCATCATCAGTCGTT","GCTGCAGCCGCTGGATCTGC","561307.5.peg.777","2218"
"31956",858,669,189,"CCATTGATTAGTGTGAAGCC","TTTCCTACCGCTGCAGCCGC","561307.5.peg.777","2218"
"31957",2221,669,1552,"TGTTGCAGTATCCCCACTTA","TTTCCTACCGCTGCAGCCGC","561307.5.peg.777","2218"
"31958",143,669,526,"TTAAGGCTTGTGCACCATTT","TTTCCTACCGCTGCAGCCGC","561307.5.peg.777","2218"
"31959",9,669,660,"GCAGAGAACAGACAACCAGG","TTTCCTACCGCTGCAGCCGC","561307.5.peg.777","2218"
"31960",2691,669,2022,"ACAACAGTTACAGGAGCAAT","TTTCCTACCGCTGCAGCCGC","561307.5.peg.777","2218"
"31961",2662,669,1993,"GGCATTTAGACCATCTCCTT","TTTCCTACCGCTGCAGCCGC","561307.5.peg.777","2218"
"31962",1698,669,1029,"CGTTAAATGTTACTGTTCT","TTTCCTACCGCTGCAGCCGC","561307.5.peg.777","2218"
"31963",273,669,396,"TTGGTTGTTGCAGATTGATT","TTTCCTACCGCTGCAGCCGC","561307.5.peg.777","2218"
"31964",1837,669,1168,"TTGAATACGTCTGTCAACTT","TTTCCTACCGCTGCAGCCGC","561307.5.peg.777","2218"
"31965",2171,669,1502,"TAACGCCATCATCAGTCGTT","TTTCCTACCGCTGCAGCCGC","561307.5.peg.777","2218"
"31966",2605,669,1936,"GATTTGTTCTAAAGCATGGT","TTTCCTACCGCTGCAGCCGC","561307.5.peg.777","2218"
"31967",1629,669,960,"TTATCAGGCATAAGTCGTGC","TTTCCTACCGCTGCAGCCGC","561307.5.peg.777","2218"
"31968",2734,669,2065,"TTGTTGTGCATCATGTGATA","TTTCCTACCGCTGCAGCCGC","561307.5.peg.777","2218"
"31969",292,669,377,"TGCTTGATTCGTTGCTTGAT","TTTCCTACCGCTGCAGCCGC","561307.5.peg.777","2218"
"31970",2781,669,2112,"CTTTCTTCTTGAGTCGCATC","TTTCCTACCGCTGCAGCCGC","561307.5.peg.777","2218"
"31971",2683,669,2014,"TACAGGAGCAATTGGATTAA","TTTCCTACCGCTGCAGCCGC","561307.5.peg.777","2218"
"31972",1524,669,855,"TCAACGCCTGAATTGTTACT","TTTCCTACCGCTGCAGCCGC","561307.5.peg.777","2218"
"31973",2244,669,1575,"TTAGCATTTGGTTTAACAAC","TTTCCTACCGCTGCAGCCGC","561307.5.peg.777","2218"
"31974",357,669,312,"GTACTTGATTGCACTGATGT","TTTCCTACCGCTGCAGCCGC","561307.5.peg.777","2218"
"31975",817,669,148,"TACTGTTGGCACAGAACGGT","TTTCCTACCGCTGCAGCCGC","561307.5.peg.777","2218"
"31976",1203,669,534,"TGAGATTTCTCACATTATC","TTTCCTACCGCTGCAGCCGC","561307.5.peg.777","2218"
"31977",810,669,141,"GGCACAGAACGGTTGGTACT","TTTCCTACCGCTGCAGCCGC","561307.5.peg.777","2218"
"31978",2319,669,1650,"ATCTCGTCTTCAGTAGCATC","TTTCCTACCGCTGCAGCCGC","561307.5.peg.777","2218"
"31979",1692,669,1023,"AATGTTACTGTTCTTGGTGT","TTTCCTACCGCTGCAGCCGC","561307.5.peg.777","2218"
"31980",12,669,657,"ACAGCAGAGAACAGACAACC","TTTCCTACCGCTGCAGCCGC","561307.5.peg.777","2218"
"31981",771,669,102,"TCAAATGACAGCACTTCGTT","TTTCCTACCGCTGCAGCCGC","561307.5.peg.777","2218"
"31982",1837,720,1117,"TTGAATACGTCTGTCAACTT","GGATCAGTTGTTGGCGTATA","561307.5.peg.777","2218"
"31983",2662,720,1942,"GGCATTTAGACCATCTCCTT","GGATCAGTTGTTGGCGTATA","561307.5.peg.777","2218"
"31984",2781,720,2061,"CTTTCTTCTTGAGTCGCATC","GGATCAGTTGTTGGCGTATA","561307.5.peg.777","2218"
"31985",573,720,147,"TCAGCAATTGCAACTAGCTC","GGATCAGTTGTTGGCGTATA","561307.5.peg.777","2218"
"31986",2734,720,2014,"TTGTTGTGCATCATGTGATA","GGATCAGTTGTTGGCGTATA","561307.5.peg.777","2218"
"31987",2605,720,1885,"GATTTGTTCTAAAGCATGGT","GGATCAGTTGTTGGCGTATA","561307.5.peg.777","2218"
"31988",273,720,447,"TTGGTTGTTGCAGATTGATT","GGATCAGTTGTTGGCGTATA","561307.5.peg.777","2218"
"31989",12,720,708,"ACAGCAGAGAACAGACAACC","GGATCAGTTGTTGGCGTATA","561307.5.peg.777","2218"
"31990",292,720,428,"TGCTTGATTCGTTGCTTGAT","GGATCAGTTGTTGGCGTATA","561307.5.peg.777","2218"
"31991",357,720,363,"GTACTTGATTGCACTGATGT","GGATCAGTTGTTGGCGTATA","561307.5.peg.777","2218"
"31992",1692,720,972,"AATGTTACTGTTCTTGGTGT","GGATCAGTTGTTGGCGTATA","561307.5.peg.777","2218"
"31993",143,720,577,"TTAAGGCTTGTGCACCATTT","GGATCAGTTGTTGGCGTATA","561307.5.peg.777","2218"
"31994",2319,720,1599,"ATCTCGTCTTCAGTAGCATC","GGATCAGTTGTTGGCGTATA","561307.5.peg.777","2218"
"31995",2683,720,1963,"TACAGGAGCAATTGGATTAA","GGATCAGTTGTTGGCGTATA","561307.5.peg.777","2218"
"31996",2221,720,1501,"TGTTGCAGTATCCCCACTTA","GGATCAGTTGTTGGCGTATA","561307.5.peg.777","2218"
"31997",1698,720,978,"CGTTAAATGTTACTGTTCT","GGATCAGTTGTTGGCGTATA","561307.5.peg.777","2218"
"31998",2691,720,1971,"ACAACAGTTACAGGAGCAAT","GGATCAGTTGTTGGCGTATA","561307.5.peg.777","2218"
"31999",2171,720,1451,"TAACGCCATCATCAGTCGTT","GGATCAGTTGTTGGCGTATA","561307.5.peg.777","2218"
"32000",2244,720,1524,"TTAGCATTTGGTTTAACAAC","GGATCAGTTGTTGGCGTATA","561307.5.peg.777","2218"
"32001",1203,720,483,"TGAGATTTCTCACATTATC","GGATCAGTTGTTGGCGTATA","561307.5.peg.777","2218"
"32002",858,720,138,"CCATTGATTAGTGTGAAGCC","GGATCAGTTGTTGGCGTATA","561307.5.peg.777","2218"
"32003",1629,720,909,"TTATCAGGCATAAGTCGTGC","GGATCAGTTGTTGGCGTATA","561307.5.peg.777","2218"
"32004",1524,720,804,"TCAACGCCTGAATTGTTACT","GGATCAGTTGTTGGCGTATA","561307.5.peg.777","2218"
"32005",9,720,711,"GCAGAGAACAGACAACCAGG","GGATCAGTTGTTGGCGTATA","561307.5.peg.777","2218"
"32006",2244,741,1503,"TTAGCATTTGGTTTAACAAC","TGTCCTGCATTATTGGCATT","561307.5.peg.777","2218"
"32007",2691,741,1950,"ACAACAGTTACAGGAGCAAT","TGTCCTGCATTATTGGCATT","561307.5.peg.777","2218"
"32008",573,741,168,"TCAGCAATTGCAACTAGCTC","TGTCCTGCATTATTGGCATT","561307.5.peg.777","2218"
"32009",2781,741,2040,"CTTTCTTCTTGAGTCGCATC","TGTCCTGCATTATTGGCATT","561307.5.peg.777","2218"
"32010",9,741,732,"GCAGAGAACAGACAACCAGG","TGTCCTGCATTATTGGCATT","561307.5.peg.777","2218"
"32011",2662,741,1921,"GGCATTTAGACCATCTCCTT","TGTCCTGCATTATTGGCATT","561307.5.peg.777","2218"
"32012",1837,741,1096,"TTGAATACGTCTGTCAACTT","TGTCCTGCATTATTGGCATT","561307.5.peg.777","2218"
"32013",639,741,102,"GGAGTTGCATTAGGATCTGC","TGTCCTGCATTATTGGCATT","561307.5.peg.777","2218"
"32014",273,741,468,"TTGGTTGTTGCAGATTGATT","TGTCCTGCATTATTGGCATT","561307.5.peg.777","2218"
"32015",2605,741,1864,"GATTTGTTCTAAAGCATGGT","TGTCCTGCATTATTGGCATT","561307.5.peg.777","2218"
"32016",12,741,729,"ACAGCAGAGAACAGACAACC","TGTCCTGCATTATTGGCATT","561307.5.peg.777","2218"
"32017",1629,741,888,"TTATCAGGCATAAGTCGTGC","TGTCCTGCATTATTGGCATT","561307.5.peg.777","2218"
"32018",357,741,384,"GTACTTGATTGCACTGATGT","TGTCCTGCATTATTGGCATT","561307.5.peg.777","2218"
"32019",143,741,598,"TTAAGGCTTGTGCACCATTT","TGTCCTGCATTATTGGCATT","561307.5.peg.777","2218"
"32020",2734,741,1993,"TTGTTGTGCATCATGTGATA","TGTCCTGCATTATTGGCATT","561307.5.peg.777","2218"
"32021",1698,741,957,"CGTTAAATGTTACTGTTCT","TGTCCTGCATTATTGGCATT","561307.5.peg.777","2218"
"32022",292,741,449,"TGCTTGATTCGTTGCTTGAT","TGTCCTGCATTATTGGCATT","561307.5.peg.777","2218"
"32023",2319,741,1578,"ATCTCGTCTTCAGTAGCATC","TGTCCTGCATTATTGGCATT","561307.5.peg.777","2218"
"32024",1692,741,951,"AATGTTACTGTTCTTGGTGT","TGTCCTGCATTATTGGCATT","561307.5.peg.777","2218"
"32025",2683,741,1942,"TACAGGAGCAATTGGATTAA","TGTCCTGCATTATTGGCATT","561307.5.peg.777","2218"
"32026",2221,741,1480,"TGTTGCAGTATCCCCACTTA","TGTCCTGCATTATTGGCATT","561307.5.peg.777","2218"
"32027",1203,741,462,"TGAGATTTCTCACATTATC","TGTCCTGCATTATTGGCATT","561307.5.peg.777","2218"
"32028",1524,741,783,"TCAACGCCTGAATTGTTACT","TGTCCTGCATTATTGGCATT","561307.5.peg.777","2218"
"32029",2171,741,1430,"TAACGCCATCATCAGTCGTT","TGTCCTGCATTATTGGCATT","561307.5.peg.777","2218"
"32030",858,741,117,"CCATTGATTAGTGTGAAGCC","TGTCCTGCATTATTGGCATT","561307.5.peg.777","2218"
"32031",2605,771,1834,"GATTTGTTCTAAAGCATGGT","TCAAATGACAGCACTTCGTT","561307.5.peg.777","2218"
"32032",1692,771,921,"AATGTTACTGTTCTTGGTGT","TCAAATGACAGCACTTCGTT","561307.5.peg.777","2218"
"32033",292,771,479,"TGCTTGATTCGTTGCTTGAT","TCAAATGACAGCACTTCGTT","561307.5.peg.777","2218"
"32034",2244,771,1473,"TTAGCATTTGGTTTAACAAC","TCAAATGACAGCACTTCGTT","561307.5.peg.777","2218"
"32035",273,771,498,"TTGGTTGTTGCAGATTGATT","TCAAATGACAGCACTTCGTT","561307.5.peg.777","2218"
"32036",2319,771,1548,"ATCTCGTCTTCAGTAGCATC","TCAAATGACAGCACTTCGTT","561307.5.peg.777","2218"
"32037",648,771,123,"GGATCTGCTGGAGTTGCATT","TCAAATGACAGCACTTCGTT","561307.5.peg.777","2218"
"32038",639,771,132,"GGAGTTGCATTAGGATCTGC","TCAAATGACAGCACTTCGTT","561307.5.peg.777","2218"
"32039",2781,771,2010,"CTTTCTTCTTGAGTCGCATC","TCAAATGACAGCACTTCGTT","561307.5.peg.777","2218"
"32040",573,771,198,"TCAGCAATTGCAACTAGCTC","TCAAATGACAGCACTTCGTT","561307.5.peg.777","2218"
"32041",1698,771,927,"CGTTAAATGTTACTGTTCT","TCAAATGACAGCACTTCGTT","561307.5.peg.777","2218"
"32042",1203,771,432,"TGAGATTTCTCACATTATC","TCAAATGACAGCACTTCGTT","561307.5.peg.777","2218"
"32043",1837,771,1066,"TTGAATACGTCTGTCAACTT","TCAAATGACAGCACTTCGTT","561307.5.peg.777","2218"
"32044",12,771,759,"ACAGCAGAGAACAGACAACC","TCAAATGACAGCACTTCGTT","561307.5.peg.777","2218"
"32045",2221,771,1450,"TGTTGCAGTATCCCCACTTA","TCAAATGACAGCACTTCGTT","561307.5.peg.777","2218"
"32046",1629,771,858,"TTATCAGGCATAAGTCGTGC","TCAAATGACAGCACTTCGTT","561307.5.peg.777","2218"
"32047",2662,771,1891,"GGCATTTAGACCATCTCCTT","TCAAATGACAGCACTTCGTT","561307.5.peg.777","2218"
"32048",2683,771,1912,"TACAGGAGCAATTGGATTAA","TCAAATGACAGCACTTCGTT","561307.5.peg.777","2218"
"32049",2734,771,1963,"TTGTTGTGCATCATGTGATA","TCAAATGACAGCACTTCGTT","561307.5.peg.777","2218"
"32050",143,771,628,"TTAAGGCTTGTGCACCATTT","TCAAATGACAGCACTTCGTT","561307.5.peg.777","2218"
"32051",357,771,414,"GTACTTGATTGCACTGATGT","TCAAATGACAGCACTTCGTT","561307.5.peg.777","2218"
"32052",660,771,111,"GCTGCAGCCGCTGGATCTGC","TCAAATGACAGCACTTCGTT","561307.5.peg.777","2218"
"32053",9,771,762,"GCAGAGAACAGACAACCAGG","TCAAATGACAGCACTTCGTT","561307.5.peg.777","2218"
"32054",2171,771,1400,"TAACGCCATCATCAGTCGTT","TCAAATGACAGCACTTCGTT","561307.5.peg.777","2218"
"32055",1524,771,753,"TCAACGCCTGAATTGTTACT","TCAAATGACAGCACTTCGTT","561307.5.peg.777","2218"
"32056",2691,771,1920,"ACAACAGTTACAGGAGCAAT","TCAAATGACAGCACTTCGTT","561307.5.peg.777","2218"
"32057",669,771,102,"TTTCCTACCGCTGCAGCCGC","TCAAATGACAGCACTTCGTT","561307.5.peg.777","2218"
"32058",2244,810,1434,"TTAGCATTTGGTTTAACAAC","GGCACAGAACGGTTGGTACT","561307.5.peg.777","2218"
"32059",1692,810,882,"AATGTTACTGTTCTTGGTGT","GGCACAGAACGGTTGGTACT","561307.5.peg.777","2218"
"32060",2781,810,1971,"CTTTCTTCTTGAGTCGCATC","GGCACAGAACGGTTGGTACT","561307.5.peg.777","2218"
"32061",2662,810,1852,"GGCATTTAGACCATCTCCTT","GGCACAGAACGGTTGGTACT","561307.5.peg.777","2218"
"32062",357,810,453,"GTACTTGATTGCACTGATGT","GGCACAGAACGGTTGGTACT","561307.5.peg.777","2218"
"32063",2734,810,1924,"TTGTTGTGCATCATGTGATA","GGCACAGAACGGTTGGTACT","561307.5.peg.777","2218"
"32064",648,810,162,"GGATCTGCTGGAGTTGCATT","GGCACAGAACGGTTGGTACT","561307.5.peg.777","2218"
"32065",660,810,150,"GCTGCAGCCGCTGGATCTGC","GGCACAGAACGGTTGGTACT","561307.5.peg.777","2218"
"32066",1203,810,393,"TGAGATTTCTCACATTATC","GGCACAGAACGGTTGGTACT","561307.5.peg.777","2218"
"32067",143,810,667,"TTAAGGCTTGTGCACCATTT","GGCACAGAACGGTTGGTACT","561307.5.peg.777","2218"
"32068",2691,810,1881,"ACAACAGTTACAGGAGCAAT","GGCACAGAACGGTTGGTACT","561307.5.peg.777","2218"
"32069",273,810,537,"TTGGTTGTTGCAGATTGATT","GGCACAGAACGGTTGGTACT","561307.5.peg.777","2218"
"32070",1837,810,1027,"TTGAATACGTCTGTCAACTT","GGCACAGAACGGTTGGTACT","561307.5.peg.777","2218"
"32071",1524,810,714,"TCAACGCCTGAATTGTTACT","GGCACAGAACGGTTGGTACT","561307.5.peg.777","2218"
"32072",1629,810,819,"TTATCAGGCATAAGTCGTGC","GGCACAGAACGGTTGGTACT","561307.5.peg.777","2218"
"32073",1698,810,888,"CGTTAAATGTTACTGTTCT","GGCACAGAACGGTTGGTACT","561307.5.peg.777","2218"
"32074",2605,810,1795,"GATTTGTTCTAAAGCATGGT","GGCACAGAACGGTTGGTACT","561307.5.peg.777","2218"
"32075",573,810,237,"TCAGCAATTGCAACTAGCTC","GGCACAGAACGGTTGGTACT","561307.5.peg.777","2218"
"32076",2221,810,1411,"TGTTGCAGTATCCCCACTTA","GGCACAGAACGGTTGGTACT","561307.5.peg.777","2218"
"32077",292,810,518,"TGCTTGATTCGTTGCTTGAT","GGCACAGAACGGTTGGTACT","561307.5.peg.777","2218"
"32078",669,810,141,"TTTCCTACCGCTGCAGCCGC","GGCACAGAACGGTTGGTACT","561307.5.peg.777","2218"
"32079",639,810,171,"GGAGTTGCATTAGGATCTGC","GGCACAGAACGGTTGGTACT","561307.5.peg.777","2218"
"32080",2683,810,1873,"TACAGGAGCAATTGGATTAA","GGCACAGAACGGTTGGTACT","561307.5.peg.777","2218"
"32081",9,810,801,"GCAGAGAACAGACAACCAGG","GGCACAGAACGGTTGGTACT","561307.5.peg.777","2218"
"32082",2171,810,1361,"TAACGCCATCATCAGTCGTT","GGCACAGAACGGTTGGTACT","561307.5.peg.777","2218"
"32083",2319,810,1509,"ATCTCGTCTTCAGTAGCATC","GGCACAGAACGGTTGGTACT","561307.5.peg.777","2218"
"32084",12,810,798,"ACAGCAGAGAACAGACAACC","GGCACAGAACGGTTGGTACT","561307.5.peg.777","2218"
"32085",1692,817,875,"AATGTTACTGTTCTTGGTGT","TACTGTTGGCACAGAACGGT","561307.5.peg.777","2218"
"32086",1837,817,1020,"TTGAATACGTCTGTCAACTT","TACTGTTGGCACAGAACGGT","561307.5.peg.777","2218"
"32087",2244,817,1427,"TTAGCATTTGGTTTAACAAC","TACTGTTGGCACAGAACGGT","561307.5.peg.777","2218"
"32088",1524,817,707,"TCAACGCCTGAATTGTTACT","TACTGTTGGCACAGAACGGT","561307.5.peg.777","2218"
"32089",2734,817,1917,"TTGTTGTGCATCATGTGATA","TACTGTTGGCACAGAACGGT","561307.5.peg.777","2218"
"32090",292,817,525,"TGCTTGATTCGTTGCTTGAT","TACTGTTGGCACAGAACGGT","561307.5.peg.777","2218"
"32091",2662,817,1845,"GGCATTTAGACCATCTCCTT","TACTGTTGGCACAGAACGGT","561307.5.peg.777","2218"
"32092",1629,817,812,"TTATCAGGCATAAGTCGTGC","TACTGTTGGCACAGAACGGT","561307.5.peg.777","2218"
"32093",2605,817,1788,"GATTTGTTCTAAAGCATGGT","TACTGTTGGCACAGAACGGT","561307.5.peg.777","2218"
"32094",2781,817,1964,"CTTTCTTCTTGAGTCGCATC","TACTGTTGGCACAGAACGGT","561307.5.peg.777","2218"
"32095",273,817,544,"TTGGTTGTTGCAGATTGATT","TACTGTTGGCACAGAACGGT","561307.5.peg.777","2218"
"32096",1698,817,881,"CGTTAAATGTTACTGTTCT","TACTGTTGGCACAGAACGGT","561307.5.peg.777","2218"
"32097",9,817,808,"GCAGAGAACAGACAACCAGG","TACTGTTGGCACAGAACGGT","561307.5.peg.777","2218"
"32098",2683,817,1866,"TACAGGAGCAATTGGATTAA","TACTGTTGGCACAGAACGGT","561307.5.peg.777","2218"
"32099",573,817,244,"TCAGCAATTGCAACTAGCTC","TACTGTTGGCACAGAACGGT","561307.5.peg.777","2218"
"32100",357,817,460,"GTACTTGATTGCACTGATGT","TACTGTTGGCACAGAACGGT","561307.5.peg.777","2218"
"32101",669,817,148,"TTTCCTACCGCTGCAGCCGC","TACTGTTGGCACAGAACGGT","561307.5.peg.777","2218"
"32102",2691,817,1874,"ACAACAGTTACAGGAGCAAT","TACTGTTGGCACAGAACGGT","561307.5.peg.777","2218"
"32103",648,817,169,"GGATCTGCTGGAGTTGCATT","TACTGTTGGCACAGAACGGT","561307.5.peg.777","2218"
"32104",660,817,157,"GCTGCAGCCGCTGGATCTGC","TACTGTTGGCACAGAACGGT","561307.5.peg.777","2218"
"32105",2319,817,1502,"ATCTCGTCTTCAGTAGCATC","TACTGTTGGCACAGAACGGT","561307.5.peg.777","2218"
"32106",1203,817,386,"TGAGATTTCTCACATTATC","TACTGTTGGCACAGAACGGT","561307.5.peg.777","2218"
"32107",2221,817,1404,"TGTTGCAGTATCCCCACTTA","TACTGTTGGCACAGAACGGT","561307.5.peg.777","2218"
"32108",2171,817,1354,"TAACGCCATCATCAGTCGTT","TACTGTTGGCACAGAACGGT","561307.5.peg.777","2218"
"32109",143,817,674,"TTAAGGCTTGTGCACCATTT","TACTGTTGGCACAGAACGGT","561307.5.peg.777","2218"
"32110",639,817,178,"GGAGTTGCATTAGGATCTGC","TACTGTTGGCACAGAACGGT","561307.5.peg.777","2218"
"32111",12,817,805,"ACAGCAGAGAACAGACAACC","TACTGTTGGCACAGAACGGT","561307.5.peg.777","2218"
"32112",2781,858,1923,"CTTTCTTCTTGAGTCGCATC","CCATTGATTAGTGTGAAGCC","561307.5.peg.777","2218"
"32113",357,858,501,"GTACTTGATTGCACTGATGT","CCATTGATTAGTGTGAAGCC","561307.5.peg.777","2218"
"32114",573,858,285,"TCAGCAATTGCAACTAGCTC","CCATTGATTAGTGTGAAGCC","561307.5.peg.777","2218"
"32115",1692,858,834,"AATGTTACTGTTCTTGGTGT","CCATTGATTAGTGTGAAGCC","561307.5.peg.777","2218"
"32116",2244,858,1386,"TTAGCATTTGGTTTAACAAC","CCATTGATTAGTGTGAAGCC","561307.5.peg.777","2218"
"32117",1629,858,771,"TTATCAGGCATAAGTCGTGC","CCATTGATTAGTGTGAAGCC","561307.5.peg.777","2218"
"32118",669,858,189,"TTTCCTACCGCTGCAGCCGC","CCATTGATTAGTGTGAAGCC","561307.5.peg.777","2218"
"32119",648,858,210,"GGATCTGCTGGAGTTGCATT","CCATTGATTAGTGTGAAGCC","561307.5.peg.777","2218"
"32120",1524,858,666,"TCAACGCCTGAATTGTTACT","CCATTGATTAGTGTGAAGCC","561307.5.peg.777","2218"
"32121",273,858,585,"TTGGTTGTTGCAGATTGATT","CCATTGATTAGTGTGAAGCC","561307.5.peg.777","2218"
"32122",2171,858,1313,"TAACGCCATCATCAGTCGTT","CCATTGATTAGTGTGAAGCC","561307.5.peg.777","2218"
"32123",2683,858,1825,"TACAGGAGCAATTGGATTAA","CCATTGATTAGTGTGAAGCC","561307.5.peg.777","2218"
"32124",1698,858,840,"CGTTAAATGTTACTGTTCT","CCATTGATTAGTGTGAAGCC","561307.5.peg.777","2218"
"32125",9,858,849,"GCAGAGAACAGACAACCAGG","CCATTGATTAGTGTGAAGCC","561307.5.peg.777","2218"
"32126",12,858,846,"ACAGCAGAGAACAGACAACC","CCATTGATTAGTGTGAAGCC","561307.5.peg.777","2218"
"32127",639,858,219,"GGAGTTGCATTAGGATCTGC","CCATTGATTAGTGTGAAGCC","561307.5.peg.777","2218"
"32128",292,858,566,"TGCTTGATTCGTTGCTTGAT","CCATTGATTAGTGTGAAGCC","561307.5.peg.777","2218"
"32129",143,858,715,"TTAAGGCTTGTGCACCATTT","CCATTGATTAGTGTGAAGCC","561307.5.peg.777","2218"
"32130",2319,858,1461,"ATCTCGTCTTCAGTAGCATC","CCATTGATTAGTGTGAAGCC","561307.5.peg.777","2218"
"32131",1837,858,979,"TTGAATACGTCTGTCAACTT","CCATTGATTAGTGTGAAGCC","561307.5.peg.777","2218"
"32132",2605,858,1747,"GATTTGTTCTAAAGCATGGT","CCATTGATTAGTGTGAAGCC","561307.5.peg.777","2218"
"32133",2221,858,1363,"TGTTGCAGTATCCCCACTTA","CCATTGATTAGTGTGAAGCC","561307.5.peg.777","2218"
"32134",1203,858,345,"TGAGATTTCTCACATTATC","CCATTGATTAGTGTGAAGCC","561307.5.peg.777","2218"
"32135",741,858,117,"TGTCCTGCATTATTGGCATT","CCATTGATTAGTGTGAAGCC","561307.5.peg.777","2218"
"32136",660,858,198,"GCTGCAGCCGCTGGATCTGC","CCATTGATTAGTGTGAAGCC","561307.5.peg.777","2218"
"32137",2662,858,1804,"GGCATTTAGACCATCTCCTT","CCATTGATTAGTGTGAAGCC","561307.5.peg.777","2218"
"32138",720,858,138,"GGATCAGTTGTTGGCGTATA","CCATTGATTAGTGTGAAGCC","561307.5.peg.777","2218"
"32139",2691,858,1833,"ACAACAGTTACAGGAGCAAT","CCATTGATTAGTGTGAAGCC","561307.5.peg.777","2218"
"32140",2734,858,1876,"TTGTTGTGCATCATGTGATA","CCATTGATTAGTGTGAAGCC","561307.5.peg.777","2218"
"32141",2781,1203,1578,"CTTTCTTCTTGAGTCGCATC","TGAGATTTCTCACATTATC","561307.5.peg.777","2218"
"32142",357,1203,846,"GTACTTGATTGCACTGATGT","TGAGATTTCTCACATTATC","561307.5.peg.777","2218"
"32143",669,1203,534,"TTTCCTACCGCTGCAGCCGC","TGAGATTTCTCACATTATC","561307.5.peg.777","2218"
"32144",810,1203,393,"GGCACAGAACGGTTGGTACT","TGAGATTTCTCACATTATC","561307.5.peg.777","2218"
"32145",771,1203,432,"TCAAATGACAGCACTTCGTT","TGAGATTTCTCACATTATC","561307.5.peg.777","2218"
"32146",2171,1203,968,"TAACGCCATCATCAGTCGTT","TGAGATTTCTCACATTATC","561307.5.peg.777","2218"
"32147",2319,1203,1116,"ATCTCGTCTTCAGTAGCATC","TGAGATTTCTCACATTATC","561307.5.peg.777","2218"
"32148",143,1203,1060,"TTAAGGCTTGTGCACCATTT","TGAGATTTCTCACATTATC","561307.5.peg.777","2218"
"32149",2221,1203,1018,"TGTTGCAGTATCCCCACTTA","TGAGATTTCTCACATTATC","561307.5.peg.777","2218"
"32150",1837,1203,634,"TTGAATACGTCTGTCAACTT","TGAGATTTCTCACATTATC","561307.5.peg.777","2218"
"32151",648,1203,555,"GGATCTGCTGGAGTTGCATT","TGAGATTTCTCACATTATC","561307.5.peg.777","2218"
"32152",2605,1203,1402,"GATTTGTTCTAAAGCATGGT","TGAGATTTCTCACATTATC","561307.5.peg.777","2218"
"32153",1698,1203,495,"CGTTAAATGTTACTGTTCT","TGAGATTTCTCACATTATC","561307.5.peg.777","2218"
"32154",9,1203,1194,"GCAGAGAACAGACAACCAGG","TGAGATTTCTCACATTATC","561307.5.peg.777","2218"
"32155",2662,1203,1459,"GGCATTTAGACCATCTCCTT","TGAGATTTCTCACATTATC","561307.5.peg.777","2218"
"32156",720,1203,483,"GGATCAGTTGTTGGCGTATA","TGAGATTTCTCACATTATC","561307.5.peg.777","2218"
"32157",1524,1203,321,"TCAACGCCTGAATTGTTACT","TGAGATTTCTCACATTATC","561307.5.peg.777","2218"
"32158",817,1203,386,"TACTGTTGGCACAGAACGGT","TGAGATTTCTCACATTATC","561307.5.peg.777","2218"
"32159",2734,1203,1531,"TTGTTGTGCATCATGTGATA","TGAGATTTCTCACATTATC","561307.5.peg.777","2218"
"32160",1629,1203,426,"TTATCAGGCATAAGTCGTGC","TGAGATTTCTCACATTATC","561307.5.peg.777","2218"
"32161",2691,1203,1488,"ACAACAGTTACAGGAGCAAT","TGAGATTTCTCACATTATC","561307.5.peg.777","2218"
"32162",12,1203,1191,"ACAGCAGAGAACAGACAACC","TGAGATTTCTCACATTATC","561307.5.peg.777","2218"
"32163",1692,1203,489,"AATGTTACTGTTCTTGGTGT","TGAGATTTCTCACATTATC","561307.5.peg.777","2218"
"32164",573,1203,630,"TCAGCAATTGCAACTAGCTC","TGAGATTTCTCACATTATC","561307.5.peg.777","2218"
"32165",639,1203,564,"GGAGTTGCATTAGGATCTGC","TGAGATTTCTCACATTATC","561307.5.peg.777","2218"
"32166",858,1203,345,"CCATTGATTAGTGTGAAGCC","TGAGATTTCTCACATTATC","561307.5.peg.777","2218"
"32167",292,1203,911,"TGCTTGATTCGTTGCTTGAT","TGAGATTTCTCACATTATC","561307.5.peg.777","2218"
"32168",273,1203,930,"TTGGTTGTTGCAGATTGATT","TGAGATTTCTCACATTATC","561307.5.peg.777","2218"
"32169",2244,1203,1041,"TTAGCATTTGGTTTAACAAC","TGAGATTTCTCACATTATC","561307.5.peg.777","2218"
"32170",2683,1203,1480,"TACAGGAGCAATTGGATTAA","TGAGATTTCTCACATTATC","561307.5.peg.777","2218"
"32171",660,1203,543,"GCTGCAGCCGCTGGATCTGC","TGAGATTTCTCACATTATC","561307.5.peg.777","2218"
"32172",741,1203,462,"TGTCCTGCATTATTGGCATT","TGAGATTTCTCACATTATC","561307.5.peg.777","2218"
"32173",573,1524,951,"TCAGCAATTGCAACTAGCTC","TCAACGCCTGAATTGTTACT","561307.5.peg.777","2218"
"32174",2662,1524,1138,"GGCATTTAGACCATCTCCTT","TCAACGCCTGAATTGTTACT","561307.5.peg.777","2218"
"32175",273,1524,1251,"TTGGTTGTTGCAGATTGATT","TCAACGCCTGAATTGTTACT","561307.5.peg.777","2218"
"32176",771,1524,753,"TCAAATGACAGCACTTCGTT","TCAACGCCTGAATTGTTACT","561307.5.peg.777","2218"
"32177",2319,1524,795,"ATCTCGTCTTCAGTAGCATC","TCAACGCCTGAATTGTTACT","561307.5.peg.777","2218"
"32178",648,1524,876,"GGATCTGCTGGAGTTGCATT","TCAACGCCTGAATTGTTACT","561307.5.peg.777","2218"
"32179",1629,1524,105,"TTATCAGGCATAAGTCGTGC","TCAACGCCTGAATTGTTACT","561307.5.peg.777","2218"
"32180",720,1524,804,"GGATCAGTTGTTGGCGTATA","TCAACGCCTGAATTGTTACT","561307.5.peg.777","2218"
"32181",357,1524,1167,"GTACTTGATTGCACTGATGT","TCAACGCCTGAATTGTTACT","561307.5.peg.777","2218"
"32182",2734,1524,1210,"TTGTTGTGCATCATGTGATA","TCAACGCCTGAATTGTTACT","561307.5.peg.777","2218"
"32183",1692,1524,168,"AATGTTACTGTTCTTGGTGT","TCAACGCCTGAATTGTTACT","561307.5.peg.777","2218"
"32184",2691,1524,1167,"ACAACAGTTACAGGAGCAAT","TCAACGCCTGAATTGTTACT","561307.5.peg.777","2218"
"32185",143,1524,1381,"TTAAGGCTTGTGCACCATTT","TCAACGCCTGAATTGTTACT","561307.5.peg.777","2218"
"32186",741,1524,783,"TGTCCTGCATTATTGGCATT","TCAACGCCTGAATTGTTACT","561307.5.peg.777","2218"
"32187",292,1524,1232,"TGCTTGATTCGTTGCTTGAT","TCAACGCCTGAATTGTTACT","561307.5.peg.777","2218"
"32188",9,1524,1515,"GCAGAGAACAGACAACCAGG","TCAACGCCTGAATTGTTACT","561307.5.peg.777","2218"
"32189",2221,1524,697,"TGTTGCAGTATCCCCACTTA","TCAACGCCTGAATTGTTACT","561307.5.peg.777","2218"
"32190",12,1524,1512,"ACAGCAGAGAACAGACAACC","TCAACGCCTGAATTGTTACT","561307.5.peg.777","2218"
"32191",2683,1524,1159,"TACAGGAGCAATTGGATTAA","TCAACGCCTGAATTGTTACT","561307.5.peg.777","2218"
"32192",639,1524,885,"GGAGTTGCATTAGGATCTGC","TCAACGCCTGAATTGTTACT","561307.5.peg.777","2218"
"32193",810,1524,714,"GGCACAGAACGGTTGGTACT","TCAACGCCTGAATTGTTACT","561307.5.peg.777","2218"
"32194",2244,1524,720,"TTAGCATTTGGTTTAACAAC","TCAACGCCTGAATTGTTACT","561307.5.peg.777","2218"
"32195",1698,1524,174,"CGTTAAATGTTACTGTTCT","TCAACGCCTGAATTGTTACT","561307.5.peg.777","2218"
"32196",1837,1524,313,"TTGAATACGTCTGTCAACTT","TCAACGCCTGAATTGTTACT","561307.5.peg.777","2218"
"32197",858,1524,666,"CCATTGATTAGTGTGAAGCC","TCAACGCCTGAATTGTTACT","561307.5.peg.777","2218"
"32198",817,1524,707,"TACTGTTGGCACAGAACGGT","TCAACGCCTGAATTGTTACT","561307.5.peg.777","2218"
"32199",669,1524,855,"TTTCCTACCGCTGCAGCCGC","TCAACGCCTGAATTGTTACT","561307.5.peg.777","2218"
"32200",2781,1524,1257,"CTTTCTTCTTGAGTCGCATC","TCAACGCCTGAATTGTTACT","561307.5.peg.777","2218"
"32201",2605,1524,1081,"GATTTGTTCTAAAGCATGGT","TCAACGCCTGAATTGTTACT","561307.5.peg.777","2218"
"32202",1203,1524,321,"TGAGATTTCTCACATTATC","TCAACGCCTGAATTGTTACT","561307.5.peg.777","2218"
"32203",2171,1524,647,"TAACGCCATCATCAGTCGTT","TCAACGCCTGAATTGTTACT","561307.5.peg.777","2218"
"32204",660,1524,864,"GCTGCAGCCGCTGGATCTGC","TCAACGCCTGAATTGTTACT","561307.5.peg.777","2218"
"32205",2171,1629,542,"TAACGCCATCATCAGTCGTT","TTATCAGGCATAAGTCGTGC","561307.5.peg.777","2218"
"32206",648,1629,981,"GGATCTGCTGGAGTTGCATT","TTATCAGGCATAAGTCGTGC","561307.5.peg.777","2218"
"32207",573,1629,1056,"TCAGCAATTGCAACTAGCTC","TTATCAGGCATAAGTCGTGC","561307.5.peg.777","2218"
"32208",639,1629,990,"GGAGTTGCATTAGGATCTGC","TTATCAGGCATAAGTCGTGC","561307.5.peg.777","2218"
"32209",2683,1629,1054,"TACAGGAGCAATTGGATTAA","TTATCAGGCATAAGTCGTGC","561307.5.peg.777","2218"
"32210",292,1629,1337,"TGCTTGATTCGTTGCTTGAT","TTATCAGGCATAAGTCGTGC","561307.5.peg.777","2218"
"32211",669,1629,960,"TTTCCTACCGCTGCAGCCGC","TTATCAGGCATAAGTCGTGC","561307.5.peg.777","2218"
"32212",858,1629,771,"CCATTGATTAGTGTGAAGCC","TTATCAGGCATAAGTCGTGC","561307.5.peg.777","2218"
"32213",357,1629,1272,"GTACTTGATTGCACTGATGT","TTATCAGGCATAAGTCGTGC","561307.5.peg.777","2218"
"32214",1524,1629,105,"TCAACGCCTGAATTGTTACT","TTATCAGGCATAAGTCGTGC","561307.5.peg.777","2218"
"32215",12,1629,1617,"ACAGCAGAGAACAGACAACC","TTATCAGGCATAAGTCGTGC","561307.5.peg.777","2218"
"32216",741,1629,888,"TGTCCTGCATTATTGGCATT","TTATCAGGCATAAGTCGTGC","561307.5.peg.777","2218"
"32217",810,1629,819,"GGCACAGAACGGTTGGTACT","TTATCAGGCATAAGTCGTGC","561307.5.peg.777","2218"
"32218",273,1629,1356,"TTGGTTGTTGCAGATTGATT","TTATCAGGCATAAGTCGTGC","561307.5.peg.777","2218"
"32219",2221,1629,592,"TGTTGCAGTATCCCCACTTA","TTATCAGGCATAAGTCGTGC","561307.5.peg.777","2218"
"32220",720,1629,909,"GGATCAGTTGTTGGCGTATA","TTATCAGGCATAAGTCGTGC","561307.5.peg.777","2218"
"32221",143,1629,1486,"TTAAGGCTTGTGCACCATTT","TTATCAGGCATAAGTCGTGC","561307.5.peg.777","2218"
"32222",2319,1629,690,"ATCTCGTCTTCAGTAGCATC","TTATCAGGCATAAGTCGTGC","561307.5.peg.777","2218"
"32223",2734,1629,1105,"TTGTTGTGCATCATGTGATA","TTATCAGGCATAAGTCGTGC","561307.5.peg.777","2218"
"32224",1203,1629,426,"TGAGATTTCTCACATTATC","TTATCAGGCATAAGTCGTGC","561307.5.peg.777","2218"
"32225",2691,1629,1062,"ACAACAGTTACAGGAGCAAT","TTATCAGGCATAAGTCGTGC","561307.5.peg.777","2218"
"32226",660,1629,969,"GCTGCAGCCGCTGGATCTGC","TTATCAGGCATAAGTCGTGC","561307.5.peg.777","2218"
"32227",2781,1629,1152,"CTTTCTTCTTGAGTCGCATC","TTATCAGGCATAAGTCGTGC","561307.5.peg.777","2218"
"32228",2662,1629,1033,"GGCATTTAGACCATCTCCTT","TTATCAGGCATAAGTCGTGC","561307.5.peg.777","2218"
"32229",1837,1629,208,"TTGAATACGTCTGTCAACTT","TTATCAGGCATAAGTCGTGC","561307.5.peg.777","2218"
"32230",9,1629,1620,"GCAGAGAACAGACAACCAGG","TTATCAGGCATAAGTCGTGC","561307.5.peg.777","2218"
"32231",771,1629,858,"TCAAATGACAGCACTTCGTT","TTATCAGGCATAAGTCGTGC","561307.5.peg.777","2218"
"32232",2605,1629,976,"GATTTGTTCTAAAGCATGGT","TTATCAGGCATAAGTCGTGC","561307.5.peg.777","2218"
"32233",817,1629,812,"TACTGTTGGCACAGAACGGT","TTATCAGGCATAAGTCGTGC","561307.5.peg.777","2218"
"32234",2244,1629,615,"TTAGCATTTGGTTTAACAAC","TTATCAGGCATAAGTCGTGC","561307.5.peg.777","2218"
"32235",2662,1692,970,"GGCATTTAGACCATCTCCTT","AATGTTACTGTTCTTGGTGT","561307.5.peg.777","2218"
"32236",2605,1692,913,"GATTTGTTCTAAAGCATGGT","AATGTTACTGTTCTTGGTGT","561307.5.peg.777","2218"
"32237",1203,1692,489,"TGAGATTTCTCACATTATC","AATGTTACTGTTCTTGGTGT","561307.5.peg.777","2218"
"32238",810,1692,882,"GGCACAGAACGGTTGGTACT","AATGTTACTGTTCTTGGTGT","561307.5.peg.777","2218"
"32239",741,1692,951,"TGTCCTGCATTATTGGCATT","AATGTTACTGTTCTTGGTGT","561307.5.peg.777","2218"
"32240",2244,1692,552,"TTAGCATTTGGTTTAACAAC","AATGTTACTGTTCTTGGTGT","561307.5.peg.777","2218"
"32241",2683,1692,991,"TACAGGAGCAATTGGATTAA","AATGTTACTGTTCTTGGTGT","561307.5.peg.777","2218"
"32242",817,1692,875,"TACTGTTGGCACAGAACGGT","AATGTTACTGTTCTTGGTGT","561307.5.peg.777","2218"
"32243",2171,1692,479,"TAACGCCATCATCAGTCGTT","AATGTTACTGTTCTTGGTGT","561307.5.peg.777","2218"
"32244",2691,1692,999,"ACAACAGTTACAGGAGCAAT","AATGTTACTGTTCTTGGTGT","561307.5.peg.777","2218"
"32245",1837,1692,145,"TTGAATACGTCTGTCAACTT","AATGTTACTGTTCTTGGTGT","561307.5.peg.777","2218"
"32246",9,1692,1683,"GCAGAGAACAGACAACCAGG","AATGTTACTGTTCTTGGTGT","561307.5.peg.777","2218"
"32247",771,1692,921,"TCAAATGACAGCACTTCGTT","AATGTTACTGTTCTTGGTGT","561307.5.peg.777","2218"
"32248",660,1692,1032,"GCTGCAGCCGCTGGATCTGC","AATGTTACTGTTCTTGGTGT","561307.5.peg.777","2218"
"32249",2221,1692,529,"TGTTGCAGTATCCCCACTTA","AATGTTACTGTTCTTGGTGT","561307.5.peg.777","2218"
"32250",1524,1692,168,"TCAACGCCTGAATTGTTACT","AATGTTACTGTTCTTGGTGT","561307.5.peg.777","2218"
"32251",573,1692,1119,"TCAGCAATTGCAACTAGCTC","AATGTTACTGTTCTTGGTGT","561307.5.peg.777","2218"
"32252",2734,1692,1042,"TTGTTGTGCATCATGTGATA","AATGTTACTGTTCTTGGTGT","561307.5.peg.777","2218"
"32253",273,1692,1419,"TTGGTTGTTGCAGATTGATT","AATGTTACTGTTCTTGGTGT","561307.5.peg.777","2218"
"32254",2319,1692,627,"ATCTCGTCTTCAGTAGCATC","AATGTTACTGTTCTTGGTGT","561307.5.peg.777","2218"
"32255",143,1692,1549,"TTAAGGCTTGTGCACCATTT","AATGTTACTGTTCTTGGTGT","561307.5.peg.777","2218"
"32256",648,1692,1044,"GGATCTGCTGGAGTTGCATT","AATGTTACTGTTCTTGGTGT","561307.5.peg.777","2218"
"32257",639,1692,1053,"GGAGTTGCATTAGGATCTGC","AATGTTACTGTTCTTGGTGT","561307.5.peg.777","2218"
"32258",2781,1692,1089,"CTTTCTTCTTGAGTCGCATC","AATGTTACTGTTCTTGGTGT","561307.5.peg.777","2218"
"32259",12,1692,1680,"ACAGCAGAGAACAGACAACC","AATGTTACTGTTCTTGGTGT","561307.5.peg.777","2218"
"32260",292,1692,1400,"TGCTTGATTCGTTGCTTGAT","AATGTTACTGTTCTTGGTGT","561307.5.peg.777","2218"
"32261",720,1692,972,"GGATCAGTTGTTGGCGTATA","AATGTTACTGTTCTTGGTGT","561307.5.peg.777","2218"
"32262",357,1692,1335,"GTACTTGATTGCACTGATGT","AATGTTACTGTTCTTGGTGT","561307.5.peg.777","2218"
"32263",858,1692,834,"CCATTGATTAGTGTGAAGCC","AATGTTACTGTTCTTGGTGT","561307.5.peg.777","2218"
"32264",669,1692,1023,"TTTCCTACCGCTGCAGCCGC","AATGTTACTGTTCTTGGTGT","561307.5.peg.777","2218"
"32265",2605,1698,907,"GATTTGTTCTAAAGCATGGT","CGTTAAATGTTACTGTTCT","561307.5.peg.777","2218"
"32266",2171,1698,473,"TAACGCCATCATCAGTCGTT","CGTTAAATGTTACTGTTCT","561307.5.peg.777","2218"
"32267",2691,1698,993,"ACAACAGTTACAGGAGCAAT","CGTTAAATGTTACTGTTCT","561307.5.peg.777","2218"
"32268",817,1698,881,"TACTGTTGGCACAGAACGGT","CGTTAAATGTTACTGTTCT","561307.5.peg.777","2218"
"32269",639,1698,1059,"GGAGTTGCATTAGGATCTGC","CGTTAAATGTTACTGTTCT","561307.5.peg.777","2218"
"32270",2683,1698,985,"TACAGGAGCAATTGGATTAA","CGTTAAATGTTACTGTTCT","561307.5.peg.777","2218"
"32271",720,1698,978,"GGATCAGTTGTTGGCGTATA","CGTTAAATGTTACTGTTCT","561307.5.peg.777","2218"
"32272",2662,1698,964,"GGCATTTAGACCATCTCCTT","CGTTAAATGTTACTGTTCT","561307.5.peg.777","2218"
"32273",2319,1698,621,"ATCTCGTCTTCAGTAGCATC","CGTTAAATGTTACTGTTCT","561307.5.peg.777","2218"
"32274",648,1698,1050,"GGATCTGCTGGAGTTGCATT","CGTTAAATGTTACTGTTCT","561307.5.peg.777","2218"
"32275",2221,1698,523,"TGTTGCAGTATCCCCACTTA","CGTTAAATGTTACTGTTCT","561307.5.peg.777","2218"
"32276",858,1698,840,"CCATTGATTAGTGTGAAGCC","CGTTAAATGTTACTGTTCT","561307.5.peg.777","2218"
"32277",1524,1698,174,"TCAACGCCTGAATTGTTACT","CGTTAAATGTTACTGTTCT","561307.5.peg.777","2218"
"32278",143,1698,1555,"TTAAGGCTTGTGCACCATTT","CGTTAAATGTTACTGTTCT","561307.5.peg.777","2218"
"32279",273,1698,1425,"TTGGTTGTTGCAGATTGATT","CGTTAAATGTTACTGTTCT","561307.5.peg.777","2218"
"32280",292,1698,1406,"TGCTTGATTCGTTGCTTGAT","CGTTAAATGTTACTGTTCT","561307.5.peg.777","2218"
"32281",771,1698,927,"TCAAATGACAGCACTTCGTT","CGTTAAATGTTACTGTTCT","561307.5.peg.777","2218"
"32282",9,1698,1689,"GCAGAGAACAGACAACCAGG","CGTTAAATGTTACTGTTCT","561307.5.peg.777","2218"
"32283",669,1698,1029,"TTTCCTACCGCTGCAGCCGC","CGTTAAATGTTACTGTTCT","561307.5.peg.777","2218"
"32284",573,1698,1125,"TCAGCAATTGCAACTAGCTC","CGTTAAATGTTACTGTTCT","561307.5.peg.777","2218"
"32285",2244,1698,546,"TTAGCATTTGGTTTAACAAC","CGTTAAATGTTACTGTTCT","561307.5.peg.777","2218"
"32286",1203,1698,495,"TGAGATTTCTCACATTATC","CGTTAAATGTTACTGTTCT","561307.5.peg.777","2218"
"32287",2781,1698,1083,"CTTTCTTCTTGAGTCGCATC","CGTTAAATGTTACTGTTCT","561307.5.peg.777","2218"
"32288",741,1698,957,"TGTCCTGCATTATTGGCATT","CGTTAAATGTTACTGTTCT","561307.5.peg.777","2218"
"32289",810,1698,888,"GGCACAGAACGGTTGGTACT","CGTTAAATGTTACTGTTCT","561307.5.peg.777","2218"
"32290",357,1698,1341,"GTACTTGATTGCACTGATGT","CGTTAAATGTTACTGTTCT","561307.5.peg.777","2218"
"32291",1837,1698,139,"TTGAATACGTCTGTCAACTT","CGTTAAATGTTACTGTTCT","561307.5.peg.777","2218"
"32292",2734,1698,1036,"TTGTTGTGCATCATGTGATA","CGTTAAATGTTACTGTTCT","561307.5.peg.777","2218"
"32293",12,1698,1686,"ACAGCAGAGAACAGACAACC","CGTTAAATGTTACTGTTCT","561307.5.peg.777","2218"
"32294",660,1698,1038,"GCTGCAGCCGCTGGATCTGC","CGTTAAATGTTACTGTTCT","561307.5.peg.777","2218"
"32295",771,1837,1066,"TCAAATGACAGCACTTCGTT","TTGAATACGTCTGTCAACTT","561307.5.peg.777","2218"
"32296",1698,1837,139,"CGTTAAATGTTACTGTTCT","TTGAATACGTCTGTCAACTT","561307.5.peg.777","2218"
"32297",2662,1837,825,"GGCATTTAGACCATCTCCTT","TTGAATACGTCTGTCAACTT","561307.5.peg.777","2218"
"32298",2781,1837,944,"CTTTCTTCTTGAGTCGCATC","TTGAATACGTCTGTCAACTT","561307.5.peg.777","2218"
"32299",273,1837,1564,"TTGGTTGTTGCAGATTGATT","TTGAATACGTCTGTCAACTT","561307.5.peg.777","2218"
"32300",2171,1837,334,"TAACGCCATCATCAGTCGTT","TTGAATACGTCTGTCAACTT","561307.5.peg.777","2218"
"32301",810,1837,1027,"GGCACAGAACGGTTGGTACT","TTGAATACGTCTGTCAACTT","561307.5.peg.777","2218"
"32302",2605,1837,768,"GATTTGTTCTAAAGCATGGT","TTGAATACGTCTGTCAACTT","561307.5.peg.777","2218"
"32303",1524,1837,313,"TCAACGCCTGAATTGTTACT","TTGAATACGTCTGTCAACTT","561307.5.peg.777","2218"
"32304",858,1837,979,"CCATTGATTAGTGTGAAGCC","TTGAATACGTCTGTCAACTT","561307.5.peg.777","2218"
"32305",1203,1837,634,"TGAGATTTCTCACATTATC","TTGAATACGTCTGTCAACTT","561307.5.peg.777","2218"
"32306",2244,1837,407,"TTAGCATTTGGTTTAACAAC","TTGAATACGTCTGTCAACTT","561307.5.peg.777","2218"
"32307",720,1837,1117,"GGATCAGTTGTTGGCGTATA","TTGAATACGTCTGTCAACTT","561307.5.peg.777","2218"
"32308",669,1837,1168,"TTTCCTACCGCTGCAGCCGC","TTGAATACGTCTGTCAACTT","561307.5.peg.777","2218"
"32309",143,1837,1694,"TTAAGGCTTGTGCACCATTT","TTGAATACGTCTGTCAACTT","561307.5.peg.777","2218"
"32310",9,1837,1828,"GCAGAGAACAGACAACCAGG","TTGAATACGTCTGTCAACTT","561307.5.peg.777","2218"
"32311",741,1837,1096,"TGTCCTGCATTATTGGCATT","TTGAATACGTCTGTCAACTT","561307.5.peg.777","2218"
"32312",2221,1837,384,"TGTTGCAGTATCCCCACTTA","TTGAATACGTCTGTCAACTT","561307.5.peg.777","2218"
"32313",2734,1837,897,"TTGTTGTGCATCATGTGATA","TTGAATACGTCTGTCAACTT","561307.5.peg.777","2218"
"32314",2319,1837,482,"ATCTCGTCTTCAGTAGCATC","TTGAATACGTCTGTCAACTT","561307.5.peg.777","2218"
"32315",573,1837,1264,"TCAGCAATTGCAACTAGCTC","TTGAATACGTCTGTCAACTT","561307.5.peg.777","2218"
"32316",292,1837,1545,"TGCTTGATTCGTTGCTTGAT","TTGAATACGTCTGTCAACTT","561307.5.peg.777","2218"
"32317",1629,1837,208,"TTATCAGGCATAAGTCGTGC","TTGAATACGTCTGTCAACTT","561307.5.peg.777","2218"
"32318",2683,1837,846,"TACAGGAGCAATTGGATTAA","TTGAATACGTCTGTCAACTT","561307.5.peg.777","2218"
"32319",660,1837,1177,"GCTGCAGCCGCTGGATCTGC","TTGAATACGTCTGTCAACTT","561307.5.peg.777","2218"
"32320",12,1837,1825,"ACAGCAGAGAACAGACAACC","TTGAATACGTCTGTCAACTT","561307.5.peg.777","2218"
"32321",648,1837,1189,"GGATCTGCTGGAGTTGCATT","TTGAATACGTCTGTCAACTT","561307.5.peg.777","2218"
"32322",357,1837,1480,"GTACTTGATTGCACTGATGT","TTGAATACGTCTGTCAACTT","561307.5.peg.777","2218"
"32323",639,1837,1198,"GGAGTTGCATTAGGATCTGC","TTGAATACGTCTGTCAACTT","561307.5.peg.777","2218"
"32324",817,1837,1020,"TACTGTTGGCACAGAACGGT","TTGAATACGTCTGTCAACTT","561307.5.peg.777","2218"
"32325",2691,1837,854,"ACAACAGTTACAGGAGCAAT","TTGAATACGTCTGTCAACTT","561307.5.peg.777","2218"
"32326",1692,1837,145,"AATGTTACTGTTCTTGGTGT","TTGAATACGTCTGTCAACTT","561307.5.peg.777","2218"
"32327",2781,2171,610,"CTTTCTTCTTGAGTCGCATC","TAACGCCATCATCAGTCGTT","561307.5.peg.777","2218"
"32328",2662,2171,491,"GGCATTTAGACCATCTCCTT","TAACGCCATCATCAGTCGTT","561307.5.peg.777","2218"
"32329",669,2171,1502,"TTTCCTACCGCTGCAGCCGC","TAACGCCATCATCAGTCGTT","561307.5.peg.777","2218"
"32330",292,2171,1879,"TGCTTGATTCGTTGCTTGAT","TAACGCCATCATCAGTCGTT","561307.5.peg.777","2218"
"32331",1698,2171,473,"CGTTAAATGTTACTGTTCT","TAACGCCATCATCAGTCGTT","561307.5.peg.777","2218"
"32332",9,2171,2162,"GCAGAGAACAGACAACCAGG","TAACGCCATCATCAGTCGTT","561307.5.peg.777","2218"
"32333",1692,2171,479,"AATGTTACTGTTCTTGGTGT","TAACGCCATCATCAGTCGTT","561307.5.peg.777","2218"
"32334",2319,2171,148,"ATCTCGTCTTCAGTAGCATC","TAACGCCATCATCAGTCGTT","561307.5.peg.777","2218"
"32335",12,2171,2159,"ACAGCAGAGAACAGACAACC","TAACGCCATCATCAGTCGTT","561307.5.peg.777","2218"
"32336",720,2171,1451,"GGATCAGTTGTTGGCGTATA","TAACGCCATCATCAGTCGTT","561307.5.peg.777","2218"
"32337",639,2171,1532,"GGAGTTGCATTAGGATCTGC","TAACGCCATCATCAGTCGTT","561307.5.peg.777","2218"
"32338",2683,2171,512,"TACAGGAGCAATTGGATTAA","TAACGCCATCATCAGTCGTT","561307.5.peg.777","2218"
"32339",2734,2171,563,"TTGTTGTGCATCATGTGATA","TAACGCCATCATCAGTCGTT","561307.5.peg.777","2218"
"32340",858,2171,1313,"CCATTGATTAGTGTGAAGCC","TAACGCCATCATCAGTCGTT","561307.5.peg.777","2218"
"32341",573,2171,1598,"TCAGCAATTGCAACTAGCTC","TAACGCCATCATCAGTCGTT","561307.5.peg.777","2218"
"32342",817,2171,1354,"TACTGTTGGCACAGAACGGT","TAACGCCATCATCAGTCGTT","561307.5.peg.777","2218"
"32343",648,2171,1523,"GGATCTGCTGGAGTTGCATT","TAACGCCATCATCAGTCGTT","561307.5.peg.777","2218"
"32344",1203,2171,968,"TGAGATTTCTCACATTATC","TAACGCCATCATCAGTCGTT","561307.5.peg.777","2218"
"32345",273,2171,1898,"TTGGTTGTTGCAGATTGATT","TAACGCCATCATCAGTCGTT","561307.5.peg.777","2218"
"32346",1524,2171,647,"TCAACGCCTGAATTGTTACT","TAACGCCATCATCAGTCGTT","561307.5.peg.777","2218"
"32347",810,2171,1361,"GGCACAGAACGGTTGGTACT","TAACGCCATCATCAGTCGTT","561307.5.peg.777","2218"
"32348",771,2171,1400,"TCAAATGACAGCACTTCGTT","TAACGCCATCATCAGTCGTT","561307.5.peg.777","2218"
"32349",660,2171,1511,"GCTGCAGCCGCTGGATCTGC","TAACGCCATCATCAGTCGTT","561307.5.peg.777","2218"
"32350",143,2171,2028,"TTAAGGCTTGTGCACCATTT","TAACGCCATCATCAGTCGTT","561307.5.peg.777","2218"
"32351",1629,2171,542,"TTATCAGGCATAAGTCGTGC","TAACGCCATCATCAGTCGTT","561307.5.peg.777","2218"
"32352",741,2171,1430,"TGTCCTGCATTATTGGCATT","TAACGCCATCATCAGTCGTT","561307.5.peg.777","2218"
"32353",2691,2171,520,"ACAACAGTTACAGGAGCAAT","TAACGCCATCATCAGTCGTT","561307.5.peg.777","2218"
"32354",1837,2171,334,"TTGAATACGTCTGTCAACTT","TAACGCCATCATCAGTCGTT","561307.5.peg.777","2218"
"32355",2605,2171,434,"GATTTGTTCTAAAGCATGGT","TAACGCCATCATCAGTCGTT","561307.5.peg.777","2218"
"32356",357,2171,1814,"GTACTTGATTGCACTGATGT","TAACGCCATCATCAGTCGTT","561307.5.peg.777","2218"
"32357",660,2221,1561,"GCTGCAGCCGCTGGATCTGC","TGTTGCAGTATCCCCACTTA","561307.5.peg.777","2218"
"32358",1698,2221,523,"CGTTAAATGTTACTGTTCT","TGTTGCAGTATCCCCACTTA","561307.5.peg.777","2218"
"32359",292,2221,1929,"TGCTTGATTCGTTGCTTGAT","TGTTGCAGTATCCCCACTTA","561307.5.peg.777","2218"
"32360",273,2221,1948,"TTGGTTGTTGCAGATTGATT","TGTTGCAGTATCCCCACTTA","561307.5.peg.777","2218"
"32361",817,2221,1404,"TACTGTTGGCACAGAACGGT","TGTTGCAGTATCCCCACTTA","561307.5.peg.777","2218"
"32362",1629,2221,592,"TTATCAGGCATAAGTCGTGC","TGTTGCAGTATCCCCACTTA","561307.5.peg.777","2218"
"32363",648,2221,1573,"GGATCTGCTGGAGTTGCATT","TGTTGCAGTATCCCCACTTA","561307.5.peg.777","2218"
"32364",1203,2221,1018,"TGAGATTTCTCACATTATC","TGTTGCAGTATCCCCACTTA","561307.5.peg.777","2218"
"32365",2781,2221,560,"CTTTCTTCTTGAGTCGCATC","TGTTGCAGTATCCCCACTTA","561307.5.peg.777","2218"
"32366",720,2221,1501,"GGATCAGTTGTTGGCGTATA","TGTTGCAGTATCCCCACTTA","561307.5.peg.777","2218"
"32367",2734,2221,513,"TTGTTGTGCATCATGTGATA","TGTTGCAGTATCCCCACTTA","561307.5.peg.777","2218"
"32368",2691,2221,470,"ACAACAGTTACAGGAGCAAT","TGTTGCAGTATCCCCACTTA","561307.5.peg.777","2218"
"32369",9,2221,2212,"GCAGAGAACAGACAACCAGG","TGTTGCAGTATCCCCACTTA","561307.5.peg.777","2218"
"32370",810,2221,1411,"GGCACAGAACGGTTGGTACT","TGTTGCAGTATCCCCACTTA","561307.5.peg.777","2218"
"32371",1524,2221,697,"TCAACGCCTGAATTGTTACT","TGTTGCAGTATCCCCACTTA","561307.5.peg.777","2218"
"32372",1692,2221,529,"AATGTTACTGTTCTTGGTGT","TGTTGCAGTATCCCCACTTA","561307.5.peg.777","2218"
"32373",357,2221,1864,"GTACTTGATTGCACTGATGT","TGTTGCAGTATCCCCACTTA","561307.5.peg.777","2218"
"32374",2683,2221,462,"TACAGGAGCAATTGGATTAA","TGTTGCAGTATCCCCACTTA","561307.5.peg.777","2218"
"32375",741,2221,1480,"TGTCCTGCATTATTGGCATT","TGTTGCAGTATCCCCACTTA","561307.5.peg.777","2218"
"32376",771,2221,1450,"TCAAATGACAGCACTTCGTT","TGTTGCAGTATCCCCACTTA","561307.5.peg.777","2218"
"32377",573,2221,1648,"TCAGCAATTGCAACTAGCTC","TGTTGCAGTATCCCCACTTA","561307.5.peg.777","2218"
"32378",2605,2221,384,"GATTTGTTCTAAAGCATGGT","TGTTGCAGTATCCCCACTTA","561307.5.peg.777","2218"
"32379",858,2221,1363,"CCATTGATTAGTGTGAAGCC","TGTTGCAGTATCCCCACTTA","561307.5.peg.777","2218"
"32380",639,2221,1582,"GGAGTTGCATTAGGATCTGC","TGTTGCAGTATCCCCACTTA","561307.5.peg.777","2218"
"32381",143,2221,2078,"TTAAGGCTTGTGCACCATTT","TGTTGCAGTATCCCCACTTA","561307.5.peg.777","2218"
"32382",1837,2221,384,"TTGAATACGTCTGTCAACTT","TGTTGCAGTATCCCCACTTA","561307.5.peg.777","2218"
"32383",2662,2221,441,"GGCATTTAGACCATCTCCTT","TGTTGCAGTATCCCCACTTA","561307.5.peg.777","2218"
"32384",669,2221,1552,"TTTCCTACCGCTGCAGCCGC","TGTTGCAGTATCCCCACTTA","561307.5.peg.777","2218"
"32385",12,2221,2209,"ACAGCAGAGAACAGACAACC","TGTTGCAGTATCCCCACTTA","561307.5.peg.777","2218"
"32386",2691,2244,447,"ACAACAGTTACAGGAGCAAT","TTAGCATTTGGTTTAACAAC","561307.5.peg.777","2218"
"32387",817,2244,1427,"TACTGTTGGCACAGAACGGT","TTAGCATTTGGTTTAACAAC","561307.5.peg.777","2218"
"32388",720,2244,1524,"GGATCAGTTGTTGGCGTATA","TTAGCATTTGGTTTAACAAC","561307.5.peg.777","2218"
"32389",2683,2244,439,"TACAGGAGCAATTGGATTAA","TTAGCATTTGGTTTAACAAC","561307.5.peg.777","2218"
"32390",12,2244,2232,"ACAGCAGAGAACAGACAACC","TTAGCATTTGGTTTAACAAC","561307.5.peg.777","2218"
"32391",1692,2244,552,"AATGTTACTGTTCTTGGTGT","TTAGCATTTGGTTTAACAAC","561307.5.peg.777","2218"
"32392",273,2244,1971,"TTGGTTGTTGCAGATTGATT","TTAGCATTTGGTTTAACAAC","561307.5.peg.777","2218"
"32393",573,2244,1671,"TCAGCAATTGCAACTAGCTC","TTAGCATTTGGTTTAACAAC","561307.5.peg.777","2218"
"32394",1203,2244,1041,"TGAGATTTCTCACATTATC","TTAGCATTTGGTTTAACAAC","561307.5.peg.777","2218"
"32395",660,2244,1584,"GCTGCAGCCGCTGGATCTGC","TTAGCATTTGGTTTAACAAC","561307.5.peg.777","2218"
"32396",1629,2244,615,"TTATCAGGCATAAGTCGTGC","TTAGCATTTGGTTTAACAAC","561307.5.peg.777","2218"
"32397",1698,2244,546,"CGTTAAATGTTACTGTTCT","TTAGCATTTGGTTTAACAAC","561307.5.peg.777","2218"
"32398",771,2244,1473,"TCAAATGACAGCACTTCGTT","TTAGCATTTGGTTTAACAAC","561307.5.peg.777","2218"
"32399",143,2244,2101,"TTAAGGCTTGTGCACCATTT","TTAGCATTTGGTTTAACAAC","561307.5.peg.777","2218"
"32400",2781,2244,537,"CTTTCTTCTTGAGTCGCATC","TTAGCATTTGGTTTAACAAC","561307.5.peg.777","2218"
"32401",357,2244,1887,"GTACTTGATTGCACTGATGT","TTAGCATTTGGTTTAACAAC","561307.5.peg.777","2218"
"32402",2662,2244,418,"GGCATTTAGACCATCTCCTT","TTAGCATTTGGTTTAACAAC","561307.5.peg.777","2218"
"32403",741,2244,1503,"TGTCCTGCATTATTGGCATT","TTAGCATTTGGTTTAACAAC","561307.5.peg.777","2218"
"32404",648,2244,1596,"GGATCTGCTGGAGTTGCATT","TTAGCATTTGGTTTAACAAC","561307.5.peg.777","2218"
"32405",292,2244,1952,"TGCTTGATTCGTTGCTTGAT","TTAGCATTTGGTTTAACAAC","561307.5.peg.777","2218"
"32406",639,2244,1605,"GGAGTTGCATTAGGATCTGC","TTAGCATTTGGTTTAACAAC","561307.5.peg.777","2218"
"32407",2734,2244,490,"TTGTTGTGCATCATGTGATA","TTAGCATTTGGTTTAACAAC","561307.5.peg.777","2218"
"32408",858,2244,1386,"CCATTGATTAGTGTGAAGCC","TTAGCATTTGGTTTAACAAC","561307.5.peg.777","2218"
"32409",1524,2244,720,"TCAACGCCTGAATTGTTACT","TTAGCATTTGGTTTAACAAC","561307.5.peg.777","2218"
"32410",669,2244,1575,"TTTCCTACCGCTGCAGCCGC","TTAGCATTTGGTTTAACAAC","561307.5.peg.777","2218"
"32411",2605,2244,361,"GATTTGTTCTAAAGCATGGT","TTAGCATTTGGTTTAACAAC","561307.5.peg.777","2218"
"32412",810,2244,1434,"GGCACAGAACGGTTGGTACT","TTAGCATTTGGTTTAACAAC","561307.5.peg.777","2218"
"32413",1837,2244,407,"TTGAATACGTCTGTCAACTT","TTAGCATTTGGTTTAACAAC","561307.5.peg.777","2218"
"32414",9,2244,2235,"GCAGAGAACAGACAACCAGG","TTAGCATTTGGTTTAACAAC","561307.5.peg.777","2218"
"32415",273,2319,2046,"TTGGTTGTTGCAGATTGATT","ATCTCGTCTTCAGTAGCATC","561307.5.peg.777","2218"
"32416",810,2319,1509,"GGCACAGAACGGTTGGTACT","ATCTCGTCTTCAGTAGCATC","561307.5.peg.777","2218"
"32417",9,2319,2310,"GCAGAGAACAGACAACCAGG","ATCTCGTCTTCAGTAGCATC","561307.5.peg.777","2218"
"32418",292,2319,2027,"TGCTTGATTCGTTGCTTGAT","ATCTCGTCTTCAGTAGCATC","561307.5.peg.777","2218"
"32419",573,2319,1746,"TCAGCAATTGCAACTAGCTC","ATCTCGTCTTCAGTAGCATC","561307.5.peg.777","2218"
"32420",2691,2319,372,"ACAACAGTTACAGGAGCAAT","ATCTCGTCTTCAGTAGCATC","561307.5.peg.777","2218"
"32421",817,2319,1502,"TACTGTTGGCACAGAACGGT","ATCTCGTCTTCAGTAGCATC","561307.5.peg.777","2218"
"32422",1203,2319,1116,"TGAGATTTCTCACATTATC","ATCTCGTCTTCAGTAGCATC","561307.5.peg.777","2218"
"32423",858,2319,1461,"CCATTGATTAGTGTGAAGCC","ATCTCGTCTTCAGTAGCATC","561307.5.peg.777","2218"
"32424",2734,2319,415,"TTGTTGTGCATCATGTGATA","ATCTCGTCTTCAGTAGCATC","561307.5.peg.777","2218"
"32425",720,2319,1599,"GGATCAGTTGTTGGCGTATA","ATCTCGTCTTCAGTAGCATC","561307.5.peg.777","2218"
"32426",771,2319,1548,"TCAAATGACAGCACTTCGTT","ATCTCGTCTTCAGTAGCATC","561307.5.peg.777","2218"
"32427",2781,2319,462,"CTTTCTTCTTGAGTCGCATC","ATCTCGTCTTCAGTAGCATC","561307.5.peg.777","2218"
"32428",12,2319,2307,"ACAGCAGAGAACAGACAACC","ATCTCGTCTTCAGTAGCATC","561307.5.peg.777","2218"
"32429",1692,2319,627,"AATGTTACTGTTCTTGGTGT","ATCTCGTCTTCAGTAGCATC","561307.5.peg.777","2218"
"32430",1524,2319,795,"TCAACGCCTGAATTGTTACT","ATCTCGTCTTCAGTAGCATC","561307.5.peg.777","2218"
"32431",660,2319,1659,"GCTGCAGCCGCTGGATCTGC","ATCTCGTCTTCAGTAGCATC","561307.5.peg.777","2218"
"32432",2662,2319,343,"GGCATTTAGACCATCTCCTT","ATCTCGTCTTCAGTAGCATC","561307.5.peg.777","2218"
"32433",2683,2319,364,"TACAGGAGCAATTGGATTAA","ATCTCGTCTTCAGTAGCATC","561307.5.peg.777","2218"
"32434",1837,2319,482,"TTGAATACGTCTGTCAACTT","ATCTCGTCTTCAGTAGCATC","561307.5.peg.777","2218"
"32435",2605,2319,286,"GATTTGTTCTAAAGCATGGT","ATCTCGTCTTCAGTAGCATC","561307.5.peg.777","2218"
"32436",741,2319,1578,"TGTCCTGCATTATTGGCATT","ATCTCGTCTTCAGTAGCATC","561307.5.peg.777","2218"
"32437",1629,2319,690,"TTATCAGGCATAAGTCGTGC","ATCTCGTCTTCAGTAGCATC","561307.5.peg.777","2218"
"32438",143,2319,2176,"TTAAGGCTTGTGCACCATTT","ATCTCGTCTTCAGTAGCATC","561307.5.peg.777","2218"
"32439",669,2319,1650,"TTTCCTACCGCTGCAGCCGC","ATCTCGTCTTCAGTAGCATC","561307.5.peg.777","2218"
"32440",2171,2319,148,"TAACGCCATCATCAGTCGTT","ATCTCGTCTTCAGTAGCATC","561307.5.peg.777","2218"
"32441",357,2319,1962,"GTACTTGATTGCACTGATGT","ATCTCGTCTTCAGTAGCATC","561307.5.peg.777","2218"
"32442",639,2319,1680,"GGAGTTGCATTAGGATCTGC","ATCTCGTCTTCAGTAGCATC","561307.5.peg.777","2218"
"32443",648,2319,1671,"GGATCTGCTGGAGTTGCATT","ATCTCGTCTTCAGTAGCATC","561307.5.peg.777","2218"
"32444",1698,2319,621,"CGTTAAATGTTACTGTTCT","ATCTCGTCTTCAGTAGCATC","561307.5.peg.777","2218"
"32445",771,2605,1834,"TCAAATGACAGCACTTCGTT","GATTTGTTCTAAAGCATGGT","561307.5.peg.777","2218"
"32446",573,2605,2032,"TCAGCAATTGCAACTAGCTC","GATTTGTTCTAAAGCATGGT","561307.5.peg.777","2218"
"32447",639,2605,1966,"GGAGTTGCATTAGGATCTGC","GATTTGTTCTAAAGCATGGT","561307.5.peg.777","2218"
"32448",2221,2605,384,"TGTTGCAGTATCCCCACTTA","GATTTGTTCTAAAGCATGGT","561307.5.peg.777","2218"
"32449",858,2605,1747,"CCATTGATTAGTGTGAAGCC","GATTTGTTCTAAAGCATGGT","561307.5.peg.777","2218"
"32450",1692,2605,913,"AATGTTACTGTTCTTGGTGT","GATTTGTTCTAAAGCATGGT","561307.5.peg.777","2218"
"32451",2781,2605,176,"CTTTCTTCTTGAGTCGCATC","GATTTGTTCTAAAGCATGGT","561307.5.peg.777","2218"
"32452",1698,2605,907,"CGTTAAATGTTACTGTTCT","GATTTGTTCTAAAGCATGGT","561307.5.peg.777","2218"
"32453",669,2605,1936,"TTTCCTACCGCTGCAGCCGC","GATTTGTTCTAAAGCATGGT","561307.5.peg.777","2218"
"32454",357,2605,2248,"GTACTTGATTGCACTGATGT","GATTTGTTCTAAAGCATGGT","561307.5.peg.777","2218"
"32455",741,2605,1864,"TGTCCTGCATTATTGGCATT","GATTTGTTCTAAAGCATGGT","561307.5.peg.777","2218"
"32456",1629,2605,976,"TTATCAGGCATAAGTCGTGC","GATTTGTTCTAAAGCATGGT","561307.5.peg.777","2218"
"32457",2171,2605,434,"TAACGCCATCATCAGTCGTT","GATTTGTTCTAAAGCATGGT","561307.5.peg.777","2218"
"32458",143,2605,2462,"TTAAGGCTTGTGCACCATTT","GATTTGTTCTAAAGCATGGT","561307.5.peg.777","2218"
"32459",9,2605,2596,"GCAGAGAACAGACAACCAGG","GATTTGTTCTAAAGCATGGT","561307.5.peg.777","2218"
"32460",2319,2605,286,"ATCTCGTCTTCAGTAGCATC","GATTTGTTCTAAAGCATGGT","561307.5.peg.777","2218"
"32461",1837,2605,768,"TTGAATACGTCTGTCAACTT","GATTTGTTCTAAAGCATGGT","561307.5.peg.777","2218"
"32462",817,2605,1788,"TACTGTTGGCACAGAACGGT","GATTTGTTCTAAAGCATGGT","561307.5.peg.777","2218"
"32463",292,2605,2313,"TGCTTGATTCGTTGCTTGAT","GATTTGTTCTAAAGCATGGT","561307.5.peg.777","2218"
"32464",720,2605,1885,"GGATCAGTTGTTGGCGTATA","GATTTGTTCTAAAGCATGGT","561307.5.peg.777","2218"
"32465",273,2605,2332,"TTGGTTGTTGCAGATTGATT","GATTTGTTCTAAAGCATGGT","561307.5.peg.777","2218"
"32466",810,2605,1795,"GGCACAGAACGGTTGGTACT","GATTTGTTCTAAAGCATGGT","561307.5.peg.777","2218"
"32467",12,2605,2593,"ACAGCAGAGAACAGACAACC","GATTTGTTCTAAAGCATGGT","561307.5.peg.777","2218"
"32468",2244,2605,361,"TTAGCATTTGGTTTAACAAC","GATTTGTTCTAAAGCATGGT","561307.5.peg.777","2218"
"32469",1524,2605,1081,"TCAACGCCTGAATTGTTACT","GATTTGTTCTAAAGCATGGT","561307.5.peg.777","2218"
"32470",2734,2605,129,"TTGTTGTGCATCATGTGATA","GATTTGTTCTAAAGCATGGT","561307.5.peg.777","2218"
"32471",660,2605,1945,"GCTGCAGCCGCTGGATCTGC","GATTTGTTCTAAAGCATGGT","561307.5.peg.777","2218"
"32472",1203,2605,1402,"TGAGATTTCTCACATTATC","GATTTGTTCTAAAGCATGGT","561307.5.peg.777","2218"
"32473",648,2605,1957,"GGATCTGCTGGAGTTGCATT","GATTTGTTCTAAAGCATGGT","561307.5.peg.777","2218"
"32474",639,2662,2023,"GGAGTTGCATTAGGATCTGC","GGCATTTAGACCATCTCCTT","561307.5.peg.777","2218"
"32475",2319,2662,343,"ATCTCGTCTTCAGTAGCATC","GGCATTTAGACCATCTCCTT","561307.5.peg.777","2218"
"32476",292,2662,2370,"TGCTTGATTCGTTGCTTGAT","GGCATTTAGACCATCTCCTT","561307.5.peg.777","2218"
"32477",12,2662,2650,"ACAGCAGAGAACAGACAACC","GGCATTTAGACCATCTCCTT","561307.5.peg.777","2218"
"32478",2244,2662,418,"TTAGCATTTGGTTTAACAAC","GGCATTTAGACCATCTCCTT","561307.5.peg.777","2218"
"32479",2171,2662,491,"TAACGCCATCATCAGTCGTT","GGCATTTAGACCATCTCCTT","561307.5.peg.777","2218"
"32480",1692,2662,970,"AATGTTACTGTTCTTGGTGT","GGCATTTAGACCATCTCCTT","561307.5.peg.777","2218"
"32481",2781,2662,119,"CTTTCTTCTTGAGTCGCATC","GGCATTTAGACCATCTCCTT","561307.5.peg.777","2218"
"32482",660,2662,2002,"GCTGCAGCCGCTGGATCTGC","GGCATTTAGACCATCTCCTT","561307.5.peg.777","2218"
"32483",1698,2662,964,"CGTTAAATGTTACTGTTCT","GGCATTTAGACCATCTCCTT","561307.5.peg.777","2218"
"32484",143,2662,2519,"TTAAGGCTTGTGCACCATTT","GGCATTTAGACCATCTCCTT","561307.5.peg.777","2218"
"32485",273,2662,2389,"TTGGTTGTTGCAGATTGATT","GGCATTTAGACCATCTCCTT","561307.5.peg.777","2218"
"32486",720,2662,1942,"GGATCAGTTGTTGGCGTATA","GGCATTTAGACCATCTCCTT","561307.5.peg.777","2218"
"32487",9,2662,2653,"GCAGAGAACAGACAACCAGG","GGCATTTAGACCATCTCCTT","561307.5.peg.777","2218"
"32488",669,2662,1993,"TTTCCTACCGCTGCAGCCGC","GGCATTTAGACCATCTCCTT","561307.5.peg.777","2218"
"32489",858,2662,1804,"CCATTGATTAGTGTGAAGCC","GGCATTTAGACCATCTCCTT","561307.5.peg.777","2218"
"32490",817,2662,1845,"TACTGTTGGCACAGAACGGT","GGCATTTAGACCATCTCCTT","561307.5.peg.777","2218"
"32491",771,2662,1891,"TCAAATGACAGCACTTCGTT","GGCATTTAGACCATCTCCTT","561307.5.peg.777","2218"
"32492",1524,2662,1138,"TCAACGCCTGAATTGTTACT","GGCATTTAGACCATCTCCTT","561307.5.peg.777","2218"
"32493",648,2662,2014,"GGATCTGCTGGAGTTGCATT","GGCATTTAGACCATCTCCTT","561307.5.peg.777","2218"
"32494",1837,2662,825,"TTGAATACGTCTGTCAACTT","GGCATTTAGACCATCTCCTT","561307.5.peg.777","2218"
"32495",2221,2662,441,"TGTTGCAGTATCCCCACTTA","GGCATTTAGACCATCTCCTT","561307.5.peg.777","2218"
"32496",741,2662,1921,"TGTCCTGCATTATTGGCATT","GGCATTTAGACCATCTCCTT","561307.5.peg.777","2218"
"32497",810,2662,1852,"GGCACAGAACGGTTGGTACT","GGCATTTAGACCATCTCCTT","561307.5.peg.777","2218"
"32498",357,2662,2305,"GTACTTGATTGCACTGATGT","GGCATTTAGACCATCTCCTT","561307.5.peg.777","2218"
"32499",1203,2662,1459,"TGAGATTTCTCACATTATC","GGCATTTAGACCATCTCCTT","561307.5.peg.777","2218"
"32500",573,2662,2089,"TCAGCAATTGCAACTAGCTC","GGCATTTAGACCATCTCCTT","561307.5.peg.777","2218"
"32501",1629,2662,1033,"TTATCAGGCATAAGTCGTGC","GGCATTTAGACCATCTCCTT","561307.5.peg.777","2218"
"32502",2244,2683,439,"TTAGCATTTGGTTTAACAAC","TACAGGAGCAATTGGATTAA","561307.5.peg.777","2218"
"32503",2171,2683,512,"TAACGCCATCATCAGTCGTT","TACAGGAGCAATTGGATTAA","561307.5.peg.777","2218"
"32504",2221,2683,462,"TGTTGCAGTATCCCCACTTA","TACAGGAGCAATTGGATTAA","561307.5.peg.777","2218"
"32505",1698,2683,985,"CGTTAAATGTTACTGTTCT","TACAGGAGCAATTGGATTAA","561307.5.peg.777","2218"
"32506",1837,2683,846,"TTGAATACGTCTGTCAACTT","TACAGGAGCAATTGGATTAA","561307.5.peg.777","2218"
"32507",1203,2683,1480,"TGAGATTTCTCACATTATC","TACAGGAGCAATTGGATTAA","561307.5.peg.777","2218"
"32508",9,2683,2674,"GCAGAGAACAGACAACCAGG","TACAGGAGCAATTGGATTAA","561307.5.peg.777","2218"
"32509",648,2683,2035,"GGATCTGCTGGAGTTGCATT","TACAGGAGCAATTGGATTAA","561307.5.peg.777","2218"
"32510",810,2683,1873,"GGCACAGAACGGTTGGTACT","TACAGGAGCAATTGGATTAA","561307.5.peg.777","2218"
"32511",273,2683,2410,"TTGGTTGTTGCAGATTGATT","TACAGGAGCAATTGGATTAA","561307.5.peg.777","2218"
"32512",12,2683,2671,"ACAGCAGAGAACAGACAACC","TACAGGAGCAATTGGATTAA","561307.5.peg.777","2218"
"32513",660,2683,2023,"GCTGCAGCCGCTGGATCTGC","TACAGGAGCAATTGGATTAA","561307.5.peg.777","2218"
"32514",573,2683,2110,"TCAGCAATTGCAACTAGCTC","TACAGGAGCAATTGGATTAA","561307.5.peg.777","2218"
"32515",2319,2683,364,"ATCTCGTCTTCAGTAGCATC","TACAGGAGCAATTGGATTAA","561307.5.peg.777","2218"
"32516",817,2683,1866,"TACTGTTGGCACAGAACGGT","TACAGGAGCAATTGGATTAA","561307.5.peg.777","2218"
"32517",357,2683,2326,"GTACTTGATTGCACTGATGT","TACAGGAGCAATTGGATTAA","561307.5.peg.777","2218"
"32518",669,2683,2014,"TTTCCTACCGCTGCAGCCGC","TACAGGAGCAATTGGATTAA","561307.5.peg.777","2218"
"32519",1629,2683,1054,"TTATCAGGCATAAGTCGTGC","TACAGGAGCAATTGGATTAA","561307.5.peg.777","2218"
"32520",1692,2683,991,"AATGTTACTGTTCTTGGTGT","TACAGGAGCAATTGGATTAA","561307.5.peg.777","2218"
"32521",858,2683,1825,"CCATTGATTAGTGTGAAGCC","TACAGGAGCAATTGGATTAA","561307.5.peg.777","2218"
"32522",720,2683,1963,"GGATCAGTTGTTGGCGTATA","TACAGGAGCAATTGGATTAA","561307.5.peg.777","2218"
"32523",639,2683,2044,"GGAGTTGCATTAGGATCTGC","TACAGGAGCAATTGGATTAA","561307.5.peg.777","2218"
"32524",741,2683,1942,"TGTCCTGCATTATTGGCATT","TACAGGAGCAATTGGATTAA","561307.5.peg.777","2218"
"32525",771,2683,1912,"TCAAATGACAGCACTTCGTT","TACAGGAGCAATTGGATTAA","561307.5.peg.777","2218"
"32526",1524,2683,1159,"TCAACGCCTGAATTGTTACT","TACAGGAGCAATTGGATTAA","561307.5.peg.777","2218"
"32527",292,2683,2391,"TGCTTGATTCGTTGCTTGAT","TACAGGAGCAATTGGATTAA","561307.5.peg.777","2218"
"32528",143,2683,2540,"TTAAGGCTTGTGCACCATTT","TACAGGAGCAATTGGATTAA","561307.5.peg.777","2218"
"32529",1203,2691,1488,"TGAGATTTCTCACATTATC","ACAACAGTTACAGGAGCAAT","561307.5.peg.777","2218"
"32530",2221,2691,470,"TGTTGCAGTATCCCCACTTA","ACAACAGTTACAGGAGCAAT","561307.5.peg.777","2218"
"32531",357,2691,2334,"GTACTTGATTGCACTGATGT","ACAACAGTTACAGGAGCAAT","561307.5.peg.777","2218"
"32532",2319,2691,372,"ATCTCGTCTTCAGTAGCATC","ACAACAGTTACAGGAGCAAT","561307.5.peg.777","2218"
"32533",12,2691,2679,"ACAGCAGAGAACAGACAACC","ACAACAGTTACAGGAGCAAT","561307.5.peg.777","2218"
"32534",292,2691,2399,"TGCTTGATTCGTTGCTTGAT","ACAACAGTTACAGGAGCAAT","561307.5.peg.777","2218"
"32535",771,2691,1920,"TCAAATGACAGCACTTCGTT","ACAACAGTTACAGGAGCAAT","561307.5.peg.777","2218"
"32536",660,2691,2031,"GCTGCAGCCGCTGGATCTGC","ACAACAGTTACAGGAGCAAT","561307.5.peg.777","2218"
"32537",143,2691,2548,"TTAAGGCTTGTGCACCATTT","ACAACAGTTACAGGAGCAAT","561307.5.peg.777","2218"
"32538",639,2691,2052,"GGAGTTGCATTAGGATCTGC","ACAACAGTTACAGGAGCAAT","561307.5.peg.777","2218"
"32539",1629,2691,1062,"TTATCAGGCATAAGTCGTGC","ACAACAGTTACAGGAGCAAT","561307.5.peg.777","2218"
"32540",858,2691,1833,"CCATTGATTAGTGTGAAGCC","ACAACAGTTACAGGAGCAAT","561307.5.peg.777","2218"
"32541",669,2691,2022,"TTTCCTACCGCTGCAGCCGC","ACAACAGTTACAGGAGCAAT","561307.5.peg.777","2218"
"32542",1692,2691,999,"AATGTTACTGTTCTTGGTGT","ACAACAGTTACAGGAGCAAT","561307.5.peg.777","2218"
"32543",817,2691,1874,"TACTGTTGGCACAGAACGGT","ACAACAGTTACAGGAGCAAT","561307.5.peg.777","2218"
"32544",2171,2691,520,"TAACGCCATCATCAGTCGTT","ACAACAGTTACAGGAGCAAT","561307.5.peg.777","2218"
"32545",273,2691,2418,"TTGGTTGTTGCAGATTGATT","ACAACAGTTACAGGAGCAAT","561307.5.peg.777","2218"
"32546",1698,2691,993,"CGTTAAATGTTACTGTTCT","ACAACAGTTACAGGAGCAAT","561307.5.peg.777","2218"
"32547",9,2691,2682,"GCAGAGAACAGACAACCAGG","ACAACAGTTACAGGAGCAAT","561307.5.peg.777","2218"
"32548",1837,2691,854,"TTGAATACGTCTGTCAACTT","ACAACAGTTACAGGAGCAAT","561307.5.peg.777","2218"
"32549",648,2691,2043,"GGATCTGCTGGAGTTGCATT","ACAACAGTTACAGGAGCAAT","561307.5.peg.777","2218"
"32550",1524,2691,1167,"TCAACGCCTGAATTGTTACT","ACAACAGTTACAGGAGCAAT","561307.5.peg.777","2218"
"32551",741,2691,1950,"TGTCCTGCATTATTGGCATT","ACAACAGTTACAGGAGCAAT","561307.5.peg.777","2218"
"32552",720,2691,1971,"GGATCAGTTGTTGGCGTATA","ACAACAGTTACAGGAGCAAT","561307.5.peg.777","2218"
"32553",810,2691,1881,"GGCACAGAACGGTTGGTACT","ACAACAGTTACAGGAGCAAT","561307.5.peg.777","2218"
"32554",573,2691,2118,"TCAGCAATTGCAACTAGCTC","ACAACAGTTACAGGAGCAAT","561307.5.peg.777","2218"
"32555",2244,2691,447,"TTAGCATTTGGTTTAACAAC","ACAACAGTTACAGGAGCAAT","561307.5.peg.777","2218"
"32556",1692,2734,1042,"AATGTTACTGTTCTTGGTGT","TTGTTGTGCATCATGTGATA","561307.5.peg.777","2218"
"32557",273,2734,2461,"TTGGTTGTTGCAGATTGATT","TTGTTGTGCATCATGTGATA","561307.5.peg.777","2218"
"32558",1524,2734,1210,"TCAACGCCTGAATTGTTACT","TTGTTGTGCATCATGTGATA","561307.5.peg.777","2218"
"32559",2319,2734,415,"ATCTCGTCTTCAGTAGCATC","TTGTTGTGCATCATGTGATA","561307.5.peg.777","2218"
"32560",2244,2734,490,"TTAGCATTTGGTTTAACAAC","TTGTTGTGCATCATGTGATA","561307.5.peg.777","2218"
"32561",2605,2734,129,"GATTTGTTCTAAAGCATGGT","TTGTTGTGCATCATGTGATA","561307.5.peg.777","2218"
"32562",741,2734,1993,"TGTCCTGCATTATTGGCATT","TTGTTGTGCATCATGTGATA","561307.5.peg.777","2218"
"32563",2221,2734,513,"TGTTGCAGTATCCCCACTTA","TTGTTGTGCATCATGTGATA","561307.5.peg.777","2218"
"32564",858,2734,1876,"CCATTGATTAGTGTGAAGCC","TTGTTGTGCATCATGTGATA","561307.5.peg.777","2218"
"32565",810,2734,1924,"GGCACAGAACGGTTGGTACT","TTGTTGTGCATCATGTGATA","561307.5.peg.777","2218"
"32566",292,2734,2442,"TGCTTGATTCGTTGCTTGAT","TTGTTGTGCATCATGTGATA","561307.5.peg.777","2218"
"32567",1203,2734,1531,"TGAGATTTCTCACATTATC","TTGTTGTGCATCATGTGATA","561307.5.peg.777","2218"
"32568",357,2734,2377,"GTACTTGATTGCACTGATGT","TTGTTGTGCATCATGTGATA","561307.5.peg.777","2218"
"32569",660,2734,2074,"GCTGCAGCCGCTGGATCTGC","TTGTTGTGCATCATGTGATA","561307.5.peg.777","2218"
"32570",1698,2734,1036,"CGTTAAATGTTACTGTTCT","TTGTTGTGCATCATGTGATA","561307.5.peg.777","2218"
"32571",1629,2734,1105,"TTATCAGGCATAAGTCGTGC","TTGTTGTGCATCATGTGATA","561307.5.peg.777","2218"
"32572",573,2734,2161,"TCAGCAATTGCAACTAGCTC","TTGTTGTGCATCATGTGATA","561307.5.peg.777","2218"
"32573",1837,2734,897,"TTGAATACGTCTGTCAACTT","TTGTTGTGCATCATGTGATA","561307.5.peg.777","2218"
"32574",9,2734,2725,"GCAGAGAACAGACAACCAGG","TTGTTGTGCATCATGTGATA","561307.5.peg.777","2218"
"32575",817,2734,1917,"TACTGTTGGCACAGAACGGT","TTGTTGTGCATCATGTGATA","561307.5.peg.777","2218"
"32576",639,2734,2095,"GGAGTTGCATTAGGATCTGC","TTGTTGTGCATCATGTGATA","561307.5.peg.777","2218"
"32577",648,2734,2086,"GGATCTGCTGGAGTTGCATT","TTGTTGTGCATCATGTGATA","561307.5.peg.777","2218"
"32578",2171,2734,563,"TAACGCCATCATCAGTCGTT","TTGTTGTGCATCATGTGATA","561307.5.peg.777","2218"
"32579",771,2734,1963,"TCAAATGACAGCACTTCGTT","TTGTTGTGCATCATGTGATA","561307.5.peg.777","2218"
"32580",12,2734,2722,"ACAGCAGAGAACAGACAACC","TTGTTGTGCATCATGTGATA","561307.5.peg.777","2218"
"32581",669,2734,2065,"TTTCCTACCGCTGCAGCCGC","TTGTTGTGCATCATGTGATA","561307.5.peg.777","2218"
"32582",143,2734,2591,"TTAAGGCTTGTGCACCATTT","TTGTTGTGCATCATGTGATA","561307.5.peg.777","2218"
"32583",720,2734,2014,"GGATCAGTTGTTGGCGTATA","TTGTTGTGCATCATGTGATA","561307.5.peg.777","2218"
"32584",858,2781,1923,"CCATTGATTAGTGTGAAGCC","CTTTCTTCTTGAGTCGCATC","561307.5.peg.777","2218"
"32585",1698,2781,1083,"CGTTAAATGTTACTGTTCT","CTTTCTTCTTGAGTCGCATC","561307.5.peg.777","2218"
"32586",12,2781,2769,"ACAGCAGAGAACAGACAACC","CTTTCTTCTTGAGTCGCATC","561307.5.peg.777","2218"
"32587",2319,2781,462,"ATCTCGTCTTCAGTAGCATC","CTTTCTTCTTGAGTCGCATC","561307.5.peg.777","2218"
"32588",639,2781,2142,"GGAGTTGCATTAGGATCTGC","CTTTCTTCTTGAGTCGCATC","561307.5.peg.777","2218"
"32589",2171,2781,610,"TAACGCCATCATCAGTCGTT","CTTTCTTCTTGAGTCGCATC","561307.5.peg.777","2218"
"32590",273,2781,2508,"TTGGTTGTTGCAGATTGATT","CTTTCTTCTTGAGTCGCATC","561307.5.peg.777","2218"
"32591",143,2781,2638,"TTAAGGCTTGTGCACCATTT","CTTTCTTCTTGAGTCGCATC","561307.5.peg.777","2218"
"32592",2244,2781,537,"TTAGCATTTGGTTTAACAAC","CTTTCTTCTTGAGTCGCATC","561307.5.peg.777","2218"
"32593",741,2781,2040,"TGTCCTGCATTATTGGCATT","CTTTCTTCTTGAGTCGCATC","561307.5.peg.777","2218"
"32594",357,2781,2424,"GTACTTGATTGCACTGATGT","CTTTCTTCTTGAGTCGCATC","561307.5.peg.777","2218"
"32595",660,2781,2121,"GCTGCAGCCGCTGGATCTGC","CTTTCTTCTTGAGTCGCATC","561307.5.peg.777","2218"
"32596",9,2781,2772,"GCAGAGAACAGACAACCAGG","CTTTCTTCTTGAGTCGCATC","561307.5.peg.777","2218"
"32597",669,2781,2112,"TTTCCTACCGCTGCAGCCGC","CTTTCTTCTTGAGTCGCATC","561307.5.peg.777","2218"
"32598",1203,2781,1578,"TGAGATTTCTCACATTATC","CTTTCTTCTTGAGTCGCATC","561307.5.peg.777","2218"
"32599",1524,2781,1257,"TCAACGCCTGAATTGTTACT","CTTTCTTCTTGAGTCGCATC","561307.5.peg.777","2218"
"32600",573,2781,2208,"TCAGCAATTGCAACTAGCTC","CTTTCTTCTTGAGTCGCATC","561307.5.peg.777","2218"
"32601",2662,2781,119,"GGCATTTAGACCATCTCCTT","CTTTCTTCTTGAGTCGCATC","561307.5.peg.777","2218"
"32602",810,2781,1971,"GGCACAGAACGGTTGGTACT","CTTTCTTCTTGAGTCGCATC","561307.5.peg.777","2218"
"32603",2605,2781,176,"GATTTGTTCTAAAGCATGGT","CTTTCTTCTTGAGTCGCATC","561307.5.peg.777","2218"
"32604",648,2781,2133,"GGATCTGCTGGAGTTGCATT","CTTTCTTCTTGAGTCGCATC","561307.5.peg.777","2218"
"32605",720,2781,2061,"GGATCAGTTGTTGGCGTATA","CTTTCTTCTTGAGTCGCATC","561307.5.peg.777","2218"
"32606",1629,2781,1152,"TTATCAGGCATAAGTCGTGC","CTTTCTTCTTGAGTCGCATC","561307.5.peg.777","2218"
"32607",292,2781,2489,"TGCTTGATTCGTTGCTTGAT","CTTTCTTCTTGAGTCGCATC","561307.5.peg.777","2218"
"32608",2221,2781,560,"TGTTGCAGTATCCCCACTTA","CTTTCTTCTTGAGTCGCATC","561307.5.peg.777","2218"
"32609",771,2781,2010,"TCAAATGACAGCACTTCGTT","CTTTCTTCTTGAGTCGCATC","561307.5.peg.777","2218"
"32610",817,2781,1964,"TACTGTTGGCACAGAACGGT","CTTTCTTCTTGAGTCGCATC","561307.5.peg.777","2218"
"32611",1692,2781,1089,"AATGTTACTGTTCTTGGTGT","CTTTCTTCTTGAGTCGCATC","561307.5.peg.777","2218"
"32612",1837,2781,944,"TTGAATACGTCTGTCAACTT","CTTTCTTCTTGAGTCGCATC","561307.5.peg.777","2218"
"32613",609,171,438,"TTAAGTACCCATTGTTTCAT","AAACCAGCACCTGATGGATA","561307.5.peg.779","2220"
"32614",438,171,267,"GTGTCCATTTATAGTATTC","AAACCAGCACCTGATGGATA","561307.5.peg.779","2220"
"32615",1116,171,945,"CCTTCGATGACTTCAATGAT","AAACCAGCACCTGATGGATA","561307.5.peg.779","2220"
"32616",276,171,105,"CCGAATGCATCCCACCCCAT","AAACCAGCACCTGATGGATA","561307.5.peg.779","2220"
"32617",303,171,132,"TCTAAAGCATATTGCTCTGC","AAACCAGCACCTGATGGATA","561307.5.peg.779","2220"
"32618",1068,171,897,"TAATCTCTGTCATCATGCGC","AAACCAGCACCTGATGGATA","561307.5.peg.779","2220"
"32619",609,177,432,"TTAAGTACCCATTGTTTCAT","ACATGTAAACCAGCACCTGA","561307.5.peg.779","2220"
"32620",303,177,126,"TCTAAAGCATATTGCTCTGC","ACATGTAAACCAGCACCTGA","561307.5.peg.779","2220"
"32621",438,177,261,"GTGTCCATTTATAGTATTC","ACATGTAAACCAGCACCTGA","561307.5.peg.779","2220"
"32622",1116,177,939,"CCTTCGATGACTTCAATGAT","ACATGTAAACCAGCACCTGA","561307.5.peg.779","2220"
"32623",1068,177,891,"TAATCTCTGTCATCATGCGC","ACATGTAAACCAGCACCTGA","561307.5.peg.779","2220"
"32624",609,207,402,"TTAAGTACCCATTGTTTCAT","TCTGTTGCTGTATAGCCCTC","561307.5.peg.779","2220"
"32625",438,207,231,"GTGTCCATTTATAGTATTC","TCTGTTGCTGTATAGCCCTC","561307.5.peg.779","2220"
"32626",1068,207,861,"TAATCTCTGTCATCATGCGC","TCTGTTGCTGTATAGCCCTC","561307.5.peg.779","2220"
"32627",1116,207,909,"CCTTCGATGACTTCAATGAT","TCTGTTGCTGTATAGCCCTC","561307.5.peg.779","2220"
"32628",1068,276,792,"TAATCTCTGTCATCATGCGC","CCGAATGCATCCCACCCCAT","561307.5.peg.779","2220"
"32629",171,276,105,"AAACCAGCACCTGATGGATA","CCGAATGCATCCCACCCCAT","561307.5.peg.779","2220"
"32630",438,276,162,"GTGTCCATTTATAGTATTC","CCGAATGCATCCCACCCCAT","561307.5.peg.779","2220"
"32631",609,276,333,"TTAAGTACCCATTGTTTCAT","CCGAATGCATCCCACCCCAT","561307.5.peg.779","2220"
"32632",1116,276,840,"CCTTCGATGACTTCAATGAT","CCGAATGCATCCCACCCCAT","561307.5.peg.779","2220"
"32633",177,303,126,"ACATGTAAACCAGCACCTGA","TCTAAAGCATATTGCTCTGC","561307.5.peg.779","2220"
"32634",609,303,306,"TTAAGTACCCATTGTTTCAT","TCTAAAGCATATTGCTCTGC","561307.5.peg.779","2220"
"32635",1116,303,813,"CCTTCGATGACTTCAATGAT","TCTAAAGCATATTGCTCTGC","561307.5.peg.779","2220"
"32636",1068,303,765,"TAATCTCTGTCATCATGCGC","TCTAAAGCATATTGCTCTGC","561307.5.peg.779","2220"
"32637",171,303,132,"AAACCAGCACCTGATGGATA","TCTAAAGCATATTGCTCTGC","561307.5.peg.779","2220"
"32638",438,303,135,"GTGTCCATTTATAGTATTC","TCTAAAGCATATTGCTCTGC","561307.5.peg.779","2220"
"32639",177,438,261,"ACATGTAAACCAGCACCTGA","GTGTCCATTTATAGTATTC","561307.5.peg.779","2220"
"32640",207,438,231,"TCTGTTGCTGTATAGCCCTC","GTGTCCATTTATAGTATTC","561307.5.peg.779","2220"
"32641",276,438,162,"CCGAATGCATCCCACCCCAT","GTGTCCATTTATAGTATTC","561307.5.peg.779","2220"
"32642",303,438,135,"TCTAAAGCATATTGCTCTGC","GTGTCCATTTATAGTATTC","561307.5.peg.779","2220"
"32643",609,438,171,"TTAAGTACCCATTGTTTCAT","GTGTCCATTTATAGTATTC","561307.5.peg.779","2220"
"32644",1116,438,678,"CCTTCGATGACTTCAATGAT","GTGTCCATTTATAGTATTC","561307.5.peg.779","2220"
"32645",171,438,267,"AAACCAGCACCTGATGGATA","GTGTCCATTTATAGTATTC","561307.5.peg.779","2220"
"32646",1068,438,630,"TAATCTCTGTCATCATGCGC","GTGTCCATTTATAGTATTC","561307.5.peg.779","2220"
"32647",207,609,402,"TCTGTTGCTGTATAGCCCTC","TTAAGTACCCATTGTTTCAT","561307.5.peg.779","2220"
"32648",177,609,432,"ACATGTAAACCAGCACCTGA","TTAAGTACCCATTGTTTCAT","561307.5.peg.779","2220"
"32649",438,609,171,"GTGTCCATTTATAGTATTC","TTAAGTACCCATTGTTTCAT","561307.5.peg.779","2220"
"32650",276,609,333,"CCGAATGCATCCCACCCCAT","TTAAGTACCCATTGTTTCAT","561307.5.peg.779","2220"
"32651",1116,609,507,"CCTTCGATGACTTCAATGAT","TTAAGTACCCATTGTTTCAT","561307.5.peg.779","2220"
"32652",1068,609,459,"TAATCTCTGTCATCATGCGC","TTAAGTACCCATTGTTTCAT","561307.5.peg.779","2220"
"32653",303,609,306,"TCTAAAGCATATTGCTCTGC","TTAAGTACCCATTGTTTCAT","561307.5.peg.779","2220"
"32654",171,609,438,"AAACCAGCACCTGATGGATA","TTAAGTACCCATTGTTTCAT","561307.5.peg.779","2220"
"32655",276,1068,792,"CCGAATGCATCCCACCCCAT","TAATCTCTGTCATCATGCGC","561307.5.peg.779","2220"
"32656",303,1068,765,"TCTAAAGCATATTGCTCTGC","TAATCTCTGTCATCATGCGC","561307.5.peg.779","2220"
"32657",609,1068,459,"TTAAGTACCCATTGTTTCAT","TAATCTCTGTCATCATGCGC","561307.5.peg.779","2220"
"32658",171,1068,897,"AAACCAGCACCTGATGGATA","TAATCTCTGTCATCATGCGC","561307.5.peg.779","2220"
"32659",207,1068,861,"TCTGTTGCTGTATAGCCCTC","TAATCTCTGTCATCATGCGC","561307.5.peg.779","2220"
"32660",438,1068,630,"GTGTCCATTTATAGTATTC","TAATCTCTGTCATCATGCGC","561307.5.peg.779","2220"
"32661",177,1068,891,"ACATGTAAACCAGCACCTGA","TAATCTCTGTCATCATGCGC","561307.5.peg.779","2220"
"32662",171,1116,945,"AAACCAGCACCTGATGGATA","CCTTCGATGACTTCAATGAT","561307.5.peg.779","2220"
"32663",207,1116,909,"TCTGTTGCTGTATAGCCCTC","CCTTCGATGACTTCAATGAT","561307.5.peg.779","2220"
"32664",609,1116,507,"TTAAGTACCCATTGTTTCAT","CCTTCGATGACTTCAATGAT","561307.5.peg.779","2220"
"32665",276,1116,840,"CCGAATGCATCCCACCCCAT","CCTTCGATGACTTCAATGAT","561307.5.peg.779","2220"
"32666",438,1116,678,"GTGTCCATTTATAGTATTC","CCTTCGATGACTTCAATGAT","561307.5.peg.779","2220"
"32667",303,1116,813,"TCTAAAGCATATTGCTCTGC","CCTTCGATGACTTCAATGAT","561307.5.peg.779","2220"
"32668",177,1116,939,"ACATGTAAACCAGCACCTGA","CCTTCGATGACTTCAATGAT","561307.5.peg.779","2220"
"32669",387,150,237,"GCATTGCAGTCAAACCATGG","GTCGCATCTAATTCGACAAC","561307.5.peg.78","2221"
"32670",150,387,237,"GTCGCATCTAATTCGACAAC","GCATTGCAGTCAAACCATGG","561307.5.peg.78","2221"
"32671",333,60,273,"ACAAGCCATACAGCATACCA","ACTAGCCACCAGACTGATTT","561307.5.peg.780","2222"
"32672",387,60,327,"CCAGCCATAGCGTATATCGC","ACTAGCCACCAGACTGATTT","561307.5.peg.780","2222"
"32673",420,60,360,"AACGTTTGTCTTCCGCCATT","ACTAGCCACCAGACTGATTT","561307.5.peg.780","2222"
"32674",60,333,273,"ACTAGCCACCAGACTGATTT","ACAAGCCATACAGCATACCA","561307.5.peg.780","2222"
"32675",60,387,327,"ACTAGCCACCAGACTGATTT","CCAGCCATAGCGTATATCGC","561307.5.peg.780","2222"
"32676",60,420,360,"ACTAGCCACCAGACTGATTT","AACGTTTGTCTTCCGCCATT","561307.5.peg.780","2222"
"32677",405,171,234,"ATAGATAATCCCACAACACC","GCTACAGTGCCATCGCGGTT","561307.5.peg.781","2223"
"32678",438,171,267,"ACATCGTCTGGTAGACAGTC","GCTACAGTGCCATCGCGGTT","561307.5.peg.781","2223"
"32679",450,171,279,"AAATATTCGACAACATCGTC","GCTACAGTGCCATCGCGGTT","561307.5.peg.781","2223"
"32680",405,176,229,"ATAGATAATCCCACAACACC","CATGTGCTACAGTGCCATCG","561307.5.peg.781","2223"
"32681",438,176,262,"ACATCGTCTGGTAGACAGTC","CATGTGCTACAGTGCCATCG","561307.5.peg.781","2223"
"32682",450,176,274,"AAATATTCGACAACATCGTC","CATGTGCTACAGTGCCATCG","561307.5.peg.781","2223"
"32683",171,405,234,"GCTACAGTGCCATCGCGGTT","ATAGATAATCCCACAACACC","561307.5.peg.781","2223"
"32684",176,405,229,"CATGTGCTACAGTGCCATCG","ATAGATAATCCCACAACACC","561307.5.peg.781","2223"
"32685",171,438,267,"GCTACAGTGCCATCGCGGTT","ACATCGTCTGGTAGACAGTC","561307.5.peg.781","2223"
"32686",176,438,262,"CATGTGCTACAGTGCCATCG","ACATCGTCTGGTAGACAGTC","561307.5.peg.781","2223"
"32687",171,450,279,"GCTACAGTGCCATCGCGGTT","AAATATTCGACAACATCGTC","561307.5.peg.781","2223"
"32688",176,450,274,"CATGTGCTACAGTGCCATCG","AAATATTCGACAACATCGTC","561307.5.peg.781","2223"
"32689",166,8,158,"ATGTCCTTCTGGTACTTGTT","AGGCTTGCGTTACAAGTCTA","561307.5.peg.782","2224"
"32690",177,8,169,"AAACCATAAACATGTCCTTC","AGGCTTGCGTTACAAGTCTA","561307.5.peg.782","2224"
"32691",8,166,158,"AGGCTTGCGTTACAAGTCTA","ATGTCCTTCTGGTACTTGTT","561307.5.peg.782","2224"
"32692",8,177,169,"AGGCTTGCGTTACAAGTCTA","AAACCATAAACATGTCCTTC","561307.5.peg.782","2224"
"32693",123,6,117,"CTTACTACAAGACATATTGC","ACAATGATTGATTATGTGG","561307.5.peg.785","2227"
"32694",171,6,165,"GTAGAAGCAGTATATTTGTC","ACAATGATTGATTATGTGG","561307.5.peg.785","2227"
"32695",6,123,117,"ACAATGATTGATTATGTGG","CTTACTACAAGACATATTGC","561307.5.peg.785","2227"
"32696",6,171,165,"ACAATGATTGATTATGTGG","GTAGAAGCAGTATATTTGTC","561307.5.peg.785","2227"
"32697",105,3,102,"ATTGTAGACTTACCTGCGCC","TTCTCGCTAATAGGTGACTT","561307.5.peg.786","2228"
"32698",228,3,225,"CTTGATAGGCCTTCATTGTT","TTCTCGCTAATAGGTGACTT","561307.5.peg.786","2228"
"32699",228,12,216,"CTTGATAGGCCTTCATTGTT","CCTCGAAATTTCTCGCTAAT","561307.5.peg.786","2228"
"32700",228,17,211,"CTTGATAGGCCTTCATTGTT","CCTATTAGCGAGAAATTTCG","561307.5.peg.786","2228"
"32701",228,63,165,"CTTGATAGGCCTTCATTGTT","ATGCTTTGAACTGCACTGTC","561307.5.peg.786","2228"
"32702",3,105,102,"TTCTCGCTAATAGGTGACTT","ATTGTAGACTTACCTGCGCC","561307.5.peg.786","2228"
"32703",228,105,123,"CTTGATAGGCCTTCATTGTT","ATTGTAGACTTACCTGCGCC","561307.5.peg.786","2228"
"32704",3,228,225,"TTCTCGCTAATAGGTGACTT","CTTGATAGGCCTTCATTGTT","561307.5.peg.786","2228"
"32705",17,228,211,"CCTATTAGCGAGAAATTTCG","CTTGATAGGCCTTCATTGTT","561307.5.peg.786","2228"
"32706",63,228,165,"ATGCTTTGAACTGCACTGTC","CTTGATAGGCCTTCATTGTT","561307.5.peg.786","2228"
"32707",12,228,216,"CCTCGAAATTTCTCGCTAAT","CTTGATAGGCCTTCATTGTT","561307.5.peg.786","2228"
"32708",105,228,123,"ATTGTAGACTTACCTGCGCC","CTTGATAGGCCTTCATTGTT","561307.5.peg.786","2228"
"32709",378,246,132,"TAATGTGGTACTTCGCCCGT","ATATCCAATGCTTGAACTTC","561307.5.peg.787","2229"
"32710",246,378,132,"ATATCCAATGCTTGAACTTC","TAATGTGGTACTTCGCCCGT","561307.5.peg.787","2229"
"32711",132,12,120,"CTTACTGATGCAACTAATTT","ATCGCAACGTATCTATATA","561307.5.peg.79","2232"
"32712",273,12,261,"CTGGTATATGATTGTTGACT","ATCGCAACGTATCTATATA","561307.5.peg.79","2232"
"32713",456,12,444,"CTGCTTATAATCTGTTCGCT","ATCGCAACGTATCTATATA","561307.5.peg.79","2232"
"32714",330,12,318,"AAATGTAATGCGCGTCGATA","ATCGCAACGTATCTATATA","561307.5.peg.79","2232"
"32715",376,12,364,"CACTTAAATTGTTGTTCTT","ATCGCAACGTATCTATATA","561307.5.peg.79","2232"
"32716",12,132,120,"ATCGCAACGTATCTATATA","CTTACTGATGCAACTAATTT","561307.5.peg.79","2232"
"32717",376,132,244,"CACTTAAATTGTTGTTCTT","CTTACTGATGCAACTAATTT","561307.5.peg.79","2232"
"32718",273,132,141,"CTGGTATATGATTGTTGACT","CTTACTGATGCAACTAATTT","561307.5.peg.79","2232"
"32719",456,132,324,"CTGCTTATAATCTGTTCGCT","CTTACTGATGCAACTAATTT","561307.5.peg.79","2232"
"32720",330,132,198,"AAATGTAATGCGCGTCGATA","CTTACTGATGCAACTAATTT","561307.5.peg.79","2232"
"32721",376,273,103,"CACTTAAATTGTTGTTCTT","CTGGTATATGATTGTTGACT","561307.5.peg.79","2232"
"32722",12,273,261,"ATCGCAACGTATCTATATA","CTGGTATATGATTGTTGACT","561307.5.peg.79","2232"
"32723",456,273,183,"CTGCTTATAATCTGTTCGCT","CTGGTATATGATTGTTGACT","561307.5.peg.79","2232"
"32724",132,273,141,"CTTACTGATGCAACTAATTT","CTGGTATATGATTGTTGACT","561307.5.peg.79","2232"
"32725",132,330,198,"CTTACTGATGCAACTAATTT","AAATGTAATGCGCGTCGATA","561307.5.peg.79","2232"
"32726",456,330,126,"CTGCTTATAATCTGTTCGCT","AAATGTAATGCGCGTCGATA","561307.5.peg.79","2232"
"32727",12,330,318,"ATCGCAACGTATCTATATA","AAATGTAATGCGCGTCGATA","561307.5.peg.79","2232"
"32728",273,376,103,"CTGGTATATGATTGTTGACT","CACTTAAATTGTTGTTCTT","561307.5.peg.79","2232"
"32729",12,376,364,"ATCGCAACGTATCTATATA","CACTTAAATTGTTGTTCTT","561307.5.peg.79","2232"
"32730",132,376,244,"CTTACTGATGCAACTAATTT","CACTTAAATTGTTGTTCTT","561307.5.peg.79","2232"
"32731",12,456,444,"ATCGCAACGTATCTATATA","CTGCTTATAATCTGTTCGCT","561307.5.peg.79","2232"
"32732",273,456,183,"CTGGTATATGATTGTTGACT","CTGCTTATAATCTGTTCGCT","561307.5.peg.79","2232"
"32733",132,456,324,"CTTACTGATGCAACTAATTT","CTGCTTATAATCTGTTCGCT","561307.5.peg.79","2232"
"32734",330,456,126,"AAATGTAATGCGCGTCGATA","CTGCTTATAATCTGTTCGCT","561307.5.peg.79","2232"
"32735",244,123,121,"ACGTTCGTGATCACCAAGAA","GAGATCCACCCTATTGGACG","561307.5.peg.794","2237"
"32736",366,123,243,"TTAAATTCATCCTCTTCTGG","GAGATCCACCCTATTGGACG","561307.5.peg.794","2237"
"32737",366,129,237,"TTAAATTCATCCTCTTCTGG","ACAGTAGAGATCCACCCTAT","561307.5.peg.794","2237"
"32738",244,129,115,"ACGTTCGTGATCACCAAGAA","ACAGTAGAGATCCACCCTAT","561307.5.peg.794","2237"
"32739",366,213,153,"TTAAATTCATCCTCTTCTGG","GCTGCGAACATAACCATAGG","561307.5.peg.794","2237"
"32740",366,216,150,"TTAAATTCATCCTCTTCTGG","TTTGCTGCGAACATAACCAT","561307.5.peg.794","2237"
"32741",123,244,121,"GAGATCCACCCTATTGGACG","ACGTTCGTGATCACCAAGAA","561307.5.peg.794","2237"
"32742",129,244,115,"ACAGTAGAGATCCACCCTAT","ACGTTCGTGATCACCAAGAA","561307.5.peg.794","2237"
"32743",366,244,122,"TTAAATTCATCCTCTTCTGG","ACGTTCGTGATCACCAAGAA","561307.5.peg.794","2237"
"32744",123,366,243,"GAGATCCACCCTATTGGACG","TTAAATTCATCCTCTTCTGG","561307.5.peg.794","2237"
"32745",129,366,237,"ACAGTAGAGATCCACCCTAT","TTAAATTCATCCTCTTCTGG","561307.5.peg.794","2237"
"32746",216,366,150,"TTTGCTGCGAACATAACCAT","TTAAATTCATCCTCTTCTGG","561307.5.peg.794","2237"
"32747",244,366,122,"ACGTTCGTGATCACCAAGAA","TTAAATTCATCCTCTTCTGG","561307.5.peg.794","2237"
"32748",213,366,153,"GCTGCGAACATAACCATAGG","TTAAATTCATCCTCTTCTGG","561307.5.peg.794","2237"
"32749",2164,565,1599,"TGTACTATCAAATGTTAGTC","CTTGATGTAGTATTCTTTG","561307.5.peg.795","2238"
"32750",1167,565,602,"TTCGCCTTTGCAGCTGAATT","CTTGATGTAGTATTCTTTG","561307.5.peg.795","2238"
"32751",895,565,330,"CTGTGTTAACGTCACAATAC","CTTGATGTAGTATTCTTTG","561307.5.peg.795","2238"
"32752",805,565,240,"AATTGTATTAGCAGTTACTG","CTTGATGTAGTATTCTTTG","561307.5.peg.795","2238"
"32753",1675,565,1110,"TGACGCATATGAACTATCGA","CTTGATGTAGTATTCTTTG","561307.5.peg.795","2238"
"32754",2434,565,1869,"GCTTACACTTGTCGATTTCG","CTTGATGTAGTATTCTTTG","561307.5.peg.795","2238"
"32755",3139,565,2574,"CGTGCTCATTGAACTACTTA","CTTGATGTAGTATTCTTTG","561307.5.peg.795","2238"
"32756",690,565,125,"TTGTTTAAGTTGACCGAAGA","CTTGATGTAGTATTCTTTG","561307.5.peg.795","2238"
"32757",1317,565,752,"TCTTGGAACGTGTTATTTGT","CTTGATGTAGTATTCTTTG","561307.5.peg.795","2238"
"32758",2160,565,1595,"CTATCAAATGTTAGTCCGGA","CTTGATGTAGTATTCTTTG","561307.5.peg.795","2238"
"32759",1985,565,1420,"TCGTCGATTTGTTATTTGCT","CTTGATGTAGTATTCTTTG","561307.5.peg.795","2238"
"32760",2842,565,2277,"TGAAATACTGATAGAGTCCG","CTTGATGTAGTATTCTTTG","561307.5.peg.795","2238"
"32761",880,565,315,"AATACCGGTACTTTGATCAT","CTTGATGTAGTATTCTTTG","561307.5.peg.795","2238"
"32762",2875,565,2310,"TGTTGACGCACTTTGAGAGT","CTTGATGTAGTATTCTTTG","561307.5.peg.795","2238"
"32763",1062,565,497,"CCTGTTTCACCTAATACACC","CTTGATGTAGTATTCTTTG","561307.5.peg.795","2238"
"32764",2208,565,1643,"GTACTTGTACCAATGTTTGT","CTTGATGTAGTATTCTTTG","561307.5.peg.795","2238"
"32765",2055,565,1490,"TCTGATGATTGATCTCCTAT","CTTGATGTAGTATTCTTTG","561307.5.peg.795","2238"
"32766",1830,565,1265,"TCCGTTGTAGTCAATACAAT","CTTGATGTAGTATTCTTTG","561307.5.peg.795","2238"
"32767",1893,565,1328,"CTATCGTAACTTAATCCGCT","CTTGATGTAGTATTCTTTG","561307.5.peg.795","2238"
"32768",2456,565,1891,"ATGCACTCACAGAATCAGAT","CTTGATGTAGTATTCTTTG","561307.5.peg.795","2238"
"32769",3343,565,2778,"CGTTGATATGCTCATTGAAT","CTTGATGTAGTATTCTTTG","561307.5.peg.795","2238"
"32770",1468,565,903,"ATTTGTCGCGCCACCTGTTG","CTTGATGTAGTATTCTTTG","561307.5.peg.795","2238"
"32771",1062,690,372,"CCTGTTTCACCTAATACACC","TTGTTTAAGTTGACCGAAGA","561307.5.peg.795","2238"
"32772",2160,690,1470,"CTATCAAATGTTAGTCCGGA","TTGTTTAAGTTGACCGAAGA","561307.5.peg.795","2238"
"32773",2055,690,1365,"TCTGATGATTGATCTCCTAT","TTGTTTAAGTTGACCGAAGA","561307.5.peg.795","2238"
"32774",3139,690,2449,"CGTGCTCATTGAACTACTTA","TTGTTTAAGTTGACCGAAGA","561307.5.peg.795","2238"
"32775",565,690,125,"CTTGATGTAGTATTCTTTG","TTGTTTAAGTTGACCGAAGA","561307.5.peg.795","2238"
"32776",2434,690,1744,"GCTTACACTTGTCGATTTCG","TTGTTTAAGTTGACCGAAGA","561307.5.peg.795","2238"
"32777",2208,690,1518,"GTACTTGTACCAATGTTTGT","TTGTTTAAGTTGACCGAAGA","561307.5.peg.795","2238"
"32778",1830,690,1140,"TCCGTTGTAGTCAATACAAT","TTGTTTAAGTTGACCGAAGA","561307.5.peg.795","2238"
"32779",3343,690,2653,"CGTTGATATGCTCATTGAAT","TTGTTTAAGTTGACCGAAGA","561307.5.peg.795","2238"
"32780",1468,690,778,"ATTTGTCGCGCCACCTGTTG","TTGTTTAAGTTGACCGAAGA","561307.5.peg.795","2238"
"32781",2164,690,1474,"TGTACTATCAAATGTTAGTC","TTGTTTAAGTTGACCGAAGA","561307.5.peg.795","2238"
"32782",2456,690,1766,"ATGCACTCACAGAATCAGAT","TTGTTTAAGTTGACCGAAGA","561307.5.peg.795","2238"
"32783",2842,690,2152,"TGAAATACTGATAGAGTCCG","TTGTTTAAGTTGACCGAAGA","561307.5.peg.795","2238"
"32784",895,690,205,"CTGTGTTAACGTCACAATAC","TTGTTTAAGTTGACCGAAGA","561307.5.peg.795","2238"
"32785",1893,690,1203,"CTATCGTAACTTAATCCGCT","TTGTTTAAGTTGACCGAAGA","561307.5.peg.795","2238"
"32786",1675,690,985,"TGACGCATATGAACTATCGA","TTGTTTAAGTTGACCGAAGA","561307.5.peg.795","2238"
"32787",805,690,115,"AATTGTATTAGCAGTTACTG","TTGTTTAAGTTGACCGAAGA","561307.5.peg.795","2238"
"32788",1167,690,477,"TTCGCCTTTGCAGCTGAATT","TTGTTTAAGTTGACCGAAGA","561307.5.peg.795","2238"
"32789",880,690,190,"AATACCGGTACTTTGATCAT","TTGTTTAAGTTGACCGAAGA","561307.5.peg.795","2238"
"32790",1985,690,1295,"TCGTCGATTTGTTATTTGCT","TTGTTTAAGTTGACCGAAGA","561307.5.peg.795","2238"
"32791",2875,690,2185,"TGTTGACGCACTTTGAGAGT","TTGTTTAAGTTGACCGAAGA","561307.5.peg.795","2238"
"32792",1317,690,627,"TCTTGGAACGTGTTATTTGT","TTGTTTAAGTTGACCGAAGA","561307.5.peg.795","2238"
"32793",2875,805,2070,"TGTTGACGCACTTTGAGAGT","AATTGTATTAGCAGTTACTG","561307.5.peg.795","2238"
"32794",1675,805,870,"TGACGCATATGAACTATCGA","AATTGTATTAGCAGTTACTG","561307.5.peg.795","2238"
"32795",1468,805,663,"ATTTGTCGCGCCACCTGTTG","AATTGTATTAGCAGTTACTG","561307.5.peg.795","2238"
"32796",2434,805,1629,"GCTTACACTTGTCGATTTCG","AATTGTATTAGCAGTTACTG","561307.5.peg.795","2238"
"32797",690,805,115,"TTGTTTAAGTTGACCGAAGA","AATTGTATTAGCAGTTACTG","561307.5.peg.795","2238"
"32798",2160,805,1355,"CTATCAAATGTTAGTCCGGA","AATTGTATTAGCAGTTACTG","561307.5.peg.795","2238"
"32799",2055,805,1250,"TCTGATGATTGATCTCCTAT","AATTGTATTAGCAGTTACTG","561307.5.peg.795","2238"
"32800",3139,805,2334,"CGTGCTCATTGAACTACTTA","AATTGTATTAGCAGTTACTG","561307.5.peg.795","2238"
"32801",2842,805,2037,"TGAAATACTGATAGAGTCCG","AATTGTATTAGCAGTTACTG","561307.5.peg.795","2238"
"32802",2456,805,1651,"ATGCACTCACAGAATCAGAT","AATTGTATTAGCAGTTACTG","561307.5.peg.795","2238"
"32803",2208,805,1403,"GTACTTGTACCAATGTTTGT","AATTGTATTAGCAGTTACTG","561307.5.peg.795","2238"
"32804",3343,805,2538,"CGTTGATATGCTCATTGAAT","AATTGTATTAGCAGTTACTG","561307.5.peg.795","2238"
"32805",1893,805,1088,"CTATCGTAACTTAATCCGCT","AATTGTATTAGCAGTTACTG","561307.5.peg.795","2238"
"32806",2164,805,1359,"TGTACTATCAAATGTTAGTC","AATTGTATTAGCAGTTACTG","561307.5.peg.795","2238"
"32807",565,805,240,"CTTGATGTAGTATTCTTTG","AATTGTATTAGCAGTTACTG","561307.5.peg.795","2238"
"32808",1985,805,1180,"TCGTCGATTTGTTATTTGCT","AATTGTATTAGCAGTTACTG","561307.5.peg.795","2238"
"32809",1830,805,1025,"TCCGTTGTAGTCAATACAAT","AATTGTATTAGCAGTTACTG","561307.5.peg.795","2238"
"32810",1167,805,362,"TTCGCCTTTGCAGCTGAATT","AATTGTATTAGCAGTTACTG","561307.5.peg.795","2238"
"32811",1062,805,257,"CCTGTTTCACCTAATACACC","AATTGTATTAGCAGTTACTG","561307.5.peg.795","2238"
"32812",1317,805,512,"TCTTGGAACGTGTTATTTGT","AATTGTATTAGCAGTTACTG","561307.5.peg.795","2238"
"32813",2456,880,1576,"ATGCACTCACAGAATCAGAT","AATACCGGTACTTTGATCAT","561307.5.peg.795","2238"
"32814",690,880,190,"TTGTTTAAGTTGACCGAAGA","AATACCGGTACTTTGATCAT","561307.5.peg.795","2238"
"32815",2875,880,1995,"TGTTGACGCACTTTGAGAGT","AATACCGGTACTTTGATCAT","561307.5.peg.795","2238"
"32816",2055,880,1175,"TCTGATGATTGATCTCCTAT","AATACCGGTACTTTGATCAT","561307.5.peg.795","2238"
"32817",2160,880,1280,"CTATCAAATGTTAGTCCGGA","AATACCGGTACTTTGATCAT","561307.5.peg.795","2238"
"32818",1167,880,287,"TTCGCCTTTGCAGCTGAATT","AATACCGGTACTTTGATCAT","561307.5.peg.795","2238"
"32819",1893,880,1013,"CTATCGTAACTTAATCCGCT","AATACCGGTACTTTGATCAT","561307.5.peg.795","2238"
"32820",3343,880,2463,"CGTTGATATGCTCATTGAAT","AATACCGGTACTTTGATCAT","561307.5.peg.795","2238"
"32821",1468,880,588,"ATTTGTCGCGCCACCTGTTG","AATACCGGTACTTTGATCAT","561307.5.peg.795","2238"
"32822",2164,880,1284,"TGTACTATCAAATGTTAGTC","AATACCGGTACTTTGATCAT","561307.5.peg.795","2238"
"32823",1317,880,437,"TCTTGGAACGTGTTATTTGT","AATACCGGTACTTTGATCAT","561307.5.peg.795","2238"
"32824",1985,880,1105,"TCGTCGATTTGTTATTTGCT","AATACCGGTACTTTGATCAT","561307.5.peg.795","2238"
"32825",2842,880,1962,"TGAAATACTGATAGAGTCCG","AATACCGGTACTTTGATCAT","561307.5.peg.795","2238"
"32826",565,880,315,"CTTGATGTAGTATTCTTTG","AATACCGGTACTTTGATCAT","561307.5.peg.795","2238"
"32827",2208,880,1328,"GTACTTGTACCAATGTTTGT","AATACCGGTACTTTGATCAT","561307.5.peg.795","2238"
"32828",1675,880,795,"TGACGCATATGAACTATCGA","AATACCGGTACTTTGATCAT","561307.5.peg.795","2238"
"32829",1830,880,950,"TCCGTTGTAGTCAATACAAT","AATACCGGTACTTTGATCAT","561307.5.peg.795","2238"
"32830",3139,880,2259,"CGTGCTCATTGAACTACTTA","AATACCGGTACTTTGATCAT","561307.5.peg.795","2238"
"32831",2434,880,1554,"GCTTACACTTGTCGATTTCG","AATACCGGTACTTTGATCAT","561307.5.peg.795","2238"
"32832",1062,880,182,"CCTGTTTCACCTAATACACC","AATACCGGTACTTTGATCAT","561307.5.peg.795","2238"
"32833",2055,895,1160,"TCTGATGATTGATCTCCTAT","CTGTGTTAACGTCACAATAC","561307.5.peg.795","2238"
"32834",2434,895,1539,"GCTTACACTTGTCGATTTCG","CTGTGTTAACGTCACAATAC","561307.5.peg.795","2238"
"32835",2208,895,1313,"GTACTTGTACCAATGTTTGT","CTGTGTTAACGTCACAATAC","561307.5.peg.795","2238"
"32836",2456,895,1561,"ATGCACTCACAGAATCAGAT","CTGTGTTAACGTCACAATAC","561307.5.peg.795","2238"
"32837",1985,895,1090,"TCGTCGATTTGTTATTTGCT","CTGTGTTAACGTCACAATAC","561307.5.peg.795","2238"
"32838",1317,895,422,"TCTTGGAACGTGTTATTTGT","CTGTGTTAACGTCACAATAC","561307.5.peg.795","2238"
"32839",1062,895,167,"CCTGTTTCACCTAATACACC","CTGTGTTAACGTCACAATAC","561307.5.peg.795","2238"
"32840",1675,895,780,"TGACGCATATGAACTATCGA","CTGTGTTAACGTCACAATAC","561307.5.peg.795","2238"
"32841",1468,895,573,"ATTTGTCGCGCCACCTGTTG","CTGTGTTAACGTCACAATAC","561307.5.peg.795","2238"
"32842",1830,895,935,"TCCGTTGTAGTCAATACAAT","CTGTGTTAACGTCACAATAC","561307.5.peg.795","2238"
"32843",3139,895,2244,"CGTGCTCATTGAACTACTTA","CTGTGTTAACGTCACAATAC","561307.5.peg.795","2238"
"32844",2160,895,1265,"CTATCAAATGTTAGTCCGGA","CTGTGTTAACGTCACAATAC","561307.5.peg.795","2238"
"32845",3343,895,2448,"CGTTGATATGCTCATTGAAT","CTGTGTTAACGTCACAATAC","561307.5.peg.795","2238"
"32846",1893,895,998,"CTATCGTAACTTAATCCGCT","CTGTGTTAACGTCACAATAC","561307.5.peg.795","2238"
"32847",690,895,205,"TTGTTTAAGTTGACCGAAGA","CTGTGTTAACGTCACAATAC","561307.5.peg.795","2238"
"32848",2875,895,1980,"TGTTGACGCACTTTGAGAGT","CTGTGTTAACGTCACAATAC","561307.5.peg.795","2238"
"32849",2164,895,1269,"TGTACTATCAAATGTTAGTC","CTGTGTTAACGTCACAATAC","561307.5.peg.795","2238"
"32850",2842,895,1947,"TGAAATACTGATAGAGTCCG","CTGTGTTAACGTCACAATAC","561307.5.peg.795","2238"
"32851",1167,895,272,"TTCGCCTTTGCAGCTGAATT","CTGTGTTAACGTCACAATAC","561307.5.peg.795","2238"
"32852",565,895,330,"CTTGATGTAGTATTCTTTG","CTGTGTTAACGTCACAATAC","561307.5.peg.795","2238"
"32853",690,1062,372,"TTGTTTAAGTTGACCGAAGA","CCTGTTTCACCTAATACACC","561307.5.peg.795","2238"
"32854",1830,1062,768,"TCCGTTGTAGTCAATACAAT","CCTGTTTCACCTAATACACC","561307.5.peg.795","2238"
"32855",805,1062,257,"AATTGTATTAGCAGTTACTG","CCTGTTTCACCTAATACACC","561307.5.peg.795","2238"
"32856",3139,1062,2077,"CGTGCTCATTGAACTACTTA","CCTGTTTCACCTAATACACC","561307.5.peg.795","2238"
"32857",565,1062,497,"CTTGATGTAGTATTCTTTG","CCTGTTTCACCTAATACACC","561307.5.peg.795","2238"
"32858",2434,1062,1372,"GCTTACACTTGTCGATTTCG","CCTGTTTCACCTAATACACC","561307.5.peg.795","2238"
"32859",2164,1062,1102,"TGTACTATCAAATGTTAGTC","CCTGTTTCACCTAATACACC","561307.5.peg.795","2238"
"32860",1468,1062,406,"ATTTGTCGCGCCACCTGTTG","CCTGTTTCACCTAATACACC","561307.5.peg.795","2238"
"32861",1167,1062,105,"TTCGCCTTTGCAGCTGAATT","CCTGTTTCACCTAATACACC","561307.5.peg.795","2238"
"32862",2208,1062,1146,"GTACTTGTACCAATGTTTGT","CCTGTTTCACCTAATACACC","561307.5.peg.795","2238"
"32863",3343,1062,2281,"CGTTGATATGCTCATTGAAT","CCTGTTTCACCTAATACACC","561307.5.peg.795","2238"
"32864",1985,1062,923,"TCGTCGATTTGTTATTTGCT","CCTGTTTCACCTAATACACC","561307.5.peg.795","2238"
"32865",2875,1062,1813,"TGTTGACGCACTTTGAGAGT","CCTGTTTCACCTAATACACC","561307.5.peg.795","2238"
"32866",1317,1062,255,"TCTTGGAACGTGTTATTTGT","CCTGTTTCACCTAATACACC","561307.5.peg.795","2238"
"32867",2160,1062,1098,"CTATCAAATGTTAGTCCGGA","CCTGTTTCACCTAATACACC","561307.5.peg.795","2238"
"32868",2842,1062,1780,"TGAAATACTGATAGAGTCCG","CCTGTTTCACCTAATACACC","561307.5.peg.795","2238"
"32869",1893,1062,831,"CTATCGTAACTTAATCCGCT","CCTGTTTCACCTAATACACC","561307.5.peg.795","2238"
"32870",2456,1062,1394,"ATGCACTCACAGAATCAGAT","CCTGTTTCACCTAATACACC","561307.5.peg.795","2238"
"32871",1675,1062,613,"TGACGCATATGAACTATCGA","CCTGTTTCACCTAATACACC","561307.5.peg.795","2238"
"32872",880,1062,182,"AATACCGGTACTTTGATCAT","CCTGTTTCACCTAATACACC","561307.5.peg.795","2238"
"32873",895,1062,167,"CTGTGTTAACGTCACAATAC","CCTGTTTCACCTAATACACC","561307.5.peg.795","2238"
"32874",2055,1062,993,"TCTGATGATTGATCTCCTAT","CCTGTTTCACCTAATACACC","561307.5.peg.795","2238"
"32875",565,1167,602,"CTTGATGTAGTATTCTTTG","TTCGCCTTTGCAGCTGAATT","561307.5.peg.795","2238"
"32876",805,1167,362,"AATTGTATTAGCAGTTACTG","TTCGCCTTTGCAGCTGAATT","561307.5.peg.795","2238"
"32877",2434,1167,1267,"GCTTACACTTGTCGATTTCG","TTCGCCTTTGCAGCTGAATT","561307.5.peg.795","2238"
"32878",2456,1167,1289,"ATGCACTCACAGAATCAGAT","TTCGCCTTTGCAGCTGAATT","561307.5.peg.795","2238"
"32879",895,1167,272,"CTGTGTTAACGTCACAATAC","TTCGCCTTTGCAGCTGAATT","561307.5.peg.795","2238"
"32880",1675,1167,508,"TGACGCATATGAACTATCGA","TTCGCCTTTGCAGCTGAATT","561307.5.peg.795","2238"
"32881",3343,1167,2176,"CGTTGATATGCTCATTGAAT","TTCGCCTTTGCAGCTGAATT","561307.5.peg.795","2238"
"32882",1893,1167,726,"CTATCGTAACTTAATCCGCT","TTCGCCTTTGCAGCTGAATT","561307.5.peg.795","2238"
"32883",1830,1167,663,"TCCGTTGTAGTCAATACAAT","TTCGCCTTTGCAGCTGAATT","561307.5.peg.795","2238"
"32884",2160,1167,993,"CTATCAAATGTTAGTCCGGA","TTCGCCTTTGCAGCTGAATT","561307.5.peg.795","2238"
"32885",2875,1167,1708,"TGTTGACGCACTTTGAGAGT","TTCGCCTTTGCAGCTGAATT","561307.5.peg.795","2238"
"32886",1468,1167,301,"ATTTGTCGCGCCACCTGTTG","TTCGCCTTTGCAGCTGAATT","561307.5.peg.795","2238"
"32887",2208,1167,1041,"GTACTTGTACCAATGTTTGT","TTCGCCTTTGCAGCTGAATT","561307.5.peg.795","2238"
"32888",3139,1167,1972,"CGTGCTCATTGAACTACTTA","TTCGCCTTTGCAGCTGAATT","561307.5.peg.795","2238"
"32889",1317,1167,150,"TCTTGGAACGTGTTATTTGT","TTCGCCTTTGCAGCTGAATT","561307.5.peg.795","2238"
"32890",690,1167,477,"TTGTTTAAGTTGACCGAAGA","TTCGCCTTTGCAGCTGAATT","561307.5.peg.795","2238"
"32891",880,1167,287,"AATACCGGTACTTTGATCAT","TTCGCCTTTGCAGCTGAATT","561307.5.peg.795","2238"
"32892",1062,1167,105,"CCTGTTTCACCTAATACACC","TTCGCCTTTGCAGCTGAATT","561307.5.peg.795","2238"
"32893",2842,1167,1675,"TGAAATACTGATAGAGTCCG","TTCGCCTTTGCAGCTGAATT","561307.5.peg.795","2238"
"32894",1985,1167,818,"TCGTCGATTTGTTATTTGCT","TTCGCCTTTGCAGCTGAATT","561307.5.peg.795","2238"
"32895",2055,1167,888,"TCTGATGATTGATCTCCTAT","TTCGCCTTTGCAGCTGAATT","561307.5.peg.795","2238"
"32896",2164,1167,997,"TGTACTATCAAATGTTAGTC","TTCGCCTTTGCAGCTGAATT","561307.5.peg.795","2238"
"32897",2875,1317,1558,"TGTTGACGCACTTTGAGAGT","TCTTGGAACGTGTTATTTGT","561307.5.peg.795","2238"
"32898",3139,1317,1822,"CGTGCTCATTGAACTACTTA","TCTTGGAACGTGTTATTTGT","561307.5.peg.795","2238"
"32899",2434,1317,1117,"GCTTACACTTGTCGATTTCG","TCTTGGAACGTGTTATTTGT","561307.5.peg.795","2238"
"32900",895,1317,422,"CTGTGTTAACGTCACAATAC","TCTTGGAACGTGTTATTTGT","561307.5.peg.795","2238"
"32901",1167,1317,150,"TTCGCCTTTGCAGCTGAATT","TCTTGGAACGTGTTATTTGT","561307.5.peg.795","2238"
"32902",3343,1317,2026,"CGTTGATATGCTCATTGAAT","TCTTGGAACGTGTTATTTGT","561307.5.peg.795","2238"
"32903",2842,1317,1525,"TGAAATACTGATAGAGTCCG","TCTTGGAACGTGTTATTTGT","561307.5.peg.795","2238"
"32904",1893,1317,576,"CTATCGTAACTTAATCCGCT","TCTTGGAACGTGTTATTTGT","561307.5.peg.795","2238"
"32905",880,1317,437,"AATACCGGTACTTTGATCAT","TCTTGGAACGTGTTATTTGT","561307.5.peg.795","2238"
"32906",805,1317,512,"AATTGTATTAGCAGTTACTG","TCTTGGAACGTGTTATTTGT","561307.5.peg.795","2238"
"32907",2208,1317,891,"GTACTTGTACCAATGTTTGT","TCTTGGAACGTGTTATTTGT","561307.5.peg.795","2238"
"32908",565,1317,752,"CTTGATGTAGTATTCTTTG","TCTTGGAACGTGTTATTTGT","561307.5.peg.795","2238"
"32909",2456,1317,1139,"ATGCACTCACAGAATCAGAT","TCTTGGAACGTGTTATTTGT","561307.5.peg.795","2238"
"32910",1062,1317,255,"CCTGTTTCACCTAATACACC","TCTTGGAACGTGTTATTTGT","561307.5.peg.795","2238"
"32911",1468,1317,151,"ATTTGTCGCGCCACCTGTTG","TCTTGGAACGTGTTATTTGT","561307.5.peg.795","2238"
"32912",2160,1317,843,"CTATCAAATGTTAGTCCGGA","TCTTGGAACGTGTTATTTGT","561307.5.peg.795","2238"
"32913",1985,1317,668,"TCGTCGATTTGTTATTTGCT","TCTTGGAACGTGTTATTTGT","561307.5.peg.795","2238"
"32914",1675,1317,358,"TGACGCATATGAACTATCGA","TCTTGGAACGTGTTATTTGT","561307.5.peg.795","2238"
"32915",690,1317,627,"TTGTTTAAGTTGACCGAAGA","TCTTGGAACGTGTTATTTGT","561307.5.peg.795","2238"
"32916",1830,1317,513,"TCCGTTGTAGTCAATACAAT","TCTTGGAACGTGTTATTTGT","561307.5.peg.795","2238"
"32917",2055,1317,738,"TCTGATGATTGATCTCCTAT","TCTTGGAACGTGTTATTTGT","561307.5.peg.795","2238"
"32918",2164,1317,847,"TGTACTATCAAATGTTAGTC","TCTTGGAACGTGTTATTTGT","561307.5.peg.795","2238"
"32919",3343,1468,1875,"CGTTGATATGCTCATTGAAT","ATTTGTCGCGCCACCTGTTG","561307.5.peg.795","2238"
"32920",690,1468,778,"TTGTTTAAGTTGACCGAAGA","ATTTGTCGCGCCACCTGTTG","561307.5.peg.795","2238"
"32921",1985,1468,517,"TCGTCGATTTGTTATTTGCT","ATTTGTCGCGCCACCTGTTG","561307.5.peg.795","2238"
"32922",2055,1468,587,"TCTGATGATTGATCTCCTAT","ATTTGTCGCGCCACCTGTTG","561307.5.peg.795","2238"
"32923",895,1468,573,"CTGTGTTAACGTCACAATAC","ATTTGTCGCGCCACCTGTTG","561307.5.peg.795","2238"
"32924",2208,1468,740,"GTACTTGTACCAATGTTTGT","ATTTGTCGCGCCACCTGTTG","561307.5.peg.795","2238"
"32925",2875,1468,1407,"TGTTGACGCACTTTGAGAGT","ATTTGTCGCGCCACCTGTTG","561307.5.peg.795","2238"
"32926",1675,1468,207,"TGACGCATATGAACTATCGA","ATTTGTCGCGCCACCTGTTG","561307.5.peg.795","2238"
"32927",2164,1468,696,"TGTACTATCAAATGTTAGTC","ATTTGTCGCGCCACCTGTTG","561307.5.peg.795","2238"
"32928",805,1468,663,"AATTGTATTAGCAGTTACTG","ATTTGTCGCGCCACCTGTTG","561307.5.peg.795","2238"
"32929",565,1468,903,"CTTGATGTAGTATTCTTTG","ATTTGTCGCGCCACCTGTTG","561307.5.peg.795","2238"
"32930",2842,1468,1374,"TGAAATACTGATAGAGTCCG","ATTTGTCGCGCCACCTGTTG","561307.5.peg.795","2238"
"32931",880,1468,588,"AATACCGGTACTTTGATCAT","ATTTGTCGCGCCACCTGTTG","561307.5.peg.795","2238"
"32932",3139,1468,1671,"CGTGCTCATTGAACTACTTA","ATTTGTCGCGCCACCTGTTG","561307.5.peg.795","2238"
"32933",2434,1468,966,"GCTTACACTTGTCGATTTCG","ATTTGTCGCGCCACCTGTTG","561307.5.peg.795","2238"
"32934",1830,1468,362,"TCCGTTGTAGTCAATACAAT","ATTTGTCGCGCCACCTGTTG","561307.5.peg.795","2238"
"32935",1893,1468,425,"CTATCGTAACTTAATCCGCT","ATTTGTCGCGCCACCTGTTG","561307.5.peg.795","2238"
"32936",2456,1468,988,"ATGCACTCACAGAATCAGAT","ATTTGTCGCGCCACCTGTTG","561307.5.peg.795","2238"
"32937",1317,1468,151,"TCTTGGAACGTGTTATTTGT","ATTTGTCGCGCCACCTGTTG","561307.5.peg.795","2238"
"32938",1062,1468,406,"CCTGTTTCACCTAATACACC","ATTTGTCGCGCCACCTGTTG","561307.5.peg.795","2238"
"32939",2160,1468,692,"CTATCAAATGTTAGTCCGGA","ATTTGTCGCGCCACCTGTTG","561307.5.peg.795","2238"
"32940",1167,1468,301,"TTCGCCTTTGCAGCTGAATT","ATTTGTCGCGCCACCTGTTG","561307.5.peg.795","2238"
"32941",1468,1675,207,"ATTTGTCGCGCCACCTGTTG","TGACGCATATGAACTATCGA","561307.5.peg.795","2238"
"32942",2434,1675,759,"GCTTACACTTGTCGATTTCG","TGACGCATATGAACTATCGA","561307.5.peg.795","2238"
"32943",2842,1675,1167,"TGAAATACTGATAGAGTCCG","TGACGCATATGAACTATCGA","561307.5.peg.795","2238"
"32944",1317,1675,358,"TCTTGGAACGTGTTATTTGT","TGACGCATATGAACTATCGA","561307.5.peg.795","2238"
"32945",3139,1675,1464,"CGTGCTCATTGAACTACTTA","TGACGCATATGAACTATCGA","561307.5.peg.795","2238"
"32946",1167,1675,508,"TTCGCCTTTGCAGCTGAATT","TGACGCATATGAACTATCGA","561307.5.peg.795","2238"
"32947",2160,1675,485,"CTATCAAATGTTAGTCCGGA","TGACGCATATGAACTATCGA","561307.5.peg.795","2238"
"32948",1062,1675,613,"CCTGTTTCACCTAATACACC","TGACGCATATGAACTATCGA","561307.5.peg.795","2238"
"32949",2456,1675,781,"ATGCACTCACAGAATCAGAT","TGACGCATATGAACTATCGA","561307.5.peg.795","2238"
"32950",3343,1675,1668,"CGTTGATATGCTCATTGAAT","TGACGCATATGAACTATCGA","561307.5.peg.795","2238"
"32951",880,1675,795,"AATACCGGTACTTTGATCAT","TGACGCATATGAACTATCGA","561307.5.peg.795","2238"
"32952",805,1675,870,"AATTGTATTAGCAGTTACTG","TGACGCATATGAACTATCGA","561307.5.peg.795","2238"
"32953",2055,1675,380,"TCTGATGATTGATCTCCTAT","TGACGCATATGAACTATCGA","561307.5.peg.795","2238"
"32954",2208,1675,533,"GTACTTGTACCAATGTTTGT","TGACGCATATGAACTATCGA","561307.5.peg.795","2238"
"32955",1830,1675,155,"TCCGTTGTAGTCAATACAAT","TGACGCATATGAACTATCGA","561307.5.peg.795","2238"
"32956",1893,1675,218,"CTATCGTAACTTAATCCGCT","TGACGCATATGAACTATCGA","561307.5.peg.795","2238"
"32957",895,1675,780,"CTGTGTTAACGTCACAATAC","TGACGCATATGAACTATCGA","561307.5.peg.795","2238"
"32958",2164,1675,489,"TGTACTATCAAATGTTAGTC","TGACGCATATGAACTATCGA","561307.5.peg.795","2238"
"32959",1985,1675,310,"TCGTCGATTTGTTATTTGCT","TGACGCATATGAACTATCGA","561307.5.peg.795","2238"
"32960",565,1675,1110,"CTTGATGTAGTATTCTTTG","TGACGCATATGAACTATCGA","561307.5.peg.795","2238"
"32961",690,1675,985,"TTGTTTAAGTTGACCGAAGA","TGACGCATATGAACTATCGA","561307.5.peg.795","2238"
"32962",2875,1675,1200,"TGTTGACGCACTTTGAGAGT","TGACGCATATGAACTATCGA","561307.5.peg.795","2238"
"32963",565,1830,1265,"CTTGATGTAGTATTCTTTG","TCCGTTGTAGTCAATACAAT","561307.5.peg.795","2238"
"32964",805,1830,1025,"AATTGTATTAGCAGTTACTG","TCCGTTGTAGTCAATACAAT","561307.5.peg.795","2238"
"32965",690,1830,1140,"TTGTTTAAGTTGACCGAAGA","TCCGTTGTAGTCAATACAAT","561307.5.peg.795","2238"
"32966",880,1830,950,"AATACCGGTACTTTGATCAT","TCCGTTGTAGTCAATACAAT","561307.5.peg.795","2238"
"32967",1985,1830,155,"TCGTCGATTTGTTATTTGCT","TCCGTTGTAGTCAATACAAT","561307.5.peg.795","2238"
"32968",1167,1830,663,"TTCGCCTTTGCAGCTGAATT","TCCGTTGTAGTCAATACAAT","561307.5.peg.795","2238"
"32969",1317,1830,513,"TCTTGGAACGTGTTATTTGT","TCCGTTGTAGTCAATACAAT","561307.5.peg.795","2238"
"32970",2456,1830,626,"ATGCACTCACAGAATCAGAT","TCCGTTGTAGTCAATACAAT","561307.5.peg.795","2238"
"32971",1062,1830,768,"CCTGTTTCACCTAATACACC","TCCGTTGTAGTCAATACAAT","561307.5.peg.795","2238"
"32972",1468,1830,362,"ATTTGTCGCGCCACCTGTTG","TCCGTTGTAGTCAATACAAT","561307.5.peg.795","2238"
"32973",2160,1830,330,"CTATCAAATGTTAGTCCGGA","TCCGTTGTAGTCAATACAAT","561307.5.peg.795","2238"
"32974",2875,1830,1045,"TGTTGACGCACTTTGAGAGT","TCCGTTGTAGTCAATACAAT","561307.5.peg.795","2238"
"32975",1675,1830,155,"TGACGCATATGAACTATCGA","TCCGTTGTAGTCAATACAAT","561307.5.peg.795","2238"
"32976",2055,1830,225,"TCTGATGATTGATCTCCTAT","TCCGTTGTAGTCAATACAAT","561307.5.peg.795","2238"
"32977",2164,1830,334,"TGTACTATCAAATGTTAGTC","TCCGTTGTAGTCAATACAAT","561307.5.peg.795","2238"
"32978",2842,1830,1012,"TGAAATACTGATAGAGTCCG","TCCGTTGTAGTCAATACAAT","561307.5.peg.795","2238"
"32979",2434,1830,604,"GCTTACACTTGTCGATTTCG","TCCGTTGTAGTCAATACAAT","561307.5.peg.795","2238"
"32980",3139,1830,1309,"CGTGCTCATTGAACTACTTA","TCCGTTGTAGTCAATACAAT","561307.5.peg.795","2238"
"32981",3343,1830,1513,"CGTTGATATGCTCATTGAAT","TCCGTTGTAGTCAATACAAT","561307.5.peg.795","2238"
"32982",895,1830,935,"CTGTGTTAACGTCACAATAC","TCCGTTGTAGTCAATACAAT","561307.5.peg.795","2238"
"32983",2208,1830,378,"GTACTTGTACCAATGTTTGT","TCCGTTGTAGTCAATACAAT","561307.5.peg.795","2238"
"32984",805,1893,1088,"AATTGTATTAGCAGTTACTG","CTATCGTAACTTAATCCGCT","561307.5.peg.795","2238"
"32985",3343,1893,1450,"CGTTGATATGCTCATTGAAT","CTATCGTAACTTAATCCGCT","561307.5.peg.795","2238"
"32986",2456,1893,563,"ATGCACTCACAGAATCAGAT","CTATCGTAACTTAATCCGCT","561307.5.peg.795","2238"
"32987",2875,1893,982,"TGTTGACGCACTTTGAGAGT","CTATCGTAACTTAATCCGCT","561307.5.peg.795","2238"
"32988",2208,1893,315,"GTACTTGTACCAATGTTTGT","CTATCGTAACTTAATCCGCT","561307.5.peg.795","2238"
"32989",1167,1893,726,"TTCGCCTTTGCAGCTGAATT","CTATCGTAACTTAATCCGCT","561307.5.peg.795","2238"
"32990",2434,1893,541,"GCTTACACTTGTCGATTTCG","CTATCGTAACTTAATCCGCT","561307.5.peg.795","2238"
"32991",1062,1893,831,"CCTGTTTCACCTAATACACC","CTATCGTAACTTAATCCGCT","561307.5.peg.795","2238"
"32992",1675,1893,218,"TGACGCATATGAACTATCGA","CTATCGTAACTTAATCCGCT","561307.5.peg.795","2238"
"32993",895,1893,998,"CTGTGTTAACGTCACAATAC","CTATCGTAACTTAATCCGCT","561307.5.peg.795","2238"
"32994",565,1893,1328,"CTTGATGTAGTATTCTTTG","CTATCGTAACTTAATCCGCT","561307.5.peg.795","2238"
"32995",1317,1893,576,"TCTTGGAACGTGTTATTTGT","CTATCGTAACTTAATCCGCT","561307.5.peg.795","2238"
"32996",690,1893,1203,"TTGTTTAAGTTGACCGAAGA","CTATCGTAACTTAATCCGCT","561307.5.peg.795","2238"
"32997",2842,1893,949,"TGAAATACTGATAGAGTCCG","CTATCGTAACTTAATCCGCT","561307.5.peg.795","2238"
"32998",880,1893,1013,"AATACCGGTACTTTGATCAT","CTATCGTAACTTAATCCGCT","561307.5.peg.795","2238"
"32999",2160,1893,267,"CTATCAAATGTTAGTCCGGA","CTATCGTAACTTAATCCGCT","561307.5.peg.795","2238"
"33000",1468,1893,425,"ATTTGTCGCGCCACCTGTTG","CTATCGTAACTTAATCCGCT","561307.5.peg.795","2238"
"33001",2055,1893,162,"TCTGATGATTGATCTCCTAT","CTATCGTAACTTAATCCGCT","561307.5.peg.795","2238"
"33002",2164,1893,271,"TGTACTATCAAATGTTAGTC","CTATCGTAACTTAATCCGCT","561307.5.peg.795","2238"
"33003",3139,1893,1246,"CGTGCTCATTGAACTACTTA","CTATCGTAACTTAATCCGCT","561307.5.peg.795","2238"
"33004",1468,1985,517,"ATTTGTCGCGCCACCTGTTG","TCGTCGATTTGTTATTTGCT","561307.5.peg.795","2238"
"33005",2875,1985,890,"TGTTGACGCACTTTGAGAGT","TCGTCGATTTGTTATTTGCT","561307.5.peg.795","2238"
"33006",565,1985,1420,"CTTGATGTAGTATTCTTTG","TCGTCGATTTGTTATTTGCT","561307.5.peg.795","2238"
"33007",2160,1985,175,"CTATCAAATGTTAGTCCGGA","TCGTCGATTTGTTATTTGCT","561307.5.peg.795","2238"
"33008",2208,1985,223,"GTACTTGTACCAATGTTTGT","TCGTCGATTTGTTATTTGCT","561307.5.peg.795","2238"
"33009",1167,1985,818,"TTCGCCTTTGCAGCTGAATT","TCGTCGATTTGTTATTTGCT","561307.5.peg.795","2238"
"33010",3139,1985,1154,"CGTGCTCATTGAACTACTTA","TCGTCGATTTGTTATTTGCT","561307.5.peg.795","2238"
"33011",2164,1985,179,"TGTACTATCAAATGTTAGTC","TCGTCGATTTGTTATTTGCT","561307.5.peg.795","2238"
"33012",1675,1985,310,"TGACGCATATGAACTATCGA","TCGTCGATTTGTTATTTGCT","561307.5.peg.795","2238"
"33013",3343,1985,1358,"CGTTGATATGCTCATTGAAT","TCGTCGATTTGTTATTTGCT","561307.5.peg.795","2238"
"33014",2842,1985,857,"TGAAATACTGATAGAGTCCG","TCGTCGATTTGTTATTTGCT","561307.5.peg.795","2238"
"33015",690,1985,1295,"TTGTTTAAGTTGACCGAAGA","TCGTCGATTTGTTATTTGCT","561307.5.peg.795","2238"
"33016",2434,1985,449,"GCTTACACTTGTCGATTTCG","TCGTCGATTTGTTATTTGCT","561307.5.peg.795","2238"
"33017",1317,1985,668,"TCTTGGAACGTGTTATTTGT","TCGTCGATTTGTTATTTGCT","561307.5.peg.795","2238"
"33018",1830,1985,155,"TCCGTTGTAGTCAATACAAT","TCGTCGATTTGTTATTTGCT","561307.5.peg.795","2238"
"33019",2456,1985,471,"ATGCACTCACAGAATCAGAT","TCGTCGATTTGTTATTTGCT","561307.5.peg.795","2238"
"33020",895,1985,1090,"CTGTGTTAACGTCACAATAC","TCGTCGATTTGTTATTTGCT","561307.5.peg.795","2238"
"33021",880,1985,1105,"AATACCGGTACTTTGATCAT","TCGTCGATTTGTTATTTGCT","561307.5.peg.795","2238"
"33022",1062,1985,923,"CCTGTTTCACCTAATACACC","TCGTCGATTTGTTATTTGCT","561307.5.peg.795","2238"
"33023",805,1985,1180,"AATTGTATTAGCAGTTACTG","TCGTCGATTTGTTATTTGCT","561307.5.peg.795","2238"
"33024",2456,2055,401,"ATGCACTCACAGAATCAGAT","TCTGATGATTGATCTCCTAT","561307.5.peg.795","2238"
"33025",805,2055,1250,"AATTGTATTAGCAGTTACTG","TCTGATGATTGATCTCCTAT","561307.5.peg.795","2238"
"33026",2164,2055,109,"TGTACTATCAAATGTTAGTC","TCTGATGATTGATCTCCTAT","561307.5.peg.795","2238"
"33027",2875,2055,820,"TGTTGACGCACTTTGAGAGT","TCTGATGATTGATCTCCTAT","561307.5.peg.795","2238"
"33028",1675,2055,380,"TGACGCATATGAACTATCGA","TCTGATGATTGATCTCCTAT","561307.5.peg.795","2238"
"33029",690,2055,1365,"TTGTTTAAGTTGACCGAAGA","TCTGATGATTGATCTCCTAT","561307.5.peg.795","2238"
"33030",1468,2055,587,"ATTTGTCGCGCCACCTGTTG","TCTGATGATTGATCTCCTAT","561307.5.peg.795","2238"
"33031",1893,2055,162,"CTATCGTAACTTAATCCGCT","TCTGATGATTGATCTCCTAT","561307.5.peg.795","2238"
"33032",880,2055,1175,"AATACCGGTACTTTGATCAT","TCTGATGATTGATCTCCTAT","561307.5.peg.795","2238"
"33033",2434,2055,379,"GCTTACACTTGTCGATTTCG","TCTGATGATTGATCTCCTAT","561307.5.peg.795","2238"
"33034",2208,2055,153,"GTACTTGTACCAATGTTTGT","TCTGATGATTGATCTCCTAT","561307.5.peg.795","2238"
"33035",895,2055,1160,"CTGTGTTAACGTCACAATAC","TCTGATGATTGATCTCCTAT","561307.5.peg.795","2238"
"33036",2160,2055,105,"CTATCAAATGTTAGTCCGGA","TCTGATGATTGATCTCCTAT","561307.5.peg.795","2238"
"33037",3139,2055,1084,"CGTGCTCATTGAACTACTTA","TCTGATGATTGATCTCCTAT","561307.5.peg.795","2238"
"33038",1062,2055,993,"CCTGTTTCACCTAATACACC","TCTGATGATTGATCTCCTAT","561307.5.peg.795","2238"
"33039",1830,2055,225,"TCCGTTGTAGTCAATACAAT","TCTGATGATTGATCTCCTAT","561307.5.peg.795","2238"
"33040",565,2055,1490,"CTTGATGTAGTATTCTTTG","TCTGATGATTGATCTCCTAT","561307.5.peg.795","2238"
"33041",1317,2055,738,"TCTTGGAACGTGTTATTTGT","TCTGATGATTGATCTCCTAT","561307.5.peg.795","2238"
"33042",3343,2055,1288,"CGTTGATATGCTCATTGAAT","TCTGATGATTGATCTCCTAT","561307.5.peg.795","2238"
"33043",2842,2055,787,"TGAAATACTGATAGAGTCCG","TCTGATGATTGATCTCCTAT","561307.5.peg.795","2238"
"33044",1167,2055,888,"TTCGCCTTTGCAGCTGAATT","TCTGATGATTGATCTCCTAT","561307.5.peg.795","2238"
"33045",880,2160,1280,"AATACCGGTACTTTGATCAT","CTATCAAATGTTAGTCCGGA","561307.5.peg.795","2238"
"33046",2456,2160,296,"ATGCACTCACAGAATCAGAT","CTATCAAATGTTAGTCCGGA","561307.5.peg.795","2238"
"33047",805,2160,1355,"AATTGTATTAGCAGTTACTG","CTATCAAATGTTAGTCCGGA","561307.5.peg.795","2238"
"33048",2055,2160,105,"TCTGATGATTGATCTCCTAT","CTATCAAATGTTAGTCCGGA","561307.5.peg.795","2238"
"33049",1985,2160,175,"TCGTCGATTTGTTATTTGCT","CTATCAAATGTTAGTCCGGA","561307.5.peg.795","2238"
"33050",3139,2160,979,"CGTGCTCATTGAACTACTTA","CTATCAAATGTTAGTCCGGA","561307.5.peg.795","2238"
"33051",1830,2160,330,"TCCGTTGTAGTCAATACAAT","CTATCAAATGTTAGTCCGGA","561307.5.peg.795","2238"
"33052",565,2160,1595,"CTTGATGTAGTATTCTTTG","CTATCAAATGTTAGTCCGGA","561307.5.peg.795","2238"
"33053",1167,2160,993,"TTCGCCTTTGCAGCTGAATT","CTATCAAATGTTAGTCCGGA","561307.5.peg.795","2238"
"33054",1468,2160,692,"ATTTGTCGCGCCACCTGTTG","CTATCAAATGTTAGTCCGGA","561307.5.peg.795","2238"
"33055",895,2160,1265,"CTGTGTTAACGTCACAATAC","CTATCAAATGTTAGTCCGGA","561307.5.peg.795","2238"
"33056",1062,2160,1098,"CCTGTTTCACCTAATACACC","CTATCAAATGTTAGTCCGGA","561307.5.peg.795","2238"
"33057",1893,2160,267,"CTATCGTAACTTAATCCGCT","CTATCAAATGTTAGTCCGGA","561307.5.peg.795","2238"
"33058",3343,2160,1183,"CGTTGATATGCTCATTGAAT","CTATCAAATGTTAGTCCGGA","561307.5.peg.795","2238"
"33059",2434,2160,274,"GCTTACACTTGTCGATTTCG","CTATCAAATGTTAGTCCGGA","561307.5.peg.795","2238"
"33060",2875,2160,715,"TGTTGACGCACTTTGAGAGT","CTATCAAATGTTAGTCCGGA","561307.5.peg.795","2238"
"33061",2842,2160,682,"TGAAATACTGATAGAGTCCG","CTATCAAATGTTAGTCCGGA","561307.5.peg.795","2238"
"33062",690,2160,1470,"TTGTTTAAGTTGACCGAAGA","CTATCAAATGTTAGTCCGGA","561307.5.peg.795","2238"
"33063",1317,2160,843,"TCTTGGAACGTGTTATTTGT","CTATCAAATGTTAGTCCGGA","561307.5.peg.795","2238"
"33064",1675,2160,485,"TGACGCATATGAACTATCGA","CTATCAAATGTTAGTCCGGA","561307.5.peg.795","2238"
"33065",565,2164,1599,"CTTGATGTAGTATTCTTTG","TGTACTATCAAATGTTAGTC","561307.5.peg.795","2238"
"33066",2842,2164,678,"TGAAATACTGATAGAGTCCG","TGTACTATCAAATGTTAGTC","561307.5.peg.795","2238"
"33067",1317,2164,847,"TCTTGGAACGTGTTATTTGT","TGTACTATCAAATGTTAGTC","561307.5.peg.795","2238"
"33068",1893,2164,271,"CTATCGTAACTTAATCCGCT","TGTACTATCAAATGTTAGTC","561307.5.peg.795","2238"
"33069",1830,2164,334,"TCCGTTGTAGTCAATACAAT","TGTACTATCAAATGTTAGTC","561307.5.peg.795","2238"
"33070",805,2164,1359,"AATTGTATTAGCAGTTACTG","TGTACTATCAAATGTTAGTC","561307.5.peg.795","2238"
"33071",690,2164,1474,"TTGTTTAAGTTGACCGAAGA","TGTACTATCAAATGTTAGTC","561307.5.peg.795","2238"
"33072",880,2164,1284,"AATACCGGTACTTTGATCAT","TGTACTATCAAATGTTAGTC","561307.5.peg.795","2238"
"33073",895,2164,1269,"CTGTGTTAACGTCACAATAC","TGTACTATCAAATGTTAGTC","561307.5.peg.795","2238"
"33074",1985,2164,179,"TCGTCGATTTGTTATTTGCT","TGTACTATCAAATGTTAGTC","561307.5.peg.795","2238"
"33075",1468,2164,696,"ATTTGTCGCGCCACCTGTTG","TGTACTATCAAATGTTAGTC","561307.5.peg.795","2238"
"33076",2055,2164,109,"TCTGATGATTGATCTCCTAT","TGTACTATCAAATGTTAGTC","561307.5.peg.795","2238"
"33077",1062,2164,1102,"CCTGTTTCACCTAATACACC","TGTACTATCAAATGTTAGTC","561307.5.peg.795","2238"
"33078",1167,2164,997,"TTCGCCTTTGCAGCTGAATT","TGTACTATCAAATGTTAGTC","561307.5.peg.795","2238"
"33079",2875,2164,711,"TGTTGACGCACTTTGAGAGT","TGTACTATCAAATGTTAGTC","561307.5.peg.795","2238"
"33080",3343,2164,1179,"CGTTGATATGCTCATTGAAT","TGTACTATCAAATGTTAGTC","561307.5.peg.795","2238"
"33081",2434,2164,270,"GCTTACACTTGTCGATTTCG","TGTACTATCAAATGTTAGTC","561307.5.peg.795","2238"
"33082",2456,2164,292,"ATGCACTCACAGAATCAGAT","TGTACTATCAAATGTTAGTC","561307.5.peg.795","2238"
"33083",1675,2164,489,"TGACGCATATGAACTATCGA","TGTACTATCAAATGTTAGTC","561307.5.peg.795","2238"
"33084",3139,2164,975,"CGTGCTCATTGAACTACTTA","TGTACTATCAAATGTTAGTC","561307.5.peg.795","2238"
"33085",1062,2208,1146,"CCTGTTTCACCTAATACACC","GTACTTGTACCAATGTTTGT","561307.5.peg.795","2238"
"33086",1167,2208,1041,"TTCGCCTTTGCAGCTGAATT","GTACTTGTACCAATGTTTGT","561307.5.peg.795","2238"
"33087",3139,2208,931,"CGTGCTCATTGAACTACTTA","GTACTTGTACCAATGTTTGT","561307.5.peg.795","2238"
"33088",565,2208,1643,"CTTGATGTAGTATTCTTTG","GTACTTGTACCAATGTTTGT","561307.5.peg.795","2238"
"33089",1675,2208,533,"TGACGCATATGAACTATCGA","GTACTTGTACCAATGTTTGT","561307.5.peg.795","2238"
"33090",2456,2208,248,"ATGCACTCACAGAATCAGAT","GTACTTGTACCAATGTTTGT","561307.5.peg.795","2238"
"33091",805,2208,1403,"AATTGTATTAGCAGTTACTG","GTACTTGTACCAATGTTTGT","561307.5.peg.795","2238"
"33092",2055,2208,153,"TCTGATGATTGATCTCCTAT","GTACTTGTACCAATGTTTGT","561307.5.peg.795","2238"
"33093",1985,2208,223,"TCGTCGATTTGTTATTTGCT","GTACTTGTACCAATGTTTGT","561307.5.peg.795","2238"
"33094",895,2208,1313,"CTGTGTTAACGTCACAATAC","GTACTTGTACCAATGTTTGT","561307.5.peg.795","2238"
"33095",1317,2208,891,"TCTTGGAACGTGTTATTTGT","GTACTTGTACCAATGTTTGT","561307.5.peg.795","2238"
"33096",2875,2208,667,"TGTTGACGCACTTTGAGAGT","GTACTTGTACCAATGTTTGT","561307.5.peg.795","2238"
"33097",1830,2208,378,"TCCGTTGTAGTCAATACAAT","GTACTTGTACCAATGTTTGT","561307.5.peg.795","2238"
"33098",2434,2208,226,"GCTTACACTTGTCGATTTCG","GTACTTGTACCAATGTTTGT","561307.5.peg.795","2238"
"33099",1893,2208,315,"CTATCGTAACTTAATCCGCT","GTACTTGTACCAATGTTTGT","561307.5.peg.795","2238"
"33100",1468,2208,740,"ATTTGTCGCGCCACCTGTTG","GTACTTGTACCAATGTTTGT","561307.5.peg.795","2238"
"33101",2842,2208,634,"TGAAATACTGATAGAGTCCG","GTACTTGTACCAATGTTTGT","561307.5.peg.795","2238"
"33102",690,2208,1518,"TTGTTTAAGTTGACCGAAGA","GTACTTGTACCAATGTTTGT","561307.5.peg.795","2238"
"33103",880,2208,1328,"AATACCGGTACTTTGATCAT","GTACTTGTACCAATGTTTGT","561307.5.peg.795","2238"
"33104",3343,2208,1135,"CGTTGATATGCTCATTGAAT","GTACTTGTACCAATGTTTGT","561307.5.peg.795","2238"
"33105",2875,2434,441,"TGTTGACGCACTTTGAGAGT","GCTTACACTTGTCGATTTCG","561307.5.peg.795","2238"
"33106",2208,2434,226,"GTACTTGTACCAATGTTTGT","GCTTACACTTGTCGATTTCG","561307.5.peg.795","2238"
"33107",1317,2434,1117,"TCTTGGAACGTGTTATTTGT","GCTTACACTTGTCGATTTCG","561307.5.peg.795","2238"
"33108",2842,2434,408,"TGAAATACTGATAGAGTCCG","GCTTACACTTGTCGATTTCG","561307.5.peg.795","2238"
"33109",2164,2434,270,"TGTACTATCAAATGTTAGTC","GCTTACACTTGTCGATTTCG","561307.5.peg.795","2238"
"33110",2055,2434,379,"TCTGATGATTGATCTCCTAT","GCTTACACTTGTCGATTTCG","561307.5.peg.795","2238"
"33111",1062,2434,1372,"CCTGTTTCACCTAATACACC","GCTTACACTTGTCGATTTCG","561307.5.peg.795","2238"
"33112",1893,2434,541,"CTATCGTAACTTAATCCGCT","GCTTACACTTGTCGATTTCG","561307.5.peg.795","2238"
"33113",1985,2434,449,"TCGTCGATTTGTTATTTGCT","GCTTACACTTGTCGATTTCG","561307.5.peg.795","2238"
"33114",690,2434,1744,"TTGTTTAAGTTGACCGAAGA","GCTTACACTTGTCGATTTCG","561307.5.peg.795","2238"
"33115",1830,2434,604,"TCCGTTGTAGTCAATACAAT","GCTTACACTTGTCGATTTCG","561307.5.peg.795","2238"
"33116",1675,2434,759,"TGACGCATATGAACTATCGA","GCTTACACTTGTCGATTTCG","561307.5.peg.795","2238"
"33117",3343,2434,909,"CGTTGATATGCTCATTGAAT","GCTTACACTTGTCGATTTCG","561307.5.peg.795","2238"
"33118",565,2434,1869,"CTTGATGTAGTATTCTTTG","GCTTACACTTGTCGATTTCG","561307.5.peg.795","2238"
"33119",1167,2434,1267,"TTCGCCTTTGCAGCTGAATT","GCTTACACTTGTCGATTTCG","561307.5.peg.795","2238"
"33120",2160,2434,274,"CTATCAAATGTTAGTCCGGA","GCTTACACTTGTCGATTTCG","561307.5.peg.795","2238"
"33121",880,2434,1554,"AATACCGGTACTTTGATCAT","GCTTACACTTGTCGATTTCG","561307.5.peg.795","2238"
"33122",895,2434,1539,"CTGTGTTAACGTCACAATAC","GCTTACACTTGTCGATTTCG","561307.5.peg.795","2238"
"33123",1468,2434,966,"ATTTGTCGCGCCACCTGTTG","GCTTACACTTGTCGATTTCG","561307.5.peg.795","2238"
"33124",3139,2434,705,"CGTGCTCATTGAACTACTTA","GCTTACACTTGTCGATTTCG","561307.5.peg.795","2238"
"33125",805,2434,1629,"AATTGTATTAGCAGTTACTG","GCTTACACTTGTCGATTTCG","561307.5.peg.795","2238"
"33126",2842,2456,386,"TGAAATACTGATAGAGTCCG","ATGCACTCACAGAATCAGAT","561307.5.peg.795","2238"
"33127",1830,2456,626,"TCCGTTGTAGTCAATACAAT","ATGCACTCACAGAATCAGAT","561307.5.peg.795","2238"
"33128",1062,2456,1394,"CCTGTTTCACCTAATACACC","ATGCACTCACAGAATCAGAT","561307.5.peg.795","2238"
"33129",1468,2456,988,"ATTTGTCGCGCCACCTGTTG","ATGCACTCACAGAATCAGAT","561307.5.peg.795","2238"
"33130",1985,2456,471,"TCGTCGATTTGTTATTTGCT","ATGCACTCACAGAATCAGAT","561307.5.peg.795","2238"
"33131",1317,2456,1139,"TCTTGGAACGTGTTATTTGT","ATGCACTCACAGAATCAGAT","561307.5.peg.795","2238"
"33132",565,2456,1891,"CTTGATGTAGTATTCTTTG","ATGCACTCACAGAATCAGAT","561307.5.peg.795","2238"
"33133",1167,2456,1289,"TTCGCCTTTGCAGCTGAATT","ATGCACTCACAGAATCAGAT","561307.5.peg.795","2238"
"33134",805,2456,1651,"AATTGTATTAGCAGTTACTG","ATGCACTCACAGAATCAGAT","561307.5.peg.795","2238"
"33135",895,2456,1561,"CTGTGTTAACGTCACAATAC","ATGCACTCACAGAATCAGAT","561307.5.peg.795","2238"
"33136",1675,2456,781,"TGACGCATATGAACTATCGA","ATGCACTCACAGAATCAGAT","561307.5.peg.795","2238"
"33137",3139,2456,683,"CGTGCTCATTGAACTACTTA","ATGCACTCACAGAATCAGAT","561307.5.peg.795","2238"
"33138",2160,2456,296,"CTATCAAATGTTAGTCCGGA","ATGCACTCACAGAATCAGAT","561307.5.peg.795","2238"
"33139",2208,2456,248,"GTACTTGTACCAATGTTTGT","ATGCACTCACAGAATCAGAT","561307.5.peg.795","2238"
"33140",690,2456,1766,"TTGTTTAAGTTGACCGAAGA","ATGCACTCACAGAATCAGAT","561307.5.peg.795","2238"
"33141",3343,2456,887,"CGTTGATATGCTCATTGAAT","ATGCACTCACAGAATCAGAT","561307.5.peg.795","2238"
"33142",2055,2456,401,"TCTGATGATTGATCTCCTAT","ATGCACTCACAGAATCAGAT","561307.5.peg.795","2238"
"33143",1893,2456,563,"CTATCGTAACTTAATCCGCT","ATGCACTCACAGAATCAGAT","561307.5.peg.795","2238"
"33144",880,2456,1576,"AATACCGGTACTTTGATCAT","ATGCACTCACAGAATCAGAT","561307.5.peg.795","2238"
"33145",2875,2456,419,"TGTTGACGCACTTTGAGAGT","ATGCACTCACAGAATCAGAT","561307.5.peg.795","2238"
"33146",2164,2456,292,"TGTACTATCAAATGTTAGTC","ATGCACTCACAGAATCAGAT","561307.5.peg.795","2238"
"33147",1893,2842,949,"CTATCGTAACTTAATCCGCT","TGAAATACTGATAGAGTCCG","561307.5.peg.795","2238"
"33148",2055,2842,787,"TCTGATGATTGATCTCCTAT","TGAAATACTGATAGAGTCCG","561307.5.peg.795","2238"
"33149",1317,2842,1525,"TCTTGGAACGTGTTATTTGT","TGAAATACTGATAGAGTCCG","561307.5.peg.795","2238"
"33150",1985,2842,857,"TCGTCGATTTGTTATTTGCT","TGAAATACTGATAGAGTCCG","561307.5.peg.795","2238"
"33151",805,2842,2037,"AATTGTATTAGCAGTTACTG","TGAAATACTGATAGAGTCCG","561307.5.peg.795","2238"
"33152",1830,2842,1012,"TCCGTTGTAGTCAATACAAT","TGAAATACTGATAGAGTCCG","561307.5.peg.795","2238"
"33153",895,2842,1947,"CTGTGTTAACGTCACAATAC","TGAAATACTGATAGAGTCCG","561307.5.peg.795","2238"
"33154",1062,2842,1780,"CCTGTTTCACCTAATACACC","TGAAATACTGATAGAGTCCG","561307.5.peg.795","2238"
"33155",2164,2842,678,"TGTACTATCAAATGTTAGTC","TGAAATACTGATAGAGTCCG","561307.5.peg.795","2238"
"33156",565,2842,2277,"CTTGATGTAGTATTCTTTG","TGAAATACTGATAGAGTCCG","561307.5.peg.795","2238"
"33157",690,2842,2152,"TTGTTTAAGTTGACCGAAGA","TGAAATACTGATAGAGTCCG","561307.5.peg.795","2238"
"33158",880,2842,1962,"AATACCGGTACTTTGATCAT","TGAAATACTGATAGAGTCCG","561307.5.peg.795","2238"
"33159",1167,2842,1675,"TTCGCCTTTGCAGCTGAATT","TGAAATACTGATAGAGTCCG","561307.5.peg.795","2238"
"33160",2160,2842,682,"CTATCAAATGTTAGTCCGGA","TGAAATACTGATAGAGTCCG","561307.5.peg.795","2238"
"33161",3139,2842,297,"CGTGCTCATTGAACTACTTA","TGAAATACTGATAGAGTCCG","561307.5.peg.795","2238"
"33162",2434,2842,408,"GCTTACACTTGTCGATTTCG","TGAAATACTGATAGAGTCCG","561307.5.peg.795","2238"
"33163",2456,2842,386,"ATGCACTCACAGAATCAGAT","TGAAATACTGATAGAGTCCG","561307.5.peg.795","2238"
"33164",3343,2842,501,"CGTTGATATGCTCATTGAAT","TGAAATACTGATAGAGTCCG","561307.5.peg.795","2238"
"33165",1468,2842,1374,"ATTTGTCGCGCCACCTGTTG","TGAAATACTGATAGAGTCCG","561307.5.peg.795","2238"
"33166",2208,2842,634,"GTACTTGTACCAATGTTTGT","TGAAATACTGATAGAGTCCG","561307.5.peg.795","2238"
"33167",1675,2842,1167,"TGACGCATATGAACTATCGA","TGAAATACTGATAGAGTCCG","561307.5.peg.795","2238"
"33168",1167,2875,1708,"TTCGCCTTTGCAGCTGAATT","TGTTGACGCACTTTGAGAGT","561307.5.peg.795","2238"
"33169",805,2875,2070,"AATTGTATTAGCAGTTACTG","TGTTGACGCACTTTGAGAGT","561307.5.peg.795","2238"
"33170",895,2875,1980,"CTGTGTTAACGTCACAATAC","TGTTGACGCACTTTGAGAGT","561307.5.peg.795","2238"
"33171",2160,2875,715,"CTATCAAATGTTAGTCCGGA","TGTTGACGCACTTTGAGAGT","561307.5.peg.795","2238"
"33172",1062,2875,1813,"CCTGTTTCACCTAATACACC","TGTTGACGCACTTTGAGAGT","561307.5.peg.795","2238"
"33173",2055,2875,820,"TCTGATGATTGATCTCCTAT","TGTTGACGCACTTTGAGAGT","561307.5.peg.795","2238"
"33174",2208,2875,667,"GTACTTGTACCAATGTTTGT","TGTTGACGCACTTTGAGAGT","561307.5.peg.795","2238"
"33175",3343,2875,468,"CGTTGATATGCTCATTGAAT","TGTTGACGCACTTTGAGAGT","561307.5.peg.795","2238"
"33176",690,2875,2185,"TTGTTTAAGTTGACCGAAGA","TGTTGACGCACTTTGAGAGT","561307.5.peg.795","2238"
"33177",1985,2875,890,"TCGTCGATTTGTTATTTGCT","TGTTGACGCACTTTGAGAGT","561307.5.peg.795","2238"
"33178",880,2875,1995,"AATACCGGTACTTTGATCAT","TGTTGACGCACTTTGAGAGT","561307.5.peg.795","2238"
"33179",2434,2875,441,"GCTTACACTTGTCGATTTCG","TGTTGACGCACTTTGAGAGT","561307.5.peg.795","2238"
"33180",565,2875,2310,"CTTGATGTAGTATTCTTTG","TGTTGACGCACTTTGAGAGT","561307.5.peg.795","2238"
"33181",1468,2875,1407,"ATTTGTCGCGCCACCTGTTG","TGTTGACGCACTTTGAGAGT","561307.5.peg.795","2238"
"33182",1830,2875,1045,"TCCGTTGTAGTCAATACAAT","TGTTGACGCACTTTGAGAGT","561307.5.peg.795","2238"
"33183",1675,2875,1200,"TGACGCATATGAACTATCGA","TGTTGACGCACTTTGAGAGT","561307.5.peg.795","2238"
"33184",2456,2875,419,"ATGCACTCACAGAATCAGAT","TGTTGACGCACTTTGAGAGT","561307.5.peg.795","2238"
"33185",1317,2875,1558,"TCTTGGAACGTGTTATTTGT","TGTTGACGCACTTTGAGAGT","561307.5.peg.795","2238"
"33186",3139,2875,264,"CGTGCTCATTGAACTACTTA","TGTTGACGCACTTTGAGAGT","561307.5.peg.795","2238"
"33187",1893,2875,982,"CTATCGTAACTTAATCCGCT","TGTTGACGCACTTTGAGAGT","561307.5.peg.795","2238"
"33188",2164,2875,711,"TGTACTATCAAATGTTAGTC","TGTTGACGCACTTTGAGAGT","561307.5.peg.795","2238"
"33189",1468,3139,1671,"ATTTGTCGCGCCACCTGTTG","CGTGCTCATTGAACTACTTA","561307.5.peg.795","2238"
"33190",565,3139,2574,"CTTGATGTAGTATTCTTTG","CGTGCTCATTGAACTACTTA","561307.5.peg.795","2238"
"33191",1830,3139,1309,"TCCGTTGTAGTCAATACAAT","CGTGCTCATTGAACTACTTA","561307.5.peg.795","2238"
"33192",2160,3139,979,"CTATCAAATGTTAGTCCGGA","CGTGCTCATTGAACTACTTA","561307.5.peg.795","2238"
"33193",2456,3139,683,"ATGCACTCACAGAATCAGAT","CGTGCTCATTGAACTACTTA","561307.5.peg.795","2238"
"33194",2875,3139,264,"TGTTGACGCACTTTGAGAGT","CGTGCTCATTGAACTACTTA","561307.5.peg.795","2238"
"33195",2055,3139,1084,"TCTGATGATTGATCTCCTAT","CGTGCTCATTGAACTACTTA","561307.5.peg.795","2238"
"33196",1317,3139,1822,"TCTTGGAACGTGTTATTTGT","CGTGCTCATTGAACTACTTA","561307.5.peg.795","2238"
"33197",2434,3139,705,"GCTTACACTTGTCGATTTCG","CGTGCTCATTGAACTACTTA","561307.5.peg.795","2238"
"33198",1062,3139,2077,"CCTGTTTCACCTAATACACC","CGTGCTCATTGAACTACTTA","561307.5.peg.795","2238"
"33199",805,3139,2334,"AATTGTATTAGCAGTTACTG","CGTGCTCATTGAACTACTTA","561307.5.peg.795","2238"
"33200",2164,3139,975,"TGTACTATCAAATGTTAGTC","CGTGCTCATTGAACTACTTA","561307.5.peg.795","2238"
"33201",1985,3139,1154,"TCGTCGATTTGTTATTTGCT","CGTGCTCATTGAACTACTTA","561307.5.peg.795","2238"
"33202",1167,3139,1972,"TTCGCCTTTGCAGCTGAATT","CGTGCTCATTGAACTACTTA","561307.5.peg.795","2238"
"33203",2208,3139,931,"GTACTTGTACCAATGTTTGT","CGTGCTCATTGAACTACTTA","561307.5.peg.795","2238"
"33204",1675,3139,1464,"TGACGCATATGAACTATCGA","CGTGCTCATTGAACTACTTA","561307.5.peg.795","2238"
"33205",880,3139,2259,"AATACCGGTACTTTGATCAT","CGTGCTCATTGAACTACTTA","561307.5.peg.795","2238"
"33206",690,3139,2449,"TTGTTTAAGTTGACCGAAGA","CGTGCTCATTGAACTACTTA","561307.5.peg.795","2238"
"33207",1893,3139,1246,"CTATCGTAACTTAATCCGCT","CGTGCTCATTGAACTACTTA","561307.5.peg.795","2238"
"33208",2842,3139,297,"TGAAATACTGATAGAGTCCG","CGTGCTCATTGAACTACTTA","561307.5.peg.795","2238"
"33209",895,3139,2244,"CTGTGTTAACGTCACAATAC","CGTGCTCATTGAACTACTTA","561307.5.peg.795","2238"
"33210",3343,3139,204,"CGTTGATATGCTCATTGAAT","CGTGCTCATTGAACTACTTA","561307.5.peg.795","2238"
"33211",1985,3343,1358,"TCGTCGATTTGTTATTTGCT","CGTTGATATGCTCATTGAAT","561307.5.peg.795","2238"
"33212",3139,3343,204,"CGTGCTCATTGAACTACTTA","CGTTGATATGCTCATTGAAT","561307.5.peg.795","2238"
"33213",2160,3343,1183,"CTATCAAATGTTAGTCCGGA","CGTTGATATGCTCATTGAAT","561307.5.peg.795","2238"
"33214",895,3343,2448,"CTGTGTTAACGTCACAATAC","CGTTGATATGCTCATTGAAT","561307.5.peg.795","2238"
"33215",1317,3343,2026,"TCTTGGAACGTGTTATTTGT","CGTTGATATGCTCATTGAAT","561307.5.peg.795","2238"
"33216",565,3343,2778,"CTTGATGTAGTATTCTTTG","CGTTGATATGCTCATTGAAT","561307.5.peg.795","2238"
"33217",1167,3343,2176,"TTCGCCTTTGCAGCTGAATT","CGTTGATATGCTCATTGAAT","561307.5.peg.795","2238"
"33218",690,3343,2653,"TTGTTTAAGTTGACCGAAGA","CGTTGATATGCTCATTGAAT","561307.5.peg.795","2238"
"33219",2208,3343,1135,"GTACTTGTACCAATGTTTGT","CGTTGATATGCTCATTGAAT","561307.5.peg.795","2238"
"33220",1675,3343,1668,"TGACGCATATGAACTATCGA","CGTTGATATGCTCATTGAAT","561307.5.peg.795","2238"
"33221",805,3343,2538,"AATTGTATTAGCAGTTACTG","CGTTGATATGCTCATTGAAT","561307.5.peg.795","2238"
"33222",2456,3343,887,"ATGCACTCACAGAATCAGAT","CGTTGATATGCTCATTGAAT","561307.5.peg.795","2238"
"33223",1830,3343,1513,"TCCGTTGTAGTCAATACAAT","CGTTGATATGCTCATTGAAT","561307.5.peg.795","2238"
"33224",1893,3343,1450,"CTATCGTAACTTAATCCGCT","CGTTGATATGCTCATTGAAT","561307.5.peg.795","2238"
"33225",1062,3343,2281,"CCTGTTTCACCTAATACACC","CGTTGATATGCTCATTGAAT","561307.5.peg.795","2238"
"33226",2434,3343,909,"GCTTACACTTGTCGATTTCG","CGTTGATATGCTCATTGAAT","561307.5.peg.795","2238"
"33227",2164,3343,1179,"TGTACTATCAAATGTTAGTC","CGTTGATATGCTCATTGAAT","561307.5.peg.795","2238"
"33228",2055,3343,1288,"TCTGATGATTGATCTCCTAT","CGTTGATATGCTCATTGAAT","561307.5.peg.795","2238"
"33229",2842,3343,501,"TGAAATACTGATAGAGTCCG","CGTTGATATGCTCATTGAAT","561307.5.peg.795","2238"
"33230",1468,3343,1875,"ATTTGTCGCGCCACCTGTTG","CGTTGATATGCTCATTGAAT","561307.5.peg.795","2238"
"33231",880,3343,2463,"AATACCGGTACTTTGATCAT","CGTTGATATGCTCATTGAAT","561307.5.peg.795","2238"
"33232",2875,3343,468,"TGTTGACGCACTTTGAGAGT","CGTTGATATGCTCATTGAAT","561307.5.peg.795","2238"
"33233",264,151,113,"TAATCATTGATGTTAACCA","CATATCGTTATAGGAAACGA","561307.5.peg.796","2239"
"33234",534,151,383,"CTAACCATTACAATCGGCAT","CATATCGTTATAGGAAACGA","561307.5.peg.796","2239"
"33235",151,264,113,"CATATCGTTATAGGAAACGA","TAATCATTGATGTTAACCA","561307.5.peg.796","2239"
"33236",534,264,270,"CTAACCATTACAATCGGCAT","TAATCATTGATGTTAACCA","561307.5.peg.796","2239"
"33237",151,534,383,"CATATCGTTATAGGAAACGA","CTAACCATTACAATCGGCAT","561307.5.peg.796","2239"
"33238",264,534,270,"TAATCATTGATGTTAACCA","CTAACCATTACAATCGGCAT","561307.5.peg.796","2239"
"33239",305,6,299,"AATTAATCGCTTGTGGCGCA","TTAAACCAGTATTGGTAAGG","561307.5.peg.797","2240"
"33240",345,6,339,"TACACAAACTCAACATCATC","TTAAACCAGTATTGGTAAGG","561307.5.peg.797","2240"
"33241",305,28,277,"AATTAATCGCTTGTGGCGCA","AATTACCTCCTTACCAATAC","561307.5.peg.797","2240"
"33242",345,28,317,"TACACAAACTCAACATCATC","AATTACCTCCTTACCAATAC","561307.5.peg.797","2240"
"33243",305,66,239,"AATTAATCGCTTGTGGCGCA","CGTTGGTCATCGTACCAAGC","561307.5.peg.797","2240"
"33244",345,66,279,"TACACAAACTCAACATCATC","CGTTGGTCATCGTACCAAGC","561307.5.peg.797","2240"
"33245",305,83,222,"AATTAATCGCTTGTGGCGCA","TCGTGTCTTGCCACCATCGT","561307.5.peg.797","2240"
"33246",345,83,262,"TACACAAACTCAACATCATC","TCGTGTCTTGCCACCATCGT","561307.5.peg.797","2240"
"33247",6,305,299,"TTAAACCAGTATTGGTAAGG","AATTAATCGCTTGTGGCGCA","561307.5.peg.797","2240"
"33248",28,305,277,"AATTACCTCCTTACCAATAC","AATTAATCGCTTGTGGCGCA","561307.5.peg.797","2240"
"33249",66,305,239,"CGTTGGTCATCGTACCAAGC","AATTAATCGCTTGTGGCGCA","561307.5.peg.797","2240"
"33250",83,305,222,"TCGTGTCTTGCCACCATCGT","AATTAATCGCTTGTGGCGCA","561307.5.peg.797","2240"
"33251",6,345,339,"TTAAACCAGTATTGGTAAGG","TACACAAACTCAACATCATC","561307.5.peg.797","2240"
"33252",28,345,317,"AATTACCTCCTTACCAATAC","TACACAAACTCAACATCATC","561307.5.peg.797","2240"
"33253",66,345,279,"CGTTGGTCATCGTACCAAGC","TACACAAACTCAACATCATC","561307.5.peg.797","2240"
"33254",83,345,262,"TCGTGTCTTGCCACCATCGT","TACACAAACTCAACATCATC","561307.5.peg.797","2240"
"33255",447,9,438,"GGATGCACAAGTGCTAACTT","CAGCTCGATGAGTTAATAGA","561307.5.peg.798","2241"
"33256",282,9,273,"CATCAACATACGTATTGTA","CAGCTCGATGAGTTAATAGA","561307.5.peg.798","2241"
"33257",723,9,714,"GGTTTCGCAGGTATCTCTAA","CAGCTCGATGAGTTAATAGA","561307.5.peg.798","2241"
"33258",374,9,365,"ATTACGTTCTTCAATATTC","CAGCTCGATGAGTTAATAGA","561307.5.peg.798","2241"
"33259",363,9,354,"CAATATTCCGGTAATGTAA","CAGCTCGATGAGTTAATAGA","561307.5.peg.798","2241"
"33260",606,9,597,"GCACCATCAATATCAAATTC","CAGCTCGATGAGTTAATAGA","561307.5.peg.798","2241"
"33261",807,9,798,"CTAGACCATCGTTTGTGTAT","CAGCTCGATGAGTTAATAGA","561307.5.peg.798","2241"
"33262",494,9,485,"ATGTGAGCTCTGAATTACCT","CAGCTCGATGAGTTAATAGA","561307.5.peg.798","2241"
"33263",237,9,228,"TTCGTTAATGTCTCCGAGTA","CAGCTCGATGAGTTAATAGA","561307.5.peg.798","2241"
"33264",735,9,726,"TAAGCATCAAATGGTTTCGC","CAGCTCGATGAGTTAATAGA","561307.5.peg.798","2241"
"33265",374,237,137,"ATTACGTTCTTCAATATTC","TTCGTTAATGTCTCCGAGTA","561307.5.peg.798","2241"
"33266",494,237,257,"ATGTGAGCTCTGAATTACCT","TTCGTTAATGTCTCCGAGTA","561307.5.peg.798","2241"
"33267",363,237,126,"CAATATTCCGGTAATGTAA","TTCGTTAATGTCTCCGAGTA","561307.5.peg.798","2241"
"33268",723,237,486,"GGTTTCGCAGGTATCTCTAA","TTCGTTAATGTCTCCGAGTA","561307.5.peg.798","2241"
"33269",606,237,369,"GCACCATCAATATCAAATTC","TTCGTTAATGTCTCCGAGTA","561307.5.peg.798","2241"
"33270",807,237,570,"CTAGACCATCGTTTGTGTAT","TTCGTTAATGTCTCCGAGTA","561307.5.peg.798","2241"
"33271",735,237,498,"TAAGCATCAAATGGTTTCGC","TTCGTTAATGTCTCCGAGTA","561307.5.peg.798","2241"
"33272",9,237,228,"CAGCTCGATGAGTTAATAGA","TTCGTTAATGTCTCCGAGTA","561307.5.peg.798","2241"
"33273",447,237,210,"GGATGCACAAGTGCTAACTT","TTCGTTAATGTCTCCGAGTA","561307.5.peg.798","2241"
"33274",9,282,273,"CAGCTCGATGAGTTAATAGA","CATCAACATACGTATTGTA","561307.5.peg.798","2241"
"33275",723,282,441,"GGTTTCGCAGGTATCTCTAA","CATCAACATACGTATTGTA","561307.5.peg.798","2241"
"33276",447,282,165,"GGATGCACAAGTGCTAACTT","CATCAACATACGTATTGTA","561307.5.peg.798","2241"
"33277",494,282,212,"ATGTGAGCTCTGAATTACCT","CATCAACATACGTATTGTA","561307.5.peg.798","2241"
"33278",807,282,525,"CTAGACCATCGTTTGTGTAT","CATCAACATACGTATTGTA","561307.5.peg.798","2241"
"33279",735,282,453,"TAAGCATCAAATGGTTTCGC","CATCAACATACGTATTGTA","561307.5.peg.798","2241"
"33280",606,282,324,"GCACCATCAATATCAAATTC","CATCAACATACGTATTGTA","561307.5.peg.798","2241"
"33281",237,363,126,"TTCGTTAATGTCTCCGAGTA","CAATATTCCGGTAATGTAA","561307.5.peg.798","2241"
"33282",606,363,243,"GCACCATCAATATCAAATTC","CAATATTCCGGTAATGTAA","561307.5.peg.798","2241"
"33283",9,363,354,"CAGCTCGATGAGTTAATAGA","CAATATTCCGGTAATGTAA","561307.5.peg.798","2241"
"33284",723,363,360,"GGTTTCGCAGGTATCTCTAA","CAATATTCCGGTAATGTAA","561307.5.peg.798","2241"
"33285",807,363,444,"CTAGACCATCGTTTGTGTAT","CAATATTCCGGTAATGTAA","561307.5.peg.798","2241"
"33286",494,363,131,"ATGTGAGCTCTGAATTACCT","CAATATTCCGGTAATGTAA","561307.5.peg.798","2241"
"33287",735,363,372,"TAAGCATCAAATGGTTTCGC","CAATATTCCGGTAATGTAA","561307.5.peg.798","2241"
"33288",807,374,433,"CTAGACCATCGTTTGTGTAT","ATTACGTTCTTCAATATTC","561307.5.peg.798","2241"
"33289",735,374,361,"TAAGCATCAAATGGTTTCGC","ATTACGTTCTTCAATATTC","561307.5.peg.798","2241"
"33290",606,374,232,"GCACCATCAATATCAAATTC","ATTACGTTCTTCAATATTC","561307.5.peg.798","2241"
"33291",494,374,120,"ATGTGAGCTCTGAATTACCT","ATTACGTTCTTCAATATTC","561307.5.peg.798","2241"
"33292",237,374,137,"TTCGTTAATGTCTCCGAGTA","ATTACGTTCTTCAATATTC","561307.5.peg.798","2241"
"33293",723,374,349,"GGTTTCGCAGGTATCTCTAA","ATTACGTTCTTCAATATTC","561307.5.peg.798","2241"
"33294",9,374,365,"CAGCTCGATGAGTTAATAGA","ATTACGTTCTTCAATATTC","561307.5.peg.798","2241"
"33295",9,447,438,"CAGCTCGATGAGTTAATAGA","GGATGCACAAGTGCTAACTT","561307.5.peg.798","2241"
"33296",606,447,159,"GCACCATCAATATCAAATTC","GGATGCACAAGTGCTAACTT","561307.5.peg.798","2241"
"33297",282,447,165,"CATCAACATACGTATTGTA","GGATGCACAAGTGCTAACTT","561307.5.peg.798","2241"
"33298",723,447,276,"GGTTTCGCAGGTATCTCTAA","GGATGCACAAGTGCTAACTT","561307.5.peg.798","2241"
"33299",237,447,210,"TTCGTTAATGTCTCCGAGTA","GGATGCACAAGTGCTAACTT","561307.5.peg.798","2241"
"33300",735,447,288,"TAAGCATCAAATGGTTTCGC","GGATGCACAAGTGCTAACTT","561307.5.peg.798","2241"
"33301",807,447,360,"CTAGACCATCGTTTGTGTAT","GGATGCACAAGTGCTAACTT","561307.5.peg.798","2241"
"33302",237,494,257,"TTCGTTAATGTCTCCGAGTA","ATGTGAGCTCTGAATTACCT","561307.5.peg.798","2241"
"33303",723,494,229,"GGTTTCGCAGGTATCTCTAA","ATGTGAGCTCTGAATTACCT","561307.5.peg.798","2241"
"33304",374,494,120,"ATTACGTTCTTCAATATTC","ATGTGAGCTCTGAATTACCT","561307.5.peg.798","2241"
"33305",807,494,313,"CTAGACCATCGTTTGTGTAT","ATGTGAGCTCTGAATTACCT","561307.5.peg.798","2241"
"33306",363,494,131,"CAATATTCCGGTAATGTAA","ATGTGAGCTCTGAATTACCT","561307.5.peg.798","2241"
"33307",9,494,485,"CAGCTCGATGAGTTAATAGA","ATGTGAGCTCTGAATTACCT","561307.5.peg.798","2241"
"33308",606,494,112,"GCACCATCAATATCAAATTC","ATGTGAGCTCTGAATTACCT","561307.5.peg.798","2241"
"33309",282,494,212,"CATCAACATACGTATTGTA","ATGTGAGCTCTGAATTACCT","561307.5.peg.798","2241"
"33310",735,494,241,"TAAGCATCAAATGGTTTCGC","ATGTGAGCTCTGAATTACCT","561307.5.peg.798","2241"
"33311",363,606,243,"CAATATTCCGGTAATGTAA","GCACCATCAATATCAAATTC","561307.5.peg.798","2241"
"33312",9,606,597,"CAGCTCGATGAGTTAATAGA","GCACCATCAATATCAAATTC","561307.5.peg.798","2241"
"33313",237,606,369,"TTCGTTAATGTCTCCGAGTA","GCACCATCAATATCAAATTC","561307.5.peg.798","2241"
"33314",807,606,201,"CTAGACCATCGTTTGTGTAT","GCACCATCAATATCAAATTC","561307.5.peg.798","2241"
"33315",735,606,129,"TAAGCATCAAATGGTTTCGC","GCACCATCAATATCAAATTC","561307.5.peg.798","2241"
"33316",447,606,159,"GGATGCACAAGTGCTAACTT","GCACCATCAATATCAAATTC","561307.5.peg.798","2241"
"33317",374,606,232,"ATTACGTTCTTCAATATTC","GCACCATCAATATCAAATTC","561307.5.peg.798","2241"
"33318",723,606,117,"GGTTTCGCAGGTATCTCTAA","GCACCATCAATATCAAATTC","561307.5.peg.798","2241"
"33319",282,606,324,"CATCAACATACGTATTGTA","GCACCATCAATATCAAATTC","561307.5.peg.798","2241"
"33320",494,606,112,"ATGTGAGCTCTGAATTACCT","GCACCATCAATATCAAATTC","561307.5.peg.798","2241"
"33321",9,723,714,"CAGCTCGATGAGTTAATAGA","GGTTTCGCAGGTATCTCTAA","561307.5.peg.798","2241"
"33322",606,723,117,"GCACCATCAATATCAAATTC","GGTTTCGCAGGTATCTCTAA","561307.5.peg.798","2241"
"33323",237,723,486,"TTCGTTAATGTCTCCGAGTA","GGTTTCGCAGGTATCTCTAA","561307.5.peg.798","2241"
"33324",374,723,349,"ATTACGTTCTTCAATATTC","GGTTTCGCAGGTATCTCTAA","561307.5.peg.798","2241"
"33325",447,723,276,"GGATGCACAAGTGCTAACTT","GGTTTCGCAGGTATCTCTAA","561307.5.peg.798","2241"
"33326",282,723,441,"CATCAACATACGTATTGTA","GGTTTCGCAGGTATCTCTAA","561307.5.peg.798","2241"
"33327",363,723,360,"CAATATTCCGGTAATGTAA","GGTTTCGCAGGTATCTCTAA","561307.5.peg.798","2241"
"33328",494,723,229,"ATGTGAGCTCTGAATTACCT","GGTTTCGCAGGTATCTCTAA","561307.5.peg.798","2241"
"33329",374,735,361,"ATTACGTTCTTCAATATTC","TAAGCATCAAATGGTTTCGC","561307.5.peg.798","2241"
"33330",9,735,726,"CAGCTCGATGAGTTAATAGA","TAAGCATCAAATGGTTTCGC","561307.5.peg.798","2241"
"33331",447,735,288,"GGATGCACAAGTGCTAACTT","TAAGCATCAAATGGTTTCGC","561307.5.peg.798","2241"
"33332",606,735,129,"GCACCATCAATATCAAATTC","TAAGCATCAAATGGTTTCGC","561307.5.peg.798","2241"
"33333",494,735,241,"ATGTGAGCTCTGAATTACCT","TAAGCATCAAATGGTTTCGC","561307.5.peg.798","2241"
"33334",363,735,372,"CAATATTCCGGTAATGTAA","TAAGCATCAAATGGTTTCGC","561307.5.peg.798","2241"
"33335",237,735,498,"TTCGTTAATGTCTCCGAGTA","TAAGCATCAAATGGTTTCGC","561307.5.peg.798","2241"
"33336",282,735,453,"CATCAACATACGTATTGTA","TAAGCATCAAATGGTTTCGC","561307.5.peg.798","2241"
"33337",363,807,444,"CAATATTCCGGTAATGTAA","CTAGACCATCGTTTGTGTAT","561307.5.peg.798","2241"
"33338",494,807,313,"ATGTGAGCTCTGAATTACCT","CTAGACCATCGTTTGTGTAT","561307.5.peg.798","2241"
"33339",447,807,360,"GGATGCACAAGTGCTAACTT","CTAGACCATCGTTTGTGTAT","561307.5.peg.798","2241"
"33340",9,807,798,"CAGCTCGATGAGTTAATAGA","CTAGACCATCGTTTGTGTAT","561307.5.peg.798","2241"
"33341",282,807,525,"CATCAACATACGTATTGTA","CTAGACCATCGTTTGTGTAT","561307.5.peg.798","2241"
"33342",237,807,570,"TTCGTTAATGTCTCCGAGTA","CTAGACCATCGTTTGTGTAT","561307.5.peg.798","2241"
"33343",606,807,201,"GCACCATCAATATCAAATTC","CTAGACCATCGTTTGTGTAT","561307.5.peg.798","2241"
"33344",374,807,433,"ATTACGTTCTTCAATATTC","CTAGACCATCGTTTGTGTAT","561307.5.peg.798","2241"
"33345",393,159,234,"TTATAAGCATAGGCTTCATC","GGTAATCCAGAGGGCATCAA","561307.5.peg.799","2242"
"33346",393,180,213,"TTATAAGCATAGGCTTCATC","AACATCAACCACTCATGAAT","561307.5.peg.799","2242"
"33347",159,393,234,"GGTAATCCAGAGGGCATCAA","TTATAAGCATAGGCTTCATC","561307.5.peg.799","2242"
"33348",180,393,213,"AACATCAACCACTCATGAAT","TTATAAGCATAGGCTTCATC","561307.5.peg.799","2242"
"33349",720,7,713,"GGTGCACCCGAAATAACTAA","TGTATCGAAACTGAATGGTG","561307.5.peg.800","2245"
"33350",1013,7,1006,"GTAACATACGACCTGTAATA","TGTATCGAAACTGAATGGTG","561307.5.peg.800","2245"
"33351",1035,7,1028,"CCAGCTTGCAACTTAGTTCC","TGTATCGAAACTGAATGGTG","561307.5.peg.800","2245"
"33352",720,12,708,"GGTGCACCCGAAATAACTAA","TAGATGTATCGAAACTGAA","561307.5.peg.800","2245"
"33353",1035,12,1023,"CCAGCTTGCAACTTAGTTCC","TAGATGTATCGAAACTGAA","561307.5.peg.800","2245"
"33354",1013,12,1001,"GTAACATACGACCTGTAATA","TAGATGTATCGAAACTGAA","561307.5.peg.800","2245"
"33355",7,720,713,"TGTATCGAAACTGAATGGTG","GGTGCACCCGAAATAACTAA","561307.5.peg.800","2245"
"33356",12,720,708,"TAGATGTATCGAAACTGAA","GGTGCACCCGAAATAACTAA","561307.5.peg.800","2245"
"33357",1013,720,293,"GTAACATACGACCTGTAATA","GGTGCACCCGAAATAACTAA","561307.5.peg.800","2245"
"33358",1035,720,315,"CCAGCTTGCAACTTAGTTCC","GGTGCACCCGAAATAACTAA","561307.5.peg.800","2245"
"33359",7,1013,1006,"TGTATCGAAACTGAATGGTG","GTAACATACGACCTGTAATA","561307.5.peg.800","2245"
"33360",12,1013,1001,"TAGATGTATCGAAACTGAA","GTAACATACGACCTGTAATA","561307.5.peg.800","2245"
"33361",720,1013,293,"GGTGCACCCGAAATAACTAA","GTAACATACGACCTGTAATA","561307.5.peg.800","2245"
"33362",7,1035,1028,"TGTATCGAAACTGAATGGTG","CCAGCTTGCAACTTAGTTCC","561307.5.peg.800","2245"
"33363",720,1035,315,"GGTGCACCCGAAATAACTAA","CCAGCTTGCAACTTAGTTCC","561307.5.peg.800","2245"
"33364",12,1035,1023,"TAGATGTATCGAAACTGAA","CCAGCTTGCAACTTAGTTCC","561307.5.peg.800","2245"
"33365",679,276,403,"TAATATGACAATATCGTCTC","TCATCTAACGTGTACGTTGT","561307.5.peg.801","2246"
"33366",704,276,428,"CCTGACCAATATCAGAAGCG","TCATCTAACGTGTACGTTGT","561307.5.peg.801","2246"
"33367",276,679,403,"TCATCTAACGTGTACGTTGT","TAATATGACAATATCGTCTC","561307.5.peg.801","2246"
"33368",276,704,428,"TCATCTAACGTGTACGTTGT","CCTGACCAATATCAGAAGCG","561307.5.peg.801","2246"
"33369",112,7,105,"AAATCTTCTTCCAACTTAC","ATGGGAAACATTAGTTCAAG","561307.5.peg.802","2247"
"33370",350,7,343,"CGACACGACTAACAATTCTA","ATGGGAAACATTAGTTCAAG","561307.5.peg.802","2247"
"33371",165,7,158,"TACGGTGATATAACATCGTC","ATGGGAAACATTAGTTCAAG","561307.5.peg.802","2247"
"33372",386,7,379,"CGACAAATCGGACACGTTGT","ATGGGAAACATTAGTTCAAG","561307.5.peg.802","2247"
"33373",572,7,565,"ATGCGAATGCGAGCTTTGAA","ATGGGAAACATTAGTTCAAG","561307.5.peg.802","2247"
"33374",7,112,105,"ATGGGAAACATTAGTTCAAG","AAATCTTCTTCCAACTTAC","561307.5.peg.802","2247"
"33375",572,112,460,"ATGCGAATGCGAGCTTTGAA","AAATCTTCTTCCAACTTAC","561307.5.peg.802","2247"
"33376",350,112,238,"CGACACGACTAACAATTCTA","AAATCTTCTTCCAACTTAC","561307.5.peg.802","2247"
"33377",386,112,274,"CGACAAATCGGACACGTTGT","AAATCTTCTTCCAACTTAC","561307.5.peg.802","2247"
"33378",7,165,158,"ATGGGAAACATTAGTTCAAG","TACGGTGATATAACATCGTC","561307.5.peg.802","2247"
"33379",350,165,185,"CGACACGACTAACAATTCTA","TACGGTGATATAACATCGTC","561307.5.peg.802","2247"
"33380",386,165,221,"CGACAAATCGGACACGTTGT","TACGGTGATATAACATCGTC","561307.5.peg.802","2247"
"33381",572,165,407,"ATGCGAATGCGAGCTTTGAA","TACGGTGATATAACATCGTC","561307.5.peg.802","2247"
"33382",7,350,343,"ATGGGAAACATTAGTTCAAG","CGACACGACTAACAATTCTA","561307.5.peg.802","2247"
"33383",112,350,238,"AAATCTTCTTCCAACTTAC","CGACACGACTAACAATTCTA","561307.5.peg.802","2247"
"33384",572,350,222,"ATGCGAATGCGAGCTTTGAA","CGACACGACTAACAATTCTA","561307.5.peg.802","2247"
"33385",165,350,185,"TACGGTGATATAACATCGTC","CGACACGACTAACAATTCTA","561307.5.peg.802","2247"
"33386",572,386,186,"ATGCGAATGCGAGCTTTGAA","CGACAAATCGGACACGTTGT","561307.5.peg.802","2247"
"33387",7,386,379,"ATGGGAAACATTAGTTCAAG","CGACAAATCGGACACGTTGT","561307.5.peg.802","2247"
"33388",112,386,274,"AAATCTTCTTCCAACTTAC","CGACAAATCGGACACGTTGT","561307.5.peg.802","2247"
"33389",165,386,221,"TACGGTGATATAACATCGTC","CGACAAATCGGACACGTTGT","561307.5.peg.802","2247"
"33390",350,572,222,"CGACACGACTAACAATTCTA","ATGCGAATGCGAGCTTTGAA","561307.5.peg.802","2247"
"33391",386,572,186,"CGACAAATCGGACACGTTGT","ATGCGAATGCGAGCTTTGAA","561307.5.peg.802","2247"
"33392",7,572,565,"ATGGGAAACATTAGTTCAAG","ATGCGAATGCGAGCTTTGAA","561307.5.peg.802","2247"
"33393",112,572,460,"AAATCTTCTTCCAACTTAC","ATGCGAATGCGAGCTTTGAA","561307.5.peg.802","2247"
"33394",165,572,407,"TACGGTGATATAACATCGTC","ATGCGAATGCGAGCTTTGAA","561307.5.peg.802","2247"
"33395",144,10,134,"GATGCAGCTTGGGCATCGTA","TTGAAGGAAGTAAGTGAGGA","561307.5.peg.803","2248"
"33396",605,10,595,"GTGTATTTGCTGATTCAAA","TTGAAGGAAGTAAGTGAGGA","561307.5.peg.803","2248"
"33397",599,10,589,"TTTGCTGATTCAAATGGTCT","TTGAAGGAAGTAAGTGAGGA","561307.5.peg.803","2248"
"33398",663,10,653,"TTATCTGTTGTAGACACTGC","TTGAAGGAAGTAAGTGAGGA","561307.5.peg.803","2248"
"33399",773,10,763,"TATCAGTGAGTCGATTACTA","TTGAAGGAAGTAAGTGAGGA","561307.5.peg.803","2248"
"33400",144,14,130,"GATGCAGCTTGGGCATCGTA","TTCTTTGAAGGAAGTAAGTG","561307.5.peg.803","2248"
"33401",773,14,759,"TATCAGTGAGTCGATTACTA","TTCTTTGAAGGAAGTAAGTG","561307.5.peg.803","2248"
"33402",599,14,585,"TTTGCTGATTCAAATGGTCT","TTCTTTGAAGGAAGTAAGTG","561307.5.peg.803","2248"
"33403",605,14,591,"GTGTATTTGCTGATTCAAA","TTCTTTGAAGGAAGTAAGTG","561307.5.peg.803","2248"
"33404",663,14,649,"TTATCTGTTGTAGACACTGC","TTCTTTGAAGGAAGTAAGTG","561307.5.peg.803","2248"
"33405",10,144,134,"TTGAAGGAAGTAAGTGAGGA","GATGCAGCTTGGGCATCGTA","561307.5.peg.803","2248"
"33406",14,144,130,"TTCTTTGAAGGAAGTAAGTG","GATGCAGCTTGGGCATCGTA","561307.5.peg.803","2248"
"33407",605,144,461,"GTGTATTTGCTGATTCAAA","GATGCAGCTTGGGCATCGTA","561307.5.peg.803","2248"
"33408",663,144,519,"TTATCTGTTGTAGACACTGC","GATGCAGCTTGGGCATCGTA","561307.5.peg.803","2248"
"33409",773,144,629,"TATCAGTGAGTCGATTACTA","GATGCAGCTTGGGCATCGTA","561307.5.peg.803","2248"
"33410",599,144,455,"TTTGCTGATTCAAATGGTCT","GATGCAGCTTGGGCATCGTA","561307.5.peg.803","2248"
"33411",10,599,589,"TTGAAGGAAGTAAGTGAGGA","TTTGCTGATTCAAATGGTCT","561307.5.peg.803","2248"
"33412",14,599,585,"TTCTTTGAAGGAAGTAAGTG","TTTGCTGATTCAAATGGTCT","561307.5.peg.803","2248"
"33413",773,599,174,"TATCAGTGAGTCGATTACTA","TTTGCTGATTCAAATGGTCT","561307.5.peg.803","2248"
"33414",144,599,455,"GATGCAGCTTGGGCATCGTA","TTTGCTGATTCAAATGGTCT","561307.5.peg.803","2248"
"33415",14,605,591,"TTCTTTGAAGGAAGTAAGTG","GTGTATTTGCTGATTCAAA","561307.5.peg.803","2248"
"33416",10,605,595,"TTGAAGGAAGTAAGTGAGGA","GTGTATTTGCTGATTCAAA","561307.5.peg.803","2248"
"33417",773,605,168,"TATCAGTGAGTCGATTACTA","GTGTATTTGCTGATTCAAA","561307.5.peg.803","2248"
"33418",144,605,461,"GATGCAGCTTGGGCATCGTA","GTGTATTTGCTGATTCAAA","561307.5.peg.803","2248"
"33419",10,663,653,"TTGAAGGAAGTAAGTGAGGA","TTATCTGTTGTAGACACTGC","561307.5.peg.803","2248"
"33420",14,663,649,"TTCTTTGAAGGAAGTAAGTG","TTATCTGTTGTAGACACTGC","561307.5.peg.803","2248"
"33421",144,663,519,"GATGCAGCTTGGGCATCGTA","TTATCTGTTGTAGACACTGC","561307.5.peg.803","2248"
"33422",773,663,110,"TATCAGTGAGTCGATTACTA","TTATCTGTTGTAGACACTGC","561307.5.peg.803","2248"
"33423",663,773,110,"TTATCTGTTGTAGACACTGC","TATCAGTGAGTCGATTACTA","561307.5.peg.803","2248"
"33424",144,773,629,"GATGCAGCTTGGGCATCGTA","TATCAGTGAGTCGATTACTA","561307.5.peg.803","2248"
"33425",10,773,763,"TTGAAGGAAGTAAGTGAGGA","TATCAGTGAGTCGATTACTA","561307.5.peg.803","2248"
"33426",14,773,759,"TTCTTTGAAGGAAGTAAGTG","TATCAGTGAGTCGATTACTA","561307.5.peg.803","2248"
"33427",599,773,174,"TTTGCTGATTCAAATGGTCT","TATCAGTGAGTCGATTACTA","561307.5.peg.803","2248"
"33428",605,773,168,"GTGTATTTGCTGATTCAAA","TATCAGTGAGTCGATTACTA","561307.5.peg.803","2248"
"33429",636,102,534,"TTGATTGATTAGGTTGTGT","GCGGTAGGTGAAACTAAAGT","561307.5.peg.805","2250"
"33430",840,102,738,"TCATCTTGTGTTGGTAACTG","GCGGTAGGTGAAACTAAAGT","561307.5.peg.805","2250"
"33431",630,102,528,"TGATTAGGTTGTGTTGGCTT","GCGGTAGGTGAAACTAAAGT","561307.5.peg.805","2250"
"33432",621,102,519,"TGTGTTGGCTTTGGCGAATT","GCGGTAGGTGAAACTAAAGT","561307.5.peg.805","2250"
"33433",882,102,780,"TCGTTATTGAATGATTGAGC","GCGGTAGGTGAAACTAAAGT","561307.5.peg.805","2250"
"33434",600,102,498,"GGTTGCTTATTAGATGTACT","GCGGTAGGTGAAACTAAAGT","561307.5.peg.805","2250"
"33435",666,102,564,"TTTGCTTTATCGTCACTTGC","GCGGTAGGTGAAACTAAAGT","561307.5.peg.805","2250"
"33436",600,117,483,"GGTTGCTTATTAGATGTACT","GGTGTATCAGCATAAGCGGT","561307.5.peg.805","2250"
"33437",621,117,504,"TGTGTTGGCTTTGGCGAATT","GGTGTATCAGCATAAGCGGT","561307.5.peg.805","2250"
"33438",636,117,519,"TTGATTGATTAGGTTGTGT","GGTGTATCAGCATAAGCGGT","561307.5.peg.805","2250"
"33439",666,117,549,"TTTGCTTTATCGTCACTTGC","GGTGTATCAGCATAAGCGGT","561307.5.peg.805","2250"
"33440",840,117,723,"TCATCTTGTGTTGGTAACTG","GGTGTATCAGCATAAGCGGT","561307.5.peg.805","2250"
"33441",882,117,765,"TCGTTATTGAATGATTGAGC","GGTGTATCAGCATAAGCGGT","561307.5.peg.805","2250"
"33442",630,117,513,"TGATTAGGTTGTGTTGGCTT","GGTGTATCAGCATAAGCGGT","561307.5.peg.805","2250"
"33443",630,121,509,"TGATTAGGTTGTGTTGGCTT","TTGAGGTGTATCAGCATAAG","561307.5.peg.805","2250"
"33444",882,121,761,"TCGTTATTGAATGATTGAGC","TTGAGGTGTATCAGCATAAG","561307.5.peg.805","2250"
"33445",636,121,515,"TTGATTGATTAGGTTGTGT","TTGAGGTGTATCAGCATAAG","561307.5.peg.805","2250"
"33446",666,121,545,"TTTGCTTTATCGTCACTTGC","TTGAGGTGTATCAGCATAAG","561307.5.peg.805","2250"
"33447",600,121,479,"GGTTGCTTATTAGATGTACT","TTGAGGTGTATCAGCATAAG","561307.5.peg.805","2250"
"33448",621,121,500,"TGTGTTGGCTTTGGCGAATT","TTGAGGTGTATCAGCATAAG","561307.5.peg.805","2250"
"33449",840,121,719,"TCATCTTGTGTTGGTAACTG","TTGAGGTGTATCAGCATAAG","561307.5.peg.805","2250"
"33450",121,600,479,"TTGAGGTGTATCAGCATAAG","GGTTGCTTATTAGATGTACT","561307.5.peg.805","2250"
"33451",102,600,498,"GCGGTAGGTGAAACTAAAGT","GGTTGCTTATTAGATGTACT","561307.5.peg.805","2250"
"33452",882,600,282,"TCGTTATTGAATGATTGAGC","GGTTGCTTATTAGATGTACT","561307.5.peg.805","2250"
"33453",840,600,240,"TCATCTTGTGTTGGTAACTG","GGTTGCTTATTAGATGTACT","561307.5.peg.805","2250"
"33454",117,600,483,"GGTGTATCAGCATAAGCGGT","GGTTGCTTATTAGATGTACT","561307.5.peg.805","2250"
"33455",117,621,504,"GGTGTATCAGCATAAGCGGT","TGTGTTGGCTTTGGCGAATT","561307.5.peg.805","2250"
"33456",121,621,500,"TTGAGGTGTATCAGCATAAG","TGTGTTGGCTTTGGCGAATT","561307.5.peg.805","2250"
"33457",840,621,219,"TCATCTTGTGTTGGTAACTG","TGTGTTGGCTTTGGCGAATT","561307.5.peg.805","2250"
"33458",882,621,261,"TCGTTATTGAATGATTGAGC","TGTGTTGGCTTTGGCGAATT","561307.5.peg.805","2250"
"33459",102,621,519,"GCGGTAGGTGAAACTAAAGT","TGTGTTGGCTTTGGCGAATT","561307.5.peg.805","2250"
"33460",102,630,528,"GCGGTAGGTGAAACTAAAGT","TGATTAGGTTGTGTTGGCTT","561307.5.peg.805","2250"
"33461",882,630,252,"TCGTTATTGAATGATTGAGC","TGATTAGGTTGTGTTGGCTT","561307.5.peg.805","2250"
"33462",117,630,513,"GGTGTATCAGCATAAGCGGT","TGATTAGGTTGTGTTGGCTT","561307.5.peg.805","2250"
"33463",840,630,210,"TCATCTTGTGTTGGTAACTG","TGATTAGGTTGTGTTGGCTT","561307.5.peg.805","2250"
"33464",121,630,509,"TTGAGGTGTATCAGCATAAG","TGATTAGGTTGTGTTGGCTT","561307.5.peg.805","2250"
"33465",840,636,204,"TCATCTTGTGTTGGTAACTG","TTGATTGATTAGGTTGTGT","561307.5.peg.805","2250"
"33466",102,636,534,"GCGGTAGGTGAAACTAAAGT","TTGATTGATTAGGTTGTGT","561307.5.peg.805","2250"
"33467",117,636,519,"GGTGTATCAGCATAAGCGGT","TTGATTGATTAGGTTGTGT","561307.5.peg.805","2250"
"33468",121,636,515,"TTGAGGTGTATCAGCATAAG","TTGATTGATTAGGTTGTGT","561307.5.peg.805","2250"
"33469",882,636,246,"TCGTTATTGAATGATTGAGC","TTGATTGATTAGGTTGTGT","561307.5.peg.805","2250"
"33470",102,666,564,"GCGGTAGGTGAAACTAAAGT","TTTGCTTTATCGTCACTTGC","561307.5.peg.805","2250"
"33471",121,666,545,"TTGAGGTGTATCAGCATAAG","TTTGCTTTATCGTCACTTGC","561307.5.peg.805","2250"
"33472",840,666,174,"TCATCTTGTGTTGGTAACTG","TTTGCTTTATCGTCACTTGC","561307.5.peg.805","2250"
"33473",117,666,549,"GGTGTATCAGCATAAGCGGT","TTTGCTTTATCGTCACTTGC","561307.5.peg.805","2250"
"33474",882,666,216,"TCGTTATTGAATGATTGAGC","TTTGCTTTATCGTCACTTGC","561307.5.peg.805","2250"
"33475",121,840,719,"TTGAGGTGTATCAGCATAAG","TCATCTTGTGTTGGTAACTG","561307.5.peg.805","2250"
"33476",621,840,219,"TGTGTTGGCTTTGGCGAATT","TCATCTTGTGTTGGTAACTG","561307.5.peg.805","2250"
"33477",600,840,240,"GGTTGCTTATTAGATGTACT","TCATCTTGTGTTGGTAACTG","561307.5.peg.805","2250"
"33478",636,840,204,"TTGATTGATTAGGTTGTGT","TCATCTTGTGTTGGTAACTG","561307.5.peg.805","2250"
"33479",630,840,210,"TGATTAGGTTGTGTTGGCTT","TCATCTTGTGTTGGTAACTG","561307.5.peg.805","2250"
"33480",102,840,738,"GCGGTAGGTGAAACTAAAGT","TCATCTTGTGTTGGTAACTG","561307.5.peg.805","2250"
"33481",117,840,723,"GGTGTATCAGCATAAGCGGT","TCATCTTGTGTTGGTAACTG","561307.5.peg.805","2250"
"33482",666,840,174,"TTTGCTTTATCGTCACTTGC","TCATCTTGTGTTGGTAACTG","561307.5.peg.805","2250"
"33483",121,882,761,"TTGAGGTGTATCAGCATAAG","TCGTTATTGAATGATTGAGC","561307.5.peg.805","2250"
"33484",102,882,780,"GCGGTAGGTGAAACTAAAGT","TCGTTATTGAATGATTGAGC","561307.5.peg.805","2250"
"33485",666,882,216,"TTTGCTTTATCGTCACTTGC","TCGTTATTGAATGATTGAGC","561307.5.peg.805","2250"
"33486",630,882,252,"TGATTAGGTTGTGTTGGCTT","TCGTTATTGAATGATTGAGC","561307.5.peg.805","2250"
"33487",600,882,282,"GGTTGCTTATTAGATGTACT","TCGTTATTGAATGATTGAGC","561307.5.peg.805","2250"
"33488",117,882,765,"GGTGTATCAGCATAAGCGGT","TCGTTATTGAATGATTGAGC","561307.5.peg.805","2250"
"33489",636,882,246,"TTGATTGATTAGGTTGTGT","TCGTTATTGAATGATTGAGC","561307.5.peg.805","2250"
"33490",621,882,261,"TGTGTTGGCTTTGGCGAATT","TCGTTATTGAATGATTGAGC","561307.5.peg.805","2250"
"33491",1173,32,1141,"TTTGGTGCAGTATCGCCACT","TCATTGTCACACTCCTATGT","561307.5.peg.806","2251"
"33492",991,32,959,"AACTTGTGTGACGAAGCCTT","TCATTGTCACACTCCTATGT","561307.5.peg.806","2251"
"33493",144,32,112,"TTAAACCAAGCGTAGAACGA","TCATTGTCACACTCCTATGT","561307.5.peg.806","2251"
"33494",707,32,675,"ATTTATCTAAATCCGCTTGG","TCATTGTCACACTCCTATGT","561307.5.peg.806","2251"
"33495",186,32,154,"ATGTGTCCCGTGTTGCCATA","TCATTGTCACACTCCTATGT","561307.5.peg.806","2251"
"33496",386,32,354,"TTCATGTGTAAACTTAGAT","TCATTGTCACACTCCTATGT","561307.5.peg.806","2251"
"33497",1161,32,1129,"TCGCCACTTGGTGCACTTGG","TCATTGTCACACTCCTATGT","561307.5.peg.806","2251"
"33498",1216,32,1184,"CGCATTATTACTATTTGGTG","TCATTGTCACACTCCTATGT","561307.5.peg.806","2251"
"33499",1164,32,1132,"GTATCGCCACTTGGTGCACT","TCATTGTCACACTCCTATGT","561307.5.peg.806","2251"
"33500",1239,32,1207,"CTTTGTGGTGTAGTCGATAC","TCATTGTCACACTCCTATGT","561307.5.peg.806","2251"
"33501",1161,105,1056,"TCGCCACTTGGTGCACTTGG","GCTAAGATAATCCACACAGC","561307.5.peg.806","2251"
"33502",1164,105,1059,"GTATCGCCACTTGGTGCACT","GCTAAGATAATCCACACAGC","561307.5.peg.806","2251"
"33503",386,105,281,"TTCATGTGTAAACTTAGAT","GCTAAGATAATCCACACAGC","561307.5.peg.806","2251"
"33504",707,105,602,"ATTTATCTAAATCCGCTTGG","GCTAAGATAATCCACACAGC","561307.5.peg.806","2251"
"33505",1216,105,1111,"CGCATTATTACTATTTGGTG","GCTAAGATAATCCACACAGC","561307.5.peg.806","2251"
"33506",1239,105,1134,"CTTTGTGGTGTAGTCGATAC","GCTAAGATAATCCACACAGC","561307.5.peg.806","2251"
"33507",1173,105,1068,"TTTGGTGCAGTATCGCCACT","GCTAAGATAATCCACACAGC","561307.5.peg.806","2251"
"33508",991,105,886,"AACTTGTGTGACGAAGCCTT","GCTAAGATAATCCACACAGC","561307.5.peg.806","2251"
"33509",991,144,847,"AACTTGTGTGACGAAGCCTT","TTAAACCAAGCGTAGAACGA","561307.5.peg.806","2251"
"33510",1161,144,1017,"TCGCCACTTGGTGCACTTGG","TTAAACCAAGCGTAGAACGA","561307.5.peg.806","2251"
"33511",1239,144,1095,"CTTTGTGGTGTAGTCGATAC","TTAAACCAAGCGTAGAACGA","561307.5.peg.806","2251"
"33512",707,144,563,"ATTTATCTAAATCCGCTTGG","TTAAACCAAGCGTAGAACGA","561307.5.peg.806","2251"
"33513",1173,144,1029,"TTTGGTGCAGTATCGCCACT","TTAAACCAAGCGTAGAACGA","561307.5.peg.806","2251"
"33514",386,144,242,"TTCATGTGTAAACTTAGAT","TTAAACCAAGCGTAGAACGA","561307.5.peg.806","2251"
"33515",32,144,112,"TCATTGTCACACTCCTATGT","TTAAACCAAGCGTAGAACGA","561307.5.peg.806","2251"
"33516",1216,144,1072,"CGCATTATTACTATTTGGTG","TTAAACCAAGCGTAGAACGA","561307.5.peg.806","2251"
"33517",1164,144,1020,"GTATCGCCACTTGGTGCACT","TTAAACCAAGCGTAGAACGA","561307.5.peg.806","2251"
"33518",991,186,805,"AACTTGTGTGACGAAGCCTT","ATGTGTCCCGTGTTGCCATA","561307.5.peg.806","2251"
"33519",1239,186,1053,"CTTTGTGGTGTAGTCGATAC","ATGTGTCCCGTGTTGCCATA","561307.5.peg.806","2251"
"33520",386,186,200,"TTCATGTGTAAACTTAGAT","ATGTGTCCCGTGTTGCCATA","561307.5.peg.806","2251"
"33521",1164,186,978,"GTATCGCCACTTGGTGCACT","ATGTGTCCCGTGTTGCCATA","561307.5.peg.806","2251"
"33522",32,186,154,"TCATTGTCACACTCCTATGT","ATGTGTCCCGTGTTGCCATA","561307.5.peg.806","2251"
"33523",1161,186,975,"TCGCCACTTGGTGCACTTGG","ATGTGTCCCGTGTTGCCATA","561307.5.peg.806","2251"
"33524",707,186,521,"ATTTATCTAAATCCGCTTGG","ATGTGTCCCGTGTTGCCATA","561307.5.peg.806","2251"
"33525",1216,186,1030,"CGCATTATTACTATTTGGTG","ATGTGTCCCGTGTTGCCATA","561307.5.peg.806","2251"
"33526",1173,186,987,"TTTGGTGCAGTATCGCCACT","ATGTGTCCCGTGTTGCCATA","561307.5.peg.806","2251"
"33527",1173,386,787,"TTTGGTGCAGTATCGCCACT","TTCATGTGTAAACTTAGAT","561307.5.peg.806","2251"
"33528",105,386,281,"GCTAAGATAATCCACACAGC","TTCATGTGTAAACTTAGAT","561307.5.peg.806","2251"
"33529",186,386,200,"ATGTGTCCCGTGTTGCCATA","TTCATGTGTAAACTTAGAT","561307.5.peg.806","2251"
"33530",991,386,605,"AACTTGTGTGACGAAGCCTT","TTCATGTGTAAACTTAGAT","561307.5.peg.806","2251"
"33531",1164,386,778,"GTATCGCCACTTGGTGCACT","TTCATGTGTAAACTTAGAT","561307.5.peg.806","2251"
"33532",144,386,242,"TTAAACCAAGCGTAGAACGA","TTCATGTGTAAACTTAGAT","561307.5.peg.806","2251"
"33533",1216,386,830,"CGCATTATTACTATTTGGTG","TTCATGTGTAAACTTAGAT","561307.5.peg.806","2251"
"33534",32,386,354,"TCATTGTCACACTCCTATGT","TTCATGTGTAAACTTAGAT","561307.5.peg.806","2251"
"33535",1161,386,775,"TCGCCACTTGGTGCACTTGG","TTCATGTGTAAACTTAGAT","561307.5.peg.806","2251"
"33536",707,386,321,"ATTTATCTAAATCCGCTTGG","TTCATGTGTAAACTTAGAT","561307.5.peg.806","2251"
"33537",1239,386,853,"CTTTGTGGTGTAGTCGATAC","TTCATGTGTAAACTTAGAT","561307.5.peg.806","2251"
"33538",144,707,563,"TTAAACCAAGCGTAGAACGA","ATTTATCTAAATCCGCTTGG","561307.5.peg.806","2251"
"33539",1239,707,532,"CTTTGTGGTGTAGTCGATAC","ATTTATCTAAATCCGCTTGG","561307.5.peg.806","2251"
"33540",105,707,602,"GCTAAGATAATCCACACAGC","ATTTATCTAAATCCGCTTGG","561307.5.peg.806","2251"
"33541",991,707,284,"AACTTGTGTGACGAAGCCTT","ATTTATCTAAATCCGCTTGG","561307.5.peg.806","2251"
"33542",32,707,675,"TCATTGTCACACTCCTATGT","ATTTATCTAAATCCGCTTGG","561307.5.peg.806","2251"
"33543",186,707,521,"ATGTGTCCCGTGTTGCCATA","ATTTATCTAAATCCGCTTGG","561307.5.peg.806","2251"
"33544",386,707,321,"TTCATGTGTAAACTTAGAT","ATTTATCTAAATCCGCTTGG","561307.5.peg.806","2251"
"33545",1173,707,466,"TTTGGTGCAGTATCGCCACT","ATTTATCTAAATCCGCTTGG","561307.5.peg.806","2251"
"33546",1161,707,454,"TCGCCACTTGGTGCACTTGG","ATTTATCTAAATCCGCTTGG","561307.5.peg.806","2251"
"33547",1164,707,457,"GTATCGCCACTTGGTGCACT","ATTTATCTAAATCCGCTTGG","561307.5.peg.806","2251"
"33548",1216,707,509,"CGCATTATTACTATTTGGTG","ATTTATCTAAATCCGCTTGG","561307.5.peg.806","2251"
"33549",32,991,959,"TCATTGTCACACTCCTATGT","AACTTGTGTGACGAAGCCTT","561307.5.peg.806","2251"
"33550",386,991,605,"TTCATGTGTAAACTTAGAT","AACTTGTGTGACGAAGCCTT","561307.5.peg.806","2251"
"33551",1164,991,173,"GTATCGCCACTTGGTGCACT","AACTTGTGTGACGAAGCCTT","561307.5.peg.806","2251"
"33552",707,991,284,"ATTTATCTAAATCCGCTTGG","AACTTGTGTGACGAAGCCTT","561307.5.peg.806","2251"
"33553",1239,991,248,"CTTTGTGGTGTAGTCGATAC","AACTTGTGTGACGAAGCCTT","561307.5.peg.806","2251"
"33554",186,991,805,"ATGTGTCCCGTGTTGCCATA","AACTTGTGTGACGAAGCCTT","561307.5.peg.806","2251"
"33555",1161,991,170,"TCGCCACTTGGTGCACTTGG","AACTTGTGTGACGAAGCCTT","561307.5.peg.806","2251"
"33556",105,991,886,"GCTAAGATAATCCACACAGC","AACTTGTGTGACGAAGCCTT","561307.5.peg.806","2251"
"33557",144,991,847,"TTAAACCAAGCGTAGAACGA","AACTTGTGTGACGAAGCCTT","561307.5.peg.806","2251"
"33558",1216,991,225,"CGCATTATTACTATTTGGTG","AACTTGTGTGACGAAGCCTT","561307.5.peg.806","2251"
"33559",1173,991,182,"TTTGGTGCAGTATCGCCACT","AACTTGTGTGACGAAGCCTT","561307.5.peg.806","2251"
"33560",105,1161,1056,"GCTAAGATAATCCACACAGC","TCGCCACTTGGTGCACTTGG","561307.5.peg.806","2251"
"33561",991,1161,170,"AACTTGTGTGACGAAGCCTT","TCGCCACTTGGTGCACTTGG","561307.5.peg.806","2251"
"33562",144,1161,1017,"TTAAACCAAGCGTAGAACGA","TCGCCACTTGGTGCACTTGG","561307.5.peg.806","2251"
"33563",707,1161,454,"ATTTATCTAAATCCGCTTGG","TCGCCACTTGGTGCACTTGG","561307.5.peg.806","2251"
"33564",32,1161,1129,"TCATTGTCACACTCCTATGT","TCGCCACTTGGTGCACTTGG","561307.5.peg.806","2251"
"33565",186,1161,975,"ATGTGTCCCGTGTTGCCATA","TCGCCACTTGGTGCACTTGG","561307.5.peg.806","2251"
"33566",386,1161,775,"TTCATGTGTAAACTTAGAT","TCGCCACTTGGTGCACTTGG","561307.5.peg.806","2251"
"33567",32,1164,1132,"TCATTGTCACACTCCTATGT","GTATCGCCACTTGGTGCACT","561307.5.peg.806","2251"
"33568",707,1164,457,"ATTTATCTAAATCCGCTTGG","GTATCGCCACTTGGTGCACT","561307.5.peg.806","2251"
"33569",144,1164,1020,"TTAAACCAAGCGTAGAACGA","GTATCGCCACTTGGTGCACT","561307.5.peg.806","2251"
"33570",991,1164,173,"AACTTGTGTGACGAAGCCTT","GTATCGCCACTTGGTGCACT","561307.5.peg.806","2251"
"33571",186,1164,978,"ATGTGTCCCGTGTTGCCATA","GTATCGCCACTTGGTGCACT","561307.5.peg.806","2251"
"33572",105,1164,1059,"GCTAAGATAATCCACACAGC","GTATCGCCACTTGGTGCACT","561307.5.peg.806","2251"
"33573",386,1164,778,"TTCATGTGTAAACTTAGAT","GTATCGCCACTTGGTGCACT","561307.5.peg.806","2251"
"33574",707,1173,466,"ATTTATCTAAATCCGCTTGG","TTTGGTGCAGTATCGCCACT","561307.5.peg.806","2251"
"33575",105,1173,1068,"GCTAAGATAATCCACACAGC","TTTGGTGCAGTATCGCCACT","561307.5.peg.806","2251"
"33576",144,1173,1029,"TTAAACCAAGCGTAGAACGA","TTTGGTGCAGTATCGCCACT","561307.5.peg.806","2251"
"33577",386,1173,787,"TTCATGTGTAAACTTAGAT","TTTGGTGCAGTATCGCCACT","561307.5.peg.806","2251"
"33578",991,1173,182,"AACTTGTGTGACGAAGCCTT","TTTGGTGCAGTATCGCCACT","561307.5.peg.806","2251"
"33579",32,1173,1141,"TCATTGTCACACTCCTATGT","TTTGGTGCAGTATCGCCACT","561307.5.peg.806","2251"
"33580",186,1173,987,"ATGTGTCCCGTGTTGCCATA","TTTGGTGCAGTATCGCCACT","561307.5.peg.806","2251"
"33581",144,1216,1072,"TTAAACCAAGCGTAGAACGA","CGCATTATTACTATTTGGTG","561307.5.peg.806","2251"
"33582",991,1216,225,"AACTTGTGTGACGAAGCCTT","CGCATTATTACTATTTGGTG","561307.5.peg.806","2251"
"33583",105,1216,1111,"GCTAAGATAATCCACACAGC","CGCATTATTACTATTTGGTG","561307.5.peg.806","2251"
"33584",707,1216,509,"ATTTATCTAAATCCGCTTGG","CGCATTATTACTATTTGGTG","561307.5.peg.806","2251"
"33585",32,1216,1184,"TCATTGTCACACTCCTATGT","CGCATTATTACTATTTGGTG","561307.5.peg.806","2251"
"33586",186,1216,1030,"ATGTGTCCCGTGTTGCCATA","CGCATTATTACTATTTGGTG","561307.5.peg.806","2251"
"33587",386,1216,830,"TTCATGTGTAAACTTAGAT","CGCATTATTACTATTTGGTG","561307.5.peg.806","2251"
"33588",144,1239,1095,"TTAAACCAAGCGTAGAACGA","CTTTGTGGTGTAGTCGATAC","561307.5.peg.806","2251"
"33589",386,1239,853,"TTCATGTGTAAACTTAGAT","CTTTGTGGTGTAGTCGATAC","561307.5.peg.806","2251"
"33590",105,1239,1134,"GCTAAGATAATCCACACAGC","CTTTGTGGTGTAGTCGATAC","561307.5.peg.806","2251"
"33591",991,1239,248,"AACTTGTGTGACGAAGCCTT","CTTTGTGGTGTAGTCGATAC","561307.5.peg.806","2251"
"33592",186,1239,1053,"ATGTGTCCCGTGTTGCCATA","CTTTGTGGTGTAGTCGATAC","561307.5.peg.806","2251"
"33593",32,1239,1207,"TCATTGTCACACTCCTATGT","CTTTGTGGTGTAGTCGATAC","561307.5.peg.806","2251"
"33594",707,1239,532,"ATTTATCTAAATCCGCTTGG","CTTTGTGGTGTAGTCGATAC","561307.5.peg.806","2251"
"33595",332,201,131,"TTAAAGCGTAGTCATCATCT","TCTAGGGTCATATCCTTGTA","561307.5.peg.807","2252"
"33596",406,201,205,"ATATATAATTTCAGCACCTG","TCTAGGGTCATATCCTTGTA","561307.5.peg.807","2252"
"33597",406,278,128,"ATATATAATTTCAGCACCTG","CTAATACTTTAGTTAGCAGA","561307.5.peg.807","2252"
"33598",201,332,131,"TCTAGGGTCATATCCTTGTA","TTAAAGCGTAGTCATCATCT","561307.5.peg.807","2252"
"33599",201,406,205,"TCTAGGGTCATATCCTTGTA","ATATATAATTTCAGCACCTG","561307.5.peg.807","2252"
"33600",278,406,128,"CTAATACTTTAGTTAGCAGA","ATATATAATTTCAGCACCTG","561307.5.peg.807","2252"
"33601",315,70,245,"ATACGTTGAATTAGACCTCT","TGCAATGCCATTTGGGCATG","561307.5.peg.808","2253"
"33602",660,70,590,"ATAGCGCCGCCAATCATACC","TGCAATGCCATTTGGGCATG","561307.5.peg.808","2253"
"33603",493,70,423,"ACCGCCTAGAGTCAGCGCGA","TGCAATGCCATTTGGGCATG","561307.5.peg.808","2253"
"33604",259,70,189,"CAACCGTTTACCAACAAATC","TGCAATGCCATTTGGGCATG","561307.5.peg.808","2253"
"33605",985,70,915,"TACTGGACCGCCCATATCGA","TGCAATGCCATTTGGGCATG","561307.5.peg.808","2253"
"33606",834,70,764,"ACAACGACCGATGAAATAAT","TGCAATGCCATTTGGGCATG","561307.5.peg.808","2253"
"33607",648,70,578,"ATCATACCAGGAACAAGACC","TGCAATGCCATTTGGGCATG","561307.5.peg.808","2253"
"33608",485,70,415,"GAGTCAGCGCGATGGCGATA","TGCAATGCCATTTGGGCATG","561307.5.peg.808","2253"
"33609",660,259,401,"ATAGCGCCGCCAATCATACC","CAACCGTTTACCAACAAATC","561307.5.peg.808","2253"
"33610",70,259,189,"TGCAATGCCATTTGGGCATG","CAACCGTTTACCAACAAATC","561307.5.peg.808","2253"
"33611",485,259,226,"GAGTCAGCGCGATGGCGATA","CAACCGTTTACCAACAAATC","561307.5.peg.808","2253"
"33612",493,259,234,"ACCGCCTAGAGTCAGCGCGA","CAACCGTTTACCAACAAATC","561307.5.peg.808","2253"
"33613",834,259,575,"ACAACGACCGATGAAATAAT","CAACCGTTTACCAACAAATC","561307.5.peg.808","2253"
"33614",648,259,389,"ATCATACCAGGAACAAGACC","CAACCGTTTACCAACAAATC","561307.5.peg.808","2253"
"33615",985,259,726,"TACTGGACCGCCCATATCGA","CAACCGTTTACCAACAAATC","561307.5.peg.808","2253"
"33616",70,315,245,"TGCAATGCCATTTGGGCATG","ATACGTTGAATTAGACCTCT","561307.5.peg.808","2253"
"33617",493,315,178,"ACCGCCTAGAGTCAGCGCGA","ATACGTTGAATTAGACCTCT","561307.5.peg.808","2253"
"33618",834,315,519,"ACAACGACCGATGAAATAAT","ATACGTTGAATTAGACCTCT","561307.5.peg.808","2253"
"33619",660,315,345,"ATAGCGCCGCCAATCATACC","ATACGTTGAATTAGACCTCT","561307.5.peg.808","2253"
"33620",485,315,170,"GAGTCAGCGCGATGGCGATA","ATACGTTGAATTAGACCTCT","561307.5.peg.808","2253"
"33621",985,315,670,"TACTGGACCGCCCATATCGA","ATACGTTGAATTAGACCTCT","561307.5.peg.808","2253"
"33622",648,315,333,"ATCATACCAGGAACAAGACC","ATACGTTGAATTAGACCTCT","561307.5.peg.808","2253"
"33623",70,485,415,"TGCAATGCCATTTGGGCATG","GAGTCAGCGCGATGGCGATA","561307.5.peg.808","2253"
"33624",259,485,226,"CAACCGTTTACCAACAAATC","GAGTCAGCGCGATGGCGATA","561307.5.peg.808","2253"
"33625",648,485,163,"ATCATACCAGGAACAAGACC","GAGTCAGCGCGATGGCGATA","561307.5.peg.808","2253"
"33626",315,485,170,"ATACGTTGAATTAGACCTCT","GAGTCAGCGCGATGGCGATA","561307.5.peg.808","2253"
"33627",834,485,349,"ACAACGACCGATGAAATAAT","GAGTCAGCGCGATGGCGATA","561307.5.peg.808","2253"
"33628",985,485,500,"TACTGGACCGCCCATATCGA","GAGTCAGCGCGATGGCGATA","561307.5.peg.808","2253"
"33629",660,485,175,"ATAGCGCCGCCAATCATACC","GAGTCAGCGCGATGGCGATA","561307.5.peg.808","2253"
"33630",259,493,234,"CAACCGTTTACCAACAAATC","ACCGCCTAGAGTCAGCGCGA","561307.5.peg.808","2253"
"33631",985,493,492,"TACTGGACCGCCCATATCGA","ACCGCCTAGAGTCAGCGCGA","561307.5.peg.808","2253"
"33632",834,493,341,"ACAACGACCGATGAAATAAT","ACCGCCTAGAGTCAGCGCGA","561307.5.peg.808","2253"
"33633",648,493,155,"ATCATACCAGGAACAAGACC","ACCGCCTAGAGTCAGCGCGA","561307.5.peg.808","2253"
"33634",660,493,167,"ATAGCGCCGCCAATCATACC","ACCGCCTAGAGTCAGCGCGA","561307.5.peg.808","2253"
"33635",315,493,178,"ATACGTTGAATTAGACCTCT","ACCGCCTAGAGTCAGCGCGA","561307.5.peg.808","2253"
"33636",70,493,423,"TGCAATGCCATTTGGGCATG","ACCGCCTAGAGTCAGCGCGA","561307.5.peg.808","2253"
"33637",493,648,155,"ACCGCCTAGAGTCAGCGCGA","ATCATACCAGGAACAAGACC","561307.5.peg.808","2253"
"33638",315,648,333,"ATACGTTGAATTAGACCTCT","ATCATACCAGGAACAAGACC","561307.5.peg.808","2253"
"33639",259,648,389,"CAACCGTTTACCAACAAATC","ATCATACCAGGAACAAGACC","561307.5.peg.808","2253"
"33640",485,648,163,"GAGTCAGCGCGATGGCGATA","ATCATACCAGGAACAAGACC","561307.5.peg.808","2253"
"33641",70,648,578,"TGCAATGCCATTTGGGCATG","ATCATACCAGGAACAAGACC","561307.5.peg.808","2253"
"33642",834,648,186,"ACAACGACCGATGAAATAAT","ATCATACCAGGAACAAGACC","561307.5.peg.808","2253"
"33643",985,648,337,"TACTGGACCGCCCATATCGA","ATCATACCAGGAACAAGACC","561307.5.peg.808","2253"
"33644",70,660,590,"TGCAATGCCATTTGGGCATG","ATAGCGCCGCCAATCATACC","561307.5.peg.808","2253"
"33645",493,660,167,"ACCGCCTAGAGTCAGCGCGA","ATAGCGCCGCCAATCATACC","561307.5.peg.808","2253"
"33646",259,660,401,"CAACCGTTTACCAACAAATC","ATAGCGCCGCCAATCATACC","561307.5.peg.808","2253"
"33647",315,660,345,"ATACGTTGAATTAGACCTCT","ATAGCGCCGCCAATCATACC","561307.5.peg.808","2253"
"33648",485,660,175,"GAGTCAGCGCGATGGCGATA","ATAGCGCCGCCAATCATACC","561307.5.peg.808","2253"
"33649",985,660,325,"TACTGGACCGCCCATATCGA","ATAGCGCCGCCAATCATACC","561307.5.peg.808","2253"
"33650",834,660,174,"ACAACGACCGATGAAATAAT","ATAGCGCCGCCAATCATACC","561307.5.peg.808","2253"
"33651",315,834,519,"ATACGTTGAATTAGACCTCT","ACAACGACCGATGAAATAAT","561307.5.peg.808","2253"
"33652",70,834,764,"TGCAATGCCATTTGGGCATG","ACAACGACCGATGAAATAAT","561307.5.peg.808","2253"
"33653",660,834,174,"ATAGCGCCGCCAATCATACC","ACAACGACCGATGAAATAAT","561307.5.peg.808","2253"
"33654",493,834,341,"ACCGCCTAGAGTCAGCGCGA","ACAACGACCGATGAAATAAT","561307.5.peg.808","2253"
"33655",259,834,575,"CAACCGTTTACCAACAAATC","ACAACGACCGATGAAATAAT","561307.5.peg.808","2253"
"33656",648,834,186,"ATCATACCAGGAACAAGACC","ACAACGACCGATGAAATAAT","561307.5.peg.808","2253"
"33657",485,834,349,"GAGTCAGCGCGATGGCGATA","ACAACGACCGATGAAATAAT","561307.5.peg.808","2253"
"33658",985,834,151,"TACTGGACCGCCCATATCGA","ACAACGACCGATGAAATAAT","561307.5.peg.808","2253"
"33659",648,985,337,"ATCATACCAGGAACAAGACC","TACTGGACCGCCCATATCGA","561307.5.peg.808","2253"
"33660",315,985,670,"ATACGTTGAATTAGACCTCT","TACTGGACCGCCCATATCGA","561307.5.peg.808","2253"
"33661",259,985,726,"CAACCGTTTACCAACAAATC","TACTGGACCGCCCATATCGA","561307.5.peg.808","2253"
"33662",485,985,500,"GAGTCAGCGCGATGGCGATA","TACTGGACCGCCCATATCGA","561307.5.peg.808","2253"
"33663",834,985,151,"ACAACGACCGATGAAATAAT","TACTGGACCGCCCATATCGA","561307.5.peg.808","2253"
"33664",70,985,915,"TGCAATGCCATTTGGGCATG","TACTGGACCGCCCATATCGA","561307.5.peg.808","2253"
"33665",493,985,492,"ACCGCCTAGAGTCAGCGCGA","TACTGGACCGCCCATATCGA","561307.5.peg.808","2253"
"33666",660,985,325,"ATAGCGCCGCCAATCATACC","TACTGGACCGCCCATATCGA","561307.5.peg.808","2253"
"33667",593,96,497,"AATATGCGAAATCATCCTT","TAGAACTAATGTGCTTTGA","561307.5.peg.809","2254"
"33668",593,149,444,"AATATGCGAAATCATCCTT","GGATATCATTGCGAACTGTG","561307.5.peg.809","2254"
"33669",96,593,497,"TAGAACTAATGTGCTTTGA","AATATGCGAAATCATCCTT","561307.5.peg.809","2254"
"33670",149,593,444,"GGATATCATTGCGAACTGTG","AATATGCGAAATCATCCTT","561307.5.peg.809","2254"
"33671",597,97,500,"CTTTCCAATGTGAAATTTC","TGGTGATAAAGTGCTCAACA","561307.5.peg.812","2258"
"33672",755,97,658,"CTTGATGCGTTAAATCTTCT","TGGTGATAAAGTGCTCAACA","561307.5.peg.812","2258"
"33673",336,97,239,"TGTACTTTCACTTCTTTGTC","TGGTGATAAAGTGCTCAACA","561307.5.peg.812","2258"
"33674",97,336,239,"TGGTGATAAAGTGCTCAACA","TGTACTTTCACTTCTTTGTC","561307.5.peg.812","2258"
"33675",597,336,261,"CTTTCCAATGTGAAATTTC","TGTACTTTCACTTCTTTGTC","561307.5.peg.812","2258"
"33676",755,336,419,"CTTGATGCGTTAAATCTTCT","TGTACTTTCACTTCTTTGTC","561307.5.peg.812","2258"
"33677",97,597,500,"TGGTGATAAAGTGCTCAACA","CTTTCCAATGTGAAATTTC","561307.5.peg.812","2258"
"33678",755,597,158,"CTTGATGCGTTAAATCTTCT","CTTTCCAATGTGAAATTTC","561307.5.peg.812","2258"
"33679",336,597,261,"TGTACTTTCACTTCTTTGTC","CTTTCCAATGTGAAATTTC","561307.5.peg.812","2258"
"33680",97,755,658,"TGGTGATAAAGTGCTCAACA","CTTGATGCGTTAAATCTTCT","561307.5.peg.812","2258"
"33681",336,755,419,"TGTACTTTCACTTCTTTGTC","CTTGATGCGTTAAATCTTCT","561307.5.peg.812","2258"
"33682",597,755,158,"CTTTCCAATGTGAAATTTC","CTTGATGCGTTAAATCTTCT","561307.5.peg.812","2258"
"33683",212,11,201,"TCCATGTCTCACAATCGATA","ACAAGAAACGTAACTACCAA","561307.5.peg.813","2259"
"33684",11,212,201,"ACAAGAAACGTAACTACCAA","TCCATGTCTCACAATCGATA","561307.5.peg.813","2259"
"33685",447,257,190,"TCTACTAGATGTGTACATTT","TTTCAGCTGCTAACTTCTCA","561307.5.peg.814","2260"
"33686",489,257,232,"GGCATTGGATCTAAATAGAA","TTTCAGCTGCTAACTTCTCA","561307.5.peg.814","2260"
"33687",534,257,277,"CCGTGTCCTATTGAGGCTTG","TTTCAGCTGCTAACTTCTCA","561307.5.peg.814","2260"
"33688",541,257,284,"TGTTATACCGTGTCCTATTG","TTTCAGCTGCTAACTTCTCA","561307.5.peg.814","2260"
"33689",257,447,190,"TTTCAGCTGCTAACTTCTCA","TCTACTAGATGTGTACATTT","561307.5.peg.814","2260"
"33690",257,489,232,"TTTCAGCTGCTAACTTCTCA","GGCATTGGATCTAAATAGAA","561307.5.peg.814","2260"
"33691",257,534,277,"TTTCAGCTGCTAACTTCTCA","CCGTGTCCTATTGAGGCTTG","561307.5.peg.814","2260"
"33692",257,541,284,"TTTCAGCTGCTAACTTCTCA","TGTTATACCGTGTCCTATTG","561307.5.peg.814","2260"
"33693",438,115,323,"TCTGTTAATCCATTCCACAC","AAGTCCTTCGAATTCTGCTT","561307.5.peg.815","2261"
"33694",115,438,323,"AAGTCCTTCGAATTCTGCTT","TCTGTTAATCCATTCCACAC","561307.5.peg.815","2261"
"33695",163,21,142,"AATAATAATGGCTAATCCAC","CTCCTTTAATACCAATATG","561307.5.peg.816","2262"
"33696",244,21,223,"GTCTAGCTCCGGCCGTTCAT","CTCCTTTAATACCAATATG","561307.5.peg.816","2262"
"33697",255,21,234,"TAAATACCACCGTCTAGCTC","CTCCTTTAATACCAATATG","561307.5.peg.816","2262"
"33698",364,21,343,"TGACATCAATAGTGTTGCAT","CTCCTTTAATACCAATATG","561307.5.peg.816","2262"
"33699",432,21,411,"AACGAGGCGACAATAACACT","CTCCTTTAATACCAATATG","561307.5.peg.816","2262"
"33700",448,21,427,"GACACCCCAGAGTAGTAACG","CTCCTTTAATACCAATATG","561307.5.peg.816","2262"
"33701",432,112,320,"AACGAGGCGACAATAACACT","GAACGCACCGCCACCAATCA","561307.5.peg.816","2262"
"33702",448,112,336,"GACACCCCAGAGTAGTAACG","GAACGCACCGCCACCAATCA","561307.5.peg.816","2262"
"33703",244,112,132,"GTCTAGCTCCGGCCGTTCAT","GAACGCACCGCCACCAATCA","561307.5.peg.816","2262"
"33704",255,112,143,"TAAATACCACCGTCTAGCTC","GAACGCACCGCCACCAATCA","561307.5.peg.816","2262"
"33705",364,112,252,"TGACATCAATAGTGTTGCAT","GAACGCACCGCCACCAATCA","561307.5.peg.816","2262"
"33706",364,163,201,"TGACATCAATAGTGTTGCAT","AATAATAATGGCTAATCCAC","561307.5.peg.816","2262"
"33707",448,163,285,"GACACCCCAGAGTAGTAACG","AATAATAATGGCTAATCCAC","561307.5.peg.816","2262"
"33708",21,163,142,"CTCCTTTAATACCAATATG","AATAATAATGGCTAATCCAC","561307.5.peg.816","2262"
"33709",432,163,269,"AACGAGGCGACAATAACACT","AATAATAATGGCTAATCCAC","561307.5.peg.816","2262"
"33710",21,244,223,"CTCCTTTAATACCAATATG","GTCTAGCTCCGGCCGTTCAT","561307.5.peg.816","2262"
"33711",432,244,188,"AACGAGGCGACAATAACACT","GTCTAGCTCCGGCCGTTCAT","561307.5.peg.816","2262"
"33712",112,244,132,"GAACGCACCGCCACCAATCA","GTCTAGCTCCGGCCGTTCAT","561307.5.peg.816","2262"
"33713",448,244,204,"GACACCCCAGAGTAGTAACG","GTCTAGCTCCGGCCGTTCAT","561307.5.peg.816","2262"
"33714",364,244,120,"TGACATCAATAGTGTTGCAT","GTCTAGCTCCGGCCGTTCAT","561307.5.peg.816","2262"
"33715",21,255,234,"CTCCTTTAATACCAATATG","TAAATACCACCGTCTAGCTC","561307.5.peg.816","2262"
"33716",112,255,143,"GAACGCACCGCCACCAATCA","TAAATACCACCGTCTAGCTC","561307.5.peg.816","2262"
"33717",448,255,193,"GACACCCCAGAGTAGTAACG","TAAATACCACCGTCTAGCTC","561307.5.peg.816","2262"
"33718",432,255,177,"AACGAGGCGACAATAACACT","TAAATACCACCGTCTAGCTC","561307.5.peg.816","2262"
"33719",364,255,109,"TGACATCAATAGTGTTGCAT","TAAATACCACCGTCTAGCTC","561307.5.peg.816","2262"
"33720",112,364,252,"GAACGCACCGCCACCAATCA","TGACATCAATAGTGTTGCAT","561307.5.peg.816","2262"
"33721",244,364,120,"GTCTAGCTCCGGCCGTTCAT","TGACATCAATAGTGTTGCAT","561307.5.peg.816","2262"
"33722",163,364,201,"AATAATAATGGCTAATCCAC","TGACATCAATAGTGTTGCAT","561307.5.peg.816","2262"
"33723",255,364,109,"TAAATACCACCGTCTAGCTC","TGACATCAATAGTGTTGCAT","561307.5.peg.816","2262"
"33724",21,364,343,"CTCCTTTAATACCAATATG","TGACATCAATAGTGTTGCAT","561307.5.peg.816","2262"
"33725",21,432,411,"CTCCTTTAATACCAATATG","AACGAGGCGACAATAACACT","561307.5.peg.816","2262"
"33726",112,432,320,"GAACGCACCGCCACCAATCA","AACGAGGCGACAATAACACT","561307.5.peg.816","2262"
"33727",163,432,269,"AATAATAATGGCTAATCCAC","AACGAGGCGACAATAACACT","561307.5.peg.816","2262"
"33728",255,432,177,"TAAATACCACCGTCTAGCTC","AACGAGGCGACAATAACACT","561307.5.peg.816","2262"
"33729",244,432,188,"GTCTAGCTCCGGCCGTTCAT","AACGAGGCGACAATAACACT","561307.5.peg.816","2262"
"33730",112,448,336,"GAACGCACCGCCACCAATCA","GACACCCCAGAGTAGTAACG","561307.5.peg.816","2262"
"33731",244,448,204,"GTCTAGCTCCGGCCGTTCAT","GACACCCCAGAGTAGTAACG","561307.5.peg.816","2262"
"33732",21,448,427,"CTCCTTTAATACCAATATG","GACACCCCAGAGTAGTAACG","561307.5.peg.816","2262"
"33733",163,448,285,"AATAATAATGGCTAATCCAC","GACACCCCAGAGTAGTAACG","561307.5.peg.816","2262"
"33734",255,448,193,"TAAATACCACCGTCTAGCTC","GACACCCCAGAGTAGTAACG","561307.5.peg.816","2262"
"33735",425,174,251,"AAGGACCAATTGGTTTAGTT","TGTGAAATGACAATACGCGC","561307.5.peg.817","2263"
"33736",489,174,315,"TCTTCTTTAAAGACTGAGTC","TGTGAAATGACAATACGCGC","561307.5.peg.817","2263"
"33737",425,230,195,"AAGGACCAATTGGTTTAGTT","CACTGTTCGATTTAGCTTGT","561307.5.peg.817","2263"
"33738",489,230,259,"TCTTCTTTAAAGACTGAGTC","CACTGTTCGATTTAGCTTGT","561307.5.peg.817","2263"
"33739",425,261,164,"AAGGACCAATTGGTTTAGTT","CAAGTATCCAATGGCATTGC","561307.5.peg.817","2263"
"33740",489,261,228,"TCTTCTTTAAAGACTGAGTC","CAAGTATCCAATGGCATTGC","561307.5.peg.817","2263"
"33741",425,270,155,"AAGGACCAATTGGTTTAGTT","ATTGCACCACAAGTATCCAA","561307.5.peg.817","2263"
"33742",489,270,219,"TCTTCTTTAAAGACTGAGTC","ATTGCACCACAAGTATCCAA","561307.5.peg.817","2263"
"33743",174,425,251,"TGTGAAATGACAATACGCGC","AAGGACCAATTGGTTTAGTT","561307.5.peg.817","2263"
"33744",230,425,195,"CACTGTTCGATTTAGCTTGT","AAGGACCAATTGGTTTAGTT","561307.5.peg.817","2263"
"33745",261,425,164,"CAAGTATCCAATGGCATTGC","AAGGACCAATTGGTTTAGTT","561307.5.peg.817","2263"
"33746",270,425,155,"ATTGCACCACAAGTATCCAA","AAGGACCAATTGGTTTAGTT","561307.5.peg.817","2263"
"33747",174,489,315,"TGTGAAATGACAATACGCGC","TCTTCTTTAAAGACTGAGTC","561307.5.peg.817","2263"
"33748",230,489,259,"CACTGTTCGATTTAGCTTGT","TCTTCTTTAAAGACTGAGTC","561307.5.peg.817","2263"
"33749",261,489,228,"CAAGTATCCAATGGCATTGC","TCTTCTTTAAAGACTGAGTC","561307.5.peg.817","2263"
"33750",270,489,219,"ATTGCACCACAAGTATCCAA","TCTTCTTTAAAGACTGAGTC","561307.5.peg.817","2263"
"33751",339,11,328,"CACAATTCGTTAACCTCTTT","TGACACTTTGCAAGGTTTGA","561307.5.peg.818","2264"
"33752",373,11,362,"CAATCCAAGAACTGTACAAT","TGACACTTTGCAAGGTTTGA","561307.5.peg.818","2264"
"33753",11,339,328,"TGACACTTTGCAAGGTTTGA","CACAATTCGTTAACCTCTTT","561307.5.peg.818","2264"
"33754",11,373,362,"TGACACTTTGCAAGGTTTGA","CAATCCAAGAACTGTACAAT","561307.5.peg.818","2264"
"33755",564,121,443,"ATCGTTTGTGGTGATGATTG","TGCCCCTACTATTACTGATG","561307.5.peg.819","2265"
"33756",834,121,713,"CCATTACCAGTTAAACTATC","TGCCCCTACTATTACTGATG","561307.5.peg.819","2265"
"33757",1040,121,919,"CTGATTTAGGTGCCTTTGCT","TGCCCCTACTATTACTGATG","561307.5.peg.819","2265"
"33758",746,121,625,"ATGTGTTACCACTTTGATTA","TGCCCCTACTATTACTGATG","561307.5.peg.819","2265"
"33759",370,121,249,"TGAAGCTGGCTCTGTTGTAG","TGCCCCTACTATTACTGATG","561307.5.peg.819","2265"
"33760",576,121,455,"TGCGCATTGGAAATCGTTTG","TGCCCCTACTATTACTGATG","561307.5.peg.819","2265"
"33761",612,121,491,"ACAGCTCTCGTTCTAACACT","TGCCCCTACTATTACTGATG","561307.5.peg.819","2265"
"33762",465,121,344,"ACTTGAGAATTTGCTTCTTG","TGCCCCTACTATTACTGATG","561307.5.peg.819","2265"
"33763",657,121,536,"GCATCAGCAGCATTTACTAC","TGCCCCTACTATTACTGATG","561307.5.peg.819","2265"
"33764",1026,121,905,"TTTGCTCGGTCTGTAAATAA","TGCCCCTACTATTACTGATG","561307.5.peg.819","2265"
"33765",121,370,249,"TGCCCCTACTATTACTGATG","TGAAGCTGGCTCTGTTGTAG","561307.5.peg.819","2265"
"33766",834,370,464,"CCATTACCAGTTAAACTATC","TGAAGCTGGCTCTGTTGTAG","561307.5.peg.819","2265"
"33767",746,370,376,"ATGTGTTACCACTTTGATTA","TGAAGCTGGCTCTGTTGTAG","561307.5.peg.819","2265"
"33768",1026,370,656,"TTTGCTCGGTCTGTAAATAA","TGAAGCTGGCTCTGTTGTAG","561307.5.peg.819","2265"
"33769",612,370,242,"ACAGCTCTCGTTCTAACACT","TGAAGCTGGCTCTGTTGTAG","561307.5.peg.819","2265"
"33770",576,370,206,"TGCGCATTGGAAATCGTTTG","TGAAGCTGGCTCTGTTGTAG","561307.5.peg.819","2265"
"33771",564,370,194,"ATCGTTTGTGGTGATGATTG","TGAAGCTGGCTCTGTTGTAG","561307.5.peg.819","2265"
"33772",657,370,287,"GCATCAGCAGCATTTACTAC","TGAAGCTGGCTCTGTTGTAG","561307.5.peg.819","2265"
"33773",1040,370,670,"CTGATTTAGGTGCCTTTGCT","TGAAGCTGGCTCTGTTGTAG","561307.5.peg.819","2265"
"33774",657,465,192,"GCATCAGCAGCATTTACTAC","ACTTGAGAATTTGCTTCTTG","561307.5.peg.819","2265"
"33775",612,465,147,"ACAGCTCTCGTTCTAACACT","ACTTGAGAATTTGCTTCTTG","561307.5.peg.819","2265"
"33776",576,465,111,"TGCGCATTGGAAATCGTTTG","ACTTGAGAATTTGCTTCTTG","561307.5.peg.819","2265"
"33777",834,465,369,"CCATTACCAGTTAAACTATC","ACTTGAGAATTTGCTTCTTG","561307.5.peg.819","2265"
"33778",121,465,344,"TGCCCCTACTATTACTGATG","ACTTGAGAATTTGCTTCTTG","561307.5.peg.819","2265"
"33779",746,465,281,"ATGTGTTACCACTTTGATTA","ACTTGAGAATTTGCTTCTTG","561307.5.peg.819","2265"
"33780",1040,465,575,"CTGATTTAGGTGCCTTTGCT","ACTTGAGAATTTGCTTCTTG","561307.5.peg.819","2265"
"33781",1026,465,561,"TTTGCTCGGTCTGTAAATAA","ACTTGAGAATTTGCTTCTTG","561307.5.peg.819","2265"
"33782",746,564,182,"ATGTGTTACCACTTTGATTA","ATCGTTTGTGGTGATGATTG","561307.5.peg.819","2265"
"33783",370,564,194,"TGAAGCTGGCTCTGTTGTAG","ATCGTTTGTGGTGATGATTG","561307.5.peg.819","2265"
"33784",121,564,443,"TGCCCCTACTATTACTGATG","ATCGTTTGTGGTGATGATTG","561307.5.peg.819","2265"
"33785",1026,564,462,"TTTGCTCGGTCTGTAAATAA","ATCGTTTGTGGTGATGATTG","561307.5.peg.819","2265"
"33786",1040,564,476,"CTGATTTAGGTGCCTTTGCT","ATCGTTTGTGGTGATGATTG","561307.5.peg.819","2265"
"33787",834,564,270,"CCATTACCAGTTAAACTATC","ATCGTTTGTGGTGATGATTG","561307.5.peg.819","2265"
"33788",834,576,258,"CCATTACCAGTTAAACTATC","TGCGCATTGGAAATCGTTTG","561307.5.peg.819","2265"
"33789",121,576,455,"TGCCCCTACTATTACTGATG","TGCGCATTGGAAATCGTTTG","561307.5.peg.819","2265"
"33790",1026,576,450,"TTTGCTCGGTCTGTAAATAA","TGCGCATTGGAAATCGTTTG","561307.5.peg.819","2265"
"33791",370,576,206,"TGAAGCTGGCTCTGTTGTAG","TGCGCATTGGAAATCGTTTG","561307.5.peg.819","2265"
"33792",746,576,170,"ATGTGTTACCACTTTGATTA","TGCGCATTGGAAATCGTTTG","561307.5.peg.819","2265"
"33793",465,576,111,"ACTTGAGAATTTGCTTCTTG","TGCGCATTGGAAATCGTTTG","561307.5.peg.819","2265"
"33794",1040,576,464,"CTGATTTAGGTGCCTTTGCT","TGCGCATTGGAAATCGTTTG","561307.5.peg.819","2265"
"33795",834,612,222,"CCATTACCAGTTAAACTATC","ACAGCTCTCGTTCTAACACT","561307.5.peg.819","2265"
"33796",370,612,242,"TGAAGCTGGCTCTGTTGTAG","ACAGCTCTCGTTCTAACACT","561307.5.peg.819","2265"
"33797",121,612,491,"TGCCCCTACTATTACTGATG","ACAGCTCTCGTTCTAACACT","561307.5.peg.819","2265"
"33798",1026,612,414,"TTTGCTCGGTCTGTAAATAA","ACAGCTCTCGTTCTAACACT","561307.5.peg.819","2265"
"33799",1040,612,428,"CTGATTTAGGTGCCTTTGCT","ACAGCTCTCGTTCTAACACT","561307.5.peg.819","2265"
"33800",465,612,147,"ACTTGAGAATTTGCTTCTTG","ACAGCTCTCGTTCTAACACT","561307.5.peg.819","2265"
"33801",746,612,134,"ATGTGTTACCACTTTGATTA","ACAGCTCTCGTTCTAACACT","561307.5.peg.819","2265"
"33802",1026,657,369,"TTTGCTCGGTCTGTAAATAA","GCATCAGCAGCATTTACTAC","561307.5.peg.819","2265"
"33803",370,657,287,"TGAAGCTGGCTCTGTTGTAG","GCATCAGCAGCATTTACTAC","561307.5.peg.819","2265"
"33804",465,657,192,"ACTTGAGAATTTGCTTCTTG","GCATCAGCAGCATTTACTAC","561307.5.peg.819","2265"
"33805",1040,657,383,"CTGATTTAGGTGCCTTTGCT","GCATCAGCAGCATTTACTAC","561307.5.peg.819","2265"
"33806",834,657,177,"CCATTACCAGTTAAACTATC","GCATCAGCAGCATTTACTAC","561307.5.peg.819","2265"
"33807",121,657,536,"TGCCCCTACTATTACTGATG","GCATCAGCAGCATTTACTAC","561307.5.peg.819","2265"
"33808",465,746,281,"ACTTGAGAATTTGCTTCTTG","ATGTGTTACCACTTTGATTA","561307.5.peg.819","2265"
"33809",370,746,376,"TGAAGCTGGCTCTGTTGTAG","ATGTGTTACCACTTTGATTA","561307.5.peg.819","2265"
"33810",576,746,170,"TGCGCATTGGAAATCGTTTG","ATGTGTTACCACTTTGATTA","561307.5.peg.819","2265"
"33811",121,746,625,"TGCCCCTACTATTACTGATG","ATGTGTTACCACTTTGATTA","561307.5.peg.819","2265"
"33812",1040,746,294,"CTGATTTAGGTGCCTTTGCT","ATGTGTTACCACTTTGATTA","561307.5.peg.819","2265"
"33813",564,746,182,"ATCGTTTGTGGTGATGATTG","ATGTGTTACCACTTTGATTA","561307.5.peg.819","2265"
"33814",612,746,134,"ACAGCTCTCGTTCTAACACT","ATGTGTTACCACTTTGATTA","561307.5.peg.819","2265"
"33815",1026,746,280,"TTTGCTCGGTCTGTAAATAA","ATGTGTTACCACTTTGATTA","561307.5.peg.819","2265"
"33816",121,834,713,"TGCCCCTACTATTACTGATG","CCATTACCAGTTAAACTATC","561307.5.peg.819","2265"
"33817",576,834,258,"TGCGCATTGGAAATCGTTTG","CCATTACCAGTTAAACTATC","561307.5.peg.819","2265"
"33818",465,834,369,"ACTTGAGAATTTGCTTCTTG","CCATTACCAGTTAAACTATC","561307.5.peg.819","2265"
"33819",657,834,177,"GCATCAGCAGCATTTACTAC","CCATTACCAGTTAAACTATC","561307.5.peg.819","2265"
"33820",1040,834,206,"CTGATTTAGGTGCCTTTGCT","CCATTACCAGTTAAACTATC","561307.5.peg.819","2265"
"33821",1026,834,192,"TTTGCTCGGTCTGTAAATAA","CCATTACCAGTTAAACTATC","561307.5.peg.819","2265"
"33822",612,834,222,"ACAGCTCTCGTTCTAACACT","CCATTACCAGTTAAACTATC","561307.5.peg.819","2265"
"33823",564,834,270,"ATCGTTTGTGGTGATGATTG","CCATTACCAGTTAAACTATC","561307.5.peg.819","2265"
"33824",370,834,464,"TGAAGCTGGCTCTGTTGTAG","CCATTACCAGTTAAACTATC","561307.5.peg.819","2265"
"33825",121,1026,905,"TGCCCCTACTATTACTGATG","TTTGCTCGGTCTGTAAATAA","561307.5.peg.819","2265"
"33826",657,1026,369,"GCATCAGCAGCATTTACTAC","TTTGCTCGGTCTGTAAATAA","561307.5.peg.819","2265"
"33827",612,1026,414,"ACAGCTCTCGTTCTAACACT","TTTGCTCGGTCTGTAAATAA","561307.5.peg.819","2265"
"33828",370,1026,656,"TGAAGCTGGCTCTGTTGTAG","TTTGCTCGGTCTGTAAATAA","561307.5.peg.819","2265"
"33829",746,1026,280,"ATGTGTTACCACTTTGATTA","TTTGCTCGGTCTGTAAATAA","561307.5.peg.819","2265"
"33830",564,1026,462,"ATCGTTTGTGGTGATGATTG","TTTGCTCGGTCTGTAAATAA","561307.5.peg.819","2265"
"33831",465,1026,561,"ACTTGAGAATTTGCTTCTTG","TTTGCTCGGTCTGTAAATAA","561307.5.peg.819","2265"
"33832",834,1026,192,"CCATTACCAGTTAAACTATC","TTTGCTCGGTCTGTAAATAA","561307.5.peg.819","2265"
"33833",576,1026,450,"TGCGCATTGGAAATCGTTTG","TTTGCTCGGTCTGTAAATAA","561307.5.peg.819","2265"
"33834",612,1040,428,"ACAGCTCTCGTTCTAACACT","CTGATTTAGGTGCCTTTGCT","561307.5.peg.819","2265"
"33835",746,1040,294,"ATGTGTTACCACTTTGATTA","CTGATTTAGGTGCCTTTGCT","561307.5.peg.819","2265"
"33836",576,1040,464,"TGCGCATTGGAAATCGTTTG","CTGATTTAGGTGCCTTTGCT","561307.5.peg.819","2265"
"33837",564,1040,476,"ATCGTTTGTGGTGATGATTG","CTGATTTAGGTGCCTTTGCT","561307.5.peg.819","2265"
"33838",465,1040,575,"ACTTGAGAATTTGCTTCTTG","CTGATTTAGGTGCCTTTGCT","561307.5.peg.819","2265"
"33839",834,1040,206,"CCATTACCAGTTAAACTATC","CTGATTTAGGTGCCTTTGCT","561307.5.peg.819","2265"
"33840",370,1040,670,"TGAAGCTGGCTCTGTTGTAG","CTGATTTAGGTGCCTTTGCT","561307.5.peg.819","2265"
"33841",657,1040,383,"GCATCAGCAGCATTTACTAC","CTGATTTAGGTGCCTTTGCT","561307.5.peg.819","2265"
"33842",121,1040,919,"TGCCCCTACTATTACTGATG","CTGATTTAGGTGCCTTTGCT","561307.5.peg.819","2265"
"33843",273,120,153,"TATGCGCTATGATCCACATT","TTAAAGAAGCTTTGATCTTC","561307.5.peg.820","2267"
"33844",120,273,153,"TTAAAGAAGCTTTGATCTTC","TATGCGCTATGATCCACATT","561307.5.peg.820","2267"
"33845",129,8,121,"TTATCGGATTGCGCAATTGC","GACATAGTCATATACTCAGG","561307.5.peg.822","2269"
"33846",234,8,226,"CGATAAGCTGTGTTAAATGA","GACATAGTCATATACTCAGG","561307.5.peg.822","2269"
"33847",421,8,413,"CTTGTTACTGTCAACACCGA","GACATAGTCATATACTCAGG","561307.5.peg.822","2269"
"33848",273,8,265,"GGGGTCATTTCTTTAGCATG","GACATAGTCATATACTCAGG","561307.5.peg.822","2269"
"33849",710,8,702,"ACTCCTTACTGTTCGTGGCA","GACATAGTCATATACTCAGG","561307.5.peg.822","2269"
"33850",531,8,523,"ACGTGTGCAGCATATGCTGC","GACATAGTCATATACTCAGG","561307.5.peg.822","2269"
"33851",715,8,707,"TGATAACTCCTTACTGTTCG","GACATAGTCATATACTCAGG","561307.5.peg.822","2269"
"33852",388,8,380,"TGTCTTATGACCAGAACTAA","GACATAGTCATATACTCAGG","561307.5.peg.822","2269"
"33853",129,11,118,"TTATCGGATTGCGCAATTGC","GAAGACATAGTCATATACTC","561307.5.peg.822","2269"
"33854",710,11,699,"ACTCCTTACTGTTCGTGGCA","GAAGACATAGTCATATACTC","561307.5.peg.822","2269"
"33855",421,11,410,"CTTGTTACTGTCAACACCGA","GAAGACATAGTCATATACTC","561307.5.peg.822","2269"
"33856",531,11,520,"ACGTGTGCAGCATATGCTGC","GAAGACATAGTCATATACTC","561307.5.peg.822","2269"
"33857",234,11,223,"CGATAAGCTGTGTTAAATGA","GAAGACATAGTCATATACTC","561307.5.peg.822","2269"
"33858",273,11,262,"GGGGTCATTTCTTTAGCATG","GAAGACATAGTCATATACTC","561307.5.peg.822","2269"
"33859",715,11,704,"TGATAACTCCTTACTGTTCG","GAAGACATAGTCATATACTC","561307.5.peg.822","2269"
"33860",388,11,377,"TGTCTTATGACCAGAACTAA","GAAGACATAGTCATATACTC","561307.5.peg.822","2269"
"33861",421,92,329,"CTTGTTACTGTCAACACCGA","AAACCGTTGACACGATAATA","561307.5.peg.822","2269"
"33862",710,92,618,"ACTCCTTACTGTTCGTGGCA","AAACCGTTGACACGATAATA","561307.5.peg.822","2269"
"33863",531,92,439,"ACGTGTGCAGCATATGCTGC","AAACCGTTGACACGATAATA","561307.5.peg.822","2269"
"33864",715,92,623,"TGATAACTCCTTACTGTTCG","AAACCGTTGACACGATAATA","561307.5.peg.822","2269"
"33865",388,92,296,"TGTCTTATGACCAGAACTAA","AAACCGTTGACACGATAATA","561307.5.peg.822","2269"
"33866",234,92,142,"CGATAAGCTGTGTTAAATGA","AAACCGTTGACACGATAATA","561307.5.peg.822","2269"
"33867",273,92,181,"GGGGTCATTTCTTTAGCATG","AAACCGTTGACACGATAATA","561307.5.peg.822","2269"
"33868",715,129,586,"TGATAACTCCTTACTGTTCG","TTATCGGATTGCGCAATTGC","561307.5.peg.822","2269"
"33869",421,129,292,"CTTGTTACTGTCAACACCGA","TTATCGGATTGCGCAATTGC","561307.5.peg.822","2269"
"33870",11,129,118,"GAAGACATAGTCATATACTC","TTATCGGATTGCGCAATTGC","561307.5.peg.822","2269"
"33871",8,129,121,"GACATAGTCATATACTCAGG","TTATCGGATTGCGCAATTGC","561307.5.peg.822","2269"
"33872",273,129,144,"GGGGTCATTTCTTTAGCATG","TTATCGGATTGCGCAATTGC","561307.5.peg.822","2269"
"33873",710,129,581,"ACTCCTTACTGTTCGTGGCA","TTATCGGATTGCGCAATTGC","561307.5.peg.822","2269"
"33874",531,129,402,"ACGTGTGCAGCATATGCTGC","TTATCGGATTGCGCAATTGC","561307.5.peg.822","2269"
"33875",388,129,259,"TGTCTTATGACCAGAACTAA","TTATCGGATTGCGCAATTGC","561307.5.peg.822","2269"
"33876",234,129,105,"CGATAAGCTGTGTTAAATGA","TTATCGGATTGCGCAATTGC","561307.5.peg.822","2269"
"33877",11,234,223,"GAAGACATAGTCATATACTC","CGATAAGCTGTGTTAAATGA","561307.5.peg.822","2269"
"33878",92,234,142,"AAACCGTTGACACGATAATA","CGATAAGCTGTGTTAAATGA","561307.5.peg.822","2269"
"33879",129,234,105,"TTATCGGATTGCGCAATTGC","CGATAAGCTGTGTTAAATGA","561307.5.peg.822","2269"
"33880",710,234,476,"ACTCCTTACTGTTCGTGGCA","CGATAAGCTGTGTTAAATGA","561307.5.peg.822","2269"
"33881",388,234,154,"TGTCTTATGACCAGAACTAA","CGATAAGCTGTGTTAAATGA","561307.5.peg.822","2269"
"33882",421,234,187,"CTTGTTACTGTCAACACCGA","CGATAAGCTGTGTTAAATGA","561307.5.peg.822","2269"
"33883",531,234,297,"ACGTGTGCAGCATATGCTGC","CGATAAGCTGTGTTAAATGA","561307.5.peg.822","2269"
"33884",715,234,481,"TGATAACTCCTTACTGTTCG","CGATAAGCTGTGTTAAATGA","561307.5.peg.822","2269"
"33885",8,234,226,"GACATAGTCATATACTCAGG","CGATAAGCTGTGTTAAATGA","561307.5.peg.822","2269"
"33886",129,273,144,"TTATCGGATTGCGCAATTGC","GGGGTCATTTCTTTAGCATG","561307.5.peg.822","2269"
"33887",710,273,437,"ACTCCTTACTGTTCGTGGCA","GGGGTCATTTCTTTAGCATG","561307.5.peg.822","2269"
"33888",8,273,265,"GACATAGTCATATACTCAGG","GGGGTCATTTCTTTAGCATG","561307.5.peg.822","2269"
"33889",11,273,262,"GAAGACATAGTCATATACTC","GGGGTCATTTCTTTAGCATG","561307.5.peg.822","2269"
"33890",92,273,181,"AAACCGTTGACACGATAATA","GGGGTCATTTCTTTAGCATG","561307.5.peg.822","2269"
"33891",388,273,115,"TGTCTTATGACCAGAACTAA","GGGGTCATTTCTTTAGCATG","561307.5.peg.822","2269"
"33892",421,273,148,"CTTGTTACTGTCAACACCGA","GGGGTCATTTCTTTAGCATG","561307.5.peg.822","2269"
"33893",715,273,442,"TGATAACTCCTTACTGTTCG","GGGGTCATTTCTTTAGCATG","561307.5.peg.822","2269"
"33894",531,273,258,"ACGTGTGCAGCATATGCTGC","GGGGTCATTTCTTTAGCATG","561307.5.peg.822","2269"
"33895",710,388,322,"ACTCCTTACTGTTCGTGGCA","TGTCTTATGACCAGAACTAA","561307.5.peg.822","2269"
"33896",8,388,380,"GACATAGTCATATACTCAGG","TGTCTTATGACCAGAACTAA","561307.5.peg.822","2269"
"33897",92,388,296,"AAACCGTTGACACGATAATA","TGTCTTATGACCAGAACTAA","561307.5.peg.822","2269"
"33898",234,388,154,"CGATAAGCTGTGTTAAATGA","TGTCTTATGACCAGAACTAA","561307.5.peg.822","2269"
"33899",273,388,115,"GGGGTCATTTCTTTAGCATG","TGTCTTATGACCAGAACTAA","561307.5.peg.822","2269"
"33900",715,388,327,"TGATAACTCCTTACTGTTCG","TGTCTTATGACCAGAACTAA","561307.5.peg.822","2269"
"33901",129,388,259,"TTATCGGATTGCGCAATTGC","TGTCTTATGACCAGAACTAA","561307.5.peg.822","2269"
"33902",11,388,377,"GAAGACATAGTCATATACTC","TGTCTTATGACCAGAACTAA","561307.5.peg.822","2269"
"33903",531,388,143,"ACGTGTGCAGCATATGCTGC","TGTCTTATGACCAGAACTAA","561307.5.peg.822","2269"
"33904",8,421,413,"GACATAGTCATATACTCAGG","CTTGTTACTGTCAACACCGA","561307.5.peg.822","2269"
"33905",710,421,289,"ACTCCTTACTGTTCGTGGCA","CTTGTTACTGTCAACACCGA","561307.5.peg.822","2269"
"33906",273,421,148,"GGGGTCATTTCTTTAGCATG","CTTGTTACTGTCAACACCGA","561307.5.peg.822","2269"
"33907",129,421,292,"TTATCGGATTGCGCAATTGC","CTTGTTACTGTCAACACCGA","561307.5.peg.822","2269"
"33908",92,421,329,"AAACCGTTGACACGATAATA","CTTGTTACTGTCAACACCGA","561307.5.peg.822","2269"
"33909",234,421,187,"CGATAAGCTGTGTTAAATGA","CTTGTTACTGTCAACACCGA","561307.5.peg.822","2269"
"33910",531,421,110,"ACGTGTGCAGCATATGCTGC","CTTGTTACTGTCAACACCGA","561307.5.peg.822","2269"
"33911",11,421,410,"GAAGACATAGTCATATACTC","CTTGTTACTGTCAACACCGA","561307.5.peg.822","2269"
"33912",715,421,294,"TGATAACTCCTTACTGTTCG","CTTGTTACTGTCAACACCGA","561307.5.peg.822","2269"
"33913",8,531,523,"GACATAGTCATATACTCAGG","ACGTGTGCAGCATATGCTGC","561307.5.peg.822","2269"
"33914",421,531,110,"CTTGTTACTGTCAACACCGA","ACGTGTGCAGCATATGCTGC","561307.5.peg.822","2269"
"33915",273,531,258,"GGGGTCATTTCTTTAGCATG","ACGTGTGCAGCATATGCTGC","561307.5.peg.822","2269"
"33916",129,531,402,"TTATCGGATTGCGCAATTGC","ACGTGTGCAGCATATGCTGC","561307.5.peg.822","2269"
"33917",11,531,520,"GAAGACATAGTCATATACTC","ACGTGTGCAGCATATGCTGC","561307.5.peg.822","2269"
"33918",234,531,297,"CGATAAGCTGTGTTAAATGA","ACGTGTGCAGCATATGCTGC","561307.5.peg.822","2269"
"33919",388,531,143,"TGTCTTATGACCAGAACTAA","ACGTGTGCAGCATATGCTGC","561307.5.peg.822","2269"
"33920",92,531,439,"AAACCGTTGACACGATAATA","ACGTGTGCAGCATATGCTGC","561307.5.peg.822","2269"
"33921",715,531,184,"TGATAACTCCTTACTGTTCG","ACGTGTGCAGCATATGCTGC","561307.5.peg.822","2269"
"33922",710,531,179,"ACTCCTTACTGTTCGTGGCA","ACGTGTGCAGCATATGCTGC","561307.5.peg.822","2269"
"33923",92,710,618,"AAACCGTTGACACGATAATA","ACTCCTTACTGTTCGTGGCA","561307.5.peg.822","2269"
"33924",388,710,322,"TGTCTTATGACCAGAACTAA","ACTCCTTACTGTTCGTGGCA","561307.5.peg.822","2269"
"33925",531,710,179,"ACGTGTGCAGCATATGCTGC","ACTCCTTACTGTTCGTGGCA","561307.5.peg.822","2269"
"33926",11,710,699,"GAAGACATAGTCATATACTC","ACTCCTTACTGTTCGTGGCA","561307.5.peg.822","2269"
"33927",129,710,581,"TTATCGGATTGCGCAATTGC","ACTCCTTACTGTTCGTGGCA","561307.5.peg.822","2269"
"33928",8,710,702,"GACATAGTCATATACTCAGG","ACTCCTTACTGTTCGTGGCA","561307.5.peg.822","2269"
"33929",273,710,437,"GGGGTCATTTCTTTAGCATG","ACTCCTTACTGTTCGTGGCA","561307.5.peg.822","2269"
"33930",234,710,476,"CGATAAGCTGTGTTAAATGA","ACTCCTTACTGTTCGTGGCA","561307.5.peg.822","2269"
"33931",421,710,289,"CTTGTTACTGTCAACACCGA","ACTCCTTACTGTTCGTGGCA","561307.5.peg.822","2269"
"33932",273,715,442,"GGGGTCATTTCTTTAGCATG","TGATAACTCCTTACTGTTCG","561307.5.peg.822","2269"
"33933",8,715,707,"GACATAGTCATATACTCAGG","TGATAACTCCTTACTGTTCG","561307.5.peg.822","2269"
"33934",421,715,294,"CTTGTTACTGTCAACACCGA","TGATAACTCCTTACTGTTCG","561307.5.peg.822","2269"
"33935",388,715,327,"TGTCTTATGACCAGAACTAA","TGATAACTCCTTACTGTTCG","561307.5.peg.822","2269"
"33936",92,715,623,"AAACCGTTGACACGATAATA","TGATAACTCCTTACTGTTCG","561307.5.peg.822","2269"
"33937",129,715,586,"TTATCGGATTGCGCAATTGC","TGATAACTCCTTACTGTTCG","561307.5.peg.822","2269"
"33938",234,715,481,"CGATAAGCTGTGTTAAATGA","TGATAACTCCTTACTGTTCG","561307.5.peg.822","2269"
"33939",531,715,184,"ACGTGTGCAGCATATGCTGC","TGATAACTCCTTACTGTTCG","561307.5.peg.822","2269"
"33940",11,715,704,"GAAGACATAGTCATATACTC","TGATAACTCCTTACTGTTCG","561307.5.peg.822","2269"
"33941",128,9,119,"CTTCTAATGGCAAATGATAC","ATGTCGGATATAAAGTATA","561307.5.peg.825","2272"
"33942",9,128,119,"ATGTCGGATATAAAGTATA","CTTCTAATGGCAAATGATAC","561307.5.peg.825","2272"
"33943",415,13,402,"CGCACCAAGTAAGTATCCGC","AGCTTAGCACTTGTGAATGG","561307.5.peg.827","2274"
"33944",498,13,485,"AACATCGCTACAGAGTCAAA","AGCTTAGCACTTGTGAATGG","561307.5.peg.827","2274"
"33945",619,13,606,"TCGTGATATGACACTAGAAT","AGCTTAGCACTTGTGAATGG","561307.5.peg.827","2274"
"33946",970,13,957,"GGTATGATTCATATCACGAT","AGCTTAGCACTTGTGAATGG","561307.5.peg.827","2274"
"33947",597,13,584,"GAACGATGTTGATAAGTTAT","AGCTTAGCACTTGTGAATGG","561307.5.peg.827","2274"
"33948",498,16,482,"AACATCGCTACAGAGTCAAA","GATAGCTTAGCACTTGTGAA","561307.5.peg.827","2274"
"33949",597,16,581,"GAACGATGTTGATAAGTTAT","GATAGCTTAGCACTTGTGAA","561307.5.peg.827","2274"
"33950",415,16,399,"CGCACCAAGTAAGTATCCGC","GATAGCTTAGCACTTGTGAA","561307.5.peg.827","2274"
"33951",619,16,603,"TCGTGATATGACACTAGAAT","GATAGCTTAGCACTTGTGAA","561307.5.peg.827","2274"
"33952",970,16,954,"GGTATGATTCATATCACGAT","GATAGCTTAGCACTTGTGAA","561307.5.peg.827","2274"
"33953",970,415,555,"GGTATGATTCATATCACGAT","CGCACCAAGTAAGTATCCGC","561307.5.peg.827","2274"
"33954",16,415,399,"GATAGCTTAGCACTTGTGAA","CGCACCAAGTAAGTATCCGC","561307.5.peg.827","2274"
"33955",13,415,402,"AGCTTAGCACTTGTGAATGG","CGCACCAAGTAAGTATCCGC","561307.5.peg.827","2274"
"33956",597,415,182,"GAACGATGTTGATAAGTTAT","CGCACCAAGTAAGTATCCGC","561307.5.peg.827","2274"
"33957",619,415,204,"TCGTGATATGACACTAGAAT","CGCACCAAGTAAGTATCCGC","561307.5.peg.827","2274"
"33958",13,498,485,"AGCTTAGCACTTGTGAATGG","AACATCGCTACAGAGTCAAA","561307.5.peg.827","2274"
"33959",16,498,482,"GATAGCTTAGCACTTGTGAA","AACATCGCTACAGAGTCAAA","561307.5.peg.827","2274"
"33960",619,498,121,"TCGTGATATGACACTAGAAT","AACATCGCTACAGAGTCAAA","561307.5.peg.827","2274"
"33961",970,498,472,"GGTATGATTCATATCACGAT","AACATCGCTACAGAGTCAAA","561307.5.peg.827","2274"
"33962",13,597,584,"AGCTTAGCACTTGTGAATGG","GAACGATGTTGATAAGTTAT","561307.5.peg.827","2274"
"33963",970,597,373,"GGTATGATTCATATCACGAT","GAACGATGTTGATAAGTTAT","561307.5.peg.827","2274"
"33964",16,597,581,"GATAGCTTAGCACTTGTGAA","GAACGATGTTGATAAGTTAT","561307.5.peg.827","2274"
"33965",415,597,182,"CGCACCAAGTAAGTATCCGC","GAACGATGTTGATAAGTTAT","561307.5.peg.827","2274"
"33966",16,619,603,"GATAGCTTAGCACTTGTGAA","TCGTGATATGACACTAGAAT","561307.5.peg.827","2274"
"33967",415,619,204,"CGCACCAAGTAAGTATCCGC","TCGTGATATGACACTAGAAT","561307.5.peg.827","2274"
"33968",13,619,606,"AGCTTAGCACTTGTGAATGG","TCGTGATATGACACTAGAAT","561307.5.peg.827","2274"
"33969",970,619,351,"GGTATGATTCATATCACGAT","TCGTGATATGACACTAGAAT","561307.5.peg.827","2274"
"33970",498,619,121,"AACATCGCTACAGAGTCAAA","TCGTGATATGACACTAGAAT","561307.5.peg.827","2274"
"33971",415,970,555,"CGCACCAAGTAAGTATCCGC","GGTATGATTCATATCACGAT","561307.5.peg.827","2274"
"33972",13,970,957,"AGCTTAGCACTTGTGAATGG","GGTATGATTCATATCACGAT","561307.5.peg.827","2274"
"33973",498,970,472,"AACATCGCTACAGAGTCAAA","GGTATGATTCATATCACGAT","561307.5.peg.827","2274"
"33974",16,970,954,"GATAGCTTAGCACTTGTGAA","GGTATGATTCATATCACGAT","561307.5.peg.827","2274"
"33975",619,970,351,"TCGTGATATGACACTAGAAT","GGTATGATTCATATCACGAT","561307.5.peg.827","2274"
"33976",597,970,373,"GAACGATGTTGATAAGTTAT","GGTATGATTCATATCACGAT","561307.5.peg.827","2274"
"33977",234,66,168,"TCGCCACCCCATTGAGGCAT","ATTTATAATCCCCAACATC","561307.5.peg.83","2277"
"33978",180,66,114,"CGGAAATCTAACATCCATTC","ATTTATAATCCCCAACATC","561307.5.peg.83","2277"
"33979",656,66,590,"CCATGTTCTCAGAGTTAATA","ATTTATAATCCCCAACATC","561307.5.peg.83","2277"
"33980",639,66,573,"ATACGGAAATAAGCTTGTAG","ATTTATAATCCCCAACATC","561307.5.peg.83","2277"
"33981",240,66,174,"GATAAGTCGCCACCCCATTG","ATTTATAATCCCCAACATC","561307.5.peg.83","2277"
"33982",300,66,234,"GAACGTTCAGCTTGTTCTGA","ATTTATAATCCCCAACATC","561307.5.peg.83","2277"
"33983",546,66,480,"GCAAATTTGTTATCTGCTGC","ATTTATAATCCCCAACATC","561307.5.peg.83","2277"
"33984",300,95,205,"GAACGTTCAGCTTGTTCTGA","AAATGGACACATCATCGTCG","561307.5.peg.83","2277"
"33985",639,95,544,"ATACGGAAATAAGCTTGTAG","AAATGGACACATCATCGTCG","561307.5.peg.83","2277"
"33986",546,95,451,"GCAAATTTGTTATCTGCTGC","AAATGGACACATCATCGTCG","561307.5.peg.83","2277"
"33987",240,95,145,"GATAAGTCGCCACCCCATTG","AAATGGACACATCATCGTCG","561307.5.peg.83","2277"
"33988",234,95,139,"TCGCCACCCCATTGAGGCAT","AAATGGACACATCATCGTCG","561307.5.peg.83","2277"
"33989",656,95,561,"CCATGTTCTCAGAGTTAATA","AAATGGACACATCATCGTCG","561307.5.peg.83","2277"
"33990",66,180,114,"ATTTATAATCCCCAACATC","CGGAAATCTAACATCCATTC","561307.5.peg.83","2277"
"33991",639,180,459,"ATACGGAAATAAGCTTGTAG","CGGAAATCTAACATCCATTC","561307.5.peg.83","2277"
"33992",656,180,476,"CCATGTTCTCAGAGTTAATA","CGGAAATCTAACATCCATTC","561307.5.peg.83","2277"
"33993",300,180,120,"GAACGTTCAGCTTGTTCTGA","CGGAAATCTAACATCCATTC","561307.5.peg.83","2277"
"33994",546,180,366,"GCAAATTTGTTATCTGCTGC","CGGAAATCTAACATCCATTC","561307.5.peg.83","2277"
"33995",639,234,405,"ATACGGAAATAAGCTTGTAG","TCGCCACCCCATTGAGGCAT","561307.5.peg.83","2277"
"33996",95,234,139,"AAATGGACACATCATCGTCG","TCGCCACCCCATTGAGGCAT","561307.5.peg.83","2277"
"33997",66,234,168,"ATTTATAATCCCCAACATC","TCGCCACCCCATTGAGGCAT","561307.5.peg.83","2277"
"33998",546,234,312,"GCAAATTTGTTATCTGCTGC","TCGCCACCCCATTGAGGCAT","561307.5.peg.83","2277"
"33999",656,234,422,"CCATGTTCTCAGAGTTAATA","TCGCCACCCCATTGAGGCAT","561307.5.peg.83","2277"
"34000",639,240,399,"ATACGGAAATAAGCTTGTAG","GATAAGTCGCCACCCCATTG","561307.5.peg.83","2277"
"34001",66,240,174,"ATTTATAATCCCCAACATC","GATAAGTCGCCACCCCATTG","561307.5.peg.83","2277"
"34002",656,240,416,"CCATGTTCTCAGAGTTAATA","GATAAGTCGCCACCCCATTG","561307.5.peg.83","2277"
"34003",546,240,306,"GCAAATTTGTTATCTGCTGC","GATAAGTCGCCACCCCATTG","561307.5.peg.83","2277"
"34004",95,240,145,"AAATGGACACATCATCGTCG","GATAAGTCGCCACCCCATTG","561307.5.peg.83","2277"
"34005",66,300,234,"ATTTATAATCCCCAACATC","GAACGTTCAGCTTGTTCTGA","561307.5.peg.83","2277"
"34006",546,300,246,"GCAAATTTGTTATCTGCTGC","GAACGTTCAGCTTGTTCTGA","561307.5.peg.83","2277"
"34007",639,300,339,"ATACGGAAATAAGCTTGTAG","GAACGTTCAGCTTGTTCTGA","561307.5.peg.83","2277"
"34008",180,300,120,"CGGAAATCTAACATCCATTC","GAACGTTCAGCTTGTTCTGA","561307.5.peg.83","2277"
"34009",95,300,205,"AAATGGACACATCATCGTCG","GAACGTTCAGCTTGTTCTGA","561307.5.peg.83","2277"
"34010",656,300,356,"CCATGTTCTCAGAGTTAATA","GAACGTTCAGCTTGTTCTGA","561307.5.peg.83","2277"
"34011",66,546,480,"ATTTATAATCCCCAACATC","GCAAATTTGTTATCTGCTGC","561307.5.peg.83","2277"
"34012",95,546,451,"AAATGGACACATCATCGTCG","GCAAATTTGTTATCTGCTGC","561307.5.peg.83","2277"
"34013",240,546,306,"GATAAGTCGCCACCCCATTG","GCAAATTTGTTATCTGCTGC","561307.5.peg.83","2277"
"34014",300,546,246,"GAACGTTCAGCTTGTTCTGA","GCAAATTTGTTATCTGCTGC","561307.5.peg.83","2277"
"34015",234,546,312,"TCGCCACCCCATTGAGGCAT","GCAAATTTGTTATCTGCTGC","561307.5.peg.83","2277"
"34016",656,546,110,"CCATGTTCTCAGAGTTAATA","GCAAATTTGTTATCTGCTGC","561307.5.peg.83","2277"
"34017",180,546,366,"CGGAAATCTAACATCCATTC","GCAAATTTGTTATCTGCTGC","561307.5.peg.83","2277"
"34018",95,639,544,"AAATGGACACATCATCGTCG","ATACGGAAATAAGCTTGTAG","561307.5.peg.83","2277"
"34019",66,639,573,"ATTTATAATCCCCAACATC","ATACGGAAATAAGCTTGTAG","561307.5.peg.83","2277"
"34020",300,639,339,"GAACGTTCAGCTTGTTCTGA","ATACGGAAATAAGCTTGTAG","561307.5.peg.83","2277"
"34021",240,639,399,"GATAAGTCGCCACCCCATTG","ATACGGAAATAAGCTTGTAG","561307.5.peg.83","2277"
"34022",234,639,405,"TCGCCACCCCATTGAGGCAT","ATACGGAAATAAGCTTGTAG","561307.5.peg.83","2277"
"34023",180,639,459,"CGGAAATCTAACATCCATTC","ATACGGAAATAAGCTTGTAG","561307.5.peg.83","2277"
"34024",66,656,590,"ATTTATAATCCCCAACATC","CCATGTTCTCAGAGTTAATA","561307.5.peg.83","2277"
"34025",240,656,416,"GATAAGTCGCCACCCCATTG","CCATGTTCTCAGAGTTAATA","561307.5.peg.83","2277"
"34026",300,656,356,"GAACGTTCAGCTTGTTCTGA","CCATGTTCTCAGAGTTAATA","561307.5.peg.83","2277"
"34027",95,656,561,"AAATGGACACATCATCGTCG","CCATGTTCTCAGAGTTAATA","561307.5.peg.83","2277"
"34028",234,656,422,"TCGCCACCCCATTGAGGCAT","CCATGTTCTCAGAGTTAATA","561307.5.peg.83","2277"
"34029",180,656,476,"CGGAAATCTAACATCCATTC","CCATGTTCTCAGAGTTAATA","561307.5.peg.83","2277"
"34030",546,656,110,"GCAAATTTGTTATCTGCTGC","CCATGTTCTCAGAGTTAATA","561307.5.peg.83","2277"
"34031",498,134,364,"AAGAAATCCCATGCATTATC","AACCACTAAGCCACTGTTGT","561307.5.peg.830","2278"
"34032",745,134,611,"ACTTTGAATACCTTCTGATG","AACCACTAAGCCACTGTTGT","561307.5.peg.830","2278"
"34033",288,134,154,"CGCTGATTAGCTTCGATATG","AACCACTAAGCCACTGTTGT","561307.5.peg.830","2278"
"34034",495,134,361,"AAATCCCATGCATTATCAGG","AACCACTAAGCCACTGTTGT","561307.5.peg.830","2278"
"34035",833,134,699,"TATTCGCTAATACTTCTGCT","AACCACTAAGCCACTGTTGT","561307.5.peg.830","2278"
"34036",936,134,802,"AATGCTACTATACAATCTCC","AACCACTAAGCCACTGTTGT","561307.5.peg.830","2278"
"34037",828,134,694,"GCTAATACTTCTGCTTGGTA","AACCACTAAGCCACTGTTGT","561307.5.peg.830","2278"
"34038",498,288,210,"AAGAAATCCCATGCATTATC","CGCTGATTAGCTTCGATATG","561307.5.peg.830","2278"
"34039",134,288,154,"AACCACTAAGCCACTGTTGT","CGCTGATTAGCTTCGATATG","561307.5.peg.830","2278"
"34040",833,288,545,"TATTCGCTAATACTTCTGCT","CGCTGATTAGCTTCGATATG","561307.5.peg.830","2278"
"34041",495,288,207,"AAATCCCATGCATTATCAGG","CGCTGATTAGCTTCGATATG","561307.5.peg.830","2278"
"34042",936,288,648,"AATGCTACTATACAATCTCC","CGCTGATTAGCTTCGATATG","561307.5.peg.830","2278"
"34043",828,288,540,"GCTAATACTTCTGCTTGGTA","CGCTGATTAGCTTCGATATG","561307.5.peg.830","2278"
"34044",745,288,457,"ACTTTGAATACCTTCTGATG","CGCTGATTAGCTTCGATATG","561307.5.peg.830","2278"
"34045",833,495,338,"TATTCGCTAATACTTCTGCT","AAATCCCATGCATTATCAGG","561307.5.peg.830","2278"
"34046",745,495,250,"ACTTTGAATACCTTCTGATG","AAATCCCATGCATTATCAGG","561307.5.peg.830","2278"
"34047",828,495,333,"GCTAATACTTCTGCTTGGTA","AAATCCCATGCATTATCAGG","561307.5.peg.830","2278"
"34048",134,495,361,"AACCACTAAGCCACTGTTGT","AAATCCCATGCATTATCAGG","561307.5.peg.830","2278"
"34049",288,495,207,"CGCTGATTAGCTTCGATATG","AAATCCCATGCATTATCAGG","561307.5.peg.830","2278"
"34050",936,495,441,"AATGCTACTATACAATCTCC","AAATCCCATGCATTATCAGG","561307.5.peg.830","2278"
"34051",936,498,438,"AATGCTACTATACAATCTCC","AAGAAATCCCATGCATTATC","561307.5.peg.830","2278"
"34052",828,498,330,"GCTAATACTTCTGCTTGGTA","AAGAAATCCCATGCATTATC","561307.5.peg.830","2278"
"34053",745,498,247,"ACTTTGAATACCTTCTGATG","AAGAAATCCCATGCATTATC","561307.5.peg.830","2278"
"34054",288,498,210,"CGCTGATTAGCTTCGATATG","AAGAAATCCCATGCATTATC","561307.5.peg.830","2278"
"34055",134,498,364,"AACCACTAAGCCACTGTTGT","AAGAAATCCCATGCATTATC","561307.5.peg.830","2278"
"34056",833,498,335,"TATTCGCTAATACTTCTGCT","AAGAAATCCCATGCATTATC","561307.5.peg.830","2278"
"34057",134,745,611,"AACCACTAAGCCACTGTTGT","ACTTTGAATACCTTCTGATG","561307.5.peg.830","2278"
"34058",288,745,457,"CGCTGATTAGCTTCGATATG","ACTTTGAATACCTTCTGATG","561307.5.peg.830","2278"
"34059",498,745,247,"AAGAAATCCCATGCATTATC","ACTTTGAATACCTTCTGATG","561307.5.peg.830","2278"
"34060",495,745,250,"AAATCCCATGCATTATCAGG","ACTTTGAATACCTTCTGATG","561307.5.peg.830","2278"
"34061",936,745,191,"AATGCTACTATACAATCTCC","ACTTTGAATACCTTCTGATG","561307.5.peg.830","2278"
"34062",498,828,330,"AAGAAATCCCATGCATTATC","GCTAATACTTCTGCTTGGTA","561307.5.peg.830","2278"
"34063",288,828,540,"CGCTGATTAGCTTCGATATG","GCTAATACTTCTGCTTGGTA","561307.5.peg.830","2278"
"34064",134,828,694,"AACCACTAAGCCACTGTTGT","GCTAATACTTCTGCTTGGTA","561307.5.peg.830","2278"
"34065",936,828,108,"AATGCTACTATACAATCTCC","GCTAATACTTCTGCTTGGTA","561307.5.peg.830","2278"
"34066",495,828,333,"AAATCCCATGCATTATCAGG","GCTAATACTTCTGCTTGGTA","561307.5.peg.830","2278"
"34067",134,833,699,"AACCACTAAGCCACTGTTGT","TATTCGCTAATACTTCTGCT","561307.5.peg.830","2278"
"34068",495,833,338,"AAATCCCATGCATTATCAGG","TATTCGCTAATACTTCTGCT","561307.5.peg.830","2278"
"34069",936,833,103,"AATGCTACTATACAATCTCC","TATTCGCTAATACTTCTGCT","561307.5.peg.830","2278"
"34070",288,833,545,"CGCTGATTAGCTTCGATATG","TATTCGCTAATACTTCTGCT","561307.5.peg.830","2278"
"34071",498,833,335,"AAGAAATCCCATGCATTATC","TATTCGCTAATACTTCTGCT","561307.5.peg.830","2278"
"34072",498,936,438,"AAGAAATCCCATGCATTATC","AATGCTACTATACAATCTCC","561307.5.peg.830","2278"
"34073",495,936,441,"AAATCCCATGCATTATCAGG","AATGCTACTATACAATCTCC","561307.5.peg.830","2278"
"34074",828,936,108,"GCTAATACTTCTGCTTGGTA","AATGCTACTATACAATCTCC","561307.5.peg.830","2278"
"34075",833,936,103,"TATTCGCTAATACTTCTGCT","AATGCTACTATACAATCTCC","561307.5.peg.830","2278"
"34076",288,936,648,"CGCTGATTAGCTTCGATATG","AATGCTACTATACAATCTCC","561307.5.peg.830","2278"
"34077",745,936,191,"ACTTTGAATACCTTCTGATG","AATGCTACTATACAATCTCC","561307.5.peg.830","2278"
"34078",134,936,802,"AACCACTAAGCCACTGTTGT","AATGCTACTATACAATCTCC","561307.5.peg.830","2278"
"34079",394,138,256,"CGCACCGGCCCCATCTAATT","ATGATTGTCATACCTACAAC","561307.5.peg.832","2280"
"34080",531,138,393,"CGAGCCATTGGACCTCCCCA","ATGATTGTCATACCTACAAC","561307.5.peg.832","2280"
"34081",312,138,174,"AATATTAAGCGTTTGACAAG","ATGATTGTCATACCTACAAC","561307.5.peg.832","2280"
"34082",543,138,405,"ACTGCAGCTACACGAGCCAT","ATGATTGTCATACCTACAAC","561307.5.peg.832","2280"
"34083",138,312,174,"ATGATTGTCATACCTACAAC","AATATTAAGCGTTTGACAAG","561307.5.peg.832","2280"
"34084",531,312,219,"CGAGCCATTGGACCTCCCCA","AATATTAAGCGTTTGACAAG","561307.5.peg.832","2280"
"34085",543,312,231,"ACTGCAGCTACACGAGCCAT","AATATTAAGCGTTTGACAAG","561307.5.peg.832","2280"
"34086",138,394,256,"ATGATTGTCATACCTACAAC","CGCACCGGCCCCATCTAATT","561307.5.peg.832","2280"
"34087",531,394,137,"CGAGCCATTGGACCTCCCCA","CGCACCGGCCCCATCTAATT","561307.5.peg.832","2280"
"34088",543,394,149,"ACTGCAGCTACACGAGCCAT","CGCACCGGCCCCATCTAATT","561307.5.peg.832","2280"
"34089",394,531,137,"CGCACCGGCCCCATCTAATT","CGAGCCATTGGACCTCCCCA","561307.5.peg.832","2280"
"34090",138,531,393,"ATGATTGTCATACCTACAAC","CGAGCCATTGGACCTCCCCA","561307.5.peg.832","2280"
"34091",312,531,219,"AATATTAAGCGTTTGACAAG","CGAGCCATTGGACCTCCCCA","561307.5.peg.832","2280"
"34092",138,543,405,"ATGATTGTCATACCTACAAC","ACTGCAGCTACACGAGCCAT","561307.5.peg.832","2280"
"34093",312,543,231,"AATATTAAGCGTTTGACAAG","ACTGCAGCTACACGAGCCAT","561307.5.peg.832","2280"
"34094",394,543,149,"CGCACCGGCCCCATCTAATT","ACTGCAGCTACACGAGCCAT","561307.5.peg.832","2280"
"34095",403,5,398,"TATTGACTGCTAGAAACAT","ACACAATATATAGGAAGAAG","561307.5.peg.833","2281"
"34096",792,5,787,"ATGTCATAGTTCGGATCTTG","ACACAATATATAGGAAGAAG","561307.5.peg.833","2281"
"34097",933,5,928,"CCTTCCGCATCTTTCCAACT","ACACAATATATAGGAAGAAG","561307.5.peg.833","2281"
"34098",267,5,262,"CAGTTAGTTAACGGTTGGAA","ACACAATATATAGGAAGAAG","561307.5.peg.833","2281"
"34099",272,5,267,"AACAACAGTTAGTTAACGGT","ACACAATATATAGGAAGAAG","561307.5.peg.833","2281"
"34100",443,5,438,"TACTAAGTAATTCGTCAACG","ACACAATATATAGGAAGAAG","561307.5.peg.833","2281"
"34101",781,5,776,"CGGATCTTGCGGACTAAAGT","ACACAATATATAGGAAGAAG","561307.5.peg.833","2281"
"34102",204,5,199,"TGTGCATCTGCAACGTGCTT","ACACAATATATAGGAAGAAG","561307.5.peg.833","2281"
"34103",801,5,796,"GTTGTTTAATGTCATAGTT","ACACAATATATAGGAAGAAG","561307.5.peg.833","2281"
"34104",267,7,260,"CAGTTAGTTAACGGTTGGAA","GACACAATATATAGGAAGA","561307.5.peg.833","2281"
"34105",204,7,197,"TGTGCATCTGCAACGTGCTT","GACACAATATATAGGAAGA","561307.5.peg.833","2281"
"34106",933,7,926,"CCTTCCGCATCTTTCCAACT","GACACAATATATAGGAAGA","561307.5.peg.833","2281"
"34107",403,7,396,"TATTGACTGCTAGAAACAT","GACACAATATATAGGAAGA","561307.5.peg.833","2281"
"34108",272,7,265,"AACAACAGTTAGTTAACGGT","GACACAATATATAGGAAGA","561307.5.peg.833","2281"
"34109",443,7,436,"TACTAAGTAATTCGTCAACG","GACACAATATATAGGAAGA","561307.5.peg.833","2281"
"34110",792,7,785,"ATGTCATAGTTCGGATCTTG","GACACAATATATAGGAAGA","561307.5.peg.833","2281"
"34111",781,7,774,"CGGATCTTGCGGACTAAAGT","GACACAATATATAGGAAGA","561307.5.peg.833","2281"
"34112",801,7,794,"GTTGTTTAATGTCATAGTT","GACACAATATATAGGAAGA","561307.5.peg.833","2281"
"34113",403,204,199,"TATTGACTGCTAGAAACAT","TGTGCATCTGCAACGTGCTT","561307.5.peg.833","2281"
"34114",933,204,729,"CCTTCCGCATCTTTCCAACT","TGTGCATCTGCAACGTGCTT","561307.5.peg.833","2281"
"34115",7,204,197,"GACACAATATATAGGAAGA","TGTGCATCTGCAACGTGCTT","561307.5.peg.833","2281"
"34116",443,204,239,"TACTAAGTAATTCGTCAACG","TGTGCATCTGCAACGTGCTT","561307.5.peg.833","2281"
"34117",801,204,597,"GTTGTTTAATGTCATAGTT","TGTGCATCTGCAACGTGCTT","561307.5.peg.833","2281"
"34118",792,204,588,"ATGTCATAGTTCGGATCTTG","TGTGCATCTGCAACGTGCTT","561307.5.peg.833","2281"
"34119",5,204,199,"ACACAATATATAGGAAGAAG","TGTGCATCTGCAACGTGCTT","561307.5.peg.833","2281"
"34120",781,204,577,"CGGATCTTGCGGACTAAAGT","TGTGCATCTGCAACGTGCTT","561307.5.peg.833","2281"
"34121",781,267,514,"CGGATCTTGCGGACTAAAGT","CAGTTAGTTAACGGTTGGAA","561307.5.peg.833","2281"
"34122",7,267,260,"GACACAATATATAGGAAGA","CAGTTAGTTAACGGTTGGAA","561307.5.peg.833","2281"
"34123",801,267,534,"GTTGTTTAATGTCATAGTT","CAGTTAGTTAACGGTTGGAA","561307.5.peg.833","2281"
"34124",933,267,666,"CCTTCCGCATCTTTCCAACT","CAGTTAGTTAACGGTTGGAA","561307.5.peg.833","2281"
"34125",5,267,262,"ACACAATATATAGGAAGAAG","CAGTTAGTTAACGGTTGGAA","561307.5.peg.833","2281"
"34126",403,267,136,"TATTGACTGCTAGAAACAT","CAGTTAGTTAACGGTTGGAA","561307.5.peg.833","2281"
"34127",443,267,176,"TACTAAGTAATTCGTCAACG","CAGTTAGTTAACGGTTGGAA","561307.5.peg.833","2281"
"34128",792,267,525,"ATGTCATAGTTCGGATCTTG","CAGTTAGTTAACGGTTGGAA","561307.5.peg.833","2281"
"34129",5,272,267,"ACACAATATATAGGAAGAAG","AACAACAGTTAGTTAACGGT","561307.5.peg.833","2281"
"34130",933,272,661,"CCTTCCGCATCTTTCCAACT","AACAACAGTTAGTTAACGGT","561307.5.peg.833","2281"
"34131",781,272,509,"CGGATCTTGCGGACTAAAGT","AACAACAGTTAGTTAACGGT","561307.5.peg.833","2281"
"34132",403,272,131,"TATTGACTGCTAGAAACAT","AACAACAGTTAGTTAACGGT","561307.5.peg.833","2281"
"34133",801,272,529,"GTTGTTTAATGTCATAGTT","AACAACAGTTAGTTAACGGT","561307.5.peg.833","2281"
"34134",443,272,171,"TACTAAGTAATTCGTCAACG","AACAACAGTTAGTTAACGGT","561307.5.peg.833","2281"
"34135",7,272,265,"GACACAATATATAGGAAGA","AACAACAGTTAGTTAACGGT","561307.5.peg.833","2281"
"34136",792,272,520,"ATGTCATAGTTCGGATCTTG","AACAACAGTTAGTTAACGGT","561307.5.peg.833","2281"
"34137",7,403,396,"GACACAATATATAGGAAGA","TATTGACTGCTAGAAACAT","561307.5.peg.833","2281"
"34138",267,403,136,"CAGTTAGTTAACGGTTGGAA","TATTGACTGCTAGAAACAT","561307.5.peg.833","2281"
"34139",801,403,398,"GTTGTTTAATGTCATAGTT","TATTGACTGCTAGAAACAT","561307.5.peg.833","2281"
"34140",272,403,131,"AACAACAGTTAGTTAACGGT","TATTGACTGCTAGAAACAT","561307.5.peg.833","2281"
"34141",204,403,199,"TGTGCATCTGCAACGTGCTT","TATTGACTGCTAGAAACAT","561307.5.peg.833","2281"
"34142",792,403,389,"ATGTCATAGTTCGGATCTTG","TATTGACTGCTAGAAACAT","561307.5.peg.833","2281"
"34143",5,403,398,"ACACAATATATAGGAAGAAG","TATTGACTGCTAGAAACAT","561307.5.peg.833","2281"
"34144",933,403,530,"CCTTCCGCATCTTTCCAACT","TATTGACTGCTAGAAACAT","561307.5.peg.833","2281"
"34145",781,403,378,"CGGATCTTGCGGACTAAAGT","TATTGACTGCTAGAAACAT","561307.5.peg.833","2281"
"34146",801,443,358,"GTTGTTTAATGTCATAGTT","TACTAAGTAATTCGTCAACG","561307.5.peg.833","2281"
"34147",272,443,171,"AACAACAGTTAGTTAACGGT","TACTAAGTAATTCGTCAACG","561307.5.peg.833","2281"
"34148",5,443,438,"ACACAATATATAGGAAGAAG","TACTAAGTAATTCGTCAACG","561307.5.peg.833","2281"
"34149",7,443,436,"GACACAATATATAGGAAGA","TACTAAGTAATTCGTCAACG","561307.5.peg.833","2281"
"34150",792,443,349,"ATGTCATAGTTCGGATCTTG","TACTAAGTAATTCGTCAACG","561307.5.peg.833","2281"
"34151",933,443,490,"CCTTCCGCATCTTTCCAACT","TACTAAGTAATTCGTCAACG","561307.5.peg.833","2281"
"34152",204,443,239,"TGTGCATCTGCAACGTGCTT","TACTAAGTAATTCGTCAACG","561307.5.peg.833","2281"
"34153",781,443,338,"CGGATCTTGCGGACTAAAGT","TACTAAGTAATTCGTCAACG","561307.5.peg.833","2281"
"34154",267,443,176,"CAGTTAGTTAACGGTTGGAA","TACTAAGTAATTCGTCAACG","561307.5.peg.833","2281"
"34155",5,781,776,"ACACAATATATAGGAAGAAG","CGGATCTTGCGGACTAAAGT","561307.5.peg.833","2281"
"34156",7,781,774,"GACACAATATATAGGAAGA","CGGATCTTGCGGACTAAAGT","561307.5.peg.833","2281"
"34157",204,781,577,"TGTGCATCTGCAACGTGCTT","CGGATCTTGCGGACTAAAGT","561307.5.peg.833","2281"
"34158",443,781,338,"TACTAAGTAATTCGTCAACG","CGGATCTTGCGGACTAAAGT","561307.5.peg.833","2281"
"34159",403,781,378,"TATTGACTGCTAGAAACAT","CGGATCTTGCGGACTAAAGT","561307.5.peg.833","2281"
"34160",267,781,514,"CAGTTAGTTAACGGTTGGAA","CGGATCTTGCGGACTAAAGT","561307.5.peg.833","2281"
"34161",272,781,509,"AACAACAGTTAGTTAACGGT","CGGATCTTGCGGACTAAAGT","561307.5.peg.833","2281"
"34162",933,781,152,"CCTTCCGCATCTTTCCAACT","CGGATCTTGCGGACTAAAGT","561307.5.peg.833","2281"
"34163",403,792,389,"TATTGACTGCTAGAAACAT","ATGTCATAGTTCGGATCTTG","561307.5.peg.833","2281"
"34164",443,792,349,"TACTAAGTAATTCGTCAACG","ATGTCATAGTTCGGATCTTG","561307.5.peg.833","2281"
"34165",267,792,525,"CAGTTAGTTAACGGTTGGAA","ATGTCATAGTTCGGATCTTG","561307.5.peg.833","2281"
"34166",7,792,785,"GACACAATATATAGGAAGA","ATGTCATAGTTCGGATCTTG","561307.5.peg.833","2281"
"34167",204,792,588,"TGTGCATCTGCAACGTGCTT","ATGTCATAGTTCGGATCTTG","561307.5.peg.833","2281"
"34168",5,792,787,"ACACAATATATAGGAAGAAG","ATGTCATAGTTCGGATCTTG","561307.5.peg.833","2281"
"34169",272,792,520,"AACAACAGTTAGTTAACGGT","ATGTCATAGTTCGGATCTTG","561307.5.peg.833","2281"
"34170",933,792,141,"CCTTCCGCATCTTTCCAACT","ATGTCATAGTTCGGATCTTG","561307.5.peg.833","2281"
"34171",267,801,534,"CAGTTAGTTAACGGTTGGAA","GTTGTTTAATGTCATAGTT","561307.5.peg.833","2281"
"34172",443,801,358,"TACTAAGTAATTCGTCAACG","GTTGTTTAATGTCATAGTT","561307.5.peg.833","2281"
"34173",5,801,796,"ACACAATATATAGGAAGAAG","GTTGTTTAATGTCATAGTT","561307.5.peg.833","2281"
"34174",933,801,132,"CCTTCCGCATCTTTCCAACT","GTTGTTTAATGTCATAGTT","561307.5.peg.833","2281"
"34175",204,801,597,"TGTGCATCTGCAACGTGCTT","GTTGTTTAATGTCATAGTT","561307.5.peg.833","2281"
"34176",7,801,794,"GACACAATATATAGGAAGA","GTTGTTTAATGTCATAGTT","561307.5.peg.833","2281"
"34177",403,801,398,"TATTGACTGCTAGAAACAT","GTTGTTTAATGTCATAGTT","561307.5.peg.833","2281"
"34178",272,801,529,"AACAACAGTTAGTTAACGGT","GTTGTTTAATGTCATAGTT","561307.5.peg.833","2281"
"34179",272,933,661,"AACAACAGTTAGTTAACGGT","CCTTCCGCATCTTTCCAACT","561307.5.peg.833","2281"
"34180",7,933,926,"GACACAATATATAGGAAGA","CCTTCCGCATCTTTCCAACT","561307.5.peg.833","2281"
"34181",403,933,530,"TATTGACTGCTAGAAACAT","CCTTCCGCATCTTTCCAACT","561307.5.peg.833","2281"
"34182",267,933,666,"CAGTTAGTTAACGGTTGGAA","CCTTCCGCATCTTTCCAACT","561307.5.peg.833","2281"
"34183",5,933,928,"ACACAATATATAGGAAGAAG","CCTTCCGCATCTTTCCAACT","561307.5.peg.833","2281"
"34184",781,933,152,"CGGATCTTGCGGACTAAAGT","CCTTCCGCATCTTTCCAACT","561307.5.peg.833","2281"
"34185",443,933,490,"TACTAAGTAATTCGTCAACG","CCTTCCGCATCTTTCCAACT","561307.5.peg.833","2281"
"34186",801,933,132,"GTTGTTTAATGTCATAGTT","CCTTCCGCATCTTTCCAACT","561307.5.peg.833","2281"
"34187",204,933,729,"TGTGCATCTGCAACGTGCTT","CCTTCCGCATCTTTCCAACT","561307.5.peg.833","2281"
"34188",792,933,141,"ATGTCATAGTTCGGATCTTG","CCTTCCGCATCTTTCCAACT","561307.5.peg.833","2281"
"34189",440,82,358,"TACCATATTGCGTCGCATAT","TACAGCTACTGTCCCTATAA","561307.5.peg.835","2283"
"34190",467,82,385,"CCCAAGCAATTGGCCCCCAG","TACAGCTACTGTCCCTATAA","561307.5.peg.835","2283"
"34191",477,82,395,"ACATAAATAGCCCAAGCAAT","TACAGCTACTGTCCCTATAA","561307.5.peg.835","2283"
"34192",82,440,358,"TACAGCTACTGTCCCTATAA","TACCATATTGCGTCGCATAT","561307.5.peg.835","2283"
"34193",82,467,385,"TACAGCTACTGTCCCTATAA","CCCAAGCAATTGGCCCCCAG","561307.5.peg.835","2283"
"34194",82,477,395,"TACAGCTACTGTCCCTATAA","ACATAAATAGCCCAAGCAAT","561307.5.peg.835","2283"
"34195",513,283,230,"GTAATAACGGATAATTCCA","TTCTTTAATCTTGTCCGCGA","561307.5.peg.838","2286"
"34196",486,283,203,"ATTTGTGTAACTACACCTAC","TTCTTTAATCTTGTCCGCGA","561307.5.peg.838","2286"
"34197",731,283,448,"TGCCACCTGTAAATGATACA","TTCTTTAATCTTGTCCGCGA","561307.5.peg.838","2286"
"34198",555,283,272,"GAACAACCCGTAGCAAGCGC","TTCTTTAATCTTGTCCGCGA","561307.5.peg.838","2286"
"34199",283,486,203,"TTCTTTAATCTTGTCCGCGA","ATTTGTGTAACTACACCTAC","561307.5.peg.838","2286"
"34200",731,486,245,"TGCCACCTGTAAATGATACA","ATTTGTGTAACTACACCTAC","561307.5.peg.838","2286"
"34201",283,513,230,"TTCTTTAATCTTGTCCGCGA","GTAATAACGGATAATTCCA","561307.5.peg.838","2286"
"34202",731,513,218,"TGCCACCTGTAAATGATACA","GTAATAACGGATAATTCCA","561307.5.peg.838","2286"
"34203",283,555,272,"TTCTTTAATCTTGTCCGCGA","GAACAACCCGTAGCAAGCGC","561307.5.peg.838","2286"
"34204",731,555,176,"TGCCACCTGTAAATGATACA","GAACAACCCGTAGCAAGCGC","561307.5.peg.838","2286"
"34205",283,731,448,"TTCTTTAATCTTGTCCGCGA","TGCCACCTGTAAATGATACA","561307.5.peg.838","2286"
"34206",486,731,245,"ATTTGTGTAACTACACCTAC","TGCCACCTGTAAATGATACA","561307.5.peg.838","2286"
"34207",513,731,218,"GTAATAACGGATAATTCCA","TGCCACCTGTAAATGATACA","561307.5.peg.838","2286"
"34208",555,731,176,"GAACAACCCGTAGCAAGCGC","TGCCACCTGTAAATGATACA","561307.5.peg.838","2286"
"34209",200,9,191,"ACATTAACGCAGCAGGCATT","GAAATACAACAAACTTTGG","561307.5.peg.839","2287"
"34210",207,9,198,"GAAGGGAACATTAACGCAGC","GAAATACAACAAACTTTGG","561307.5.peg.839","2287"
"34211",522,9,513,"TGGAATAAAGGATTCGTTGC","GAAATACAACAAACTTTGG","561307.5.peg.839","2287"
"34212",491,9,482,"TAACTTAATTGGTCCATCA","GAAATACAACAAACTTTGG","561307.5.peg.839","2287"
"34213",366,9,357,"GCCCAGCCTTCATAGTCCAT","GAAATACAACAAACTTTGG","561307.5.peg.839","2287"
"34214",542,9,533,"CACCTGCATCAAAGAATGAC","GAAATACAACAAACTTTGG","561307.5.peg.839","2287"
"34215",709,9,700,"TACAAAGGCACGTGTTTCAA","GAAATACAACAAACTTTGG","561307.5.peg.839","2287"
"34216",273,9,264,"ACTTTACGACCGCCCATATG","GAAATACAACAAACTTTGG","561307.5.peg.839","2287"
"34217",624,9,615,"CGATGTACTTGACTATCGAA","GAAATACAACAAACTTTGG","561307.5.peg.839","2287"
"34218",709,200,509,"TACAAAGGCACGTGTTTCAA","ACATTAACGCAGCAGGCATT","561307.5.peg.839","2287"
"34219",624,200,424,"CGATGTACTTGACTATCGAA","ACATTAACGCAGCAGGCATT","561307.5.peg.839","2287"
"34220",366,200,166,"GCCCAGCCTTCATAGTCCAT","ACATTAACGCAGCAGGCATT","561307.5.peg.839","2287"
"34221",542,200,342,"CACCTGCATCAAAGAATGAC","ACATTAACGCAGCAGGCATT","561307.5.peg.839","2287"
"34222",522,200,322,"TGGAATAAAGGATTCGTTGC","ACATTAACGCAGCAGGCATT","561307.5.peg.839","2287"
"34223",491,200,291,"TAACTTAATTGGTCCATCA","ACATTAACGCAGCAGGCATT","561307.5.peg.839","2287"
"34224",9,200,191,"GAAATACAACAAACTTTGG","ACATTAACGCAGCAGGCATT","561307.5.peg.839","2287"
"34225",624,207,417,"CGATGTACTTGACTATCGAA","GAAGGGAACATTAACGCAGC","561307.5.peg.839","2287"
"34226",366,207,159,"GCCCAGCCTTCATAGTCCAT","GAAGGGAACATTAACGCAGC","561307.5.peg.839","2287"
"34227",709,207,502,"TACAAAGGCACGTGTTTCAA","GAAGGGAACATTAACGCAGC","561307.5.peg.839","2287"
"34228",542,207,335,"CACCTGCATCAAAGAATGAC","GAAGGGAACATTAACGCAGC","561307.5.peg.839","2287"
"34229",491,207,284,"TAACTTAATTGGTCCATCA","GAAGGGAACATTAACGCAGC","561307.5.peg.839","2287"
"34230",522,207,315,"TGGAATAAAGGATTCGTTGC","GAAGGGAACATTAACGCAGC","561307.5.peg.839","2287"
"34231",9,207,198,"GAAATACAACAAACTTTGG","GAAGGGAACATTAACGCAGC","561307.5.peg.839","2287"
"34232",542,273,269,"CACCTGCATCAAAGAATGAC","ACTTTACGACCGCCCATATG","561307.5.peg.839","2287"
"34233",9,273,264,"GAAATACAACAAACTTTGG","ACTTTACGACCGCCCATATG","561307.5.peg.839","2287"
"34234",709,273,436,"TACAAAGGCACGTGTTTCAA","ACTTTACGACCGCCCATATG","561307.5.peg.839","2287"
"34235",491,273,218,"TAACTTAATTGGTCCATCA","ACTTTACGACCGCCCATATG","561307.5.peg.839","2287"
"34236",624,273,351,"CGATGTACTTGACTATCGAA","ACTTTACGACCGCCCATATG","561307.5.peg.839","2287"
"34237",522,273,249,"TGGAATAAAGGATTCGTTGC","ACTTTACGACCGCCCATATG","561307.5.peg.839","2287"
"34238",9,366,357,"GAAATACAACAAACTTTGG","GCCCAGCCTTCATAGTCCAT","561307.5.peg.839","2287"
"34239",200,366,166,"ACATTAACGCAGCAGGCATT","GCCCAGCCTTCATAGTCCAT","561307.5.peg.839","2287"
"34240",522,366,156,"TGGAATAAAGGATTCGTTGC","GCCCAGCCTTCATAGTCCAT","561307.5.peg.839","2287"
"34241",709,366,343,"TACAAAGGCACGTGTTTCAA","GCCCAGCCTTCATAGTCCAT","561307.5.peg.839","2287"
"34242",542,366,176,"CACCTGCATCAAAGAATGAC","GCCCAGCCTTCATAGTCCAT","561307.5.peg.839","2287"
"34243",491,366,125,"TAACTTAATTGGTCCATCA","GCCCAGCCTTCATAGTCCAT","561307.5.peg.839","2287"
"34244",207,366,159,"GAAGGGAACATTAACGCAGC","GCCCAGCCTTCATAGTCCAT","561307.5.peg.839","2287"
"34245",624,366,258,"CGATGTACTTGACTATCGAA","GCCCAGCCTTCATAGTCCAT","561307.5.peg.839","2287"
"34246",9,491,482,"GAAATACAACAAACTTTGG","TAACTTAATTGGTCCATCA","561307.5.peg.839","2287"
"34247",207,491,284,"GAAGGGAACATTAACGCAGC","TAACTTAATTGGTCCATCA","561307.5.peg.839","2287"
"34248",624,491,133,"CGATGTACTTGACTATCGAA","TAACTTAATTGGTCCATCA","561307.5.peg.839","2287"
"34249",273,491,218,"ACTTTACGACCGCCCATATG","TAACTTAATTGGTCCATCA","561307.5.peg.839","2287"
"34250",709,491,218,"TACAAAGGCACGTGTTTCAA","TAACTTAATTGGTCCATCA","561307.5.peg.839","2287"
"34251",200,491,291,"ACATTAACGCAGCAGGCATT","TAACTTAATTGGTCCATCA","561307.5.peg.839","2287"
"34252",366,491,125,"GCCCAGCCTTCATAGTCCAT","TAACTTAATTGGTCCATCA","561307.5.peg.839","2287"
"34253",207,522,315,"GAAGGGAACATTAACGCAGC","TGGAATAAAGGATTCGTTGC","561307.5.peg.839","2287"
"34254",200,522,322,"ACATTAACGCAGCAGGCATT","TGGAATAAAGGATTCGTTGC","561307.5.peg.839","2287"
"34255",273,522,249,"ACTTTACGACCGCCCATATG","TGGAATAAAGGATTCGTTGC","561307.5.peg.839","2287"
"34256",9,522,513,"GAAATACAACAAACTTTGG","TGGAATAAAGGATTCGTTGC","561307.5.peg.839","2287"
"34257",709,522,187,"TACAAAGGCACGTGTTTCAA","TGGAATAAAGGATTCGTTGC","561307.5.peg.839","2287"
"34258",366,522,156,"GCCCAGCCTTCATAGTCCAT","TGGAATAAAGGATTCGTTGC","561307.5.peg.839","2287"
"34259",624,522,102,"CGATGTACTTGACTATCGAA","TGGAATAAAGGATTCGTTGC","561307.5.peg.839","2287"
"34260",9,542,533,"GAAATACAACAAACTTTGG","CACCTGCATCAAAGAATGAC","561307.5.peg.839","2287"
"34261",709,542,167,"TACAAAGGCACGTGTTTCAA","CACCTGCATCAAAGAATGAC","561307.5.peg.839","2287"
"34262",207,542,335,"GAAGGGAACATTAACGCAGC","CACCTGCATCAAAGAATGAC","561307.5.peg.839","2287"
"34263",366,542,176,"GCCCAGCCTTCATAGTCCAT","CACCTGCATCAAAGAATGAC","561307.5.peg.839","2287"
"34264",200,542,342,"ACATTAACGCAGCAGGCATT","CACCTGCATCAAAGAATGAC","561307.5.peg.839","2287"
"34265",273,542,269,"ACTTTACGACCGCCCATATG","CACCTGCATCAAAGAATGAC","561307.5.peg.839","2287"
"34266",273,624,351,"ACTTTACGACCGCCCATATG","CGATGTACTTGACTATCGAA","561307.5.peg.839","2287"
"34267",207,624,417,"GAAGGGAACATTAACGCAGC","CGATGTACTTGACTATCGAA","561307.5.peg.839","2287"
"34268",366,624,258,"GCCCAGCCTTCATAGTCCAT","CGATGTACTTGACTATCGAA","561307.5.peg.839","2287"
"34269",200,624,424,"ACATTAACGCAGCAGGCATT","CGATGTACTTGACTATCGAA","561307.5.peg.839","2287"
"34270",9,624,615,"GAAATACAACAAACTTTGG","CGATGTACTTGACTATCGAA","561307.5.peg.839","2287"
"34271",491,624,133,"TAACTTAATTGGTCCATCA","CGATGTACTTGACTATCGAA","561307.5.peg.839","2287"
"34272",522,624,102,"TGGAATAAAGGATTCGTTGC","CGATGTACTTGACTATCGAA","561307.5.peg.839","2287"
"34273",491,709,218,"TAACTTAATTGGTCCATCA","TACAAAGGCACGTGTTTCAA","561307.5.peg.839","2287"
"34274",366,709,343,"GCCCAGCCTTCATAGTCCAT","TACAAAGGCACGTGTTTCAA","561307.5.peg.839","2287"
"34275",207,709,502,"GAAGGGAACATTAACGCAGC","TACAAAGGCACGTGTTTCAA","561307.5.peg.839","2287"
"34276",542,709,167,"CACCTGCATCAAAGAATGAC","TACAAAGGCACGTGTTTCAA","561307.5.peg.839","2287"
"34277",200,709,509,"ACATTAACGCAGCAGGCATT","TACAAAGGCACGTGTTTCAA","561307.5.peg.839","2287"
"34278",273,709,436,"ACTTTACGACCGCCCATATG","TACAAAGGCACGTGTTTCAA","561307.5.peg.839","2287"
"34279",9,709,700,"GAAATACAACAAACTTTGG","TACAAAGGCACGTGTTTCAA","561307.5.peg.839","2287"
"34280",522,709,187,"TGGAATAAAGGATTCGTTGC","TACAAAGGCACGTGTTTCAA","561307.5.peg.839","2287"
"34281",164,13,151,"GTATACGGTCACCGCATGTC","AAATGCCTTGAAACAAACGA","561307.5.peg.84","2288"
"34282",179,13,166,"ATCAAATGTTAGTCGTATA","AAATGCCTTGAAACAAACGA","561307.5.peg.84","2288"
"34283",164,21,143,"GTATACGGTCACCGCATGTC","AAACTCCTTCGTTTGTTTCA","561307.5.peg.84","2288"
"34284",179,21,158,"ATCAAATGTTAGTCGTATA","AAACTCCTTCGTTTGTTTCA","561307.5.peg.84","2288"
"34285",13,164,151,"AAATGCCTTGAAACAAACGA","GTATACGGTCACCGCATGTC","561307.5.peg.84","2288"
"34286",21,164,143,"AAACTCCTTCGTTTGTTTCA","GTATACGGTCACCGCATGTC","561307.5.peg.84","2288"
"34287",13,179,166,"AAATGCCTTGAAACAAACGA","ATCAAATGTTAGTCGTATA","561307.5.peg.84","2288"
"34288",21,179,158,"AAACTCCTTCGTTTGTTTCA","ATCAAATGTTAGTCGTATA","561307.5.peg.84","2288"
"34289",371,182,189,"TAATTTCACCATGTGTGATA","TAGACTGTTCAATGAGCTGT","561307.5.peg.842","2291"
"34290",333,182,151,"GTTCTTAGCATTTCAGAACA","TAGACTGTTCAATGAGCTGT","561307.5.peg.842","2291"
"34291",603,182,421,"TGACAATGTGTAACGGCTTT","TAGACTGTTCAATGAGCTGT","561307.5.peg.842","2291"
"34292",610,182,428,"CCATCCATGACAATGTGTAA","TAGACTGTTCAATGAGCTGT","561307.5.peg.842","2291"
"34293",603,270,333,"TGACAATGTGTAACGGCTTT","TCATACGTCGCAATAGATCG","561307.5.peg.842","2291"
"34294",610,270,340,"CCATCCATGACAATGTGTAA","TCATACGTCGCAATAGATCG","561307.5.peg.842","2291"
"34295",371,270,101,"TAATTTCACCATGTGTGATA","TCATACGTCGCAATAGATCG","561307.5.peg.842","2291"
"34296",182,333,151,"TAGACTGTTCAATGAGCTGT","GTTCTTAGCATTTCAGAACA","561307.5.peg.842","2291"
"34297",603,333,270,"TGACAATGTGTAACGGCTTT","GTTCTTAGCATTTCAGAACA","561307.5.peg.842","2291"
"34298",610,333,277,"CCATCCATGACAATGTGTAA","GTTCTTAGCATTTCAGAACA","561307.5.peg.842","2291"
"34299",182,371,189,"TAGACTGTTCAATGAGCTGT","TAATTTCACCATGTGTGATA","561307.5.peg.842","2291"
"34300",603,371,232,"TGACAATGTGTAACGGCTTT","TAATTTCACCATGTGTGATA","561307.5.peg.842","2291"
"34301",610,371,239,"CCATCCATGACAATGTGTAA","TAATTTCACCATGTGTGATA","561307.5.peg.842","2291"
"34302",270,371,101,"TCATACGTCGCAATAGATCG","TAATTTCACCATGTGTGATA","561307.5.peg.842","2291"
"34303",182,603,421,"TAGACTGTTCAATGAGCTGT","TGACAATGTGTAACGGCTTT","561307.5.peg.842","2291"
"34304",371,603,232,"TAATTTCACCATGTGTGATA","TGACAATGTGTAACGGCTTT","561307.5.peg.842","2291"
"34305",270,603,333,"TCATACGTCGCAATAGATCG","TGACAATGTGTAACGGCTTT","561307.5.peg.842","2291"
"34306",333,603,270,"GTTCTTAGCATTTCAGAACA","TGACAATGTGTAACGGCTTT","561307.5.peg.842","2291"
"34307",270,610,340,"TCATACGTCGCAATAGATCG","CCATCCATGACAATGTGTAA","561307.5.peg.842","2291"
"34308",182,610,428,"TAGACTGTTCAATGAGCTGT","CCATCCATGACAATGTGTAA","561307.5.peg.842","2291"
"34309",333,610,277,"GTTCTTAGCATTTCAGAACA","CCATCCATGACAATGTGTAA","561307.5.peg.842","2291"
"34310",371,610,239,"TAATTTCACCATGTGTGATA","CCATCCATGACAATGTGTAA","561307.5.peg.842","2291"
"34311",152,48,104,"GATCCAAGCGTTCGTAAACG","TACTATTAGACTTAGCCAT","561307.5.peg.843","2292"
"34312",384,48,336,"ACATAACTGATGTGTGGTAA","TACTATTAGACTTAGCCAT","561307.5.peg.843","2292"
"34313",551,48,503,"TACTTGCCGCCATGATACCA","TACTATTAGACTTAGCCAT","561307.5.peg.843","2292"
"34314",390,48,342,"CCTCTAACATAACTGATGTG","TACTATTAGACTTAGCCAT","561307.5.peg.843","2292"
"34315",645,48,597,"TAAATTGCACTGTAGCATT","TACTATTAGACTTAGCCAT","561307.5.peg.843","2292"
"34316",731,48,683,"GTTTGAATTTCTCACCAGTT","TACTATTAGACTTAGCCAT","561307.5.peg.843","2292"
"34317",177,48,129,"TCGTTTGAACTTTCGATTGC","TACTATTAGACTTAGCCAT","561307.5.peg.843","2292"
"34318",539,48,491,"TGATACCAGGGTTATCTTCA","TACTATTAGACTTAGCCAT","561307.5.peg.843","2292"
"34319",464,48,416,"TTCGATATTATCGAACATA","TACTATTAGACTTAGCCAT","561307.5.peg.843","2292"
"34320",464,91,373,"TTCGATATTATCGAACATA","AAATGTTGTGCTAAGTACAC","561307.5.peg.843","2292"
"34321",551,91,460,"TACTTGCCGCCATGATACCA","AAATGTTGTGCTAAGTACAC","561307.5.peg.843","2292"
"34322",390,91,299,"CCTCTAACATAACTGATGTG","AAATGTTGTGCTAAGTACAC","561307.5.peg.843","2292"
"34323",384,91,293,"ACATAACTGATGTGTGGTAA","AAATGTTGTGCTAAGTACAC","561307.5.peg.843","2292"
"34324",731,91,640,"GTTTGAATTTCTCACCAGTT","AAATGTTGTGCTAAGTACAC","561307.5.peg.843","2292"
"34325",645,91,554,"TAAATTGCACTGTAGCATT","AAATGTTGTGCTAAGTACAC","561307.5.peg.843","2292"
"34326",539,91,448,"TGATACCAGGGTTATCTTCA","AAATGTTGTGCTAAGTACAC","561307.5.peg.843","2292"
"34327",539,138,401,"TGATACCAGGGTTATCTTCA","TAAACGTGGATATTCCAGTC","561307.5.peg.843","2292"
"34328",390,138,252,"CCTCTAACATAACTGATGTG","TAAACGTGGATATTCCAGTC","561307.5.peg.843","2292"
"34329",551,138,413,"TACTTGCCGCCATGATACCA","TAAACGTGGATATTCCAGTC","561307.5.peg.843","2292"
"34330",645,138,507,"TAAATTGCACTGTAGCATT","TAAACGTGGATATTCCAGTC","561307.5.peg.843","2292"
"34331",384,138,246,"ACATAACTGATGTGTGGTAA","TAAACGTGGATATTCCAGTC","561307.5.peg.843","2292"
"34332",464,138,326,"TTCGATATTATCGAACATA","TAAACGTGGATATTCCAGTC","561307.5.peg.843","2292"
"34333",731,138,593,"GTTTGAATTTCTCACCAGTT","TAAACGTGGATATTCCAGTC","561307.5.peg.843","2292"
"34334",48,152,104,"TACTATTAGACTTAGCCAT","GATCCAAGCGTTCGTAAACG","561307.5.peg.843","2292"
"34335",539,152,387,"TGATACCAGGGTTATCTTCA","GATCCAAGCGTTCGTAAACG","561307.5.peg.843","2292"
"34336",731,152,579,"GTTTGAATTTCTCACCAGTT","GATCCAAGCGTTCGTAAACG","561307.5.peg.843","2292"
"34337",464,152,312,"TTCGATATTATCGAACATA","GATCCAAGCGTTCGTAAACG","561307.5.peg.843","2292"
"34338",384,152,232,"ACATAACTGATGTGTGGTAA","GATCCAAGCGTTCGTAAACG","561307.5.peg.843","2292"
"34339",390,152,238,"CCTCTAACATAACTGATGTG","GATCCAAGCGTTCGTAAACG","561307.5.peg.843","2292"
"34340",551,152,399,"TACTTGCCGCCATGATACCA","GATCCAAGCGTTCGTAAACG","561307.5.peg.843","2292"
"34341",645,152,493,"TAAATTGCACTGTAGCATT","GATCCAAGCGTTCGTAAACG","561307.5.peg.843","2292"
"34342",539,177,362,"TGATACCAGGGTTATCTTCA","TCGTTTGAACTTTCGATTGC","561307.5.peg.843","2292"
"34343",384,177,207,"ACATAACTGATGTGTGGTAA","TCGTTTGAACTTTCGATTGC","561307.5.peg.843","2292"
"34344",464,177,287,"TTCGATATTATCGAACATA","TCGTTTGAACTTTCGATTGC","561307.5.peg.843","2292"
"34345",551,177,374,"TACTTGCCGCCATGATACCA","TCGTTTGAACTTTCGATTGC","561307.5.peg.843","2292"
"34346",390,177,213,"CCTCTAACATAACTGATGTG","TCGTTTGAACTTTCGATTGC","561307.5.peg.843","2292"
"34347",48,177,129,"TACTATTAGACTTAGCCAT","TCGTTTGAACTTTCGATTGC","561307.5.peg.843","2292"
"34348",731,177,554,"GTTTGAATTTCTCACCAGTT","TCGTTTGAACTTTCGATTGC","561307.5.peg.843","2292"
"34349",645,177,468,"TAAATTGCACTGTAGCATT","TCGTTTGAACTTTCGATTGC","561307.5.peg.843","2292"
"34350",138,384,246,"TAAACGTGGATATTCCAGTC","ACATAACTGATGTGTGGTAA","561307.5.peg.843","2292"
"34351",731,384,347,"GTTTGAATTTCTCACCAGTT","ACATAACTGATGTGTGGTAA","561307.5.peg.843","2292"
"34352",551,384,167,"TACTTGCCGCCATGATACCA","ACATAACTGATGTGTGGTAA","561307.5.peg.843","2292"
"34353",91,384,293,"AAATGTTGTGCTAAGTACAC","ACATAACTGATGTGTGGTAA","561307.5.peg.843","2292"
"34354",48,384,336,"TACTATTAGACTTAGCCAT","ACATAACTGATGTGTGGTAA","561307.5.peg.843","2292"
"34355",645,384,261,"TAAATTGCACTGTAGCATT","ACATAACTGATGTGTGGTAA","561307.5.peg.843","2292"
"34356",152,384,232,"GATCCAAGCGTTCGTAAACG","ACATAACTGATGTGTGGTAA","561307.5.peg.843","2292"
"34357",177,384,207,"TCGTTTGAACTTTCGATTGC","ACATAACTGATGTGTGGTAA","561307.5.peg.843","2292"
"34358",539,384,155,"TGATACCAGGGTTATCTTCA","ACATAACTGATGTGTGGTAA","561307.5.peg.843","2292"
"34359",91,390,299,"AAATGTTGTGCTAAGTACAC","CCTCTAACATAACTGATGTG","561307.5.peg.843","2292"
"34360",177,390,213,"TCGTTTGAACTTTCGATTGC","CCTCTAACATAACTGATGTG","561307.5.peg.843","2292"
"34361",731,390,341,"GTTTGAATTTCTCACCAGTT","CCTCTAACATAACTGATGTG","561307.5.peg.843","2292"
"34362",539,390,149,"TGATACCAGGGTTATCTTCA","CCTCTAACATAACTGATGTG","561307.5.peg.843","2292"
"34363",138,390,252,"TAAACGTGGATATTCCAGTC","CCTCTAACATAACTGATGTG","561307.5.peg.843","2292"
"34364",645,390,255,"TAAATTGCACTGTAGCATT","CCTCTAACATAACTGATGTG","561307.5.peg.843","2292"
"34365",48,390,342,"TACTATTAGACTTAGCCAT","CCTCTAACATAACTGATGTG","561307.5.peg.843","2292"
"34366",152,390,238,"GATCCAAGCGTTCGTAAACG","CCTCTAACATAACTGATGTG","561307.5.peg.843","2292"
"34367",551,390,161,"TACTTGCCGCCATGATACCA","CCTCTAACATAACTGATGTG","561307.5.peg.843","2292"
"34368",731,464,267,"GTTTGAATTTCTCACCAGTT","TTCGATATTATCGAACATA","561307.5.peg.843","2292"
"34369",645,464,181,"TAAATTGCACTGTAGCATT","TTCGATATTATCGAACATA","561307.5.peg.843","2292"
"34370",138,464,326,"TAAACGTGGATATTCCAGTC","TTCGATATTATCGAACATA","561307.5.peg.843","2292"
"34371",48,464,416,"TACTATTAGACTTAGCCAT","TTCGATATTATCGAACATA","561307.5.peg.843","2292"
"34372",91,464,373,"AAATGTTGTGCTAAGTACAC","TTCGATATTATCGAACATA","561307.5.peg.843","2292"
"34373",152,464,312,"GATCCAAGCGTTCGTAAACG","TTCGATATTATCGAACATA","561307.5.peg.843","2292"
"34374",177,464,287,"TCGTTTGAACTTTCGATTGC","TTCGATATTATCGAACATA","561307.5.peg.843","2292"
"34375",48,539,491,"TACTATTAGACTTAGCCAT","TGATACCAGGGTTATCTTCA","561307.5.peg.843","2292"
"34376",152,539,387,"GATCCAAGCGTTCGTAAACG","TGATACCAGGGTTATCTTCA","561307.5.peg.843","2292"
"34377",177,539,362,"TCGTTTGAACTTTCGATTGC","TGATACCAGGGTTATCTTCA","561307.5.peg.843","2292"
"34378",731,539,192,"GTTTGAATTTCTCACCAGTT","TGATACCAGGGTTATCTTCA","561307.5.peg.843","2292"
"34379",138,539,401,"TAAACGTGGATATTCCAGTC","TGATACCAGGGTTATCTTCA","561307.5.peg.843","2292"
"34380",91,539,448,"AAATGTTGTGCTAAGTACAC","TGATACCAGGGTTATCTTCA","561307.5.peg.843","2292"
"34381",384,539,155,"ACATAACTGATGTGTGGTAA","TGATACCAGGGTTATCTTCA","561307.5.peg.843","2292"
"34382",390,539,149,"CCTCTAACATAACTGATGTG","TGATACCAGGGTTATCTTCA","561307.5.peg.843","2292"
"34383",645,539,106,"TAAATTGCACTGTAGCATT","TGATACCAGGGTTATCTTCA","561307.5.peg.843","2292"
"34384",390,551,161,"CCTCTAACATAACTGATGTG","TACTTGCCGCCATGATACCA","561307.5.peg.843","2292"
"34385",152,551,399,"GATCCAAGCGTTCGTAAACG","TACTTGCCGCCATGATACCA","561307.5.peg.843","2292"
"34386",384,551,167,"ACATAACTGATGTGTGGTAA","TACTTGCCGCCATGATACCA","561307.5.peg.843","2292"
"34387",177,551,374,"TCGTTTGAACTTTCGATTGC","TACTTGCCGCCATGATACCA","561307.5.peg.843","2292"
"34388",91,551,460,"AAATGTTGTGCTAAGTACAC","TACTTGCCGCCATGATACCA","561307.5.peg.843","2292"
"34389",48,551,503,"TACTATTAGACTTAGCCAT","TACTTGCCGCCATGATACCA","561307.5.peg.843","2292"
"34390",731,551,180,"GTTTGAATTTCTCACCAGTT","TACTTGCCGCCATGATACCA","561307.5.peg.843","2292"
"34391",138,551,413,"TAAACGTGGATATTCCAGTC","TACTTGCCGCCATGATACCA","561307.5.peg.843","2292"
"34392",464,645,181,"TTCGATATTATCGAACATA","TAAATTGCACTGTAGCATT","561307.5.peg.843","2292"
"34393",91,645,554,"AAATGTTGTGCTAAGTACAC","TAAATTGCACTGTAGCATT","561307.5.peg.843","2292"
"34394",390,645,255,"CCTCTAACATAACTGATGTG","TAAATTGCACTGTAGCATT","561307.5.peg.843","2292"
"34395",177,645,468,"TCGTTTGAACTTTCGATTGC","TAAATTGCACTGTAGCATT","561307.5.peg.843","2292"
"34396",138,645,507,"TAAACGTGGATATTCCAGTC","TAAATTGCACTGTAGCATT","561307.5.peg.843","2292"
"34397",539,645,106,"TGATACCAGGGTTATCTTCA","TAAATTGCACTGTAGCATT","561307.5.peg.843","2292"
"34398",152,645,493,"GATCCAAGCGTTCGTAAACG","TAAATTGCACTGTAGCATT","561307.5.peg.843","2292"
"34399",48,645,597,"TACTATTAGACTTAGCCAT","TAAATTGCACTGTAGCATT","561307.5.peg.843","2292"
"34400",384,645,261,"ACATAACTGATGTGTGGTAA","TAAATTGCACTGTAGCATT","561307.5.peg.843","2292"
"34401",384,731,347,"ACATAACTGATGTGTGGTAA","GTTTGAATTTCTCACCAGTT","561307.5.peg.843","2292"
"34402",48,731,683,"TACTATTAGACTTAGCCAT","GTTTGAATTTCTCACCAGTT","561307.5.peg.843","2292"
"34403",551,731,180,"TACTTGCCGCCATGATACCA","GTTTGAATTTCTCACCAGTT","561307.5.peg.843","2292"
"34404",91,731,640,"AAATGTTGTGCTAAGTACAC","GTTTGAATTTCTCACCAGTT","561307.5.peg.843","2292"
"34405",464,731,267,"TTCGATATTATCGAACATA","GTTTGAATTTCTCACCAGTT","561307.5.peg.843","2292"
"34406",138,731,593,"TAAACGTGGATATTCCAGTC","GTTTGAATTTCTCACCAGTT","561307.5.peg.843","2292"
"34407",152,731,579,"GATCCAAGCGTTCGTAAACG","GTTTGAATTTCTCACCAGTT","561307.5.peg.843","2292"
"34408",539,731,192,"TGATACCAGGGTTATCTTCA","GTTTGAATTTCTCACCAGTT","561307.5.peg.843","2292"
"34409",177,731,554,"TCGTTTGAACTTTCGATTGC","GTTTGAATTTCTCACCAGTT","561307.5.peg.843","2292"
"34410",390,731,341,"CCTCTAACATAACTGATGTG","GTTTGAATTTCTCACCAGTT","561307.5.peg.843","2292"
"34411",402,100,302,"AATTGTCTAAGTTGTCGAT","ACCACCACTTTGGTCTAATG","561307.5.peg.844","2293"
"34412",431,100,331,"AAATGTGACGTTCGTTTGCA","ACCACCACTTTGGTCTAATG","561307.5.peg.844","2293"
"34413",402,110,292,"AATTGTCTAAGTTGTCGAT","TTGGTGTACTACCACCACTT","561307.5.peg.844","2293"
"34414",431,110,321,"AAATGTGACGTTCGTTTGCA","TTGGTGTACTACCACCACTT","561307.5.peg.844","2293"
"34415",402,191,211,"AATTGTCTAAGTTGTCGAT","TACGCATATCGTGAACAAGT","561307.5.peg.844","2293"
"34416",431,191,240,"AAATGTGACGTTCGTTTGCA","TACGCATATCGTGAACAAGT","561307.5.peg.844","2293"
"34417",100,402,302,"ACCACCACTTTGGTCTAATG","AATTGTCTAAGTTGTCGAT","561307.5.peg.844","2293"
"34418",110,402,292,"TTGGTGTACTACCACCACTT","AATTGTCTAAGTTGTCGAT","561307.5.peg.844","2293"
"34419",191,402,211,"TACGCATATCGTGAACAAGT","AATTGTCTAAGTTGTCGAT","561307.5.peg.844","2293"
"34420",100,431,331,"ACCACCACTTTGGTCTAATG","AAATGTGACGTTCGTTTGCA","561307.5.peg.844","2293"
"34421",110,431,321,"TTGGTGTACTACCACCACTT","AAATGTGACGTTCGTTTGCA","561307.5.peg.844","2293"
"34422",191,431,240,"TACGCATATCGTGAACAAGT","AAATGTGACGTTCGTTTGCA","561307.5.peg.844","2293"
"34423",306,6,300,"TTCTTAGCTAAACGTACCAA","GTATTAATGTGCAAGCAAAG","561307.5.peg.846","2295"
"34424",370,6,364,"GTCTGATCCGGTTAATCCGA","GTATTAATGTGCAAGCAAAG","561307.5.peg.846","2295"
"34425",123,6,117,"TATCCATGATCAATCACTAA","GTATTAATGTGCAAGCAAAG","561307.5.peg.846","2295"
"34426",561,6,555,"CCACGATATTTATCTGGAAA","GTATTAATGTGCAAGCAAAG","561307.5.peg.846","2295"
"34427",285,6,279,"GGTTCATGATACATATATGC","GTATTAATGTGCAAGCAAAG","561307.5.peg.846","2295"
"34428",418,6,412,"AGGACGCCCTGTATATGCTC","GTATTAATGTGCAAGCAAAG","561307.5.peg.846","2295"
"34429",382,6,376,"GCCATCATTTGCGTCTGATC","GTATTAATGTGCAAGCAAAG","561307.5.peg.846","2295"
"34430",597,6,591,"TCTTCTACTGAATTAGCTTG","GTATTAATGTGCAAGCAAAG","561307.5.peg.846","2295"
"34431",306,8,298,"TTCTTAGCTAAACGTACCAA","ATTAATACTGTCAATGGGAG","561307.5.peg.846","2295"
"34432",561,8,553,"CCACGATATTTATCTGGAAA","ATTAATACTGTCAATGGGAG","561307.5.peg.846","2295"
"34433",382,8,374,"GCCATCATTTGCGTCTGATC","ATTAATACTGTCAATGGGAG","561307.5.peg.846","2295"
"34434",597,8,589,"TCTTCTACTGAATTAGCTTG","ATTAATACTGTCAATGGGAG","561307.5.peg.846","2295"
"34435",370,8,362,"GTCTGATCCGGTTAATCCGA","ATTAATACTGTCAATGGGAG","561307.5.peg.846","2295"
"34436",418,8,410,"AGGACGCCCTGTATATGCTC","ATTAATACTGTCAATGGGAG","561307.5.peg.846","2295"
"34437",123,8,115,"TATCCATGATCAATCACTAA","ATTAATACTGTCAATGGGAG","561307.5.peg.846","2295"
"34438",285,8,277,"GGTTCATGATACATATATGC","ATTAATACTGTCAATGGGAG","561307.5.peg.846","2295"
"34439",285,10,275,"GGTTCATGATACATATATGC","ACATTAATACTGTCAATGGG","561307.5.peg.846","2295"
"34440",306,10,296,"TTCTTAGCTAAACGTACCAA","ACATTAATACTGTCAATGGG","561307.5.peg.846","2295"
"34441",597,10,587,"TCTTCTACTGAATTAGCTTG","ACATTAATACTGTCAATGGG","561307.5.peg.846","2295"
"34442",561,10,551,"CCACGATATTTATCTGGAAA","ACATTAATACTGTCAATGGG","561307.5.peg.846","2295"
"34443",370,10,360,"GTCTGATCCGGTTAATCCGA","ACATTAATACTGTCAATGGG","561307.5.peg.846","2295"
"34444",123,10,113,"TATCCATGATCAATCACTAA","ACATTAATACTGTCAATGGG","561307.5.peg.846","2295"
"34445",418,10,408,"AGGACGCCCTGTATATGCTC","ACATTAATACTGTCAATGGG","561307.5.peg.846","2295"
"34446",382,10,372,"GCCATCATTTGCGTCTGATC","ACATTAATACTGTCAATGGG","561307.5.peg.846","2295"
"34447",123,13,110,"TATCCATGATCAATCACTAA","TGCACATTAATACTGTCAAT","561307.5.peg.846","2295"
"34448",370,13,357,"GTCTGATCCGGTTAATCCGA","TGCACATTAATACTGTCAAT","561307.5.peg.846","2295"
"34449",382,13,369,"GCCATCATTTGCGTCTGATC","TGCACATTAATACTGTCAAT","561307.5.peg.846","2295"
"34450",285,13,272,"GGTTCATGATACATATATGC","TGCACATTAATACTGTCAAT","561307.5.peg.846","2295"
"34451",597,13,584,"TCTTCTACTGAATTAGCTTG","TGCACATTAATACTGTCAAT","561307.5.peg.846","2295"
"34452",561,13,548,"CCACGATATTTATCTGGAAA","TGCACATTAATACTGTCAAT","561307.5.peg.846","2295"
"34453",418,13,405,"AGGACGCCCTGTATATGCTC","TGCACATTAATACTGTCAAT","561307.5.peg.846","2295"
"34454",306,13,293,"TTCTTAGCTAAACGTACCAA","TGCACATTAATACTGTCAAT","561307.5.peg.846","2295"
"34455",13,123,110,"TGCACATTAATACTGTCAAT","TATCCATGATCAATCACTAA","561307.5.peg.846","2295"
"34456",382,123,259,"GCCATCATTTGCGTCTGATC","TATCCATGATCAATCACTAA","561307.5.peg.846","2295"
"34457",8,123,115,"ATTAATACTGTCAATGGGAG","TATCCATGATCAATCACTAA","561307.5.peg.846","2295"
"34458",6,123,117,"GTATTAATGTGCAAGCAAAG","TATCCATGATCAATCACTAA","561307.5.peg.846","2295"
"34459",370,123,247,"GTCTGATCCGGTTAATCCGA","TATCCATGATCAATCACTAA","561307.5.peg.846","2295"
"34460",597,123,474,"TCTTCTACTGAATTAGCTTG","TATCCATGATCAATCACTAA","561307.5.peg.846","2295"
"34461",10,123,113,"ACATTAATACTGTCAATGGG","TATCCATGATCAATCACTAA","561307.5.peg.846","2295"
"34462",561,123,438,"CCACGATATTTATCTGGAAA","TATCCATGATCAATCACTAA","561307.5.peg.846","2295"
"34463",285,123,162,"GGTTCATGATACATATATGC","TATCCATGATCAATCACTAA","561307.5.peg.846","2295"
"34464",306,123,183,"TTCTTAGCTAAACGTACCAA","TATCCATGATCAATCACTAA","561307.5.peg.846","2295"
"34465",418,123,295,"AGGACGCCCTGTATATGCTC","TATCCATGATCAATCACTAA","561307.5.peg.846","2295"
"34466",561,285,276,"CCACGATATTTATCTGGAAA","GGTTCATGATACATATATGC","561307.5.peg.846","2295"
"34467",6,285,279,"GTATTAATGTGCAAGCAAAG","GGTTCATGATACATATATGC","561307.5.peg.846","2295"
"34468",8,285,277,"ATTAATACTGTCAATGGGAG","GGTTCATGATACATATATGC","561307.5.peg.846","2295"
"34469",10,285,275,"ACATTAATACTGTCAATGGG","GGTTCATGATACATATATGC","561307.5.peg.846","2295"
"34470",13,285,272,"TGCACATTAATACTGTCAAT","GGTTCATGATACATATATGC","561307.5.peg.846","2295"
"34471",123,285,162,"TATCCATGATCAATCACTAA","GGTTCATGATACATATATGC","561307.5.peg.846","2295"
"34472",418,285,133,"AGGACGCCCTGTATATGCTC","GGTTCATGATACATATATGC","561307.5.peg.846","2295"
"34473",597,285,312,"TCTTCTACTGAATTAGCTTG","GGTTCATGATACATATATGC","561307.5.peg.846","2295"
"34474",8,306,298,"ATTAATACTGTCAATGGGAG","TTCTTAGCTAAACGTACCAA","561307.5.peg.846","2295"
"34475",6,306,300,"GTATTAATGTGCAAGCAAAG","TTCTTAGCTAAACGTACCAA","561307.5.peg.846","2295"
"34476",10,306,296,"ACATTAATACTGTCAATGGG","TTCTTAGCTAAACGTACCAA","561307.5.peg.846","2295"
"34477",123,306,183,"TATCCATGATCAATCACTAA","TTCTTAGCTAAACGTACCAA","561307.5.peg.846","2295"
"34478",13,306,293,"TGCACATTAATACTGTCAAT","TTCTTAGCTAAACGTACCAA","561307.5.peg.846","2295"
"34479",561,306,255,"CCACGATATTTATCTGGAAA","TTCTTAGCTAAACGTACCAA","561307.5.peg.846","2295"
"34480",597,306,291,"TCTTCTACTGAATTAGCTTG","TTCTTAGCTAAACGTACCAA","561307.5.peg.846","2295"
"34481",418,306,112,"AGGACGCCCTGTATATGCTC","TTCTTAGCTAAACGTACCAA","561307.5.peg.846","2295"
"34482",6,370,364,"GTATTAATGTGCAAGCAAAG","GTCTGATCCGGTTAATCCGA","561307.5.peg.846","2295"
"34483",8,370,362,"ATTAATACTGTCAATGGGAG","GTCTGATCCGGTTAATCCGA","561307.5.peg.846","2295"
"34484",597,370,227,"TCTTCTACTGAATTAGCTTG","GTCTGATCCGGTTAATCCGA","561307.5.peg.846","2295"
"34485",123,370,247,"TATCCATGATCAATCACTAA","GTCTGATCCGGTTAATCCGA","561307.5.peg.846","2295"
"34486",13,370,357,"TGCACATTAATACTGTCAAT","GTCTGATCCGGTTAATCCGA","561307.5.peg.846","2295"
"34487",10,370,360,"ACATTAATACTGTCAATGGG","GTCTGATCCGGTTAATCCGA","561307.5.peg.846","2295"
"34488",561,370,191,"CCACGATATTTATCTGGAAA","GTCTGATCCGGTTAATCCGA","561307.5.peg.846","2295"
"34489",597,382,215,"TCTTCTACTGAATTAGCTTG","GCCATCATTTGCGTCTGATC","561307.5.peg.846","2295"
"34490",8,382,374,"ATTAATACTGTCAATGGGAG","GCCATCATTTGCGTCTGATC","561307.5.peg.846","2295"
"34491",561,382,179,"CCACGATATTTATCTGGAAA","GCCATCATTTGCGTCTGATC","561307.5.peg.846","2295"
"34492",13,382,369,"TGCACATTAATACTGTCAAT","GCCATCATTTGCGTCTGATC","561307.5.peg.846","2295"
"34493",123,382,259,"TATCCATGATCAATCACTAA","GCCATCATTTGCGTCTGATC","561307.5.peg.846","2295"
"34494",6,382,376,"GTATTAATGTGCAAGCAAAG","GCCATCATTTGCGTCTGATC","561307.5.peg.846","2295"
"34495",10,382,372,"ACATTAATACTGTCAATGGG","GCCATCATTTGCGTCTGATC","561307.5.peg.846","2295"
"34496",6,418,412,"GTATTAATGTGCAAGCAAAG","AGGACGCCCTGTATATGCTC","561307.5.peg.846","2295"
"34497",285,418,133,"GGTTCATGATACATATATGC","AGGACGCCCTGTATATGCTC","561307.5.peg.846","2295"
"34498",597,418,179,"TCTTCTACTGAATTAGCTTG","AGGACGCCCTGTATATGCTC","561307.5.peg.846","2295"
"34499",123,418,295,"TATCCATGATCAATCACTAA","AGGACGCCCTGTATATGCTC","561307.5.peg.846","2295"
"34500",8,418,410,"ATTAATACTGTCAATGGGAG","AGGACGCCCTGTATATGCTC","561307.5.peg.846","2295"
"34501",561,418,143,"CCACGATATTTATCTGGAAA","AGGACGCCCTGTATATGCTC","561307.5.peg.846","2295"
"34502",306,418,112,"TTCTTAGCTAAACGTACCAA","AGGACGCCCTGTATATGCTC","561307.5.peg.846","2295"
"34503",10,418,408,"ACATTAATACTGTCAATGGG","AGGACGCCCTGTATATGCTC","561307.5.peg.846","2295"
"34504",13,418,405,"TGCACATTAATACTGTCAAT","AGGACGCCCTGTATATGCTC","561307.5.peg.846","2295"
"34505",13,561,548,"TGCACATTAATACTGTCAAT","CCACGATATTTATCTGGAAA","561307.5.peg.846","2295"
"34506",285,561,276,"GGTTCATGATACATATATGC","CCACGATATTTATCTGGAAA","561307.5.peg.846","2295"
"34507",8,561,553,"ATTAATACTGTCAATGGGAG","CCACGATATTTATCTGGAAA","561307.5.peg.846","2295"
"34508",382,561,179,"GCCATCATTTGCGTCTGATC","CCACGATATTTATCTGGAAA","561307.5.peg.846","2295"
"34509",123,561,438,"TATCCATGATCAATCACTAA","CCACGATATTTATCTGGAAA","561307.5.peg.846","2295"
"34510",6,561,555,"GTATTAATGTGCAAGCAAAG","CCACGATATTTATCTGGAAA","561307.5.peg.846","2295"
"34511",10,561,551,"ACATTAATACTGTCAATGGG","CCACGATATTTATCTGGAAA","561307.5.peg.846","2295"
"34512",370,561,191,"GTCTGATCCGGTTAATCCGA","CCACGATATTTATCTGGAAA","561307.5.peg.846","2295"
"34513",306,561,255,"TTCTTAGCTAAACGTACCAA","CCACGATATTTATCTGGAAA","561307.5.peg.846","2295"
"34514",418,561,143,"AGGACGCCCTGTATATGCTC","CCACGATATTTATCTGGAAA","561307.5.peg.846","2295"
"34515",10,597,587,"ACATTAATACTGTCAATGGG","TCTTCTACTGAATTAGCTTG","561307.5.peg.846","2295"
"34516",285,597,312,"GGTTCATGATACATATATGC","TCTTCTACTGAATTAGCTTG","561307.5.peg.846","2295"
"34517",370,597,227,"GTCTGATCCGGTTAATCCGA","TCTTCTACTGAATTAGCTTG","561307.5.peg.846","2295"
"34518",418,597,179,"AGGACGCCCTGTATATGCTC","TCTTCTACTGAATTAGCTTG","561307.5.peg.846","2295"
"34519",8,597,589,"ATTAATACTGTCAATGGGAG","TCTTCTACTGAATTAGCTTG","561307.5.peg.846","2295"
"34520",6,597,591,"GTATTAATGTGCAAGCAAAG","TCTTCTACTGAATTAGCTTG","561307.5.peg.846","2295"
"34521",382,597,215,"GCCATCATTTGCGTCTGATC","TCTTCTACTGAATTAGCTTG","561307.5.peg.846","2295"
"34522",123,597,474,"TATCCATGATCAATCACTAA","TCTTCTACTGAATTAGCTTG","561307.5.peg.846","2295"
"34523",13,597,584,"TGCACATTAATACTGTCAAT","TCTTCTACTGAATTAGCTTG","561307.5.peg.846","2295"
"34524",306,597,291,"TTCTTAGCTAAACGTACCAA","TCTTCTACTGAATTAGCTTG","561307.5.peg.846","2295"
"34525",232,8,224,"GAGTAAGAATGATAACGCAA","TTGTTTATGAATGTTTGGG","561307.5.peg.847","2296"
"34526",312,8,304,"GAATAGGCTGAACCTGCAAA","TTGTTTATGAATGTTTGGG","561307.5.peg.847","2296"
"34527",328,8,320,"AATACATTGACCCAAGAAT","TTGTTTATGAATGTTTGGG","561307.5.peg.847","2296"
"34528",409,8,401,"TCCTGATGCAACAAAGGCTA","TTGTTTATGAATGTTTGGG","561307.5.peg.847","2296"
"34529",415,8,407,"TGAGAATCCTGATGCAACAA","TTGTTTATGAATGTTTGGG","561307.5.peg.847","2296"
"34530",696,8,688,"GTAGCAGTTACTTTGTGTTC","TTGTTTATGAATGTTTGGG","561307.5.peg.847","2296"
"34531",376,8,368,"TTCAGCTAATAGAGCCCAAC","TTGTTTATGAATGTTTGGG","561307.5.peg.847","2296"
"34532",687,8,679,"CTTTGTGTTCTGGAATAAA","TTGTTTATGAATGTTTGGG","561307.5.peg.847","2296"
"34533",462,8,454,"GCAGGTAATTCGATGCCAAT","TTGTTTATGAATGTTTGGG","561307.5.peg.847","2296"
"34534",228,8,220,"AAGAATGATAACGCAACGGC","TTGTTTATGAATGTTTGGG","561307.5.peg.847","2296"
"34535",304,8,296,"TGAACCTGCAAATGGCATAG","TTGTTTATGAATGTTTGGG","561307.5.peg.847","2296"
"34536",198,8,190,"TGTTCTGCAGCAACAATGCC","TTGTTTATGAATGTTTGGG","561307.5.peg.847","2296"
"34537",312,198,114,"GAATAGGCTGAACCTGCAAA","TGTTCTGCAGCAACAATGCC","561307.5.peg.847","2296"
"34538",415,198,217,"TGAGAATCCTGATGCAACAA","TGTTCTGCAGCAACAATGCC","561307.5.peg.847","2296"
"34539",696,198,498,"GTAGCAGTTACTTTGTGTTC","TGTTCTGCAGCAACAATGCC","561307.5.peg.847","2296"
"34540",304,198,106,"TGAACCTGCAAATGGCATAG","TGTTCTGCAGCAACAATGCC","561307.5.peg.847","2296"
"34541",8,198,190,"TTGTTTATGAATGTTTGGG","TGTTCTGCAGCAACAATGCC","561307.5.peg.847","2296"
"34542",328,198,130,"AATACATTGACCCAAGAAT","TGTTCTGCAGCAACAATGCC","561307.5.peg.847","2296"
"34543",409,198,211,"TCCTGATGCAACAAAGGCTA","TGTTCTGCAGCAACAATGCC","561307.5.peg.847","2296"
"34544",687,198,489,"CTTTGTGTTCTGGAATAAA","TGTTCTGCAGCAACAATGCC","561307.5.peg.847","2296"
"34545",462,198,264,"GCAGGTAATTCGATGCCAAT","TGTTCTGCAGCAACAATGCC","561307.5.peg.847","2296"
"34546",376,198,178,"TTCAGCTAATAGAGCCCAAC","TGTTCTGCAGCAACAATGCC","561307.5.peg.847","2296"
"34547",687,228,459,"CTTTGTGTTCTGGAATAAA","AAGAATGATAACGCAACGGC","561307.5.peg.847","2296"
"34548",462,228,234,"GCAGGTAATTCGATGCCAAT","AAGAATGATAACGCAACGGC","561307.5.peg.847","2296"
"34549",415,228,187,"TGAGAATCCTGATGCAACAA","AAGAATGATAACGCAACGGC","561307.5.peg.847","2296"
"34550",328,228,100,"AATACATTGACCCAAGAAT","AAGAATGATAACGCAACGGC","561307.5.peg.847","2296"
"34551",8,228,220,"TTGTTTATGAATGTTTGGG","AAGAATGATAACGCAACGGC","561307.5.peg.847","2296"
"34552",409,228,181,"TCCTGATGCAACAAAGGCTA","AAGAATGATAACGCAACGGC","561307.5.peg.847","2296"
"34553",376,228,148,"TTCAGCTAATAGAGCCCAAC","AAGAATGATAACGCAACGGC","561307.5.peg.847","2296"
"34554",696,228,468,"GTAGCAGTTACTTTGTGTTC","AAGAATGATAACGCAACGGC","561307.5.peg.847","2296"
"34555",8,232,224,"TTGTTTATGAATGTTTGGG","GAGTAAGAATGATAACGCAA","561307.5.peg.847","2296"
"34556",409,232,177,"TCCTGATGCAACAAAGGCTA","GAGTAAGAATGATAACGCAA","561307.5.peg.847","2296"
"34557",687,232,455,"CTTTGTGTTCTGGAATAAA","GAGTAAGAATGATAACGCAA","561307.5.peg.847","2296"
"34558",696,232,464,"GTAGCAGTTACTTTGTGTTC","GAGTAAGAATGATAACGCAA","561307.5.peg.847","2296"
"34559",415,232,183,"TGAGAATCCTGATGCAACAA","GAGTAAGAATGATAACGCAA","561307.5.peg.847","2296"
"34560",462,232,230,"GCAGGTAATTCGATGCCAAT","GAGTAAGAATGATAACGCAA","561307.5.peg.847","2296"
"34561",376,232,144,"TTCAGCTAATAGAGCCCAAC","GAGTAAGAATGATAACGCAA","561307.5.peg.847","2296"
"34562",198,304,106,"TGTTCTGCAGCAACAATGCC","TGAACCTGCAAATGGCATAG","561307.5.peg.847","2296"
"34563",8,304,296,"TTGTTTATGAATGTTTGGG","TGAACCTGCAAATGGCATAG","561307.5.peg.847","2296"
"34564",415,304,111,"TGAGAATCCTGATGCAACAA","TGAACCTGCAAATGGCATAG","561307.5.peg.847","2296"
"34565",687,304,383,"CTTTGTGTTCTGGAATAAA","TGAACCTGCAAATGGCATAG","561307.5.peg.847","2296"
"34566",462,304,158,"GCAGGTAATTCGATGCCAAT","TGAACCTGCAAATGGCATAG","561307.5.peg.847","2296"
"34567",409,304,105,"TCCTGATGCAACAAAGGCTA","TGAACCTGCAAATGGCATAG","561307.5.peg.847","2296"
"34568",696,304,392,"GTAGCAGTTACTTTGTGTTC","TGAACCTGCAAATGGCATAG","561307.5.peg.847","2296"
"34569",8,312,304,"TTGTTTATGAATGTTTGGG","GAATAGGCTGAACCTGCAAA","561307.5.peg.847","2296"
"34570",687,312,375,"CTTTGTGTTCTGGAATAAA","GAATAGGCTGAACCTGCAAA","561307.5.peg.847","2296"
"34571",462,312,150,"GCAGGTAATTCGATGCCAAT","GAATAGGCTGAACCTGCAAA","561307.5.peg.847","2296"
"34572",415,312,103,"TGAGAATCCTGATGCAACAA","GAATAGGCTGAACCTGCAAA","561307.5.peg.847","2296"
"34573",696,312,384,"GTAGCAGTTACTTTGTGTTC","GAATAGGCTGAACCTGCAAA","561307.5.peg.847","2296"
"34574",198,312,114,"TGTTCTGCAGCAACAATGCC","GAATAGGCTGAACCTGCAAA","561307.5.peg.847","2296"
"34575",198,328,130,"TGTTCTGCAGCAACAATGCC","AATACATTGACCCAAGAAT","561307.5.peg.847","2296"
"34576",462,328,134,"GCAGGTAATTCGATGCCAAT","AATACATTGACCCAAGAAT","561307.5.peg.847","2296"
"34577",696,328,368,"GTAGCAGTTACTTTGTGTTC","AATACATTGACCCAAGAAT","561307.5.peg.847","2296"
"34578",228,328,100,"AAGAATGATAACGCAACGGC","AATACATTGACCCAAGAAT","561307.5.peg.847","2296"
"34579",687,328,359,"CTTTGTGTTCTGGAATAAA","AATACATTGACCCAAGAAT","561307.5.peg.847","2296"
"34580",8,328,320,"TTGTTTATGAATGTTTGGG","AATACATTGACCCAAGAAT","561307.5.peg.847","2296"
"34581",8,376,368,"TTGTTTATGAATGTTTGGG","TTCAGCTAATAGAGCCCAAC","561307.5.peg.847","2296"
"34582",232,376,144,"GAGTAAGAATGATAACGCAA","TTCAGCTAATAGAGCCCAAC","561307.5.peg.847","2296"
"34583",228,376,148,"AAGAATGATAACGCAACGGC","TTCAGCTAATAGAGCCCAAC","561307.5.peg.847","2296"
"34584",198,376,178,"TGTTCTGCAGCAACAATGCC","TTCAGCTAATAGAGCCCAAC","561307.5.peg.847","2296"
"34585",687,376,311,"CTTTGTGTTCTGGAATAAA","TTCAGCTAATAGAGCCCAAC","561307.5.peg.847","2296"
"34586",696,376,320,"GTAGCAGTTACTTTGTGTTC","TTCAGCTAATAGAGCCCAAC","561307.5.peg.847","2296"
"34587",198,409,211,"TGTTCTGCAGCAACAATGCC","TCCTGATGCAACAAAGGCTA","561307.5.peg.847","2296"
"34588",8,409,401,"TTGTTTATGAATGTTTGGG","TCCTGATGCAACAAAGGCTA","561307.5.peg.847","2296"
"34589",232,409,177,"GAGTAAGAATGATAACGCAA","TCCTGATGCAACAAAGGCTA","561307.5.peg.847","2296"
"34590",228,409,181,"AAGAATGATAACGCAACGGC","TCCTGATGCAACAAAGGCTA","561307.5.peg.847","2296"
"34591",304,409,105,"TGAACCTGCAAATGGCATAG","TCCTGATGCAACAAAGGCTA","561307.5.peg.847","2296"
"34592",687,409,278,"CTTTGTGTTCTGGAATAAA","TCCTGATGCAACAAAGGCTA","561307.5.peg.847","2296"
"34593",696,409,287,"GTAGCAGTTACTTTGTGTTC","TCCTGATGCAACAAAGGCTA","561307.5.peg.847","2296"
"34594",8,415,407,"TTGTTTATGAATGTTTGGG","TGAGAATCCTGATGCAACAA","561307.5.peg.847","2296"
"34595",232,415,183,"GAGTAAGAATGATAACGCAA","TGAGAATCCTGATGCAACAA","561307.5.peg.847","2296"
"34596",312,415,103,"GAATAGGCTGAACCTGCAAA","TGAGAATCCTGATGCAACAA","561307.5.peg.847","2296"
"34597",687,415,272,"CTTTGTGTTCTGGAATAAA","TGAGAATCCTGATGCAACAA","561307.5.peg.847","2296"
"34598",228,415,187,"AAGAATGATAACGCAACGGC","TGAGAATCCTGATGCAACAA","561307.5.peg.847","2296"
"34599",304,415,111,"TGAACCTGCAAATGGCATAG","TGAGAATCCTGATGCAACAA","561307.5.peg.847","2296"
"34600",198,415,217,"TGTTCTGCAGCAACAATGCC","TGAGAATCCTGATGCAACAA","561307.5.peg.847","2296"
"34601",696,415,281,"GTAGCAGTTACTTTGTGTTC","TGAGAATCCTGATGCAACAA","561307.5.peg.847","2296"
"34602",232,462,230,"GAGTAAGAATGATAACGCAA","GCAGGTAATTCGATGCCAAT","561307.5.peg.847","2296"
"34603",304,462,158,"TGAACCTGCAAATGGCATAG","GCAGGTAATTCGATGCCAAT","561307.5.peg.847","2296"
"34604",696,462,234,"GTAGCAGTTACTTTGTGTTC","GCAGGTAATTCGATGCCAAT","561307.5.peg.847","2296"
"34605",198,462,264,"TGTTCTGCAGCAACAATGCC","GCAGGTAATTCGATGCCAAT","561307.5.peg.847","2296"
"34606",687,462,225,"CTTTGTGTTCTGGAATAAA","GCAGGTAATTCGATGCCAAT","561307.5.peg.847","2296"
"34607",312,462,150,"GAATAGGCTGAACCTGCAAA","GCAGGTAATTCGATGCCAAT","561307.5.peg.847","2296"
"34608",228,462,234,"AAGAATGATAACGCAACGGC","GCAGGTAATTCGATGCCAAT","561307.5.peg.847","2296"
"34609",328,462,134,"AATACATTGACCCAAGAAT","GCAGGTAATTCGATGCCAAT","561307.5.peg.847","2296"
"34610",8,462,454,"TTGTTTATGAATGTTTGGG","GCAGGTAATTCGATGCCAAT","561307.5.peg.847","2296"
"34611",198,687,489,"TGTTCTGCAGCAACAATGCC","CTTTGTGTTCTGGAATAAA","561307.5.peg.847","2296"
"34612",304,687,383,"TGAACCTGCAAATGGCATAG","CTTTGTGTTCTGGAATAAA","561307.5.peg.847","2296"
"34613",312,687,375,"GAATAGGCTGAACCTGCAAA","CTTTGTGTTCTGGAATAAA","561307.5.peg.847","2296"
"34614",8,687,679,"TTGTTTATGAATGTTTGGG","CTTTGTGTTCTGGAATAAA","561307.5.peg.847","2296"
"34615",232,687,455,"GAGTAAGAATGATAACGCAA","CTTTGTGTTCTGGAATAAA","561307.5.peg.847","2296"
"34616",415,687,272,"TGAGAATCCTGATGCAACAA","CTTTGTGTTCTGGAATAAA","561307.5.peg.847","2296"
"34617",328,687,359,"AATACATTGACCCAAGAAT","CTTTGTGTTCTGGAATAAA","561307.5.peg.847","2296"
"34618",409,687,278,"TCCTGATGCAACAAAGGCTA","CTTTGTGTTCTGGAATAAA","561307.5.peg.847","2296"
"34619",376,687,311,"TTCAGCTAATAGAGCCCAAC","CTTTGTGTTCTGGAATAAA","561307.5.peg.847","2296"
"34620",462,687,225,"GCAGGTAATTCGATGCCAAT","CTTTGTGTTCTGGAATAAA","561307.5.peg.847","2296"
"34621",228,687,459,"AAGAATGATAACGCAACGGC","CTTTGTGTTCTGGAATAAA","561307.5.peg.847","2296"
"34622",312,696,384,"GAATAGGCTGAACCTGCAAA","GTAGCAGTTACTTTGTGTTC","561307.5.peg.847","2296"
"34623",462,696,234,"GCAGGTAATTCGATGCCAAT","GTAGCAGTTACTTTGTGTTC","561307.5.peg.847","2296"
"34624",409,696,287,"TCCTGATGCAACAAAGGCTA","GTAGCAGTTACTTTGTGTTC","561307.5.peg.847","2296"
"34625",415,696,281,"TGAGAATCCTGATGCAACAA","GTAGCAGTTACTTTGTGTTC","561307.5.peg.847","2296"
"34626",198,696,498,"TGTTCTGCAGCAACAATGCC","GTAGCAGTTACTTTGTGTTC","561307.5.peg.847","2296"
"34627",232,696,464,"GAGTAAGAATGATAACGCAA","GTAGCAGTTACTTTGTGTTC","561307.5.peg.847","2296"
"34628",376,696,320,"TTCAGCTAATAGAGCCCAAC","GTAGCAGTTACTTTGTGTTC","561307.5.peg.847","2296"
"34629",328,696,368,"AATACATTGACCCAAGAAT","GTAGCAGTTACTTTGTGTTC","561307.5.peg.847","2296"
"34630",304,696,392,"TGAACCTGCAAATGGCATAG","GTAGCAGTTACTTTGTGTTC","561307.5.peg.847","2296"
"34631",8,696,688,"TTGTTTATGAATGTTTGGG","GTAGCAGTTACTTTGTGTTC","561307.5.peg.847","2296"
"34632",228,696,468,"AAGAATGATAACGCAACGGC","GTAGCAGTTACTTTGTGTTC","561307.5.peg.847","2296"
"34633",215,112,103,"CATCAACTGGTGAAGGACTG","ACCTTGCGTAACCATTGCAA","561307.5.peg.848","2297"
"34634",222,112,110,"GCTTTCACATCAACTGGTGA","ACCTTGCGTAACCATTGCAA","561307.5.peg.848","2297"
"34635",228,112,116,"TCACCTGCTTTCACATCAAC","ACCTTGCGTAACCATTGCAA","561307.5.peg.848","2297"
"34636",309,112,197,"AATTGTAAACGTGTTTCACC","ACCTTGCGTAACCATTGCAA","561307.5.peg.848","2297"
"34637",309,203,106,"AATTGTAAACGTGTTTCACC","AAGGACTGTGGACTGTACCA","561307.5.peg.848","2297"
"34638",112,215,103,"ACCTTGCGTAACCATTGCAA","CATCAACTGGTGAAGGACTG","561307.5.peg.848","2297"
"34639",112,222,110,"ACCTTGCGTAACCATTGCAA","GCTTTCACATCAACTGGTGA","561307.5.peg.848","2297"
"34640",112,228,116,"ACCTTGCGTAACCATTGCAA","TCACCTGCTTTCACATCAAC","561307.5.peg.848","2297"
"34641",112,309,197,"ACCTTGCGTAACCATTGCAA","AATTGTAAACGTGTTTCACC","561307.5.peg.848","2297"
"34642",203,309,106,"AAGGACTGTGGACTGTACCA","AATTGTAAACGTGTTTCACC","561307.5.peg.848","2297"
"34643",356,55,301,"CACCATAGCTATGTGCTACA","ATTAACGTCAAATGAGTGTT","561307.5.peg.85","2299"
"34644",433,55,378,"CTGTTGCCAAGGAACAATAT","ATTAACGTCAAATGAGTGTT","561307.5.peg.85","2299"
"34645",444,55,389,"CGCTTTGCTAACTGTTGCCA","ATTAACGTCAAATGAGTGTT","561307.5.peg.85","2299"
"34646",492,55,437,"AATTCACCGTCAGCTGTCAT","ATTAACGTCAAATGAGTGTT","561307.5.peg.85","2299"
"34647",55,356,301,"ATTAACGTCAAATGAGTGTT","CACCATAGCTATGTGCTACA","561307.5.peg.85","2299"
"34648",492,356,136,"AATTCACCGTCAGCTGTCAT","CACCATAGCTATGTGCTACA","561307.5.peg.85","2299"
"34649",55,433,378,"ATTAACGTCAAATGAGTGTT","CTGTTGCCAAGGAACAATAT","561307.5.peg.85","2299"
"34650",55,444,389,"ATTAACGTCAAATGAGTGTT","CGCTTTGCTAACTGTTGCCA","561307.5.peg.85","2299"
"34651",55,492,437,"ATTAACGTCAAATGAGTGTT","AATTCACCGTCAGCTGTCAT","561307.5.peg.85","2299"
"34652",356,492,136,"CACCATAGCTATGTGCTACA","AATTCACCGTCAGCTGTCAT","561307.5.peg.85","2299"
"34653",177,74,103,"ATATCTTGTGCAGGTGCATG","TAGTTGTACCGACAGCGCCT","561307.5.peg.850","2300"
"34654",380,74,306,"CACTTATATAGACAACTGCT","TAGTTGTACCGACAGCGCCT","561307.5.peg.850","2300"
"34655",380,123,257,"CACTTATATAGACAACTGCT","CTCCCGATAAGCGTTGTATG","561307.5.peg.850","2300"
"34656",74,177,103,"TAGTTGTACCGACAGCGCCT","ATATCTTGTGCAGGTGCATG","561307.5.peg.850","2300"
"34657",380,177,203,"CACTTATATAGACAACTGCT","ATATCTTGTGCAGGTGCATG","561307.5.peg.850","2300"
"34658",74,380,306,"TAGTTGTACCGACAGCGCCT","CACTTATATAGACAACTGCT","561307.5.peg.850","2300"
"34659",123,380,257,"CTCCCGATAAGCGTTGTATG","CACTTATATAGACAACTGCT","561307.5.peg.850","2300"
"34660",177,380,203,"ATATCTTGTGCAGGTGCATG","CACTTATATAGACAACTGCT","561307.5.peg.850","2300"
"34661",300,126,174,"GAGATGCCTACTGCACCAAT","GCTTCCACTTGTTTAGCACT","561307.5.peg.851","2301"
"34662",126,300,174,"GCTTCCACTTGTTTAGCACT","GAGATGCCTACTGCACCAAT","561307.5.peg.851","2301"
"34663",228,103,125,"TCGTTTGGACCAAATTGTAA","AATCGTTGTGCCTGAGCGTT","561307.5.peg.852","2302"
"34664",243,103,140,"TAAGCATCGAAATCTTCGTT","AATCGTTGTGCCTGAGCGTT","561307.5.peg.852","2302"
"34665",330,103,227,"GGATACATATCTTCTACTGC","AATCGTTGTGCCTGAGCGTT","561307.5.peg.852","2302"
"34666",330,148,182,"GGATACATATCTTCTACTGC","CGTTAAATGTCCATCATGTA","561307.5.peg.852","2302"
"34667",103,228,125,"AATCGTTGTGCCTGAGCGTT","TCGTTTGGACCAAATTGTAA","561307.5.peg.852","2302"
"34668",330,228,102,"GGATACATATCTTCTACTGC","TCGTTTGGACCAAATTGTAA","561307.5.peg.852","2302"
"34669",103,243,140,"AATCGTTGTGCCTGAGCGTT","TAAGCATCGAAATCTTCGTT","561307.5.peg.852","2302"
"34670",103,330,227,"AATCGTTGTGCCTGAGCGTT","GGATACATATCTTCTACTGC","561307.5.peg.852","2302"
"34671",148,330,182,"CGTTAAATGTCCATCATGTA","GGATACATATCTTCTACTGC","561307.5.peg.852","2302"
"34672",228,330,102,"TCGTTTGGACCAAATTGTAA","GGATACATATCTTCTACTGC","561307.5.peg.852","2302"
"34673",658,56,602,"ATCTGGTATACCTCCGTGAA","TGGATTTCCTAGTAAATGT","561307.5.peg.854","2304"
"34674",316,56,260,"GGTACCTAATGTTGGCCAAA","TGGATTTCCTAGTAAATGT","561307.5.peg.854","2304"
"34675",324,56,268,"GTCGGAATGGTACCTAATGT","TGGATTTCCTAGTAAATGT","561307.5.peg.854","2304"
"34676",442,56,386,"CCATGGAGATAAGACGCCTT","TGGATTTCCTAGTAAATGT","561307.5.peg.854","2304"
"34677",360,56,304,"CCTGGGTCTGGTGATTCTTC","TGGATTTCCTAGTAAATGT","561307.5.peg.854","2304"
"34678",251,56,195,"TATCTGCAGACATAACTACA","TGGATTTCCTAGTAAATGT","561307.5.peg.854","2304"
"34679",831,56,775,"CAACTAGCACATGTTAGTAG","TGGATTTCCTAGTAAATGT","561307.5.peg.854","2304"
"34680",324,112,212,"GTCGGAATGGTACCTAATGT","GACAACGATGTGGTTAATAC","561307.5.peg.854","2304"
"34681",831,112,719,"CAACTAGCACATGTTAGTAG","GACAACGATGTGGTTAATAC","561307.5.peg.854","2304"
"34682",251,112,139,"TATCTGCAGACATAACTACA","GACAACGATGTGGTTAATAC","561307.5.peg.854","2304"
"34683",658,112,546,"ATCTGGTATACCTCCGTGAA","GACAACGATGTGGTTAATAC","561307.5.peg.854","2304"
"34684",316,112,204,"GGTACCTAATGTTGGCCAAA","GACAACGATGTGGTTAATAC","561307.5.peg.854","2304"
"34685",360,112,248,"CCTGGGTCTGGTGATTCTTC","GACAACGATGTGGTTAATAC","561307.5.peg.854","2304"
"34686",442,112,330,"CCATGGAGATAAGACGCCTT","GACAACGATGTGGTTAATAC","561307.5.peg.854","2304"
"34687",316,122,194,"GGTACCTAATGTTGGCCAAA","GAACACTGTCGACAACGATG","561307.5.peg.854","2304"
"34688",324,122,202,"GTCGGAATGGTACCTAATGT","GAACACTGTCGACAACGATG","561307.5.peg.854","2304"
"34689",442,122,320,"CCATGGAGATAAGACGCCTT","GAACACTGTCGACAACGATG","561307.5.peg.854","2304"
"34690",360,122,238,"CCTGGGTCTGGTGATTCTTC","GAACACTGTCGACAACGATG","561307.5.peg.854","2304"
"34691",831,122,709,"CAACTAGCACATGTTAGTAG","GAACACTGTCGACAACGATG","561307.5.peg.854","2304"
"34692",251,122,129,"TATCTGCAGACATAACTACA","GAACACTGTCGACAACGATG","561307.5.peg.854","2304"
"34693",658,122,536,"ATCTGGTATACCTCCGTGAA","GAACACTGTCGACAACGATG","561307.5.peg.854","2304"
"34694",831,251,580,"CAACTAGCACATGTTAGTAG","TATCTGCAGACATAACTACA","561307.5.peg.854","2304"
"34695",360,251,109,"CCTGGGTCTGGTGATTCTTC","TATCTGCAGACATAACTACA","561307.5.peg.854","2304"
"34696",442,251,191,"CCATGGAGATAAGACGCCTT","TATCTGCAGACATAACTACA","561307.5.peg.854","2304"
"34697",122,251,129,"GAACACTGTCGACAACGATG","TATCTGCAGACATAACTACA","561307.5.peg.854","2304"
"34698",56,251,195,"TGGATTTCCTAGTAAATGT","TATCTGCAGACATAACTACA","561307.5.peg.854","2304"
"34699",112,251,139,"GACAACGATGTGGTTAATAC","TATCTGCAGACATAACTACA","561307.5.peg.854","2304"
"34700",658,251,407,"ATCTGGTATACCTCCGTGAA","TATCTGCAGACATAACTACA","561307.5.peg.854","2304"
"34701",56,316,260,"TGGATTTCCTAGTAAATGT","GGTACCTAATGTTGGCCAAA","561307.5.peg.854","2304"
"34702",831,316,515,"CAACTAGCACATGTTAGTAG","GGTACCTAATGTTGGCCAAA","561307.5.peg.854","2304"
"34703",658,316,342,"ATCTGGTATACCTCCGTGAA","GGTACCTAATGTTGGCCAAA","561307.5.peg.854","2304"
"34704",442,316,126,"CCATGGAGATAAGACGCCTT","GGTACCTAATGTTGGCCAAA","561307.5.peg.854","2304"
"34705",122,316,194,"GAACACTGTCGACAACGATG","GGTACCTAATGTTGGCCAAA","561307.5.peg.854","2304"
"34706",112,316,204,"GACAACGATGTGGTTAATAC","GGTACCTAATGTTGGCCAAA","561307.5.peg.854","2304"
"34707",56,324,268,"TGGATTTCCTAGTAAATGT","GTCGGAATGGTACCTAATGT","561307.5.peg.854","2304"
"34708",112,324,212,"GACAACGATGTGGTTAATAC","GTCGGAATGGTACCTAATGT","561307.5.peg.854","2304"
"34709",831,324,507,"CAACTAGCACATGTTAGTAG","GTCGGAATGGTACCTAATGT","561307.5.peg.854","2304"
"34710",658,324,334,"ATCTGGTATACCTCCGTGAA","GTCGGAATGGTACCTAATGT","561307.5.peg.854","2304"
"34711",442,324,118,"CCATGGAGATAAGACGCCTT","GTCGGAATGGTACCTAATGT","561307.5.peg.854","2304"
"34712",122,324,202,"GAACACTGTCGACAACGATG","GTCGGAATGGTACCTAATGT","561307.5.peg.854","2304"
"34713",112,360,248,"GACAACGATGTGGTTAATAC","CCTGGGTCTGGTGATTCTTC","561307.5.peg.854","2304"
"34714",122,360,238,"GAACACTGTCGACAACGATG","CCTGGGTCTGGTGATTCTTC","561307.5.peg.854","2304"
"34715",251,360,109,"TATCTGCAGACATAACTACA","CCTGGGTCTGGTGATTCTTC","561307.5.peg.854","2304"
"34716",56,360,304,"TGGATTTCCTAGTAAATGT","CCTGGGTCTGGTGATTCTTC","561307.5.peg.854","2304"
"34717",831,360,471,"CAACTAGCACATGTTAGTAG","CCTGGGTCTGGTGATTCTTC","561307.5.peg.854","2304"
"34718",658,360,298,"ATCTGGTATACCTCCGTGAA","CCTGGGTCTGGTGATTCTTC","561307.5.peg.854","2304"
"34719",324,442,118,"GTCGGAATGGTACCTAATGT","CCATGGAGATAAGACGCCTT","561307.5.peg.854","2304"
"34720",831,442,389,"CAACTAGCACATGTTAGTAG","CCATGGAGATAAGACGCCTT","561307.5.peg.854","2304"
"34721",658,442,216,"ATCTGGTATACCTCCGTGAA","CCATGGAGATAAGACGCCTT","561307.5.peg.854","2304"
"34722",112,442,330,"GACAACGATGTGGTTAATAC","CCATGGAGATAAGACGCCTT","561307.5.peg.854","2304"
"34723",56,442,386,"TGGATTTCCTAGTAAATGT","CCATGGAGATAAGACGCCTT","561307.5.peg.854","2304"
"34724",122,442,320,"GAACACTGTCGACAACGATG","CCATGGAGATAAGACGCCTT","561307.5.peg.854","2304"
"34725",316,442,126,"GGTACCTAATGTTGGCCAAA","CCATGGAGATAAGACGCCTT","561307.5.peg.854","2304"
"34726",251,442,191,"TATCTGCAGACATAACTACA","CCATGGAGATAAGACGCCTT","561307.5.peg.854","2304"
"34727",122,658,536,"GAACACTGTCGACAACGATG","ATCTGGTATACCTCCGTGAA","561307.5.peg.854","2304"
"34728",360,658,298,"CCTGGGTCTGGTGATTCTTC","ATCTGGTATACCTCCGTGAA","561307.5.peg.854","2304"
"34729",56,658,602,"TGGATTTCCTAGTAAATGT","ATCTGGTATACCTCCGTGAA","561307.5.peg.854","2304"
"34730",442,658,216,"CCATGGAGATAAGACGCCTT","ATCTGGTATACCTCCGTGAA","561307.5.peg.854","2304"
"34731",831,658,173,"CAACTAGCACATGTTAGTAG","ATCTGGTATACCTCCGTGAA","561307.5.peg.854","2304"
"34732",112,658,546,"GACAACGATGTGGTTAATAC","ATCTGGTATACCTCCGTGAA","561307.5.peg.854","2304"
"34733",251,658,407,"TATCTGCAGACATAACTACA","ATCTGGTATACCTCCGTGAA","561307.5.peg.854","2304"
"34734",316,658,342,"GGTACCTAATGTTGGCCAAA","ATCTGGTATACCTCCGTGAA","561307.5.peg.854","2304"
"34735",324,658,334,"GTCGGAATGGTACCTAATGT","ATCTGGTATACCTCCGTGAA","561307.5.peg.854","2304"
"34736",251,831,580,"TATCTGCAGACATAACTACA","CAACTAGCACATGTTAGTAG","561307.5.peg.854","2304"
"34737",56,831,775,"TGGATTTCCTAGTAAATGT","CAACTAGCACATGTTAGTAG","561307.5.peg.854","2304"
"34738",658,831,173,"ATCTGGTATACCTCCGTGAA","CAACTAGCACATGTTAGTAG","561307.5.peg.854","2304"
"34739",112,831,719,"GACAACGATGTGGTTAATAC","CAACTAGCACATGTTAGTAG","561307.5.peg.854","2304"
"34740",442,831,389,"CCATGGAGATAAGACGCCTT","CAACTAGCACATGTTAGTAG","561307.5.peg.854","2304"
"34741",324,831,507,"GTCGGAATGGTACCTAATGT","CAACTAGCACATGTTAGTAG","561307.5.peg.854","2304"
"34742",122,831,709,"GAACACTGTCGACAACGATG","CAACTAGCACATGTTAGTAG","561307.5.peg.854","2304"
"34743",316,831,515,"GGTACCTAATGTTGGCCAAA","CAACTAGCACATGTTAGTAG","561307.5.peg.854","2304"
"34744",360,831,471,"CCTGGGTCTGGTGATTCTTC","CAACTAGCACATGTTAGTAG","561307.5.peg.854","2304"
"34745",236,12,224,"CTCTTATTTCCTCCAACTGC","AACGTTTATAATCATTGGGG","561307.5.peg.855","2305"
"34746",301,12,289,"ATTTGATGTATGTTATCCG","AACGTTTATAATCATTGGGG","561307.5.peg.855","2305"
"34747",12,236,224,"AACGTTTATAATCATTGGGG","CTCTTATTTCCTCCAACTGC","561307.5.peg.855","2305"
"34748",12,301,289,"AACGTTTATAATCATTGGGG","ATTTGATGTATGTTATCCG","561307.5.peg.855","2305"
"34749",144,35,109,"CAGTAGTATGCTTATGATT","TGCCATAAATTCATGTGTA","561307.5.peg.856","2306"
"34750",408,35,373,"ATTACAGGACCTAGTGAACC","TGCCATAAATTCATGTGTA","561307.5.peg.856","2306"
"34751",35,144,109,"TGCCATAAATTCATGTGTA","CAGTAGTATGCTTATGATT","561307.5.peg.856","2306"
"34752",408,144,264,"ATTACAGGACCTAGTGAACC","CAGTAGTATGCTTATGATT","561307.5.peg.856","2306"
"34753",35,408,373,"TGCCATAAATTCATGTGTA","ATTACAGGACCTAGTGAACC","561307.5.peg.856","2306"
"34754",144,408,264,"CAGTAGTATGCTTATGATT","ATTACAGGACCTAGTGAACC","561307.5.peg.856","2306"
"34755",1269,201,1068,"TCTTGTGGTTTGTATGCAAT","TCTTCATGAGCTAAGAATTG","561307.5.peg.857","2307"
"34756",1881,201,1680,"CAATTAATGTGACATGACT","TCTTCATGAGCTAAGAATTG","561307.5.peg.857","2307"
"34757",1501,201,1300,"AAGTACTTCTTCAATCTCAG","TCTTCATGAGCTAAGAATTG","561307.5.peg.857","2307"
"34758",1146,201,945,"TGGTCTGTAACCGCAATGGC","TCTTCATGAGCTAAGAATTG","561307.5.peg.857","2307"
"34759",1188,201,987,"TCCGCTGCTGCGTGAGCATC","TCTTCATGAGCTAAGAATTG","561307.5.peg.857","2307"
"34760",1986,201,1785,"ATTCATCTAACAATGAACG","TCTTCATGAGCTAAGAATTG","561307.5.peg.857","2307"
"34761",1150,201,949,"ATTATGGTCTGTAACCGCAA","TCTTCATGAGCTAAGAATTG","561307.5.peg.857","2307"
"34762",1626,201,1425,"TCGATAACACCATTCGTTGA","TCTTCATGAGCTAAGAATTG","561307.5.peg.857","2307"
"34763",1434,201,1233,"GTTTCCGATAATCGTTCATG","TCTTCATGAGCTAAGAATTG","561307.5.peg.857","2307"
"34764",2130,201,1929,"AAATCTTGATAAAGTGCCGG","TCTTCATGAGCTAAGAATTG","561307.5.peg.857","2307"
"34765",1970,201,1769,"AACGTGGAATTCGAGGTGTA","TCTTCATGAGCTAAGAATTG","561307.5.peg.857","2307"
"34766",1101,201,900,"TTAACATACGCACCAATATT","TCTTCATGAGCTAAGAATTG","561307.5.peg.857","2307"
"34767",1977,201,1776,"AACAATGAACGTGGAATTCG","TCTTCATGAGCTAAGAATTG","561307.5.peg.857","2307"
"34768",1166,201,965,"GAAATGCTTGCACAACATTA","TCTTCATGAGCTAAGAATTG","561307.5.peg.857","2307"
"34769",1064,201,863,"GGCTCATTGCAGTATGCAAG","TCTTCATGAGCTAAGAATTG","561307.5.peg.857","2307"
"34770",2133,201,1932,"TTAAATCTTGATAAAGTGC","TCTTCATGAGCTAAGAATTG","561307.5.peg.857","2307"
"34771",1881,1064,817,"CAATTAATGTGACATGACT","GGCTCATTGCAGTATGCAAG","561307.5.peg.857","2307"
"34772",201,1064,863,"TCTTCATGAGCTAAGAATTG","GGCTCATTGCAGTATGCAAG","561307.5.peg.857","2307"
"34773",2130,1064,1066,"AAATCTTGATAAAGTGCCGG","GGCTCATTGCAGTATGCAAG","561307.5.peg.857","2307"
"34774",1501,1064,437,"AAGTACTTCTTCAATCTCAG","GGCTCATTGCAGTATGCAAG","561307.5.peg.857","2307"
"34775",1166,1064,102,"GAAATGCTTGCACAACATTA","GGCTCATTGCAGTATGCAAG","561307.5.peg.857","2307"
"34776",1977,1064,913,"AACAATGAACGTGGAATTCG","GGCTCATTGCAGTATGCAAG","561307.5.peg.857","2307"
"34777",2133,1064,1069,"TTAAATCTTGATAAAGTGC","GGCTCATTGCAGTATGCAAG","561307.5.peg.857","2307"
"34778",1626,1064,562,"TCGATAACACCATTCGTTGA","GGCTCATTGCAGTATGCAAG","561307.5.peg.857","2307"
"34779",1269,1064,205,"TCTTGTGGTTTGTATGCAAT","GGCTCATTGCAGTATGCAAG","561307.5.peg.857","2307"
"34780",1188,1064,124,"TCCGCTGCTGCGTGAGCATC","GGCTCATTGCAGTATGCAAG","561307.5.peg.857","2307"
"34781",1970,1064,906,"AACGTGGAATTCGAGGTGTA","GGCTCATTGCAGTATGCAAG","561307.5.peg.857","2307"
"34782",1986,1064,922,"ATTCATCTAACAATGAACG","GGCTCATTGCAGTATGCAAG","561307.5.peg.857","2307"
"34783",1434,1064,370,"GTTTCCGATAATCGTTCATG","GGCTCATTGCAGTATGCAAG","561307.5.peg.857","2307"
"34784",2130,1101,1029,"AAATCTTGATAAAGTGCCGG","TTAACATACGCACCAATATT","561307.5.peg.857","2307"
"34785",1501,1101,400,"AAGTACTTCTTCAATCTCAG","TTAACATACGCACCAATATT","561307.5.peg.857","2307"
"34786",1626,1101,525,"TCGATAACACCATTCGTTGA","TTAACATACGCACCAATATT","561307.5.peg.857","2307"
"34787",201,1101,900,"TCTTCATGAGCTAAGAATTG","TTAACATACGCACCAATATT","561307.5.peg.857","2307"
"34788",1434,1101,333,"GTTTCCGATAATCGTTCATG","TTAACATACGCACCAATATT","561307.5.peg.857","2307"
"34789",1269,1101,168,"TCTTGTGGTTTGTATGCAAT","TTAACATACGCACCAATATT","561307.5.peg.857","2307"
"34790",1977,1101,876,"AACAATGAACGTGGAATTCG","TTAACATACGCACCAATATT","561307.5.peg.857","2307"
"34791",1986,1101,885,"ATTCATCTAACAATGAACG","TTAACATACGCACCAATATT","561307.5.peg.857","2307"
"34792",1881,1101,780,"CAATTAATGTGACATGACT","TTAACATACGCACCAATATT","561307.5.peg.857","2307"
"34793",2133,1101,1032,"TTAAATCTTGATAAAGTGC","TTAACATACGCACCAATATT","561307.5.peg.857","2307"
"34794",1970,1101,869,"AACGTGGAATTCGAGGTGTA","TTAACATACGCACCAATATT","561307.5.peg.857","2307"
"34795",1626,1146,480,"TCGATAACACCATTCGTTGA","TGGTCTGTAACCGCAATGGC","561307.5.peg.857","2307"
"34796",1434,1146,288,"GTTTCCGATAATCGTTCATG","TGGTCTGTAACCGCAATGGC","561307.5.peg.857","2307"
"34797",1970,1146,824,"AACGTGGAATTCGAGGTGTA","TGGTCTGTAACCGCAATGGC","561307.5.peg.857","2307"
"34798",2133,1146,987,"TTAAATCTTGATAAAGTGC","TGGTCTGTAACCGCAATGGC","561307.5.peg.857","2307"
"34799",1881,1146,735,"CAATTAATGTGACATGACT","TGGTCTGTAACCGCAATGGC","561307.5.peg.857","2307"
"34800",1269,1146,123,"TCTTGTGGTTTGTATGCAAT","TGGTCTGTAACCGCAATGGC","561307.5.peg.857","2307"
"34801",1501,1146,355,"AAGTACTTCTTCAATCTCAG","TGGTCTGTAACCGCAATGGC","561307.5.peg.857","2307"
"34802",1977,1146,831,"AACAATGAACGTGGAATTCG","TGGTCTGTAACCGCAATGGC","561307.5.peg.857","2307"
"34803",2130,1146,984,"AAATCTTGATAAAGTGCCGG","TGGTCTGTAACCGCAATGGC","561307.5.peg.857","2307"
"34804",1986,1146,840,"ATTCATCTAACAATGAACG","TGGTCTGTAACCGCAATGGC","561307.5.peg.857","2307"
"34805",201,1146,945,"TCTTCATGAGCTAAGAATTG","TGGTCTGTAACCGCAATGGC","561307.5.peg.857","2307"
"34806",1977,1150,827,"AACAATGAACGTGGAATTCG","ATTATGGTCTGTAACCGCAA","561307.5.peg.857","2307"
"34807",2130,1150,980,"AAATCTTGATAAAGTGCCGG","ATTATGGTCTGTAACCGCAA","561307.5.peg.857","2307"
"34808",1986,1150,836,"ATTCATCTAACAATGAACG","ATTATGGTCTGTAACCGCAA","561307.5.peg.857","2307"
"34809",1501,1150,351,"AAGTACTTCTTCAATCTCAG","ATTATGGTCTGTAACCGCAA","561307.5.peg.857","2307"
"34810",1970,1150,820,"AACGTGGAATTCGAGGTGTA","ATTATGGTCTGTAACCGCAA","561307.5.peg.857","2307"
"34811",2133,1150,983,"TTAAATCTTGATAAAGTGC","ATTATGGTCTGTAACCGCAA","561307.5.peg.857","2307"
"34812",1269,1150,119,"TCTTGTGGTTTGTATGCAAT","ATTATGGTCTGTAACCGCAA","561307.5.peg.857","2307"
"34813",1626,1150,476,"TCGATAACACCATTCGTTGA","ATTATGGTCTGTAACCGCAA","561307.5.peg.857","2307"
"34814",1881,1150,731,"CAATTAATGTGACATGACT","ATTATGGTCTGTAACCGCAA","561307.5.peg.857","2307"
"34815",201,1150,949,"TCTTCATGAGCTAAGAATTG","ATTATGGTCTGTAACCGCAA","561307.5.peg.857","2307"
"34816",1434,1150,284,"GTTTCCGATAATCGTTCATG","ATTATGGTCTGTAACCGCAA","561307.5.peg.857","2307"
"34817",1986,1166,820,"ATTCATCTAACAATGAACG","GAAATGCTTGCACAACATTA","561307.5.peg.857","2307"
"34818",201,1166,965,"TCTTCATGAGCTAAGAATTG","GAAATGCTTGCACAACATTA","561307.5.peg.857","2307"
"34819",1434,1166,268,"GTTTCCGATAATCGTTCATG","GAAATGCTTGCACAACATTA","561307.5.peg.857","2307"
"34820",1269,1166,103,"TCTTGTGGTTTGTATGCAAT","GAAATGCTTGCACAACATTA","561307.5.peg.857","2307"
"34821",1977,1166,811,"AACAATGAACGTGGAATTCG","GAAATGCTTGCACAACATTA","561307.5.peg.857","2307"
"34822",1970,1166,804,"AACGTGGAATTCGAGGTGTA","GAAATGCTTGCACAACATTA","561307.5.peg.857","2307"
"34823",1881,1166,715,"CAATTAATGTGACATGACT","GAAATGCTTGCACAACATTA","561307.5.peg.857","2307"
"34824",1626,1166,460,"TCGATAACACCATTCGTTGA","GAAATGCTTGCACAACATTA","561307.5.peg.857","2307"
"34825",1501,1166,335,"AAGTACTTCTTCAATCTCAG","GAAATGCTTGCACAACATTA","561307.5.peg.857","2307"
"34826",1064,1166,102,"GGCTCATTGCAGTATGCAAG","GAAATGCTTGCACAACATTA","561307.5.peg.857","2307"
"34827",2130,1166,964,"AAATCTTGATAAAGTGCCGG","GAAATGCTTGCACAACATTA","561307.5.peg.857","2307"
"34828",2133,1166,967,"TTAAATCTTGATAAAGTGC","GAAATGCTTGCACAACATTA","561307.5.peg.857","2307"
"34829",2130,1188,942,"AAATCTTGATAAAGTGCCGG","TCCGCTGCTGCGTGAGCATC","561307.5.peg.857","2307"
"34830",1986,1188,798,"ATTCATCTAACAATGAACG","TCCGCTGCTGCGTGAGCATC","561307.5.peg.857","2307"
"34831",1501,1188,313,"AAGTACTTCTTCAATCTCAG","TCCGCTGCTGCGTGAGCATC","561307.5.peg.857","2307"
"34832",2133,1188,945,"TTAAATCTTGATAAAGTGC","TCCGCTGCTGCGTGAGCATC","561307.5.peg.857","2307"
"34833",1064,1188,124,"GGCTCATTGCAGTATGCAAG","TCCGCTGCTGCGTGAGCATC","561307.5.peg.857","2307"
"34834",1434,1188,246,"GTTTCCGATAATCGTTCATG","TCCGCTGCTGCGTGAGCATC","561307.5.peg.857","2307"
"34835",1626,1188,438,"TCGATAACACCATTCGTTGA","TCCGCTGCTGCGTGAGCATC","561307.5.peg.857","2307"
"34836",1881,1188,693,"CAATTAATGTGACATGACT","TCCGCTGCTGCGTGAGCATC","561307.5.peg.857","2307"
"34837",201,1188,987,"TCTTCATGAGCTAAGAATTG","TCCGCTGCTGCGTGAGCATC","561307.5.peg.857","2307"
"34838",1970,1188,782,"AACGTGGAATTCGAGGTGTA","TCCGCTGCTGCGTGAGCATC","561307.5.peg.857","2307"
"34839",1977,1188,789,"AACAATGAACGTGGAATTCG","TCCGCTGCTGCGTGAGCATC","561307.5.peg.857","2307"
"34840",2130,1269,861,"AAATCTTGATAAAGTGCCGG","TCTTGTGGTTTGTATGCAAT","561307.5.peg.857","2307"
"34841",1881,1269,612,"CAATTAATGTGACATGACT","TCTTGTGGTTTGTATGCAAT","561307.5.peg.857","2307"
"34842",1146,1269,123,"TGGTCTGTAACCGCAATGGC","TCTTGTGGTTTGTATGCAAT","561307.5.peg.857","2307"
"34843",1166,1269,103,"GAAATGCTTGCACAACATTA","TCTTGTGGTTTGTATGCAAT","561307.5.peg.857","2307"
"34844",1970,1269,701,"AACGTGGAATTCGAGGTGTA","TCTTGTGGTTTGTATGCAAT","561307.5.peg.857","2307"
"34845",1626,1269,357,"TCGATAACACCATTCGTTGA","TCTTGTGGTTTGTATGCAAT","561307.5.peg.857","2307"
"34846",1501,1269,232,"AAGTACTTCTTCAATCTCAG","TCTTGTGGTTTGTATGCAAT","561307.5.peg.857","2307"
"34847",201,1269,1068,"TCTTCATGAGCTAAGAATTG","TCTTGTGGTTTGTATGCAAT","561307.5.peg.857","2307"
"34848",1064,1269,205,"GGCTCATTGCAGTATGCAAG","TCTTGTGGTTTGTATGCAAT","561307.5.peg.857","2307"
"34849",2133,1269,864,"TTAAATCTTGATAAAGTGC","TCTTGTGGTTTGTATGCAAT","561307.5.peg.857","2307"
"34850",1434,1269,165,"GTTTCCGATAATCGTTCATG","TCTTGTGGTTTGTATGCAAT","561307.5.peg.857","2307"
"34851",1977,1269,708,"AACAATGAACGTGGAATTCG","TCTTGTGGTTTGTATGCAAT","561307.5.peg.857","2307"
"34852",1101,1269,168,"TTAACATACGCACCAATATT","TCTTGTGGTTTGTATGCAAT","561307.5.peg.857","2307"
"34853",1986,1269,717,"ATTCATCTAACAATGAACG","TCTTGTGGTTTGTATGCAAT","561307.5.peg.857","2307"
"34854",1150,1269,119,"ATTATGGTCTGTAACCGCAA","TCTTGTGGTTTGTATGCAAT","561307.5.peg.857","2307"
"34855",1626,1434,192,"TCGATAACACCATTCGTTGA","GTTTCCGATAATCGTTCATG","561307.5.peg.857","2307"
"34856",2130,1434,696,"AAATCTTGATAAAGTGCCGG","GTTTCCGATAATCGTTCATG","561307.5.peg.857","2307"
"34857",1150,1434,284,"ATTATGGTCTGTAACCGCAA","GTTTCCGATAATCGTTCATG","561307.5.peg.857","2307"
"34858",1970,1434,536,"AACGTGGAATTCGAGGTGTA","GTTTCCGATAATCGTTCATG","561307.5.peg.857","2307"
"34859",1881,1434,447,"CAATTAATGTGACATGACT","GTTTCCGATAATCGTTCATG","561307.5.peg.857","2307"
"34860",1166,1434,268,"GAAATGCTTGCACAACATTA","GTTTCCGATAATCGTTCATG","561307.5.peg.857","2307"
"34861",1146,1434,288,"TGGTCTGTAACCGCAATGGC","GTTTCCGATAATCGTTCATG","561307.5.peg.857","2307"
"34862",1064,1434,370,"GGCTCATTGCAGTATGCAAG","GTTTCCGATAATCGTTCATG","561307.5.peg.857","2307"
"34863",1188,1434,246,"TCCGCTGCTGCGTGAGCATC","GTTTCCGATAATCGTTCATG","561307.5.peg.857","2307"
"34864",1269,1434,165,"TCTTGTGGTTTGTATGCAAT","GTTTCCGATAATCGTTCATG","561307.5.peg.857","2307"
"34865",1101,1434,333,"TTAACATACGCACCAATATT","GTTTCCGATAATCGTTCATG","561307.5.peg.857","2307"
"34866",201,1434,1233,"TCTTCATGAGCTAAGAATTG","GTTTCCGATAATCGTTCATG","561307.5.peg.857","2307"
"34867",1977,1434,543,"AACAATGAACGTGGAATTCG","GTTTCCGATAATCGTTCATG","561307.5.peg.857","2307"
"34868",2133,1434,699,"TTAAATCTTGATAAAGTGC","GTTTCCGATAATCGTTCATG","561307.5.peg.857","2307"
"34869",1986,1434,552,"ATTCATCTAACAATGAACG","GTTTCCGATAATCGTTCATG","561307.5.peg.857","2307"
"34870",1150,1501,351,"ATTATGGTCTGTAACCGCAA","AAGTACTTCTTCAATCTCAG","561307.5.peg.857","2307"
"34871",1188,1501,313,"TCCGCTGCTGCGTGAGCATC","AAGTACTTCTTCAATCTCAG","561307.5.peg.857","2307"
"34872",1970,1501,469,"AACGTGGAATTCGAGGTGTA","AAGTACTTCTTCAATCTCAG","561307.5.peg.857","2307"
"34873",1977,1501,476,"AACAATGAACGTGGAATTCG","AAGTACTTCTTCAATCTCAG","561307.5.peg.857","2307"
"34874",1064,1501,437,"GGCTCATTGCAGTATGCAAG","AAGTACTTCTTCAATCTCAG","561307.5.peg.857","2307"
"34875",1269,1501,232,"TCTTGTGGTTTGTATGCAAT","AAGTACTTCTTCAATCTCAG","561307.5.peg.857","2307"
"34876",1146,1501,355,"TGGTCTGTAACCGCAATGGC","AAGTACTTCTTCAATCTCAG","561307.5.peg.857","2307"
"34877",1166,1501,335,"GAAATGCTTGCACAACATTA","AAGTACTTCTTCAATCTCAG","561307.5.peg.857","2307"
"34878",2130,1501,629,"AAATCTTGATAAAGTGCCGG","AAGTACTTCTTCAATCTCAG","561307.5.peg.857","2307"
"34879",201,1501,1300,"TCTTCATGAGCTAAGAATTG","AAGTACTTCTTCAATCTCAG","561307.5.peg.857","2307"
"34880",1881,1501,380,"CAATTAATGTGACATGACT","AAGTACTTCTTCAATCTCAG","561307.5.peg.857","2307"
"34881",2133,1501,632,"TTAAATCTTGATAAAGTGC","AAGTACTTCTTCAATCTCAG","561307.5.peg.857","2307"
"34882",1101,1501,400,"TTAACATACGCACCAATATT","AAGTACTTCTTCAATCTCAG","561307.5.peg.857","2307"
"34883",1626,1501,125,"TCGATAACACCATTCGTTGA","AAGTACTTCTTCAATCTCAG","561307.5.peg.857","2307"
"34884",1986,1501,485,"ATTCATCTAACAATGAACG","AAGTACTTCTTCAATCTCAG","561307.5.peg.857","2307"
"34885",1269,1626,357,"TCTTGTGGTTTGTATGCAAT","TCGATAACACCATTCGTTGA","561307.5.peg.857","2307"
"34886",1501,1626,125,"AAGTACTTCTTCAATCTCAG","TCGATAACACCATTCGTTGA","561307.5.peg.857","2307"
"34887",1166,1626,460,"GAAATGCTTGCACAACATTA","TCGATAACACCATTCGTTGA","561307.5.peg.857","2307"
"34888",2133,1626,507,"TTAAATCTTGATAAAGTGC","TCGATAACACCATTCGTTGA","561307.5.peg.857","2307"
"34889",1434,1626,192,"GTTTCCGATAATCGTTCATG","TCGATAACACCATTCGTTGA","561307.5.peg.857","2307"
"34890",1986,1626,360,"ATTCATCTAACAATGAACG","TCGATAACACCATTCGTTGA","561307.5.peg.857","2307"
"34891",1188,1626,438,"TCCGCTGCTGCGTGAGCATC","TCGATAACACCATTCGTTGA","561307.5.peg.857","2307"
"34892",1881,1626,255,"CAATTAATGTGACATGACT","TCGATAACACCATTCGTTGA","561307.5.peg.857","2307"
"34893",1150,1626,476,"ATTATGGTCTGTAACCGCAA","TCGATAACACCATTCGTTGA","561307.5.peg.857","2307"
"34894",1101,1626,525,"TTAACATACGCACCAATATT","TCGATAACACCATTCGTTGA","561307.5.peg.857","2307"
"34895",201,1626,1425,"TCTTCATGAGCTAAGAATTG","TCGATAACACCATTCGTTGA","561307.5.peg.857","2307"
"34896",1977,1626,351,"AACAATGAACGTGGAATTCG","TCGATAACACCATTCGTTGA","561307.5.peg.857","2307"
"34897",1146,1626,480,"TGGTCTGTAACCGCAATGGC","TCGATAACACCATTCGTTGA","561307.5.peg.857","2307"
"34898",1064,1626,562,"GGCTCATTGCAGTATGCAAG","TCGATAACACCATTCGTTGA","561307.5.peg.857","2307"
"34899",2130,1626,504,"AAATCTTGATAAAGTGCCGG","TCGATAACACCATTCGTTGA","561307.5.peg.857","2307"
"34900",1970,1626,344,"AACGTGGAATTCGAGGTGTA","TCGATAACACCATTCGTTGA","561307.5.peg.857","2307"
"34901",1986,1881,105,"ATTCATCTAACAATGAACG","CAATTAATGTGACATGACT","561307.5.peg.857","2307"
"34902",2130,1881,249,"AAATCTTGATAAAGTGCCGG","CAATTAATGTGACATGACT","561307.5.peg.857","2307"
"34903",1434,1881,447,"GTTTCCGATAATCGTTCATG","CAATTAATGTGACATGACT","561307.5.peg.857","2307"
"34904",1064,1881,817,"GGCTCATTGCAGTATGCAAG","CAATTAATGTGACATGACT","561307.5.peg.857","2307"
"34905",1188,1881,693,"TCCGCTGCTGCGTGAGCATC","CAATTAATGTGACATGACT","561307.5.peg.857","2307"
"34906",1166,1881,715,"GAAATGCTTGCACAACATTA","CAATTAATGTGACATGACT","561307.5.peg.857","2307"
"34907",1146,1881,735,"TGGTCTGTAACCGCAATGGC","CAATTAATGTGACATGACT","561307.5.peg.857","2307"
"34908",2133,1881,252,"TTAAATCTTGATAAAGTGC","CAATTAATGTGACATGACT","561307.5.peg.857","2307"
"34909",201,1881,1680,"TCTTCATGAGCTAAGAATTG","CAATTAATGTGACATGACT","561307.5.peg.857","2307"
"34910",1101,1881,780,"TTAACATACGCACCAATATT","CAATTAATGTGACATGACT","561307.5.peg.857","2307"
"34911",1150,1881,731,"ATTATGGTCTGTAACCGCAA","CAATTAATGTGACATGACT","561307.5.peg.857","2307"
"34912",1501,1881,380,"AAGTACTTCTTCAATCTCAG","CAATTAATGTGACATGACT","561307.5.peg.857","2307"
"34913",1269,1881,612,"TCTTGTGGTTTGTATGCAAT","CAATTAATGTGACATGACT","561307.5.peg.857","2307"
"34914",1626,1881,255,"TCGATAACACCATTCGTTGA","CAATTAATGTGACATGACT","561307.5.peg.857","2307"
"34915",201,1970,1769,"TCTTCATGAGCTAAGAATTG","AACGTGGAATTCGAGGTGTA","561307.5.peg.857","2307"
"34916",1150,1970,820,"ATTATGGTCTGTAACCGCAA","AACGTGGAATTCGAGGTGTA","561307.5.peg.857","2307"
"34917",1101,1970,869,"TTAACATACGCACCAATATT","AACGTGGAATTCGAGGTGTA","561307.5.peg.857","2307"
"34918",1434,1970,536,"GTTTCCGATAATCGTTCATG","AACGTGGAATTCGAGGTGTA","561307.5.peg.857","2307"
"34919",1064,1970,906,"GGCTCATTGCAGTATGCAAG","AACGTGGAATTCGAGGTGTA","561307.5.peg.857","2307"
"34920",1188,1970,782,"TCCGCTGCTGCGTGAGCATC","AACGTGGAATTCGAGGTGTA","561307.5.peg.857","2307"
"34921",2130,1970,160,"AAATCTTGATAAAGTGCCGG","AACGTGGAATTCGAGGTGTA","561307.5.peg.857","2307"
"34922",1269,1970,701,"TCTTGTGGTTTGTATGCAAT","AACGTGGAATTCGAGGTGTA","561307.5.peg.857","2307"
"34923",2133,1970,163,"TTAAATCTTGATAAAGTGC","AACGTGGAATTCGAGGTGTA","561307.5.peg.857","2307"
"34924",1146,1970,824,"TGGTCTGTAACCGCAATGGC","AACGTGGAATTCGAGGTGTA","561307.5.peg.857","2307"
"34925",1501,1970,469,"AAGTACTTCTTCAATCTCAG","AACGTGGAATTCGAGGTGTA","561307.5.peg.857","2307"
"34926",1166,1970,804,"GAAATGCTTGCACAACATTA","AACGTGGAATTCGAGGTGTA","561307.5.peg.857","2307"
"34927",1626,1970,344,"TCGATAACACCATTCGTTGA","AACGTGGAATTCGAGGTGTA","561307.5.peg.857","2307"
"34928",1269,1977,708,"TCTTGTGGTTTGTATGCAAT","AACAATGAACGTGGAATTCG","561307.5.peg.857","2307"
"34929",201,1977,1776,"TCTTCATGAGCTAAGAATTG","AACAATGAACGTGGAATTCG","561307.5.peg.857","2307"
"34930",2130,1977,153,"AAATCTTGATAAAGTGCCGG","AACAATGAACGTGGAATTCG","561307.5.peg.857","2307"
"34931",1064,1977,913,"GGCTCATTGCAGTATGCAAG","AACAATGAACGTGGAATTCG","561307.5.peg.857","2307"
"34932",1146,1977,831,"TGGTCTGTAACCGCAATGGC","AACAATGAACGTGGAATTCG","561307.5.peg.857","2307"
"34933",1166,1977,811,"GAAATGCTTGCACAACATTA","AACAATGAACGTGGAATTCG","561307.5.peg.857","2307"
"34934",1626,1977,351,"TCGATAACACCATTCGTTGA","AACAATGAACGTGGAATTCG","561307.5.peg.857","2307"
"34935",1188,1977,789,"TCCGCTGCTGCGTGAGCATC","AACAATGAACGTGGAATTCG","561307.5.peg.857","2307"
"34936",1150,1977,827,"ATTATGGTCTGTAACCGCAA","AACAATGAACGTGGAATTCG","561307.5.peg.857","2307"
"34937",1434,1977,543,"GTTTCCGATAATCGTTCATG","AACAATGAACGTGGAATTCG","561307.5.peg.857","2307"
"34938",1501,1977,476,"AAGTACTTCTTCAATCTCAG","AACAATGAACGTGGAATTCG","561307.5.peg.857","2307"
"34939",2133,1977,156,"TTAAATCTTGATAAAGTGC","AACAATGAACGTGGAATTCG","561307.5.peg.857","2307"
"34940",1101,1977,876,"TTAACATACGCACCAATATT","AACAATGAACGTGGAATTCG","561307.5.peg.857","2307"
"34941",1501,1986,485,"AAGTACTTCTTCAATCTCAG","ATTCATCTAACAATGAACG","561307.5.peg.857","2307"
"34942",1188,1986,798,"TCCGCTGCTGCGTGAGCATC","ATTCATCTAACAATGAACG","561307.5.peg.857","2307"
"34943",2133,1986,147,"TTAAATCTTGATAAAGTGC","ATTCATCTAACAATGAACG","561307.5.peg.857","2307"
"34944",1881,1986,105,"CAATTAATGTGACATGACT","ATTCATCTAACAATGAACG","561307.5.peg.857","2307"
"34945",1434,1986,552,"GTTTCCGATAATCGTTCATG","ATTCATCTAACAATGAACG","561307.5.peg.857","2307"
"34946",2130,1986,144,"AAATCTTGATAAAGTGCCGG","ATTCATCTAACAATGAACG","561307.5.peg.857","2307"
"34947",201,1986,1785,"TCTTCATGAGCTAAGAATTG","ATTCATCTAACAATGAACG","561307.5.peg.857","2307"
"34948",1166,1986,820,"GAAATGCTTGCACAACATTA","ATTCATCTAACAATGAACG","561307.5.peg.857","2307"
"34949",1101,1986,885,"TTAACATACGCACCAATATT","ATTCATCTAACAATGAACG","561307.5.peg.857","2307"
"34950",1146,1986,840,"TGGTCTGTAACCGCAATGGC","ATTCATCTAACAATGAACG","561307.5.peg.857","2307"
"34951",1064,1986,922,"GGCTCATTGCAGTATGCAAG","ATTCATCTAACAATGAACG","561307.5.peg.857","2307"
"34952",1150,1986,836,"ATTATGGTCTGTAACCGCAA","ATTCATCTAACAATGAACG","561307.5.peg.857","2307"
"34953",1269,1986,717,"TCTTGTGGTTTGTATGCAAT","ATTCATCTAACAATGAACG","561307.5.peg.857","2307"
"34954",1626,1986,360,"TCGATAACACCATTCGTTGA","ATTCATCTAACAATGAACG","561307.5.peg.857","2307"
"34955",201,2130,1929,"TCTTCATGAGCTAAGAATTG","AAATCTTGATAAAGTGCCGG","561307.5.peg.857","2307"
"34956",1064,2130,1066,"GGCTCATTGCAGTATGCAAG","AAATCTTGATAAAGTGCCGG","561307.5.peg.857","2307"
"34957",1146,2130,984,"TGGTCTGTAACCGCAATGGC","AAATCTTGATAAAGTGCCGG","561307.5.peg.857","2307"
"34958",1970,2130,160,"AACGTGGAATTCGAGGTGTA","AAATCTTGATAAAGTGCCGG","561307.5.peg.857","2307"
"34959",1434,2130,696,"GTTTCCGATAATCGTTCATG","AAATCTTGATAAAGTGCCGG","561307.5.peg.857","2307"
"34960",1269,2130,861,"TCTTGTGGTTTGTATGCAAT","AAATCTTGATAAAGTGCCGG","561307.5.peg.857","2307"
"34961",1166,2130,964,"GAAATGCTTGCACAACATTA","AAATCTTGATAAAGTGCCGG","561307.5.peg.857","2307"
"34962",1101,2130,1029,"TTAACATACGCACCAATATT","AAATCTTGATAAAGTGCCGG","561307.5.peg.857","2307"
"34963",1881,2130,249,"CAATTAATGTGACATGACT","AAATCTTGATAAAGTGCCGG","561307.5.peg.857","2307"
"34964",1150,2130,980,"ATTATGGTCTGTAACCGCAA","AAATCTTGATAAAGTGCCGG","561307.5.peg.857","2307"
"34965",1188,2130,942,"TCCGCTGCTGCGTGAGCATC","AAATCTTGATAAAGTGCCGG","561307.5.peg.857","2307"
"34966",1626,2130,504,"TCGATAACACCATTCGTTGA","AAATCTTGATAAAGTGCCGG","561307.5.peg.857","2307"
"34967",1977,2130,153,"AACAATGAACGTGGAATTCG","AAATCTTGATAAAGTGCCGG","561307.5.peg.857","2307"
"34968",1501,2130,629,"AAGTACTTCTTCAATCTCAG","AAATCTTGATAAAGTGCCGG","561307.5.peg.857","2307"
"34969",1986,2130,144,"ATTCATCTAACAATGAACG","AAATCTTGATAAAGTGCCGG","561307.5.peg.857","2307"
"34970",1064,2133,1069,"GGCTCATTGCAGTATGCAAG","TTAAATCTTGATAAAGTGC","561307.5.peg.857","2307"
"34971",1188,2133,945,"TCCGCTGCTGCGTGAGCATC","TTAAATCTTGATAAAGTGC","561307.5.peg.857","2307"
"34972",1986,2133,147,"ATTCATCTAACAATGAACG","TTAAATCTTGATAAAGTGC","561307.5.peg.857","2307"
"34973",1101,2133,1032,"TTAACATACGCACCAATATT","TTAAATCTTGATAAAGTGC","561307.5.peg.857","2307"
"34974",1970,2133,163,"AACGTGGAATTCGAGGTGTA","TTAAATCTTGATAAAGTGC","561307.5.peg.857","2307"
"34975",1881,2133,252,"CAATTAATGTGACATGACT","TTAAATCTTGATAAAGTGC","561307.5.peg.857","2307"
"34976",1269,2133,864,"TCTTGTGGTTTGTATGCAAT","TTAAATCTTGATAAAGTGC","561307.5.peg.857","2307"
"34977",201,2133,1932,"TCTTCATGAGCTAAGAATTG","TTAAATCTTGATAAAGTGC","561307.5.peg.857","2307"
"34978",1977,2133,156,"AACAATGAACGTGGAATTCG","TTAAATCTTGATAAAGTGC","561307.5.peg.857","2307"
"34979",1434,2133,699,"GTTTCCGATAATCGTTCATG","TTAAATCTTGATAAAGTGC","561307.5.peg.857","2307"
"34980",1166,2133,967,"GAAATGCTTGCACAACATTA","TTAAATCTTGATAAAGTGC","561307.5.peg.857","2307"
"34981",1146,2133,987,"TGGTCTGTAACCGCAATGGC","TTAAATCTTGATAAAGTGC","561307.5.peg.857","2307"
"34982",1626,2133,507,"TCGATAACACCATTCGTTGA","TTAAATCTTGATAAAGTGC","561307.5.peg.857","2307"
"34983",1150,2133,983,"ATTATGGTCTGTAACCGCAA","TTAAATCTTGATAAAGTGC","561307.5.peg.857","2307"
"34984",1501,2133,632,"AAGTACTTCTTCAATCTCAG","TTAAATCTTGATAAAGTGC","561307.5.peg.857","2307"
"34985",305,8,297,"TATCACCAATTTCATATGCA","TATGATTTAACGTGATGAGG","561307.5.peg.859","2309"
"34986",573,8,565,"ATACTTTGATACGTTCGTT","TATGATTTAACGTGATGAGG","561307.5.peg.859","2309"
"34987",108,8,100,"GCATCAATTAATACTGCTCT","TATGATTTAACGTGATGAGG","561307.5.peg.859","2309"
"34988",482,8,474,"ATACATAACGATGGTCAACA","TATGATTTAACGTGATGAGG","561307.5.peg.859","2309"
"34989",188,8,180,"GATCCATATTTAATTCCACA","TATGATTTAACGTGATGAGG","561307.5.peg.859","2309"
"34990",305,11,294,"TATCACCAATTTCATATGCA","GTTATGATTTAACGTGATG","561307.5.peg.859","2309"
"34991",482,11,471,"ATACATAACGATGGTCAACA","GTTATGATTTAACGTGATG","561307.5.peg.859","2309"
"34992",188,11,177,"GATCCATATTTAATTCCACA","GTTATGATTTAACGTGATG","561307.5.peg.859","2309"
"34993",573,11,562,"ATACTTTGATACGTTCGTT","GTTATGATTTAACGTGATG","561307.5.peg.859","2309"
"34994",8,108,100,"TATGATTTAACGTGATGAGG","GCATCAATTAATACTGCTCT","561307.5.peg.859","2309"
"34995",573,108,465,"ATACTTTGATACGTTCGTT","GCATCAATTAATACTGCTCT","561307.5.peg.859","2309"
"34996",305,108,197,"TATCACCAATTTCATATGCA","GCATCAATTAATACTGCTCT","561307.5.peg.859","2309"
"34997",482,108,374,"ATACATAACGATGGTCAACA","GCATCAATTAATACTGCTCT","561307.5.peg.859","2309"
"34998",8,188,180,"TATGATTTAACGTGATGAGG","GATCCATATTTAATTCCACA","561307.5.peg.859","2309"
"34999",11,188,177,"GTTATGATTTAACGTGATG","GATCCATATTTAATTCCACA","561307.5.peg.859","2309"
"35000",305,188,117,"TATCACCAATTTCATATGCA","GATCCATATTTAATTCCACA","561307.5.peg.859","2309"
"35001",482,188,294,"ATACATAACGATGGTCAACA","GATCCATATTTAATTCCACA","561307.5.peg.859","2309"
"35002",573,188,385,"ATACTTTGATACGTTCGTT","GATCCATATTTAATTCCACA","561307.5.peg.859","2309"
"35003",482,305,177,"ATACATAACGATGGTCAACA","TATCACCAATTTCATATGCA","561307.5.peg.859","2309"
"35004",8,305,297,"TATGATTTAACGTGATGAGG","TATCACCAATTTCATATGCA","561307.5.peg.859","2309"
"35005",11,305,294,"GTTATGATTTAACGTGATG","TATCACCAATTTCATATGCA","561307.5.peg.859","2309"
"35006",108,305,197,"GCATCAATTAATACTGCTCT","TATCACCAATTTCATATGCA","561307.5.peg.859","2309"
"35007",188,305,117,"GATCCATATTTAATTCCACA","TATCACCAATTTCATATGCA","561307.5.peg.859","2309"
"35008",573,305,268,"ATACTTTGATACGTTCGTT","TATCACCAATTTCATATGCA","561307.5.peg.859","2309"
"35009",108,482,374,"GCATCAATTAATACTGCTCT","ATACATAACGATGGTCAACA","561307.5.peg.859","2309"
"35010",188,482,294,"GATCCATATTTAATTCCACA","ATACATAACGATGGTCAACA","561307.5.peg.859","2309"
"35011",8,482,474,"TATGATTTAACGTGATGAGG","ATACATAACGATGGTCAACA","561307.5.peg.859","2309"
"35012",305,482,177,"TATCACCAATTTCATATGCA","ATACATAACGATGGTCAACA","561307.5.peg.859","2309"
"35013",11,482,471,"GTTATGATTTAACGTGATG","ATACATAACGATGGTCAACA","561307.5.peg.859","2309"
"35014",11,573,562,"GTTATGATTTAACGTGATG","ATACTTTGATACGTTCGTT","561307.5.peg.859","2309"
"35015",8,573,565,"TATGATTTAACGTGATGAGG","ATACTTTGATACGTTCGTT","561307.5.peg.859","2309"
"35016",305,573,268,"TATCACCAATTTCATATGCA","ATACTTTGATACGTTCGTT","561307.5.peg.859","2309"
"35017",108,573,465,"GCATCAATTAATACTGCTCT","ATACTTTGATACGTTCGTT","561307.5.peg.859","2309"
"35018",188,573,385,"GATCCATATTTAATTCCACA","ATACTTTGATACGTTCGTT","561307.5.peg.859","2309"
"35019",605,9,596,"CTTCAGTAACGATGATAACA","GTAAATTTCATCAAGTAGG","561307.5.peg.86","2310"
"35020",273,9,264,"TAATTTCTCTTACTGACTC","GTAAATTTCATCAAGTAGG","561307.5.peg.86","2310"
"35021",555,9,546,"TGCAACACAACGTATTGTAC","GTAAATTTCATCAAGTAGG","561307.5.peg.86","2310"
"35022",117,9,108,"CGTAATTCTGTCATCCAAGA","GTAAATTTCATCAAGTAGG","561307.5.peg.86","2310"
"35023",273,106,167,"TAATTTCTCTTACTGACTC","CATCCAAGAAGGTTCATTGT","561307.5.peg.86","2310"
"35024",555,106,449,"TGCAACACAACGTATTGTAC","CATCCAAGAAGGTTCATTGT","561307.5.peg.86","2310"
"35025",605,106,499,"CTTCAGTAACGATGATAACA","CATCCAAGAAGGTTCATTGT","561307.5.peg.86","2310"
"35026",273,117,156,"TAATTTCTCTTACTGACTC","CGTAATTCTGTCATCCAAGA","561307.5.peg.86","2310"
"35027",605,117,488,"CTTCAGTAACGATGATAACA","CGTAATTCTGTCATCCAAGA","561307.5.peg.86","2310"
"35028",9,117,108,"GTAAATTTCATCAAGTAGG","CGTAATTCTGTCATCCAAGA","561307.5.peg.86","2310"
"35029",555,117,438,"TGCAACACAACGTATTGTAC","CGTAATTCTGTCATCCAAGA","561307.5.peg.86","2310"
"35030",117,273,156,"CGTAATTCTGTCATCCAAGA","TAATTTCTCTTACTGACTC","561307.5.peg.86","2310"
"35031",106,273,167,"CATCCAAGAAGGTTCATTGT","TAATTTCTCTTACTGACTC","561307.5.peg.86","2310"
"35032",605,273,332,"CTTCAGTAACGATGATAACA","TAATTTCTCTTACTGACTC","561307.5.peg.86","2310"
"35033",9,273,264,"GTAAATTTCATCAAGTAGG","TAATTTCTCTTACTGACTC","561307.5.peg.86","2310"
"35034",555,273,282,"TGCAACACAACGTATTGTAC","TAATTTCTCTTACTGACTC","561307.5.peg.86","2310"
"35035",9,555,546,"GTAAATTTCATCAAGTAGG","TGCAACACAACGTATTGTAC","561307.5.peg.86","2310"
"35036",117,555,438,"CGTAATTCTGTCATCCAAGA","TGCAACACAACGTATTGTAC","561307.5.peg.86","2310"
"35037",273,555,282,"TAATTTCTCTTACTGACTC","TGCAACACAACGTATTGTAC","561307.5.peg.86","2310"
"35038",106,555,449,"CATCCAAGAAGGTTCATTGT","TGCAACACAACGTATTGTAC","561307.5.peg.86","2310"
"35039",106,605,499,"CATCCAAGAAGGTTCATTGT","CTTCAGTAACGATGATAACA","561307.5.peg.86","2310"
"35040",9,605,596,"GTAAATTTCATCAAGTAGG","CTTCAGTAACGATGATAACA","561307.5.peg.86","2310"
"35041",117,605,488,"CGTAATTCTGTCATCCAAGA","CTTCAGTAACGATGATAACA","561307.5.peg.86","2310"
"35042",273,605,332,"TAATTTCTCTTACTGACTC","CTTCAGTAACGATGATAACA","561307.5.peg.86","2310"
"35043",1065,571,494,"GTTTCGCCGCCCCAATCTTC","AACCTCAACGCCATAATCAT","561307.5.peg.862","2313"
"35044",840,571,269,"GTTGTAAATGCAGCATGTCC","AACCTCAACGCCATAATCAT","561307.5.peg.862","2313"
"35045",1023,571,452,"AATTCTTGCATAACTCGATC","AACCTCAACGCCATAATCAT","561307.5.peg.862","2313"
"35046",675,571,104,"CCCATAATTGTTACAACTGC","AACCTCAACGCCATAATCAT","561307.5.peg.862","2313"
"35047",840,657,183,"GTTGTAAATGCAGCATGTCC","GCTGGTCTCTCAATTGCCTC","561307.5.peg.862","2313"
"35048",1023,657,366,"AATTCTTGCATAACTCGATC","GCTGGTCTCTCAATTGCCTC","561307.5.peg.862","2313"
"35049",1065,657,408,"GTTTCGCCGCCCCAATCTTC","GCTGGTCTCTCAATTGCCTC","561307.5.peg.862","2313"
"35050",840,675,165,"GTTGTAAATGCAGCATGTCC","CCCATAATTGTTACAACTGC","561307.5.peg.862","2313"
"35051",1065,675,390,"GTTTCGCCGCCCCAATCTTC","CCCATAATTGTTACAACTGC","561307.5.peg.862","2313"
"35052",571,675,104,"AACCTCAACGCCATAATCAT","CCCATAATTGTTACAACTGC","561307.5.peg.862","2313"
"35053",1023,675,348,"AATTCTTGCATAACTCGATC","CCCATAATTGTTACAACTGC","561307.5.peg.862","2313"
"35054",675,840,165,"CCCATAATTGTTACAACTGC","GTTGTAAATGCAGCATGTCC","561307.5.peg.862","2313"
"35055",657,840,183,"GCTGGTCTCTCAATTGCCTC","GTTGTAAATGCAGCATGTCC","561307.5.peg.862","2313"
"35056",1065,840,225,"GTTTCGCCGCCCCAATCTTC","GTTGTAAATGCAGCATGTCC","561307.5.peg.862","2313"
"35057",571,840,269,"AACCTCAACGCCATAATCAT","GTTGTAAATGCAGCATGTCC","561307.5.peg.862","2313"
"35058",1023,840,183,"AATTCTTGCATAACTCGATC","GTTGTAAATGCAGCATGTCC","561307.5.peg.862","2313"
"35059",571,1023,452,"AACCTCAACGCCATAATCAT","AATTCTTGCATAACTCGATC","561307.5.peg.862","2313"
"35060",675,1023,348,"CCCATAATTGTTACAACTGC","AATTCTTGCATAACTCGATC","561307.5.peg.862","2313"
"35061",840,1023,183,"GTTGTAAATGCAGCATGTCC","AATTCTTGCATAACTCGATC","561307.5.peg.862","2313"
"35062",657,1023,366,"GCTGGTCTCTCAATTGCCTC","AATTCTTGCATAACTCGATC","561307.5.peg.862","2313"
"35063",657,1065,408,"GCTGGTCTCTCAATTGCCTC","GTTTCGCCGCCCCAATCTTC","561307.5.peg.862","2313"
"35064",571,1065,494,"AACCTCAACGCCATAATCAT","GTTTCGCCGCCCCAATCTTC","561307.5.peg.862","2313"
"35065",675,1065,390,"CCCATAATTGTTACAACTGC","GTTTCGCCGCCCCAATCTTC","561307.5.peg.862","2313"
"35066",840,1065,225,"GTTGTAAATGCAGCATGTCC","GTTTCGCCGCCCCAATCTTC","561307.5.peg.862","2313"
"35067",189,69,120,"GTTGCATTACCTATACATAC","AAACCGCGCTCTTTATATAC","561307.5.peg.864","2315"
"35068",399,69,330,"TTGACGGATGAGTACATCGG","AAACCGCGCTCTTTATATAC","561307.5.peg.864","2315"
"35069",402,69,333,"ACTTTGACGGATGAGTACAT","AAACCGCGCTCTTTATATAC","561307.5.peg.864","2315"
"35070",402,168,234,"ACTTTGACGGATGAGTACAT","GGTAACACGCCTGCAACTTC","561307.5.peg.864","2315"
"35071",399,168,231,"TTGACGGATGAGTACATCGG","GGTAACACGCCTGCAACTTC","561307.5.peg.864","2315"
"35072",69,189,120,"AAACCGCGCTCTTTATATAC","GTTGCATTACCTATACATAC","561307.5.peg.864","2315"
"35073",399,189,210,"TTGACGGATGAGTACATCGG","GTTGCATTACCTATACATAC","561307.5.peg.864","2315"
"35074",402,189,213,"ACTTTGACGGATGAGTACAT","GTTGCATTACCTATACATAC","561307.5.peg.864","2315"
"35075",69,399,330,"AAACCGCGCTCTTTATATAC","TTGACGGATGAGTACATCGG","561307.5.peg.864","2315"
"35076",189,399,210,"GTTGCATTACCTATACATAC","TTGACGGATGAGTACATCGG","561307.5.peg.864","2315"
"35077",168,399,231,"GGTAACACGCCTGCAACTTC","TTGACGGATGAGTACATCGG","561307.5.peg.864","2315"
"35078",69,402,333,"AAACCGCGCTCTTTATATAC","ACTTTGACGGATGAGTACAT","561307.5.peg.864","2315"
"35079",168,402,234,"GGTAACACGCCTGCAACTTC","ACTTTGACGGATGAGTACAT","561307.5.peg.864","2315"
"35080",189,402,213,"GTTGCATTACCTATACATAC","ACTTTGACGGATGAGTACAT","561307.5.peg.864","2315"
"35081",123,2,121,"AGTACAGCGATTTGTACTTC","AATACTCCTTAATCCGAGTT","561307.5.peg.866","2317"
"35082",2,123,121,"AATACTCCTTAATCCGAGTT","AGTACAGCGATTTGTACTTC","561307.5.peg.866","2317"
"35083",426,221,205,"CCAATCATTGCAGCCATTTG","CTTCATAGTTCACTGTTAAT","561307.5.peg.867","2318"
"35084",704,221,483,"TGTGGTCGACGATTTGTTGT","CTTCATAGTTCACTGTTAAT","561307.5.peg.867","2318"
"35085",1038,221,817,"TACCAACTTCAGAATCTAA","CTTCATAGTTCACTGTTAAT","561307.5.peg.867","2318"
"35086",578,221,357,"CTTTATGACCAGCTACTTCA","CTTCATAGTTCACTGTTAAT","561307.5.peg.867","2318"
"35087",1034,221,813,"CAACTTCAGAATCTAATGGA","CTTCATAGTTCACTGTTAAT","561307.5.peg.867","2318"
"35088",499,221,278,"AATATAACCCACATTTACAC","CTTCATAGTTCACTGTTAAT","561307.5.peg.867","2318"
"35089",414,221,193,"GCCATTTGTGGTGAACAATC","CTTCATAGTTCACTGTTAAT","561307.5.peg.867","2318"
"35090",480,221,259,"CCGGCGATTGGCCCTTGGAA","CTTCATAGTTCACTGTTAAT","561307.5.peg.867","2318"
"35091",722,221,501,"CTTGTTTAACAGGTTGAATG","CTTCATAGTTCACTGTTAAT","561307.5.peg.867","2318"
"35092",492,221,271,"CCCACATTTACACCGGCGAT","CTTCATAGTTCACTGTTAAT","561307.5.peg.867","2318"
"35093",342,221,121,"TAGGGAATAAAGGTCTAAT","CTTCATAGTTCACTGTTAAT","561307.5.peg.867","2318"
"35094",753,221,532,"AGCGCTTCATCACGCTCTGC","CTTCATAGTTCACTGTTAAT","561307.5.peg.867","2318"
"35095",1016,221,795,"GACGGATTTCATCAGGTTTA","CTTCATAGTTCACTGTTAAT","561307.5.peg.867","2318"
"35096",1008,221,787,"TCATCAGGTTTACGGCCGTC","CTTCATAGTTCACTGTTAAT","561307.5.peg.867","2318"
"35097",485,221,264,"TTACACCGGCGATTGGCCCT","CTTCATAGTTCACTGTTAAT","561307.5.peg.867","2318"
"35098",1023,221,802,"TCTAATGGACGGATTTCATC","CTTCATAGTTCACTGTTAAT","561307.5.peg.867","2318"
"35099",1065,221,844,"AGACCTGAACCATGCGTTCT","CTTCATAGTTCACTGTTAAT","561307.5.peg.867","2318"
"35100",426,300,126,"CCAATCATTGCAGCCATTTG","GTTAATGTTGCATCGTCACC","561307.5.peg.867","2318"
"35101",704,300,404,"TGTGGTCGACGATTTGTTGT","GTTAATGTTGCATCGTCACC","561307.5.peg.867","2318"
"35102",1016,300,716,"GACGGATTTCATCAGGTTTA","GTTAATGTTGCATCGTCACC","561307.5.peg.867","2318"
"35103",578,300,278,"CTTTATGACCAGCTACTTCA","GTTAATGTTGCATCGTCACC","561307.5.peg.867","2318"
"35104",1034,300,734,"CAACTTCAGAATCTAATGGA","GTTAATGTTGCATCGTCACC","561307.5.peg.867","2318"
"35105",722,300,422,"CTTGTTTAACAGGTTGAATG","GTTAATGTTGCATCGTCACC","561307.5.peg.867","2318"
"35106",414,300,114,"GCCATTTGTGGTGAACAATC","GTTAATGTTGCATCGTCACC","561307.5.peg.867","2318"
"35107",1038,300,738,"TACCAACTTCAGAATCTAA","GTTAATGTTGCATCGTCACC","561307.5.peg.867","2318"
"35108",1023,300,723,"TCTAATGGACGGATTTCATC","GTTAATGTTGCATCGTCACC","561307.5.peg.867","2318"
"35109",485,300,185,"TTACACCGGCGATTGGCCCT","GTTAATGTTGCATCGTCACC","561307.5.peg.867","2318"
"35110",1065,300,765,"AGACCTGAACCATGCGTTCT","GTTAATGTTGCATCGTCACC","561307.5.peg.867","2318"
"35111",499,300,199,"AATATAACCCACATTTACAC","GTTAATGTTGCATCGTCACC","561307.5.peg.867","2318"
"35112",1008,300,708,"TCATCAGGTTTACGGCCGTC","GTTAATGTTGCATCGTCACC","561307.5.peg.867","2318"
"35113",480,300,180,"CCGGCGATTGGCCCTTGGAA","GTTAATGTTGCATCGTCACC","561307.5.peg.867","2318"
"35114",753,300,453,"AGCGCTTCATCACGCTCTGC","GTTAATGTTGCATCGTCACC","561307.5.peg.867","2318"
"35115",492,300,192,"CCCACATTTACACCGGCGAT","GTTAATGTTGCATCGTCACC","561307.5.peg.867","2318"
"35116",704,342,362,"TGTGGTCGACGATTTGTTGT","TAGGGAATAAAGGTCTAAT","561307.5.peg.867","2318"
"35117",753,342,411,"AGCGCTTCATCACGCTCTGC","TAGGGAATAAAGGTCTAAT","561307.5.peg.867","2318"
"35118",221,342,121,"CTTCATAGTTCACTGTTAAT","TAGGGAATAAAGGTCTAAT","561307.5.peg.867","2318"
"35119",1016,342,674,"GACGGATTTCATCAGGTTTA","TAGGGAATAAAGGTCTAAT","561307.5.peg.867","2318"
"35120",1008,342,666,"TCATCAGGTTTACGGCCGTC","TAGGGAATAAAGGTCTAAT","561307.5.peg.867","2318"
"35121",722,342,380,"CTTGTTTAACAGGTTGAATG","TAGGGAATAAAGGTCTAAT","561307.5.peg.867","2318"
"35122",485,342,143,"TTACACCGGCGATTGGCCCT","TAGGGAATAAAGGTCTAAT","561307.5.peg.867","2318"
"35123",480,342,138,"CCGGCGATTGGCCCTTGGAA","TAGGGAATAAAGGTCTAAT","561307.5.peg.867","2318"
"35124",1065,342,723,"AGACCTGAACCATGCGTTCT","TAGGGAATAAAGGTCTAAT","561307.5.peg.867","2318"
"35125",499,342,157,"AATATAACCCACATTTACAC","TAGGGAATAAAGGTCTAAT","561307.5.peg.867","2318"
"35126",492,342,150,"CCCACATTTACACCGGCGAT","TAGGGAATAAAGGTCTAAT","561307.5.peg.867","2318"
"35127",1023,342,681,"TCTAATGGACGGATTTCATC","TAGGGAATAAAGGTCTAAT","561307.5.peg.867","2318"
"35128",1038,342,696,"TACCAACTTCAGAATCTAA","TAGGGAATAAAGGTCTAAT","561307.5.peg.867","2318"
"35129",1034,342,692,"CAACTTCAGAATCTAATGGA","TAGGGAATAAAGGTCTAAT","561307.5.peg.867","2318"
"35130",578,342,236,"CTTTATGACCAGCTACTTCA","TAGGGAATAAAGGTCTAAT","561307.5.peg.867","2318"
"35131",722,414,308,"CTTGTTTAACAGGTTGAATG","GCCATTTGTGGTGAACAATC","561307.5.peg.867","2318"
"35132",300,414,114,"GTTAATGTTGCATCGTCACC","GCCATTTGTGGTGAACAATC","561307.5.peg.867","2318"
"35133",1008,414,594,"TCATCAGGTTTACGGCCGTC","GCCATTTGTGGTGAACAATC","561307.5.peg.867","2318"
"35134",753,414,339,"AGCGCTTCATCACGCTCTGC","GCCATTTGTGGTGAACAATC","561307.5.peg.867","2318"
"35135",578,414,164,"CTTTATGACCAGCTACTTCA","GCCATTTGTGGTGAACAATC","561307.5.peg.867","2318"
"35136",1065,414,651,"AGACCTGAACCATGCGTTCT","GCCATTTGTGGTGAACAATC","561307.5.peg.867","2318"
"35137",221,414,193,"CTTCATAGTTCACTGTTAAT","GCCATTTGTGGTGAACAATC","561307.5.peg.867","2318"
"35138",704,414,290,"TGTGGTCGACGATTTGTTGT","GCCATTTGTGGTGAACAATC","561307.5.peg.867","2318"
"35139",1016,414,602,"GACGGATTTCATCAGGTTTA","GCCATTTGTGGTGAACAATC","561307.5.peg.867","2318"
"35140",1023,414,609,"TCTAATGGACGGATTTCATC","GCCATTTGTGGTGAACAATC","561307.5.peg.867","2318"
"35141",1038,414,624,"TACCAACTTCAGAATCTAA","GCCATTTGTGGTGAACAATC","561307.5.peg.867","2318"
"35142",1034,414,620,"CAACTTCAGAATCTAATGGA","GCCATTTGTGGTGAACAATC","561307.5.peg.867","2318"
"35143",1008,426,582,"TCATCAGGTTTACGGCCGTC","CCAATCATTGCAGCCATTTG","561307.5.peg.867","2318"
"35144",704,426,278,"TGTGGTCGACGATTTGTTGT","CCAATCATTGCAGCCATTTG","561307.5.peg.867","2318"
"35145",1034,426,608,"CAACTTCAGAATCTAATGGA","CCAATCATTGCAGCCATTTG","561307.5.peg.867","2318"
"35146",753,426,327,"AGCGCTTCATCACGCTCTGC","CCAATCATTGCAGCCATTTG","561307.5.peg.867","2318"
"35147",1016,426,590,"GACGGATTTCATCAGGTTTA","CCAATCATTGCAGCCATTTG","561307.5.peg.867","2318"
"35148",1038,426,612,"TACCAACTTCAGAATCTAA","CCAATCATTGCAGCCATTTG","561307.5.peg.867","2318"
"35149",722,426,296,"CTTGTTTAACAGGTTGAATG","CCAATCATTGCAGCCATTTG","561307.5.peg.867","2318"
"35150",1023,426,597,"TCTAATGGACGGATTTCATC","CCAATCATTGCAGCCATTTG","561307.5.peg.867","2318"
"35151",578,426,152,"CTTTATGACCAGCTACTTCA","CCAATCATTGCAGCCATTTG","561307.5.peg.867","2318"
"35152",1065,426,639,"AGACCTGAACCATGCGTTCT","CCAATCATTGCAGCCATTTG","561307.5.peg.867","2318"
"35153",221,426,205,"CTTCATAGTTCACTGTTAAT","CCAATCATTGCAGCCATTTG","561307.5.peg.867","2318"
"35154",300,426,126,"GTTAATGTTGCATCGTCACC","CCAATCATTGCAGCCATTTG","561307.5.peg.867","2318"
"35155",1008,480,528,"TCATCAGGTTTACGGCCGTC","CCGGCGATTGGCCCTTGGAA","561307.5.peg.867","2318"
"35156",753,480,273,"AGCGCTTCATCACGCTCTGC","CCGGCGATTGGCCCTTGGAA","561307.5.peg.867","2318"
"35157",300,480,180,"GTTAATGTTGCATCGTCACC","CCGGCGATTGGCCCTTGGAA","561307.5.peg.867","2318"
"35158",1038,480,558,"TACCAACTTCAGAATCTAA","CCGGCGATTGGCCCTTGGAA","561307.5.peg.867","2318"
"35159",1034,480,554,"CAACTTCAGAATCTAATGGA","CCGGCGATTGGCCCTTGGAA","561307.5.peg.867","2318"
"35160",342,480,138,"TAGGGAATAAAGGTCTAAT","CCGGCGATTGGCCCTTGGAA","561307.5.peg.867","2318"
"35161",221,480,259,"CTTCATAGTTCACTGTTAAT","CCGGCGATTGGCCCTTGGAA","561307.5.peg.867","2318"
"35162",722,480,242,"CTTGTTTAACAGGTTGAATG","CCGGCGATTGGCCCTTGGAA","561307.5.peg.867","2318"
"35163",1016,480,536,"GACGGATTTCATCAGGTTTA","CCGGCGATTGGCCCTTGGAA","561307.5.peg.867","2318"
"35164",1023,480,543,"TCTAATGGACGGATTTCATC","CCGGCGATTGGCCCTTGGAA","561307.5.peg.867","2318"
"35165",704,480,224,"TGTGGTCGACGATTTGTTGT","CCGGCGATTGGCCCTTGGAA","561307.5.peg.867","2318"
"35166",1065,480,585,"AGACCTGAACCATGCGTTCT","CCGGCGATTGGCCCTTGGAA","561307.5.peg.867","2318"
"35167",1038,485,553,"TACCAACTTCAGAATCTAA","TTACACCGGCGATTGGCCCT","561307.5.peg.867","2318"
"35168",1065,485,580,"AGACCTGAACCATGCGTTCT","TTACACCGGCGATTGGCCCT","561307.5.peg.867","2318"
"35169",1034,485,549,"CAACTTCAGAATCTAATGGA","TTACACCGGCGATTGGCCCT","561307.5.peg.867","2318"
"35170",221,485,264,"CTTCATAGTTCACTGTTAAT","TTACACCGGCGATTGGCCCT","561307.5.peg.867","2318"
"35171",300,485,185,"GTTAATGTTGCATCGTCACC","TTACACCGGCGATTGGCCCT","561307.5.peg.867","2318"
"35172",704,485,219,"TGTGGTCGACGATTTGTTGT","TTACACCGGCGATTGGCCCT","561307.5.peg.867","2318"
"35173",753,485,268,"AGCGCTTCATCACGCTCTGC","TTACACCGGCGATTGGCCCT","561307.5.peg.867","2318"
"35174",342,485,143,"TAGGGAATAAAGGTCTAAT","TTACACCGGCGATTGGCCCT","561307.5.peg.867","2318"
"35175",1016,485,531,"GACGGATTTCATCAGGTTTA","TTACACCGGCGATTGGCCCT","561307.5.peg.867","2318"
"35176",1023,485,538,"TCTAATGGACGGATTTCATC","TTACACCGGCGATTGGCCCT","561307.5.peg.867","2318"
"35177",722,485,237,"CTTGTTTAACAGGTTGAATG","TTACACCGGCGATTGGCCCT","561307.5.peg.867","2318"
"35178",1008,485,523,"TCATCAGGTTTACGGCCGTC","TTACACCGGCGATTGGCCCT","561307.5.peg.867","2318"
"35179",342,492,150,"TAGGGAATAAAGGTCTAAT","CCCACATTTACACCGGCGAT","561307.5.peg.867","2318"
"35180",1023,492,531,"TCTAATGGACGGATTTCATC","CCCACATTTACACCGGCGAT","561307.5.peg.867","2318"
"35181",300,492,192,"GTTAATGTTGCATCGTCACC","CCCACATTTACACCGGCGAT","561307.5.peg.867","2318"
"35182",722,492,230,"CTTGTTTAACAGGTTGAATG","CCCACATTTACACCGGCGAT","561307.5.peg.867","2318"
"35183",1065,492,573,"AGACCTGAACCATGCGTTCT","CCCACATTTACACCGGCGAT","561307.5.peg.867","2318"
"35184",1038,492,546,"TACCAACTTCAGAATCTAA","CCCACATTTACACCGGCGAT","561307.5.peg.867","2318"
"35185",1034,492,542,"CAACTTCAGAATCTAATGGA","CCCACATTTACACCGGCGAT","561307.5.peg.867","2318"
"35186",221,492,271,"CTTCATAGTTCACTGTTAAT","CCCACATTTACACCGGCGAT","561307.5.peg.867","2318"
"35187",704,492,212,"TGTGGTCGACGATTTGTTGT","CCCACATTTACACCGGCGAT","561307.5.peg.867","2318"
"35188",753,492,261,"AGCGCTTCATCACGCTCTGC","CCCACATTTACACCGGCGAT","561307.5.peg.867","2318"
"35189",1008,492,516,"TCATCAGGTTTACGGCCGTC","CCCACATTTACACCGGCGAT","561307.5.peg.867","2318"
"35190",1016,492,524,"GACGGATTTCATCAGGTTTA","CCCACATTTACACCGGCGAT","561307.5.peg.867","2318"
"35191",342,499,157,"TAGGGAATAAAGGTCTAAT","AATATAACCCACATTTACAC","561307.5.peg.867","2318"
"35192",1008,499,509,"TCATCAGGTTTACGGCCGTC","AATATAACCCACATTTACAC","561307.5.peg.867","2318"
"35193",753,499,254,"AGCGCTTCATCACGCTCTGC","AATATAACCCACATTTACAC","561307.5.peg.867","2318"
"35194",300,499,199,"GTTAATGTTGCATCGTCACC","AATATAACCCACATTTACAC","561307.5.peg.867","2318"
"35195",1016,499,517,"GACGGATTTCATCAGGTTTA","AATATAACCCACATTTACAC","561307.5.peg.867","2318"
"35196",221,499,278,"CTTCATAGTTCACTGTTAAT","AATATAACCCACATTTACAC","561307.5.peg.867","2318"
"35197",1038,499,539,"TACCAACTTCAGAATCTAA","AATATAACCCACATTTACAC","561307.5.peg.867","2318"
"35198",1065,499,566,"AGACCTGAACCATGCGTTCT","AATATAACCCACATTTACAC","561307.5.peg.867","2318"
"35199",704,499,205,"TGTGGTCGACGATTTGTTGT","AATATAACCCACATTTACAC","561307.5.peg.867","2318"
"35200",722,499,223,"CTTGTTTAACAGGTTGAATG","AATATAACCCACATTTACAC","561307.5.peg.867","2318"
"35201",1034,499,535,"CAACTTCAGAATCTAATGGA","AATATAACCCACATTTACAC","561307.5.peg.867","2318"
"35202",1023,499,524,"TCTAATGGACGGATTTCATC","AATATAACCCACATTTACAC","561307.5.peg.867","2318"
"35203",1065,578,487,"AGACCTGAACCATGCGTTCT","CTTTATGACCAGCTACTTCA","561307.5.peg.867","2318"
"35204",1034,578,456,"CAACTTCAGAATCTAATGGA","CTTTATGACCAGCTACTTCA","561307.5.peg.867","2318"
"35205",414,578,164,"GCCATTTGTGGTGAACAATC","CTTTATGACCAGCTACTTCA","561307.5.peg.867","2318"
"35206",342,578,236,"TAGGGAATAAAGGTCTAAT","CTTTATGACCAGCTACTTCA","561307.5.peg.867","2318"
"35207",1038,578,460,"TACCAACTTCAGAATCTAA","CTTTATGACCAGCTACTTCA","561307.5.peg.867","2318"
"35208",300,578,278,"GTTAATGTTGCATCGTCACC","CTTTATGACCAGCTACTTCA","561307.5.peg.867","2318"
"35209",1016,578,438,"GACGGATTTCATCAGGTTTA","CTTTATGACCAGCTACTTCA","561307.5.peg.867","2318"
"35210",1008,578,430,"TCATCAGGTTTACGGCCGTC","CTTTATGACCAGCTACTTCA","561307.5.peg.867","2318"
"35211",221,578,357,"CTTCATAGTTCACTGTTAAT","CTTTATGACCAGCTACTTCA","561307.5.peg.867","2318"
"35212",1023,578,445,"TCTAATGGACGGATTTCATC","CTTTATGACCAGCTACTTCA","561307.5.peg.867","2318"
"35213",704,578,126,"TGTGGTCGACGATTTGTTGT","CTTTATGACCAGCTACTTCA","561307.5.peg.867","2318"
"35214",753,578,175,"AGCGCTTCATCACGCTCTGC","CTTTATGACCAGCTACTTCA","561307.5.peg.867","2318"
"35215",426,578,152,"CCAATCATTGCAGCCATTTG","CTTTATGACCAGCTACTTCA","561307.5.peg.867","2318"
"35216",722,578,144,"CTTGTTTAACAGGTTGAATG","CTTTATGACCAGCTACTTCA","561307.5.peg.867","2318"
"35217",426,704,278,"CCAATCATTGCAGCCATTTG","TGTGGTCGACGATTTGTTGT","561307.5.peg.867","2318"
"35218",485,704,219,"TTACACCGGCGATTGGCCCT","TGTGGTCGACGATTTGTTGT","561307.5.peg.867","2318"
"35219",300,704,404,"GTTAATGTTGCATCGTCACC","TGTGGTCGACGATTTGTTGT","561307.5.peg.867","2318"
"35220",221,704,483,"CTTCATAGTTCACTGTTAAT","TGTGGTCGACGATTTGTTGT","561307.5.peg.867","2318"
"35221",1023,704,319,"TCTAATGGACGGATTTCATC","TGTGGTCGACGATTTGTTGT","561307.5.peg.867","2318"
"35222",1008,704,304,"TCATCAGGTTTACGGCCGTC","TGTGGTCGACGATTTGTTGT","561307.5.peg.867","2318"
"35223",1065,704,361,"AGACCTGAACCATGCGTTCT","TGTGGTCGACGATTTGTTGT","561307.5.peg.867","2318"
"35224",480,704,224,"CCGGCGATTGGCCCTTGGAA","TGTGGTCGACGATTTGTTGT","561307.5.peg.867","2318"
"35225",342,704,362,"TAGGGAATAAAGGTCTAAT","TGTGGTCGACGATTTGTTGT","561307.5.peg.867","2318"
"35226",492,704,212,"CCCACATTTACACCGGCGAT","TGTGGTCGACGATTTGTTGT","561307.5.peg.867","2318"
"35227",578,704,126,"CTTTATGACCAGCTACTTCA","TGTGGTCGACGATTTGTTGT","561307.5.peg.867","2318"
"35228",1034,704,330,"CAACTTCAGAATCTAATGGA","TGTGGTCGACGATTTGTTGT","561307.5.peg.867","2318"
"35229",499,704,205,"AATATAACCCACATTTACAC","TGTGGTCGACGATTTGTTGT","561307.5.peg.867","2318"
"35230",414,704,290,"GCCATTTGTGGTGAACAATC","TGTGGTCGACGATTTGTTGT","561307.5.peg.867","2318"
"35231",1038,704,334,"TACCAACTTCAGAATCTAA","TGTGGTCGACGATTTGTTGT","561307.5.peg.867","2318"
"35232",1016,704,312,"GACGGATTTCATCAGGTTTA","TGTGGTCGACGATTTGTTGT","561307.5.peg.867","2318"
"35233",1038,722,316,"TACCAACTTCAGAATCTAA","CTTGTTTAACAGGTTGAATG","561307.5.peg.867","2318"
"35234",492,722,230,"CCCACATTTACACCGGCGAT","CTTGTTTAACAGGTTGAATG","561307.5.peg.867","2318"
"35235",1023,722,301,"TCTAATGGACGGATTTCATC","CTTGTTTAACAGGTTGAATG","561307.5.peg.867","2318"
"35236",499,722,223,"AATATAACCCACATTTACAC","CTTGTTTAACAGGTTGAATG","561307.5.peg.867","2318"
"35237",1065,722,343,"AGACCTGAACCATGCGTTCT","CTTGTTTAACAGGTTGAATG","561307.5.peg.867","2318"
"35238",221,722,501,"CTTCATAGTTCACTGTTAAT","CTTGTTTAACAGGTTGAATG","561307.5.peg.867","2318"
"35239",414,722,308,"GCCATTTGTGGTGAACAATC","CTTGTTTAACAGGTTGAATG","561307.5.peg.867","2318"
"35240",485,722,237,"TTACACCGGCGATTGGCCCT","CTTGTTTAACAGGTTGAATG","561307.5.peg.867","2318"
"35241",1008,722,286,"TCATCAGGTTTACGGCCGTC","CTTGTTTAACAGGTTGAATG","561307.5.peg.867","2318"
"35242",1034,722,312,"CAACTTCAGAATCTAATGGA","CTTGTTTAACAGGTTGAATG","561307.5.peg.867","2318"
"35243",480,722,242,"CCGGCGATTGGCCCTTGGAA","CTTGTTTAACAGGTTGAATG","561307.5.peg.867","2318"
"35244",342,722,380,"TAGGGAATAAAGGTCTAAT","CTTGTTTAACAGGTTGAATG","561307.5.peg.867","2318"
"35245",426,722,296,"CCAATCATTGCAGCCATTTG","CTTGTTTAACAGGTTGAATG","561307.5.peg.867","2318"
"35246",300,722,422,"GTTAATGTTGCATCGTCACC","CTTGTTTAACAGGTTGAATG","561307.5.peg.867","2318"
"35247",1016,722,294,"GACGGATTTCATCAGGTTTA","CTTGTTTAACAGGTTGAATG","561307.5.peg.867","2318"
"35248",578,722,144,"CTTTATGACCAGCTACTTCA","CTTGTTTAACAGGTTGAATG","561307.5.peg.867","2318"
"35249",1023,753,270,"TCTAATGGACGGATTTCATC","AGCGCTTCATCACGCTCTGC","561307.5.peg.867","2318"
"35250",221,753,532,"CTTCATAGTTCACTGTTAAT","AGCGCTTCATCACGCTCTGC","561307.5.peg.867","2318"
"35251",414,753,339,"GCCATTTGTGGTGAACAATC","AGCGCTTCATCACGCTCTGC","561307.5.peg.867","2318"
"35252",499,753,254,"AATATAACCCACATTTACAC","AGCGCTTCATCACGCTCTGC","561307.5.peg.867","2318"
"35253",342,753,411,"TAGGGAATAAAGGTCTAAT","AGCGCTTCATCACGCTCTGC","561307.5.peg.867","2318"
"35254",1065,753,312,"AGACCTGAACCATGCGTTCT","AGCGCTTCATCACGCTCTGC","561307.5.peg.867","2318"
"35255",300,753,453,"GTTAATGTTGCATCGTCACC","AGCGCTTCATCACGCTCTGC","561307.5.peg.867","2318"
"35256",1008,753,255,"TCATCAGGTTTACGGCCGTC","AGCGCTTCATCACGCTCTGC","561307.5.peg.867","2318"
"35257",1016,753,263,"GACGGATTTCATCAGGTTTA","AGCGCTTCATCACGCTCTGC","561307.5.peg.867","2318"
"35258",480,753,273,"CCGGCGATTGGCCCTTGGAA","AGCGCTTCATCACGCTCTGC","561307.5.peg.867","2318"
"35259",1034,753,281,"CAACTTCAGAATCTAATGGA","AGCGCTTCATCACGCTCTGC","561307.5.peg.867","2318"
"35260",426,753,327,"CCAATCATTGCAGCCATTTG","AGCGCTTCATCACGCTCTGC","561307.5.peg.867","2318"
"35261",1038,753,285,"TACCAACTTCAGAATCTAA","AGCGCTTCATCACGCTCTGC","561307.5.peg.867","2318"
"35262",485,753,268,"TTACACCGGCGATTGGCCCT","AGCGCTTCATCACGCTCTGC","561307.5.peg.867","2318"
"35263",578,753,175,"CTTTATGACCAGCTACTTCA","AGCGCTTCATCACGCTCTGC","561307.5.peg.867","2318"
"35264",492,753,261,"CCCACATTTACACCGGCGAT","AGCGCTTCATCACGCTCTGC","561307.5.peg.867","2318"
"35265",499,1008,509,"AATATAACCCACATTTACAC","TCATCAGGTTTACGGCCGTC","561307.5.peg.867","2318"
"35266",578,1008,430,"CTTTATGACCAGCTACTTCA","TCATCAGGTTTACGGCCGTC","561307.5.peg.867","2318"
"35267",704,1008,304,"TGTGGTCGACGATTTGTTGT","TCATCAGGTTTACGGCCGTC","561307.5.peg.867","2318"
"35268",300,1008,708,"GTTAATGTTGCATCGTCACC","TCATCAGGTTTACGGCCGTC","561307.5.peg.867","2318"
"35269",753,1008,255,"AGCGCTTCATCACGCTCTGC","TCATCAGGTTTACGGCCGTC","561307.5.peg.867","2318"
"35270",480,1008,528,"CCGGCGATTGGCCCTTGGAA","TCATCAGGTTTACGGCCGTC","561307.5.peg.867","2318"
"35271",722,1008,286,"CTTGTTTAACAGGTTGAATG","TCATCAGGTTTACGGCCGTC","561307.5.peg.867","2318"
"35272",414,1008,594,"GCCATTTGTGGTGAACAATC","TCATCAGGTTTACGGCCGTC","561307.5.peg.867","2318"
"35273",492,1008,516,"CCCACATTTACACCGGCGAT","TCATCAGGTTTACGGCCGTC","561307.5.peg.867","2318"
"35274",426,1008,582,"CCAATCATTGCAGCCATTTG","TCATCAGGTTTACGGCCGTC","561307.5.peg.867","2318"
"35275",342,1008,666,"TAGGGAATAAAGGTCTAAT","TCATCAGGTTTACGGCCGTC","561307.5.peg.867","2318"
"35276",485,1008,523,"TTACACCGGCGATTGGCCCT","TCATCAGGTTTACGGCCGTC","561307.5.peg.867","2318"
"35277",221,1008,787,"CTTCATAGTTCACTGTTAAT","TCATCAGGTTTACGGCCGTC","561307.5.peg.867","2318"
"35278",221,1016,795,"CTTCATAGTTCACTGTTAAT","GACGGATTTCATCAGGTTTA","561307.5.peg.867","2318"
"35279",414,1016,602,"GCCATTTGTGGTGAACAATC","GACGGATTTCATCAGGTTTA","561307.5.peg.867","2318"
"35280",704,1016,312,"TGTGGTCGACGATTTGTTGT","GACGGATTTCATCAGGTTTA","561307.5.peg.867","2318"
"35281",578,1016,438,"CTTTATGACCAGCTACTTCA","GACGGATTTCATCAGGTTTA","561307.5.peg.867","2318"
"35282",499,1016,517,"AATATAACCCACATTTACAC","GACGGATTTCATCAGGTTTA","561307.5.peg.867","2318"
"35283",342,1016,674,"TAGGGAATAAAGGTCTAAT","GACGGATTTCATCAGGTTTA","561307.5.peg.867","2318"
"35284",426,1016,590,"CCAATCATTGCAGCCATTTG","GACGGATTTCATCAGGTTTA","561307.5.peg.867","2318"
"35285",480,1016,536,"CCGGCGATTGGCCCTTGGAA","GACGGATTTCATCAGGTTTA","561307.5.peg.867","2318"
"35286",300,1016,716,"GTTAATGTTGCATCGTCACC","GACGGATTTCATCAGGTTTA","561307.5.peg.867","2318"
"35287",492,1016,524,"CCCACATTTACACCGGCGAT","GACGGATTTCATCAGGTTTA","561307.5.peg.867","2318"
"35288",722,1016,294,"CTTGTTTAACAGGTTGAATG","GACGGATTTCATCAGGTTTA","561307.5.peg.867","2318"
"35289",753,1016,263,"AGCGCTTCATCACGCTCTGC","GACGGATTTCATCAGGTTTA","561307.5.peg.867","2318"
"35290",485,1016,531,"TTACACCGGCGATTGGCCCT","GACGGATTTCATCAGGTTTA","561307.5.peg.867","2318"
"35291",300,1023,723,"GTTAATGTTGCATCGTCACC","TCTAATGGACGGATTTCATC","561307.5.peg.867","2318"
"35292",578,1023,445,"CTTTATGACCAGCTACTTCA","TCTAATGGACGGATTTCATC","561307.5.peg.867","2318"
"35293",485,1023,538,"TTACACCGGCGATTGGCCCT","TCTAATGGACGGATTTCATC","561307.5.peg.867","2318"
"35294",342,1023,681,"TAGGGAATAAAGGTCTAAT","TCTAATGGACGGATTTCATC","561307.5.peg.867","2318"
"35295",722,1023,301,"CTTGTTTAACAGGTTGAATG","TCTAATGGACGGATTTCATC","561307.5.peg.867","2318"
"35296",221,1023,802,"CTTCATAGTTCACTGTTAAT","TCTAATGGACGGATTTCATC","561307.5.peg.867","2318"
"35297",704,1023,319,"TGTGGTCGACGATTTGTTGT","TCTAATGGACGGATTTCATC","561307.5.peg.867","2318"
"35298",492,1023,531,"CCCACATTTACACCGGCGAT","TCTAATGGACGGATTTCATC","561307.5.peg.867","2318"
"35299",753,1023,270,"AGCGCTTCATCACGCTCTGC","TCTAATGGACGGATTTCATC","561307.5.peg.867","2318"
"35300",499,1023,524,"AATATAACCCACATTTACAC","TCTAATGGACGGATTTCATC","561307.5.peg.867","2318"
"35301",414,1023,609,"GCCATTTGTGGTGAACAATC","TCTAATGGACGGATTTCATC","561307.5.peg.867","2318"
"35302",426,1023,597,"CCAATCATTGCAGCCATTTG","TCTAATGGACGGATTTCATC","561307.5.peg.867","2318"
"35303",480,1023,543,"CCGGCGATTGGCCCTTGGAA","TCTAATGGACGGATTTCATC","561307.5.peg.867","2318"
"35304",753,1034,281,"AGCGCTTCATCACGCTCTGC","CAACTTCAGAATCTAATGGA","561307.5.peg.867","2318"
"35305",492,1034,542,"CCCACATTTACACCGGCGAT","CAACTTCAGAATCTAATGGA","561307.5.peg.867","2318"
"35306",704,1034,330,"TGTGGTCGACGATTTGTTGT","CAACTTCAGAATCTAATGGA","561307.5.peg.867","2318"
"35307",499,1034,535,"AATATAACCCACATTTACAC","CAACTTCAGAATCTAATGGA","561307.5.peg.867","2318"
"35308",480,1034,554,"CCGGCGATTGGCCCTTGGAA","CAACTTCAGAATCTAATGGA","561307.5.peg.867","2318"
"35309",722,1034,312,"CTTGTTTAACAGGTTGAATG","CAACTTCAGAATCTAATGGA","561307.5.peg.867","2318"
"35310",414,1034,620,"GCCATTTGTGGTGAACAATC","CAACTTCAGAATCTAATGGA","561307.5.peg.867","2318"
"35311",300,1034,734,"GTTAATGTTGCATCGTCACC","CAACTTCAGAATCTAATGGA","561307.5.peg.867","2318"
"35312",578,1034,456,"CTTTATGACCAGCTACTTCA","CAACTTCAGAATCTAATGGA","561307.5.peg.867","2318"
"35313",485,1034,549,"TTACACCGGCGATTGGCCCT","CAACTTCAGAATCTAATGGA","561307.5.peg.867","2318"
"35314",342,1034,692,"TAGGGAATAAAGGTCTAAT","CAACTTCAGAATCTAATGGA","561307.5.peg.867","2318"
"35315",221,1034,813,"CTTCATAGTTCACTGTTAAT","CAACTTCAGAATCTAATGGA","561307.5.peg.867","2318"
"35316",426,1034,608,"CCAATCATTGCAGCCATTTG","CAACTTCAGAATCTAATGGA","561307.5.peg.867","2318"
"35317",342,1038,696,"TAGGGAATAAAGGTCTAAT","TACCAACTTCAGAATCTAA","561307.5.peg.867","2318"
"35318",753,1038,285,"AGCGCTTCATCACGCTCTGC","TACCAACTTCAGAATCTAA","561307.5.peg.867","2318"
"35319",221,1038,817,"CTTCATAGTTCACTGTTAAT","TACCAACTTCAGAATCTAA","561307.5.peg.867","2318"
"35320",300,1038,738,"GTTAATGTTGCATCGTCACC","TACCAACTTCAGAATCTAA","561307.5.peg.867","2318"
"35321",485,1038,553,"TTACACCGGCGATTGGCCCT","TACCAACTTCAGAATCTAA","561307.5.peg.867","2318"
"35322",704,1038,334,"TGTGGTCGACGATTTGTTGT","TACCAACTTCAGAATCTAA","561307.5.peg.867","2318"
"35323",722,1038,316,"CTTGTTTAACAGGTTGAATG","TACCAACTTCAGAATCTAA","561307.5.peg.867","2318"
"35324",492,1038,546,"CCCACATTTACACCGGCGAT","TACCAACTTCAGAATCTAA","561307.5.peg.867","2318"
"35325",480,1038,558,"CCGGCGATTGGCCCTTGGAA","TACCAACTTCAGAATCTAA","561307.5.peg.867","2318"
"35326",426,1038,612,"CCAATCATTGCAGCCATTTG","TACCAACTTCAGAATCTAA","561307.5.peg.867","2318"
"35327",414,1038,624,"GCCATTTGTGGTGAACAATC","TACCAACTTCAGAATCTAA","561307.5.peg.867","2318"
"35328",499,1038,539,"AATATAACCCACATTTACAC","TACCAACTTCAGAATCTAA","561307.5.peg.867","2318"
"35329",578,1038,460,"CTTTATGACCAGCTACTTCA","TACCAACTTCAGAATCTAA","561307.5.peg.867","2318"
"35330",342,1065,723,"TAGGGAATAAAGGTCTAAT","AGACCTGAACCATGCGTTCT","561307.5.peg.867","2318"
"35331",414,1065,651,"GCCATTTGTGGTGAACAATC","AGACCTGAACCATGCGTTCT","561307.5.peg.867","2318"
"35332",300,1065,765,"GTTAATGTTGCATCGTCACC","AGACCTGAACCATGCGTTCT","561307.5.peg.867","2318"
"35333",221,1065,844,"CTTCATAGTTCACTGTTAAT","AGACCTGAACCATGCGTTCT","561307.5.peg.867","2318"
"35334",499,1065,566,"AATATAACCCACATTTACAC","AGACCTGAACCATGCGTTCT","561307.5.peg.867","2318"
"35335",578,1065,487,"CTTTATGACCAGCTACTTCA","AGACCTGAACCATGCGTTCT","561307.5.peg.867","2318"
"35336",492,1065,573,"CCCACATTTACACCGGCGAT","AGACCTGAACCATGCGTTCT","561307.5.peg.867","2318"
"35337",485,1065,580,"TTACACCGGCGATTGGCCCT","AGACCTGAACCATGCGTTCT","561307.5.peg.867","2318"
"35338",753,1065,312,"AGCGCTTCATCACGCTCTGC","AGACCTGAACCATGCGTTCT","561307.5.peg.867","2318"
"35339",722,1065,343,"CTTGTTTAACAGGTTGAATG","AGACCTGAACCATGCGTTCT","561307.5.peg.867","2318"
"35340",480,1065,585,"CCGGCGATTGGCCCTTGGAA","AGACCTGAACCATGCGTTCT","561307.5.peg.867","2318"
"35341",426,1065,639,"CCAATCATTGCAGCCATTTG","AGACCTGAACCATGCGTTCT","561307.5.peg.867","2318"
"35342",704,1065,361,"TGTGGTCGACGATTTGTTGT","AGACCTGAACCATGCGTTCT","561307.5.peg.867","2318"
"35343",219,24,195,"TCAAGTACGTATGAAATGTC","TAGTGAGTTTATATATGGAC","561307.5.peg.868","2319"
"35344",269,24,245,"CGTGCTCATGTCCGTGTGTA","TAGTGAGTTTATATATGGAC","561307.5.peg.868","2319"
"35345",183,24,159,"ATACCTAGCATTTCGTCTTC","TAGTGAGTTTATATATGGAC","561307.5.peg.868","2319"
"35346",489,24,465,"TACAAACACCTAAACTATC","TAGTGAGTTTATATATGGAC","561307.5.peg.868","2319"
"35347",529,24,505,"AATTCACCTGTATACACAA","TAGTGAGTTTATATATGGAC","561307.5.peg.868","2319"
"35348",219,93,126,"TCAAGTACGTATGAAATGTC","ATTTCGCCAACACCGCCTAA","561307.5.peg.868","2319"
"35349",489,93,396,"TACAAACACCTAAACTATC","ATTTCGCCAACACCGCCTAA","561307.5.peg.868","2319"
"35350",529,93,436,"AATTCACCTGTATACACAA","ATTTCGCCAACACCGCCTAA","561307.5.peg.868","2319"
"35351",269,93,176,"CGTGCTCATGTCCGTGTGTA","ATTTCGCCAACACCGCCTAA","561307.5.peg.868","2319"
"35352",24,183,159,"TAGTGAGTTTATATATGGAC","ATACCTAGCATTTCGTCTTC","561307.5.peg.868","2319"
"35353",489,183,306,"TACAAACACCTAAACTATC","ATACCTAGCATTTCGTCTTC","561307.5.peg.868","2319"
"35354",529,183,346,"AATTCACCTGTATACACAA","ATACCTAGCATTTCGTCTTC","561307.5.peg.868","2319"
"35355",529,219,310,"AATTCACCTGTATACACAA","TCAAGTACGTATGAAATGTC","561307.5.peg.868","2319"
"35356",24,219,195,"TAGTGAGTTTATATATGGAC","TCAAGTACGTATGAAATGTC","561307.5.peg.868","2319"
"35357",93,219,126,"ATTTCGCCAACACCGCCTAA","TCAAGTACGTATGAAATGTC","561307.5.peg.868","2319"
"35358",489,219,270,"TACAAACACCTAAACTATC","TCAAGTACGTATGAAATGTC","561307.5.peg.868","2319"
"35359",489,269,220,"TACAAACACCTAAACTATC","CGTGCTCATGTCCGTGTGTA","561307.5.peg.868","2319"
"35360",93,269,176,"ATTTCGCCAACACCGCCTAA","CGTGCTCATGTCCGTGTGTA","561307.5.peg.868","2319"
"35361",529,269,260,"AATTCACCTGTATACACAA","CGTGCTCATGTCCGTGTGTA","561307.5.peg.868","2319"
"35362",24,269,245,"TAGTGAGTTTATATATGGAC","CGTGCTCATGTCCGTGTGTA","561307.5.peg.868","2319"
"35363",24,489,465,"TAGTGAGTTTATATATGGAC","TACAAACACCTAAACTATC","561307.5.peg.868","2319"
"35364",183,489,306,"ATACCTAGCATTTCGTCTTC","TACAAACACCTAAACTATC","561307.5.peg.868","2319"
"35365",93,489,396,"ATTTCGCCAACACCGCCTAA","TACAAACACCTAAACTATC","561307.5.peg.868","2319"
"35366",269,489,220,"CGTGCTCATGTCCGTGTGTA","TACAAACACCTAAACTATC","561307.5.peg.868","2319"
"35367",219,489,270,"TCAAGTACGTATGAAATGTC","TACAAACACCTAAACTATC","561307.5.peg.868","2319"
"35368",269,529,260,"CGTGCTCATGTCCGTGTGTA","AATTCACCTGTATACACAA","561307.5.peg.868","2319"
"35369",24,529,505,"TAGTGAGTTTATATATGGAC","AATTCACCTGTATACACAA","561307.5.peg.868","2319"
"35370",93,529,436,"ATTTCGCCAACACCGCCTAA","AATTCACCTGTATACACAA","561307.5.peg.868","2319"
"35371",219,529,310,"TCAAGTACGTATGAAATGTC","AATTCACCTGTATACACAA","561307.5.peg.868","2319"
"35372",183,529,346,"ATACCTAGCATTTCGTCTTC","AATTCACCTGTATACACAA","561307.5.peg.868","2319"
"35373",194,9,185,"GACGACCTATTATTCCTAAT","TTAACTAAGGCAACATAAGG","561307.5.peg.869","2320"
"35374",452,9,443,"AATTTGGGAAATGACTGTGT","TTAACTAAGGCAACATAAGG","561307.5.peg.869","2320"
"35375",789,9,780,"TTGGAATATCTCTTTCTTG","TTAACTAAGGCAACATAAGG","561307.5.peg.869","2320"
"35376",1158,9,1149,"TTTCATATTGAGTTACTGC","TTAACTAAGGCAACATAAGG","561307.5.peg.869","2320"
"35377",1185,9,1176,"CTCACTTTAACCCCTTGAGC","TTAACTAAGGCAACATAAGG","561307.5.peg.869","2320"
"35378",423,9,414,"GATACACATAAGAAAGTAC","TTAACTAAGGCAACATAAGG","561307.5.peg.869","2320"
"35379",138,9,129,"ATAGCTATGACATAACGTAT","TTAACTAAGGCAACATAAGG","561307.5.peg.869","2320"
"35380",1020,9,1011,"GATTAAGTAAAGTTAACGG","TTAACTAAGGCAACATAAGG","561307.5.peg.869","2320"
"35381",9,138,129,"TTAACTAAGGCAACATAAGG","ATAGCTATGACATAACGTAT","561307.5.peg.869","2320"
"35382",789,138,651,"TTGGAATATCTCTTTCTTG","ATAGCTATGACATAACGTAT","561307.5.peg.869","2320"
"35383",423,138,285,"GATACACATAAGAAAGTAC","ATAGCTATGACATAACGTAT","561307.5.peg.869","2320"
"35384",1158,138,1020,"TTTCATATTGAGTTACTGC","ATAGCTATGACATAACGTAT","561307.5.peg.869","2320"
"35385",1020,138,882,"GATTAAGTAAAGTTAACGG","ATAGCTATGACATAACGTAT","561307.5.peg.869","2320"
"35386",452,138,314,"AATTTGGGAAATGACTGTGT","ATAGCTATGACATAACGTAT","561307.5.peg.869","2320"
"35387",1185,138,1047,"CTCACTTTAACCCCTTGAGC","ATAGCTATGACATAACGTAT","561307.5.peg.869","2320"
"35388",9,194,185,"TTAACTAAGGCAACATAAGG","GACGACCTATTATTCCTAAT","561307.5.peg.869","2320"
"35389",1020,194,826,"GATTAAGTAAAGTTAACGG","GACGACCTATTATTCCTAAT","561307.5.peg.869","2320"
"35390",423,194,229,"GATACACATAAGAAAGTAC","GACGACCTATTATTCCTAAT","561307.5.peg.869","2320"
"35391",1158,194,964,"TTTCATATTGAGTTACTGC","GACGACCTATTATTCCTAAT","561307.5.peg.869","2320"
"35392",1185,194,991,"CTCACTTTAACCCCTTGAGC","GACGACCTATTATTCCTAAT","561307.5.peg.869","2320"
"35393",452,194,258,"AATTTGGGAAATGACTGTGT","GACGACCTATTATTCCTAAT","561307.5.peg.869","2320"
"35394",789,194,595,"TTGGAATATCTCTTTCTTG","GACGACCTATTATTCCTAAT","561307.5.peg.869","2320"
"35395",1185,423,762,"CTCACTTTAACCCCTTGAGC","GATACACATAAGAAAGTAC","561307.5.peg.869","2320"
"35396",1158,423,735,"TTTCATATTGAGTTACTGC","GATACACATAAGAAAGTAC","561307.5.peg.869","2320"
"35397",138,423,285,"ATAGCTATGACATAACGTAT","GATACACATAAGAAAGTAC","561307.5.peg.869","2320"
"35398",789,423,366,"TTGGAATATCTCTTTCTTG","GATACACATAAGAAAGTAC","561307.5.peg.869","2320"
"35399",194,423,229,"GACGACCTATTATTCCTAAT","GATACACATAAGAAAGTAC","561307.5.peg.869","2320"
"35400",1020,423,597,"GATTAAGTAAAGTTAACGG","GATACACATAAGAAAGTAC","561307.5.peg.869","2320"
"35401",9,423,414,"TTAACTAAGGCAACATAAGG","GATACACATAAGAAAGTAC","561307.5.peg.869","2320"
"35402",1158,452,706,"TTTCATATTGAGTTACTGC","AATTTGGGAAATGACTGTGT","561307.5.peg.869","2320"
"35403",194,452,258,"GACGACCTATTATTCCTAAT","AATTTGGGAAATGACTGTGT","561307.5.peg.869","2320"
"35404",1020,452,568,"GATTAAGTAAAGTTAACGG","AATTTGGGAAATGACTGTGT","561307.5.peg.869","2320"
"35405",789,452,337,"TTGGAATATCTCTTTCTTG","AATTTGGGAAATGACTGTGT","561307.5.peg.869","2320"
"35406",9,452,443,"TTAACTAAGGCAACATAAGG","AATTTGGGAAATGACTGTGT","561307.5.peg.869","2320"
"35407",1185,452,733,"CTCACTTTAACCCCTTGAGC","AATTTGGGAAATGACTGTGT","561307.5.peg.869","2320"
"35408",138,452,314,"ATAGCTATGACATAACGTAT","AATTTGGGAAATGACTGTGT","561307.5.peg.869","2320"
"35409",9,789,780,"TTAACTAAGGCAACATAAGG","TTGGAATATCTCTTTCTTG","561307.5.peg.869","2320"
"35410",194,789,595,"GACGACCTATTATTCCTAAT","TTGGAATATCTCTTTCTTG","561307.5.peg.869","2320"
"35411",138,789,651,"ATAGCTATGACATAACGTAT","TTGGAATATCTCTTTCTTG","561307.5.peg.869","2320"
"35412",452,789,337,"AATTTGGGAAATGACTGTGT","TTGGAATATCTCTTTCTTG","561307.5.peg.869","2320"
"35413",1185,789,396,"CTCACTTTAACCCCTTGAGC","TTGGAATATCTCTTTCTTG","561307.5.peg.869","2320"
"35414",1020,789,231,"GATTAAGTAAAGTTAACGG","TTGGAATATCTCTTTCTTG","561307.5.peg.869","2320"
"35415",1158,789,369,"TTTCATATTGAGTTACTGC","TTGGAATATCTCTTTCTTG","561307.5.peg.869","2320"
"35416",423,789,366,"GATACACATAAGAAAGTAC","TTGGAATATCTCTTTCTTG","561307.5.peg.869","2320"
"35417",9,1020,1011,"TTAACTAAGGCAACATAAGG","GATTAAGTAAAGTTAACGG","561307.5.peg.869","2320"
"35418",1185,1020,165,"CTCACTTTAACCCCTTGAGC","GATTAAGTAAAGTTAACGG","561307.5.peg.869","2320"
"35419",1158,1020,138,"TTTCATATTGAGTTACTGC","GATTAAGTAAAGTTAACGG","561307.5.peg.869","2320"
"35420",194,1020,826,"GACGACCTATTATTCCTAAT","GATTAAGTAAAGTTAACGG","561307.5.peg.869","2320"
"35421",452,1020,568,"AATTTGGGAAATGACTGTGT","GATTAAGTAAAGTTAACGG","561307.5.peg.869","2320"
"35422",138,1020,882,"ATAGCTATGACATAACGTAT","GATTAAGTAAAGTTAACGG","561307.5.peg.869","2320"
"35423",423,1020,597,"GATACACATAAGAAAGTAC","GATTAAGTAAAGTTAACGG","561307.5.peg.869","2320"
"35424",789,1020,231,"TTGGAATATCTCTTTCTTG","GATTAAGTAAAGTTAACGG","561307.5.peg.869","2320"
"35425",9,1158,1149,"TTAACTAAGGCAACATAAGG","TTTCATATTGAGTTACTGC","561307.5.peg.869","2320"
"35426",194,1158,964,"GACGACCTATTATTCCTAAT","TTTCATATTGAGTTACTGC","561307.5.peg.869","2320"
"35427",423,1158,735,"GATACACATAAGAAAGTAC","TTTCATATTGAGTTACTGC","561307.5.peg.869","2320"
"35428",789,1158,369,"TTGGAATATCTCTTTCTTG","TTTCATATTGAGTTACTGC","561307.5.peg.869","2320"
"35429",452,1158,706,"AATTTGGGAAATGACTGTGT","TTTCATATTGAGTTACTGC","561307.5.peg.869","2320"
"35430",138,1158,1020,"ATAGCTATGACATAACGTAT","TTTCATATTGAGTTACTGC","561307.5.peg.869","2320"
"35431",1020,1158,138,"GATTAAGTAAAGTTAACGG","TTTCATATTGAGTTACTGC","561307.5.peg.869","2320"
"35432",194,1185,991,"GACGACCTATTATTCCTAAT","CTCACTTTAACCCCTTGAGC","561307.5.peg.869","2320"
"35433",789,1185,396,"TTGGAATATCTCTTTCTTG","CTCACTTTAACCCCTTGAGC","561307.5.peg.869","2320"
"35434",452,1185,733,"AATTTGGGAAATGACTGTGT","CTCACTTTAACCCCTTGAGC","561307.5.peg.869","2320"
"35435",1020,1185,165,"GATTAAGTAAAGTTAACGG","CTCACTTTAACCCCTTGAGC","561307.5.peg.869","2320"
"35436",138,1185,1047,"ATAGCTATGACATAACGTAT","CTCACTTTAACCCCTTGAGC","561307.5.peg.869","2320"
"35437",423,1185,762,"GATACACATAAGAAAGTAC","CTCACTTTAACCCCTTGAGC","561307.5.peg.869","2320"
"35438",9,1185,1176,"TTAACTAAGGCAACATAAGG","CTCACTTTAACCCCTTGAGC","561307.5.peg.869","2320"
"35439",209,77,132,"CTTTAGTTACTTCATAGCTT","TATCCTCAATAGACACATGT","561307.5.peg.87","2321"
"35440",318,77,241,"GTAACACCTGTAATTTCTGA","TATCCTCAATAGACACATGT","561307.5.peg.87","2321"
"35441",318,162,156,"GTAACACCTGTAATTTCTGA","GTTGATTTACCTGTCCCGTT","561307.5.peg.87","2321"
"35442",77,209,132,"TATCCTCAATAGACACATGT","CTTTAGTTACTTCATAGCTT","561307.5.peg.87","2321"
"35443",318,209,109,"GTAACACCTGTAATTTCTGA","CTTTAGTTACTTCATAGCTT","561307.5.peg.87","2321"
"35444",77,318,241,"TATCCTCAATAGACACATGT","GTAACACCTGTAATTTCTGA","561307.5.peg.87","2321"
"35445",162,318,156,"GTTGATTTACCTGTCCCGTT","GTAACACCTGTAATTTCTGA","561307.5.peg.87","2321"
"35446",209,318,109,"CTTTAGTTACTTCATAGCTT","GTAACACCTGTAATTTCTGA","561307.5.peg.87","2321"
"35447",213,9,204,"TATTAAACGACTTATCGGT","GATGTAAGAAGATATAGAGG","561307.5.peg.871","2323"
"35448",581,9,572,"GTGTTTCAGCAGTAATATGT","GATGTAAGAAGATATAGAGG","561307.5.peg.871","2323"
"35449",9,213,204,"GATGTAAGAAGATATAGAGG","TATTAAACGACTTATCGGT","561307.5.peg.871","2323"
"35450",581,213,368,"GTGTTTCAGCAGTAATATGT","TATTAAACGACTTATCGGT","561307.5.peg.871","2323"
"35451",9,581,572,"GATGTAAGAAGATATAGAGG","GTGTTTCAGCAGTAATATGT","561307.5.peg.871","2323"
"35452",213,581,368,"TATTAAACGACTTATCGGT","GTGTTTCAGCAGTAATATGT","561307.5.peg.871","2323"
"35453",549,204,345,"CCGGCAATATCAACACGTAT","ACAAATTGGTCTTGTCCAAG","561307.5.peg.872","2324"
"35454",568,204,364,"GTATATACTTTCTACACTAC","ACAAATTGGTCTTGTCCAAG","561307.5.peg.872","2324"
"35455",549,206,343,"CCGGCAATATCAACACGTAT","TAACAAATTGGTCTTGTCCA","561307.5.peg.872","2324"
"35456",568,206,362,"GTATATACTTTCTACACTAC","TAACAAATTGGTCTTGTCCA","561307.5.peg.872","2324"
"35457",549,218,331,"CCGGCAATATCAACACGTAT","CATCAGGTACAGTAACAAAT","561307.5.peg.872","2324"
"35458",568,218,350,"GTATATACTTTCTACACTAC","CATCAGGTACAGTAACAAAT","561307.5.peg.872","2324"
"35459",204,549,345,"ACAAATTGGTCTTGTCCAAG","CCGGCAATATCAACACGTAT","561307.5.peg.872","2324"
"35460",206,549,343,"TAACAAATTGGTCTTGTCCA","CCGGCAATATCAACACGTAT","561307.5.peg.872","2324"
"35461",218,549,331,"CATCAGGTACAGTAACAAAT","CCGGCAATATCAACACGTAT","561307.5.peg.872","2324"
"35462",204,568,364,"ACAAATTGGTCTTGTCCAAG","GTATATACTTTCTACACTAC","561307.5.peg.872","2324"
"35463",206,568,362,"TAACAAATTGGTCTTGTCCA","GTATATACTTTCTACACTAC","561307.5.peg.872","2324"
"35464",218,568,350,"CATCAGGTACAGTAACAAAT","GTATATACTTTCTACACTAC","561307.5.peg.872","2324"
"35465",291,7,284,"GCAAGACGGTCTCTTAATTC","TGTTAATTAAACAAGGGGTG","561307.5.peg.874","2326"
"35466",305,7,298,"TTCCATGTCTTACTGCAAGA","TGTTAATTAAACAAGGGGTG","561307.5.peg.874","2326"
"35467",361,7,354,"ATCTTCACGCTCAAATCGAA","TGTTAATTAAACAAGGGGTG","561307.5.peg.874","2326"
"35468",7,291,284,"TGTTAATTAAACAAGGGGTG","GCAAGACGGTCTCTTAATTC","561307.5.peg.874","2326"
"35469",7,305,298,"TGTTAATTAAACAAGGGGTG","TTCCATGTCTTACTGCAAGA","561307.5.peg.874","2326"
"35470",7,361,354,"TGTTAATTAAACAAGGGGTG","ATCTTCACGCTCAAATCGAA","561307.5.peg.874","2326"
"35471",295,7,288,"AAATCTTTACCAACAATCT","ATGAATTAAACGATACAAGG","561307.5.peg.877","2329"
"35472",498,7,491,"TGCATTTCTTTCGGTGGACC","ATGAATTAAACGATACAAGG","561307.5.peg.877","2329"
"35473",261,7,254,"TTCGTTAAGTCATCTTTCGT","ATGAATTAAACGATACAAGG","561307.5.peg.877","2329"
"35474",504,7,497,"ATTGGTTGCATTTCTTTCGG","ATGAATTAAACGATACAAGG","561307.5.peg.877","2329"
"35475",7,261,254,"ATGAATTAAACGATACAAGG","TTCGTTAAGTCATCTTTCGT","561307.5.peg.877","2329"
"35476",498,261,237,"TGCATTTCTTTCGGTGGACC","TTCGTTAAGTCATCTTTCGT","561307.5.peg.877","2329"
"35477",504,261,243,"ATTGGTTGCATTTCTTTCGG","TTCGTTAAGTCATCTTTCGT","561307.5.peg.877","2329"
"35478",7,295,288,"ATGAATTAAACGATACAAGG","AAATCTTTACCAACAATCT","561307.5.peg.877","2329"
"35479",498,295,203,"TGCATTTCTTTCGGTGGACC","AAATCTTTACCAACAATCT","561307.5.peg.877","2329"
"35480",504,295,209,"ATTGGTTGCATTTCTTTCGG","AAATCTTTACCAACAATCT","561307.5.peg.877","2329"
"35481",295,498,203,"AAATCTTTACCAACAATCT","TGCATTTCTTTCGGTGGACC","561307.5.peg.877","2329"
"35482",7,498,491,"ATGAATTAAACGATACAAGG","TGCATTTCTTTCGGTGGACC","561307.5.peg.877","2329"
"35483",261,498,237,"TTCGTTAAGTCATCTTTCGT","TGCATTTCTTTCGGTGGACC","561307.5.peg.877","2329"
"35484",7,504,497,"ATGAATTAAACGATACAAGG","ATTGGTTGCATTTCTTTCGG","561307.5.peg.877","2329"
"35485",261,504,243,"TTCGTTAAGTCATCTTTCGT","ATTGGTTGCATTTCTTTCGG","561307.5.peg.877","2329"
"35486",295,504,209,"AAATCTTTACCAACAATCT","ATTGGTTGCATTTCTTTCGG","561307.5.peg.877","2329"
"35487",121,8,113,"ATTGTCACCCAACTTCATTA","GATAGCAATTTCAATTAGG","561307.5.peg.878","2330"
"35488",348,8,340,"CCTAATGCTTGAGCATATTC","GATAGCAATTTCAATTAGG","561307.5.peg.878","2330"
"35489",152,8,144,"CAGTTGATGTAGTTGAAACT","GATAGCAATTTCAATTAGG","561307.5.peg.878","2330"
"35490",246,8,238,"GTTGTCTTACCAGAACTTTC","GATAGCAATTTCAATTAGG","561307.5.peg.878","2330"
"35491",498,8,490,"TCTCCTTCAATTTCAGCTTT","GATAGCAATTTCAATTAGG","561307.5.peg.878","2330"
"35492",402,8,394,"AGACCTTGTTCACCATGATC","GATAGCAATTTCAATTAGG","561307.5.peg.878","2330"
"35493",8,121,113,"GATAGCAATTTCAATTAGG","ATTGTCACCCAACTTCATTA","561307.5.peg.878","2330"
"35494",402,121,281,"AGACCTTGTTCACCATGATC","ATTGTCACCCAACTTCATTA","561307.5.peg.878","2330"
"35495",348,121,227,"CCTAATGCTTGAGCATATTC","ATTGTCACCCAACTTCATTA","561307.5.peg.878","2330"
"35496",498,121,377,"TCTCCTTCAATTTCAGCTTT","ATTGTCACCCAACTTCATTA","561307.5.peg.878","2330"
"35497",246,121,125,"GTTGTCTTACCAGAACTTTC","ATTGTCACCCAACTTCATTA","561307.5.peg.878","2330"
"35498",8,152,144,"GATAGCAATTTCAATTAGG","CAGTTGATGTAGTTGAAACT","561307.5.peg.878","2330"
"35499",402,152,250,"AGACCTTGTTCACCATGATC","CAGTTGATGTAGTTGAAACT","561307.5.peg.878","2330"
"35500",348,152,196,"CCTAATGCTTGAGCATATTC","CAGTTGATGTAGTTGAAACT","561307.5.peg.878","2330"
"35501",498,152,346,"TCTCCTTCAATTTCAGCTTT","CAGTTGATGTAGTTGAAACT","561307.5.peg.878","2330"
"35502",402,246,156,"AGACCTTGTTCACCATGATC","GTTGTCTTACCAGAACTTTC","561307.5.peg.878","2330"
"35503",121,246,125,"ATTGTCACCCAACTTCATTA","GTTGTCTTACCAGAACTTTC","561307.5.peg.878","2330"
"35504",498,246,252,"TCTCCTTCAATTTCAGCTTT","GTTGTCTTACCAGAACTTTC","561307.5.peg.878","2330"
"35505",8,246,238,"GATAGCAATTTCAATTAGG","GTTGTCTTACCAGAACTTTC","561307.5.peg.878","2330"
"35506",348,246,102,"CCTAATGCTTGAGCATATTC","GTTGTCTTACCAGAACTTTC","561307.5.peg.878","2330"
"35507",498,348,150,"TCTCCTTCAATTTCAGCTTT","CCTAATGCTTGAGCATATTC","561307.5.peg.878","2330"
"35508",152,348,196,"CAGTTGATGTAGTTGAAACT","CCTAATGCTTGAGCATATTC","561307.5.peg.878","2330"
"35509",121,348,227,"ATTGTCACCCAACTTCATTA","CCTAATGCTTGAGCATATTC","561307.5.peg.878","2330"
"35510",246,348,102,"GTTGTCTTACCAGAACTTTC","CCTAATGCTTGAGCATATTC","561307.5.peg.878","2330"
"35511",8,348,340,"GATAGCAATTTCAATTAGG","CCTAATGCTTGAGCATATTC","561307.5.peg.878","2330"
"35512",8,402,394,"GATAGCAATTTCAATTAGG","AGACCTTGTTCACCATGATC","561307.5.peg.878","2330"
"35513",152,402,250,"CAGTTGATGTAGTTGAAACT","AGACCTTGTTCACCATGATC","561307.5.peg.878","2330"
"35514",246,402,156,"GTTGTCTTACCAGAACTTTC","AGACCTTGTTCACCATGATC","561307.5.peg.878","2330"
"35515",121,402,281,"ATTGTCACCCAACTTCATTA","AGACCTTGTTCACCATGATC","561307.5.peg.878","2330"
"35516",8,498,490,"GATAGCAATTTCAATTAGG","TCTCCTTCAATTTCAGCTTT","561307.5.peg.878","2330"
"35517",121,498,377,"ATTGTCACCCAACTTCATTA","TCTCCTTCAATTTCAGCTTT","561307.5.peg.878","2330"
"35518",152,498,346,"CAGTTGATGTAGTTGAAACT","TCTCCTTCAATTTCAGCTTT","561307.5.peg.878","2330"
"35519",246,498,252,"GTTGTCTTACCAGAACTTTC","TCTCCTTCAATTTCAGCTTT","561307.5.peg.878","2330"
"35520",348,498,150,"CCTAATGCTTGAGCATATTC","TCTCCTTCAATTTCAGCTTT","561307.5.peg.878","2330"
"35521",490,166,324,"AGCTTCTTCTTGAGTGAGAC","GCTTGATTTACAATATCTT","561307.5.peg.879","2331"
"35522",696,166,530,"CGACCTTTCATCTCATCATT","GCTTGATTTACAATATCTT","561307.5.peg.879","2331"
"35523",795,166,629,"CCAGATAATATAACCGCTTC","GCTTGATTTACAATATCTT","561307.5.peg.879","2331"
"35524",746,166,580,"CAGTTAAAGTTTCAAGTGTG","GCTTGATTTACAATATCTT","561307.5.peg.879","2331"
"35525",746,245,501,"CAGTTAAAGTTTCAAGTGTG","CAGTTTGTTCTCTTAGGATT","561307.5.peg.879","2331"
"35526",696,245,451,"CGACCTTTCATCTCATCATT","CAGTTTGTTCTCTTAGGATT","561307.5.peg.879","2331"
"35527",490,245,245,"AGCTTCTTCTTGAGTGAGAC","CAGTTTGTTCTCTTAGGATT","561307.5.peg.879","2331"
"35528",795,245,550,"CCAGATAATATAACCGCTTC","CAGTTTGTTCTCTTAGGATT","561307.5.peg.879","2331"
"35529",166,490,324,"GCTTGATTTACAATATCTT","AGCTTCTTCTTGAGTGAGAC","561307.5.peg.879","2331"
"35530",696,490,206,"CGACCTTTCATCTCATCATT","AGCTTCTTCTTGAGTGAGAC","561307.5.peg.879","2331"
"35531",795,490,305,"CCAGATAATATAACCGCTTC","AGCTTCTTCTTGAGTGAGAC","561307.5.peg.879","2331"
"35532",245,490,245,"CAGTTTGTTCTCTTAGGATT","AGCTTCTTCTTGAGTGAGAC","561307.5.peg.879","2331"
"35533",746,490,256,"CAGTTAAAGTTTCAAGTGTG","AGCTTCTTCTTGAGTGAGAC","561307.5.peg.879","2331"
"35534",166,696,530,"GCTTGATTTACAATATCTT","CGACCTTTCATCTCATCATT","561307.5.peg.879","2331"
"35535",245,696,451,"CAGTTTGTTCTCTTAGGATT","CGACCTTTCATCTCATCATT","561307.5.peg.879","2331"
"35536",490,696,206,"AGCTTCTTCTTGAGTGAGAC","CGACCTTTCATCTCATCATT","561307.5.peg.879","2331"
"35537",166,746,580,"GCTTGATTTACAATATCTT","CAGTTAAAGTTTCAAGTGTG","561307.5.peg.879","2331"
"35538",490,746,256,"AGCTTCTTCTTGAGTGAGAC","CAGTTAAAGTTTCAAGTGTG","561307.5.peg.879","2331"
"35539",245,746,501,"CAGTTTGTTCTCTTAGGATT","CAGTTAAAGTTTCAAGTGTG","561307.5.peg.879","2331"
"35540",490,795,305,"AGCTTCTTCTTGAGTGAGAC","CCAGATAATATAACCGCTTC","561307.5.peg.879","2331"
"35541",245,795,550,"CAGTTTGTTCTCTTAGGATT","CCAGATAATATAACCGCTTC","561307.5.peg.879","2331"
"35542",166,795,629,"GCTTGATTTACAATATCTT","CCAGATAATATAACCGCTTC","561307.5.peg.879","2331"
"35543",293,114,179,"ACATAGTTGGAATATGGTGT","ATAGTCCCACCGCTAACACC","561307.5.peg.88","2332"
"35544",114,293,179,"ATAGTCCCACCGCTAACACC","ACATAGTTGGAATATGGTGT","561307.5.peg.88","2332"
"35545",228,57,171,"TCATCACTAATTGCATGAAC","CCAACTTTCCACGATAATTG","561307.5.peg.882","2335"
"35546",726,57,669,"TATTCCATAACTTCAGACGC","CCAACTTTCCACGATAATTG","561307.5.peg.882","2335"
"35547",357,57,300,"AGCTGTGCATGACATCCTTC","CCAACTTTCCACGATAATTG","561307.5.peg.882","2335"
"35548",337,57,280,"TGGTTTCACAGGTTTAGCCT","CCAACTTTCCACGATAATTG","561307.5.peg.882","2335"
"35549",594,57,537,"TCAAAGTCCCCGTAGATTTC","CCAACTTTCCACGATAATTG","561307.5.peg.882","2335"
"35550",717,57,660,"ACTTCAGACGCAGGTGTAAT","CCAACTTTCCACGATAATTG","561307.5.peg.882","2335"
"35551",296,57,239,"TGTCTTCTCTCATTTCATGA","CCAACTTTCCACGATAATTG","561307.5.peg.882","2335"
"35552",551,57,494,"GATAACCTTCGTTTAATGCT","CCAACTTTCCACGATAATTG","561307.5.peg.882","2335"
"35553",348,57,291,"TGACATCCTTCTGGTTTCAC","CCAACTTTCCACGATAATTG","561307.5.peg.882","2335"
"35554",873,57,816,"CCATCATTAAAGATAAACC","CCAACTTTCCACGATAATTG","561307.5.peg.882","2335"
"35555",717,228,489,"ACTTCAGACGCAGGTGTAAT","TCATCACTAATTGCATGAAC","561307.5.peg.882","2335"
"35556",337,228,109,"TGGTTTCACAGGTTTAGCCT","TCATCACTAATTGCATGAAC","561307.5.peg.882","2335"
"35557",57,228,171,"CCAACTTTCCACGATAATTG","TCATCACTAATTGCATGAAC","561307.5.peg.882","2335"
"35558",551,228,323,"GATAACCTTCGTTTAATGCT","TCATCACTAATTGCATGAAC","561307.5.peg.882","2335"
"35559",348,228,120,"TGACATCCTTCTGGTTTCAC","TCATCACTAATTGCATGAAC","561307.5.peg.882","2335"
"35560",357,228,129,"AGCTGTGCATGACATCCTTC","TCATCACTAATTGCATGAAC","561307.5.peg.882","2335"
"35561",873,228,645,"CCATCATTAAAGATAAACC","TCATCACTAATTGCATGAAC","561307.5.peg.882","2335"
"35562",594,228,366,"TCAAAGTCCCCGTAGATTTC","TCATCACTAATTGCATGAAC","561307.5.peg.882","2335"
"35563",726,228,498,"TATTCCATAACTTCAGACGC","TCATCACTAATTGCATGAAC","561307.5.peg.882","2335"
"35564",551,296,255,"GATAACCTTCGTTTAATGCT","TGTCTTCTCTCATTTCATGA","561307.5.peg.882","2335"
"35565",594,296,298,"TCAAAGTCCCCGTAGATTTC","TGTCTTCTCTCATTTCATGA","561307.5.peg.882","2335"
"35566",726,296,430,"TATTCCATAACTTCAGACGC","TGTCTTCTCTCATTTCATGA","561307.5.peg.882","2335"
"35567",717,296,421,"ACTTCAGACGCAGGTGTAAT","TGTCTTCTCTCATTTCATGA","561307.5.peg.882","2335"
"35568",57,296,239,"CCAACTTTCCACGATAATTG","TGTCTTCTCTCATTTCATGA","561307.5.peg.882","2335"
"35569",873,296,577,"CCATCATTAAAGATAAACC","TGTCTTCTCTCATTTCATGA","561307.5.peg.882","2335"
"35570",57,337,280,"CCAACTTTCCACGATAATTG","TGGTTTCACAGGTTTAGCCT","561307.5.peg.882","2335"
"35571",228,337,109,"TCATCACTAATTGCATGAAC","TGGTTTCACAGGTTTAGCCT","561307.5.peg.882","2335"
"35572",594,337,257,"TCAAAGTCCCCGTAGATTTC","TGGTTTCACAGGTTTAGCCT","561307.5.peg.882","2335"
"35573",873,337,536,"CCATCATTAAAGATAAACC","TGGTTTCACAGGTTTAGCCT","561307.5.peg.882","2335"
"35574",717,337,380,"ACTTCAGACGCAGGTGTAAT","TGGTTTCACAGGTTTAGCCT","561307.5.peg.882","2335"
"35575",551,337,214,"GATAACCTTCGTTTAATGCT","TGGTTTCACAGGTTTAGCCT","561307.5.peg.882","2335"
"35576",726,337,389,"TATTCCATAACTTCAGACGC","TGGTTTCACAGGTTTAGCCT","561307.5.peg.882","2335"
"35577",228,348,120,"TCATCACTAATTGCATGAAC","TGACATCCTTCTGGTTTCAC","561307.5.peg.882","2335"
"35578",726,348,378,"TATTCCATAACTTCAGACGC","TGACATCCTTCTGGTTTCAC","561307.5.peg.882","2335"
"35579",57,348,291,"CCAACTTTCCACGATAATTG","TGACATCCTTCTGGTTTCAC","561307.5.peg.882","2335"
"35580",873,348,525,"CCATCATTAAAGATAAACC","TGACATCCTTCTGGTTTCAC","561307.5.peg.882","2335"
"35581",594,348,246,"TCAAAGTCCCCGTAGATTTC","TGACATCCTTCTGGTTTCAC","561307.5.peg.882","2335"
"35582",551,348,203,"GATAACCTTCGTTTAATGCT","TGACATCCTTCTGGTTTCAC","561307.5.peg.882","2335"
"35583",717,348,369,"ACTTCAGACGCAGGTGTAAT","TGACATCCTTCTGGTTTCAC","561307.5.peg.882","2335"
"35584",594,357,237,"TCAAAGTCCCCGTAGATTTC","AGCTGTGCATGACATCCTTC","561307.5.peg.882","2335"
"35585",873,357,516,"CCATCATTAAAGATAAACC","AGCTGTGCATGACATCCTTC","561307.5.peg.882","2335"
"35586",551,357,194,"GATAACCTTCGTTTAATGCT","AGCTGTGCATGACATCCTTC","561307.5.peg.882","2335"
"35587",228,357,129,"TCATCACTAATTGCATGAAC","AGCTGTGCATGACATCCTTC","561307.5.peg.882","2335"
"35588",57,357,300,"CCAACTTTCCACGATAATTG","AGCTGTGCATGACATCCTTC","561307.5.peg.882","2335"
"35589",726,357,369,"TATTCCATAACTTCAGACGC","AGCTGTGCATGACATCCTTC","561307.5.peg.882","2335"
"35590",717,357,360,"ACTTCAGACGCAGGTGTAAT","AGCTGTGCATGACATCCTTC","561307.5.peg.882","2335"
"35591",348,551,203,"TGACATCCTTCTGGTTTCAC","GATAACCTTCGTTTAATGCT","561307.5.peg.882","2335"
"35592",57,551,494,"CCAACTTTCCACGATAATTG","GATAACCTTCGTTTAATGCT","561307.5.peg.882","2335"
"35593",228,551,323,"TCATCACTAATTGCATGAAC","GATAACCTTCGTTTAATGCT","561307.5.peg.882","2335"
"35594",726,551,175,"TATTCCATAACTTCAGACGC","GATAACCTTCGTTTAATGCT","561307.5.peg.882","2335"
"35595",873,551,322,"CCATCATTAAAGATAAACC","GATAACCTTCGTTTAATGCT","561307.5.peg.882","2335"
"35596",357,551,194,"AGCTGTGCATGACATCCTTC","GATAACCTTCGTTTAATGCT","561307.5.peg.882","2335"
"35597",296,551,255,"TGTCTTCTCTCATTTCATGA","GATAACCTTCGTTTAATGCT","561307.5.peg.882","2335"
"35598",717,551,166,"ACTTCAGACGCAGGTGTAAT","GATAACCTTCGTTTAATGCT","561307.5.peg.882","2335"
"35599",337,551,214,"TGGTTTCACAGGTTTAGCCT","GATAACCTTCGTTTAATGCT","561307.5.peg.882","2335"
"35600",57,594,537,"CCAACTTTCCACGATAATTG","TCAAAGTCCCCGTAGATTTC","561307.5.peg.882","2335"
"35601",296,594,298,"TGTCTTCTCTCATTTCATGA","TCAAAGTCCCCGTAGATTTC","561307.5.peg.882","2335"
"35602",357,594,237,"AGCTGTGCATGACATCCTTC","TCAAAGTCCCCGTAGATTTC","561307.5.peg.882","2335"
"35603",228,594,366,"TCATCACTAATTGCATGAAC","TCAAAGTCCCCGTAGATTTC","561307.5.peg.882","2335"
"35604",337,594,257,"TGGTTTCACAGGTTTAGCCT","TCAAAGTCCCCGTAGATTTC","561307.5.peg.882","2335"
"35605",873,594,279,"CCATCATTAAAGATAAACC","TCAAAGTCCCCGTAGATTTC","561307.5.peg.882","2335"
"35606",717,594,123,"ACTTCAGACGCAGGTGTAAT","TCAAAGTCCCCGTAGATTTC","561307.5.peg.882","2335"
"35607",348,594,246,"TGACATCCTTCTGGTTTCAC","TCAAAGTCCCCGTAGATTTC","561307.5.peg.882","2335"
"35608",726,594,132,"TATTCCATAACTTCAGACGC","TCAAAGTCCCCGTAGATTTC","561307.5.peg.882","2335"
"35609",348,717,369,"TGACATCCTTCTGGTTTCAC","ACTTCAGACGCAGGTGTAAT","561307.5.peg.882","2335"
"35610",296,717,421,"TGTCTTCTCTCATTTCATGA","ACTTCAGACGCAGGTGTAAT","561307.5.peg.882","2335"
"35611",873,717,156,"CCATCATTAAAGATAAACC","ACTTCAGACGCAGGTGTAAT","561307.5.peg.882","2335"
"35612",337,717,380,"TGGTTTCACAGGTTTAGCCT","ACTTCAGACGCAGGTGTAAT","561307.5.peg.882","2335"
"35613",551,717,166,"GATAACCTTCGTTTAATGCT","ACTTCAGACGCAGGTGTAAT","561307.5.peg.882","2335"
"35614",228,717,489,"TCATCACTAATTGCATGAAC","ACTTCAGACGCAGGTGTAAT","561307.5.peg.882","2335"
"35615",594,717,123,"TCAAAGTCCCCGTAGATTTC","ACTTCAGACGCAGGTGTAAT","561307.5.peg.882","2335"
"35616",357,717,360,"AGCTGTGCATGACATCCTTC","ACTTCAGACGCAGGTGTAAT","561307.5.peg.882","2335"
"35617",57,717,660,"CCAACTTTCCACGATAATTG","ACTTCAGACGCAGGTGTAAT","561307.5.peg.882","2335"
"35618",337,726,389,"TGGTTTCACAGGTTTAGCCT","TATTCCATAACTTCAGACGC","561307.5.peg.882","2335"
"35619",594,726,132,"TCAAAGTCCCCGTAGATTTC","TATTCCATAACTTCAGACGC","561307.5.peg.882","2335"
"35620",296,726,430,"TGTCTTCTCTCATTTCATGA","TATTCCATAACTTCAGACGC","561307.5.peg.882","2335"
"35621",873,726,147,"CCATCATTAAAGATAAACC","TATTCCATAACTTCAGACGC","561307.5.peg.882","2335"
"35622",551,726,175,"GATAACCTTCGTTTAATGCT","TATTCCATAACTTCAGACGC","561307.5.peg.882","2335"
"35623",57,726,669,"CCAACTTTCCACGATAATTG","TATTCCATAACTTCAGACGC","561307.5.peg.882","2335"
"35624",357,726,369,"AGCTGTGCATGACATCCTTC","TATTCCATAACTTCAGACGC","561307.5.peg.882","2335"
"35625",348,726,378,"TGACATCCTTCTGGTTTCAC","TATTCCATAACTTCAGACGC","561307.5.peg.882","2335"
"35626",228,726,498,"TCATCACTAATTGCATGAAC","TATTCCATAACTTCAGACGC","561307.5.peg.882","2335"
"35627",228,873,645,"TCATCACTAATTGCATGAAC","CCATCATTAAAGATAAACC","561307.5.peg.882","2335"
"35628",357,873,516,"AGCTGTGCATGACATCCTTC","CCATCATTAAAGATAAACC","561307.5.peg.882","2335"
"35629",57,873,816,"CCAACTTTCCACGATAATTG","CCATCATTAAAGATAAACC","561307.5.peg.882","2335"
"35630",296,873,577,"TGTCTTCTCTCATTTCATGA","CCATCATTAAAGATAAACC","561307.5.peg.882","2335"
"35631",348,873,525,"TGACATCCTTCTGGTTTCAC","CCATCATTAAAGATAAACC","561307.5.peg.882","2335"
"35632",551,873,322,"GATAACCTTCGTTTAATGCT","CCATCATTAAAGATAAACC","561307.5.peg.882","2335"
"35633",337,873,536,"TGGTTTCACAGGTTTAGCCT","CCATCATTAAAGATAAACC","561307.5.peg.882","2335"
"35634",717,873,156,"ACTTCAGACGCAGGTGTAAT","CCATCATTAAAGATAAACC","561307.5.peg.882","2335"
"35635",594,873,279,"TCAAAGTCCCCGTAGATTTC","CCATCATTAAAGATAAACC","561307.5.peg.882","2335"
"35636",726,873,147,"TATTCCATAACTTCAGACGC","CCATCATTAAAGATAAACC","561307.5.peg.882","2335"
"35637",145,6,139,"AGGTTCTAACCCTATATTTG","TGCTACTGAAATAAAGGAGA","561307.5.peg.883","2336"
"35638",444,6,438,"ACAAATCCTACTGCTGATGA","TGCTACTGAAATAAAGGAGA","561307.5.peg.883","2336"
"35639",187,6,181,"ACGGCCAGAACATCCTATAC","TGCTACTGAAATAAAGGAGA","561307.5.peg.883","2336"
"35640",187,87,100,"ACGGCCAGAACATCCTATAC","CCACATCCGGGGCACCAGTT","561307.5.peg.883","2336"
"35641",444,87,357,"ACAAATCCTACTGCTGATGA","CCACATCCGGGGCACCAGTT","561307.5.peg.883","2336"
"35642",444,98,346,"ACAAATCCTACTGCTGATGA","CTGAGAAATCGCCACATCCG","561307.5.peg.883","2336"
"35643",444,100,344,"ACAAATCCTACTGCTGATGA","TACTGAGAAATCGCCACATC","561307.5.peg.883","2336"
"35644",6,145,139,"TGCTACTGAAATAAAGGAGA","AGGTTCTAACCCTATATTTG","561307.5.peg.883","2336"
"35645",444,145,299,"ACAAATCCTACTGCTGATGA","AGGTTCTAACCCTATATTTG","561307.5.peg.883","2336"
"35646",444,187,257,"ACAAATCCTACTGCTGATGA","ACGGCCAGAACATCCTATAC","561307.5.peg.883","2336"
"35647",87,187,100,"CCACATCCGGGGCACCAGTT","ACGGCCAGAACATCCTATAC","561307.5.peg.883","2336"
"35648",6,187,181,"TGCTACTGAAATAAAGGAGA","ACGGCCAGAACATCCTATAC","561307.5.peg.883","2336"
"35649",87,444,357,"CCACATCCGGGGCACCAGTT","ACAAATCCTACTGCTGATGA","561307.5.peg.883","2336"
"35650",6,444,438,"TGCTACTGAAATAAAGGAGA","ACAAATCCTACTGCTGATGA","561307.5.peg.883","2336"
"35651",187,444,257,"ACGGCCAGAACATCCTATAC","ACAAATCCTACTGCTGATGA","561307.5.peg.883","2336"
"35652",145,444,299,"AGGTTCTAACCCTATATTTG","ACAAATCCTACTGCTGATGA","561307.5.peg.883","2336"
"35653",98,444,346,"CTGAGAAATCGCCACATCCG","ACAAATCCTACTGCTGATGA","561307.5.peg.883","2336"
"35654",100,444,344,"TACTGAGAAATCGCCACATC","ACAAATCCTACTGCTGATGA","561307.5.peg.883","2336"
"35655",674,11,663,"ATGCTTTAATGTTGCCTTCA","AATGATACGGGCAAATAGAA","561307.5.peg.885","2338"
"35656",406,11,395,"TTCACTAAACACTTTGTTCT","AATGATACGGGCAAATAGAA","561307.5.peg.885","2338"
"35657",780,11,769,"CTTCATCTATAATGTCTTC","AATGATACGGGCAAATAGAA","561307.5.peg.885","2338"
"35658",773,11,762,"CTATAATGTCTTCAGGTCTA","AATGATACGGGCAAATAGAA","561307.5.peg.885","2338"
"35659",11,406,395,"AATGATACGGGCAAATAGAA","TTCACTAAACACTTTGTTCT","561307.5.peg.885","2338"
"35660",674,406,268,"ATGCTTTAATGTTGCCTTCA","TTCACTAAACACTTTGTTCT","561307.5.peg.885","2338"
"35661",773,406,367,"CTATAATGTCTTCAGGTCTA","TTCACTAAACACTTTGTTCT","561307.5.peg.885","2338"
"35662",780,406,374,"CTTCATCTATAATGTCTTC","TTCACTAAACACTTTGTTCT","561307.5.peg.885","2338"
"35663",11,674,663,"AATGATACGGGCAAATAGAA","ATGCTTTAATGTTGCCTTCA","561307.5.peg.885","2338"
"35664",780,674,106,"CTTCATCTATAATGTCTTC","ATGCTTTAATGTTGCCTTCA","561307.5.peg.885","2338"
"35665",406,674,268,"TTCACTAAACACTTTGTTCT","ATGCTTTAATGTTGCCTTCA","561307.5.peg.885","2338"
"35666",11,773,762,"AATGATACGGGCAAATAGAA","CTATAATGTCTTCAGGTCTA","561307.5.peg.885","2338"
"35667",406,773,367,"TTCACTAAACACTTTGTTCT","CTATAATGTCTTCAGGTCTA","561307.5.peg.885","2338"
"35668",674,780,106,"ATGCTTTAATGTTGCCTTCA","CTTCATCTATAATGTCTTC","561307.5.peg.885","2338"
"35669",11,780,769,"AATGATACGGGCAAATAGAA","CTTCATCTATAATGTCTTC","561307.5.peg.885","2338"
"35670",406,780,374,"TTCACTAAACACTTTGTTCT","CTTCATCTATAATGTCTTC","561307.5.peg.885","2338"
"35671",327,163,164,"ACCATACCTTTCGTTTGTTT","AAGTACACGTGATGCCTCCT","561307.5.peg.888","2341"
"35672",453,163,290,"CAGTAACTAAGCGCAATTTC","AAGTACACGTGATGCCTCCT","561307.5.peg.888","2341"
"35673",821,163,658,"GAATGCTTTCCGTTAACTCA","AAGTACACGTGATGCCTCCT","561307.5.peg.888","2341"
"35674",378,163,215,"CCTTGCTCCATCACAGTTCC","AAGTACACGTGATGCCTCCT","561307.5.peg.888","2341"
"35675",897,163,734,"TTTAAGCGGCGTGCTCCCAT","AAGTACACGTGATGCCTCCT","561307.5.peg.888","2341"
"35676",1245,163,1082,"CCATCTTTAACTGAAATTGG","AAGTACACGTGATGCCTCCT","561307.5.peg.888","2341"
"35677",453,225,228,"CAGTAACTAAGCGCAATTTC","GGAACACCACACATCGGAAT","561307.5.peg.888","2341"
"35678",821,225,596,"GAATGCTTTCCGTTAACTCA","GGAACACCACACATCGGAAT","561307.5.peg.888","2341"
"35679",897,225,672,"TTTAAGCGGCGTGCTCCCAT","GGAACACCACACATCGGAAT","561307.5.peg.888","2341"
"35680",327,225,102,"ACCATACCTTTCGTTTGTTT","GGAACACCACACATCGGAAT","561307.5.peg.888","2341"
"35681",378,225,153,"CCTTGCTCCATCACAGTTCC","GGAACACCACACATCGGAAT","561307.5.peg.888","2341"
"35682",1245,225,1020,"CCATCTTTAACTGAAATTGG","GGAACACCACACATCGGAAT","561307.5.peg.888","2341"
"35683",1245,231,1014,"CCATCTTTAACTGAAATTGG","TGATACGGAACACCACACAT","561307.5.peg.888","2341"
"35684",821,231,590,"GAATGCTTTCCGTTAACTCA","TGATACGGAACACCACACAT","561307.5.peg.888","2341"
"35685",897,231,666,"TTTAAGCGGCGTGCTCCCAT","TGATACGGAACACCACACAT","561307.5.peg.888","2341"
"35686",378,231,147,"CCTTGCTCCATCACAGTTCC","TGATACGGAACACCACACAT","561307.5.peg.888","2341"
"35687",453,231,222,"CAGTAACTAAGCGCAATTTC","TGATACGGAACACCACACAT","561307.5.peg.888","2341"
"35688",821,246,575,"GAATGCTTTCCGTTAACTCA","TAACTATCTGCAGAATGATA","561307.5.peg.888","2341"
"35689",453,246,207,"CAGTAACTAAGCGCAATTTC","TAACTATCTGCAGAATGATA","561307.5.peg.888","2341"
"35690",1245,246,999,"CCATCTTTAACTGAAATTGG","TAACTATCTGCAGAATGATA","561307.5.peg.888","2341"
"35691",378,246,132,"CCTTGCTCCATCACAGTTCC","TAACTATCTGCAGAATGATA","561307.5.peg.888","2341"
"35692",897,246,651,"TTTAAGCGGCGTGCTCCCAT","TAACTATCTGCAGAATGATA","561307.5.peg.888","2341"
"35693",163,327,164,"AAGTACACGTGATGCCTCCT","ACCATACCTTTCGTTTGTTT","561307.5.peg.888","2341"
"35694",453,327,126,"CAGTAACTAAGCGCAATTTC","ACCATACCTTTCGTTTGTTT","561307.5.peg.888","2341"
"35695",1245,327,918,"CCATCTTTAACTGAAATTGG","ACCATACCTTTCGTTTGTTT","561307.5.peg.888","2341"
"35696",821,327,494,"GAATGCTTTCCGTTAACTCA","ACCATACCTTTCGTTTGTTT","561307.5.peg.888","2341"
"35697",225,327,102,"GGAACACCACACATCGGAAT","ACCATACCTTTCGTTTGTTT","561307.5.peg.888","2341"
"35698",897,327,570,"TTTAAGCGGCGTGCTCCCAT","ACCATACCTTTCGTTTGTTT","561307.5.peg.888","2341"
"35699",163,378,215,"AAGTACACGTGATGCCTCCT","CCTTGCTCCATCACAGTTCC","561307.5.peg.888","2341"
"35700",246,378,132,"TAACTATCTGCAGAATGATA","CCTTGCTCCATCACAGTTCC","561307.5.peg.888","2341"
"35701",225,378,153,"GGAACACCACACATCGGAAT","CCTTGCTCCATCACAGTTCC","561307.5.peg.888","2341"
"35702",1245,378,867,"CCATCTTTAACTGAAATTGG","CCTTGCTCCATCACAGTTCC","561307.5.peg.888","2341"
"35703",821,378,443,"GAATGCTTTCCGTTAACTCA","CCTTGCTCCATCACAGTTCC","561307.5.peg.888","2341"
"35704",231,378,147,"TGATACGGAACACCACACAT","CCTTGCTCCATCACAGTTCC","561307.5.peg.888","2341"
"35705",897,378,519,"TTTAAGCGGCGTGCTCCCAT","CCTTGCTCCATCACAGTTCC","561307.5.peg.888","2341"
"35706",225,453,228,"GGAACACCACACATCGGAAT","CAGTAACTAAGCGCAATTTC","561307.5.peg.888","2341"
"35707",163,453,290,"AAGTACACGTGATGCCTCCT","CAGTAACTAAGCGCAATTTC","561307.5.peg.888","2341"
"35708",1245,453,792,"CCATCTTTAACTGAAATTGG","CAGTAACTAAGCGCAATTTC","561307.5.peg.888","2341"
"35709",246,453,207,"TAACTATCTGCAGAATGATA","CAGTAACTAAGCGCAATTTC","561307.5.peg.888","2341"
"35710",327,453,126,"ACCATACCTTTCGTTTGTTT","CAGTAACTAAGCGCAATTTC","561307.5.peg.888","2341"
"35711",821,453,368,"GAATGCTTTCCGTTAACTCA","CAGTAACTAAGCGCAATTTC","561307.5.peg.888","2341"
"35712",897,453,444,"TTTAAGCGGCGTGCTCCCAT","CAGTAACTAAGCGCAATTTC","561307.5.peg.888","2341"
"35713",231,453,222,"TGATACGGAACACCACACAT","CAGTAACTAAGCGCAATTTC","561307.5.peg.888","2341"
"35714",246,821,575,"TAACTATCTGCAGAATGATA","GAATGCTTTCCGTTAACTCA","561307.5.peg.888","2341"
"35715",378,821,443,"CCTTGCTCCATCACAGTTCC","GAATGCTTTCCGTTAACTCA","561307.5.peg.888","2341"
"35716",163,821,658,"AAGTACACGTGATGCCTCCT","GAATGCTTTCCGTTAACTCA","561307.5.peg.888","2341"
"35717",225,821,596,"GGAACACCACACATCGGAAT","GAATGCTTTCCGTTAACTCA","561307.5.peg.888","2341"
"35718",231,821,590,"TGATACGGAACACCACACAT","GAATGCTTTCCGTTAACTCA","561307.5.peg.888","2341"
"35719",453,821,368,"CAGTAACTAAGCGCAATTTC","GAATGCTTTCCGTTAACTCA","561307.5.peg.888","2341"
"35720",1245,821,424,"CCATCTTTAACTGAAATTGG","GAATGCTTTCCGTTAACTCA","561307.5.peg.888","2341"
"35721",327,821,494,"ACCATACCTTTCGTTTGTTT","GAATGCTTTCCGTTAACTCA","561307.5.peg.888","2341"
"35722",163,897,734,"AAGTACACGTGATGCCTCCT","TTTAAGCGGCGTGCTCCCAT","561307.5.peg.888","2341"
"35723",225,897,672,"GGAACACCACACATCGGAAT","TTTAAGCGGCGTGCTCCCAT","561307.5.peg.888","2341"
"35724",231,897,666,"TGATACGGAACACCACACAT","TTTAAGCGGCGTGCTCCCAT","561307.5.peg.888","2341"
"35725",246,897,651,"TAACTATCTGCAGAATGATA","TTTAAGCGGCGTGCTCCCAT","561307.5.peg.888","2341"
"35726",327,897,570,"ACCATACCTTTCGTTTGTTT","TTTAAGCGGCGTGCTCCCAT","561307.5.peg.888","2341"
"35727",1245,897,348,"CCATCTTTAACTGAAATTGG","TTTAAGCGGCGTGCTCCCAT","561307.5.peg.888","2341"
"35728",453,897,444,"CAGTAACTAAGCGCAATTTC","TTTAAGCGGCGTGCTCCCAT","561307.5.peg.888","2341"
"35729",378,897,519,"CCTTGCTCCATCACAGTTCC","TTTAAGCGGCGTGCTCCCAT","561307.5.peg.888","2341"
"35730",897,1245,348,"TTTAAGCGGCGTGCTCCCAT","CCATCTTTAACTGAAATTGG","561307.5.peg.888","2341"
"35731",378,1245,867,"CCTTGCTCCATCACAGTTCC","CCATCTTTAACTGAAATTGG","561307.5.peg.888","2341"
"35732",231,1245,1014,"TGATACGGAACACCACACAT","CCATCTTTAACTGAAATTGG","561307.5.peg.888","2341"
"35733",246,1245,999,"TAACTATCTGCAGAATGATA","CCATCTTTAACTGAAATTGG","561307.5.peg.888","2341"
"35734",453,1245,792,"CAGTAACTAAGCGCAATTTC","CCATCTTTAACTGAAATTGG","561307.5.peg.888","2341"
"35735",163,1245,1082,"AAGTACACGTGATGCCTCCT","CCATCTTTAACTGAAATTGG","561307.5.peg.888","2341"
"35736",225,1245,1020,"GGAACACCACACATCGGAAT","CCATCTTTAACTGAAATTGG","561307.5.peg.888","2341"
"35737",821,1245,424,"GAATGCTTTCCGTTAACTCA","CCATCTTTAACTGAAATTGG","561307.5.peg.888","2341"
"35738",327,1245,918,"ACCATACCTTTCGTTTGTTT","CCATCTTTAACTGAAATTGG","561307.5.peg.888","2341"
"35739",921,120,801,"CATTTACGTCTACTAAGAT","AGTTCTTTCACAACAGAACT","561307.5.peg.889","2342"
"35740",590,120,470,"GTGCTATTCGAATGTCCGGA","AGTTCTTTCACAACAGAACT","561307.5.peg.889","2342"
"35741",594,120,474,"ATGAGTGCTATTCGAATGTC","AGTTCTTTCACAACAGAACT","561307.5.peg.889","2342"
"35742",335,120,215,"TACTGGCTAGTGCTTCACCA","AGTTCTTTCACAACAGAACT","561307.5.peg.889","2342"
"35743",590,206,384,"GTGCTATTCGAATGTCCGGA","TATCGACTACGCGAATAGAT","561307.5.peg.889","2342"
"35744",335,206,129,"TACTGGCTAGTGCTTCACCA","TATCGACTACGCGAATAGAT","561307.5.peg.889","2342"
"35745",594,206,388,"ATGAGTGCTATTCGAATGTC","TATCGACTACGCGAATAGAT","561307.5.peg.889","2342"
"35746",921,206,715,"CATTTACGTCTACTAAGAT","TATCGACTACGCGAATAGAT","561307.5.peg.889","2342"
"35747",120,335,215,"AGTTCTTTCACAACAGAACT","TACTGGCTAGTGCTTCACCA","561307.5.peg.889","2342"
"35748",206,335,129,"TATCGACTACGCGAATAGAT","TACTGGCTAGTGCTTCACCA","561307.5.peg.889","2342"
"35749",921,335,586,"CATTTACGTCTACTAAGAT","TACTGGCTAGTGCTTCACCA","561307.5.peg.889","2342"
"35750",590,335,255,"GTGCTATTCGAATGTCCGGA","TACTGGCTAGTGCTTCACCA","561307.5.peg.889","2342"
"35751",594,335,259,"ATGAGTGCTATTCGAATGTC","TACTGGCTAGTGCTTCACCA","561307.5.peg.889","2342"
"35752",120,590,470,"AGTTCTTTCACAACAGAACT","GTGCTATTCGAATGTCCGGA","561307.5.peg.889","2342"
"35753",335,590,255,"TACTGGCTAGTGCTTCACCA","GTGCTATTCGAATGTCCGGA","561307.5.peg.889","2342"
"35754",921,590,331,"CATTTACGTCTACTAAGAT","GTGCTATTCGAATGTCCGGA","561307.5.peg.889","2342"
"35755",206,590,384,"TATCGACTACGCGAATAGAT","GTGCTATTCGAATGTCCGGA","561307.5.peg.889","2342"
"35756",335,594,259,"TACTGGCTAGTGCTTCACCA","ATGAGTGCTATTCGAATGTC","561307.5.peg.889","2342"
"35757",120,594,474,"AGTTCTTTCACAACAGAACT","ATGAGTGCTATTCGAATGTC","561307.5.peg.889","2342"
"35758",921,594,327,"CATTTACGTCTACTAAGAT","ATGAGTGCTATTCGAATGTC","561307.5.peg.889","2342"
"35759",206,594,388,"TATCGACTACGCGAATAGAT","ATGAGTGCTATTCGAATGTC","561307.5.peg.889","2342"
"35760",120,921,801,"AGTTCTTTCACAACAGAACT","CATTTACGTCTACTAAGAT","561307.5.peg.889","2342"
"35761",206,921,715,"TATCGACTACGCGAATAGAT","CATTTACGTCTACTAAGAT","561307.5.peg.889","2342"
"35762",335,921,586,"TACTGGCTAGTGCTTCACCA","CATTTACGTCTACTAAGAT","561307.5.peg.889","2342"
"35763",594,921,327,"ATGAGTGCTATTCGAATGTC","CATTTACGTCTACTAAGAT","561307.5.peg.889","2342"
"35764",590,921,331,"GTGCTATTCGAATGTCCGGA","CATTTACGTCTACTAAGAT","561307.5.peg.889","2342"
"35765",242,1,241,"CAAGAGCTAAAGACACCGCT","AGATTCCTACACTAGCAGTT","561307.5.peg.891","2345"
"35766",423,1,422,"GCAAAGTAATTCTTAATAGC","AGATTCCTACACTAGCAGTT","561307.5.peg.891","2345"
"35767",366,1,365,"TCTTCTGTCGCTTTCCAATG","AGATTCCTACACTAGCAGTT","561307.5.peg.891","2345"
"35768",297,1,296,"TTTGAGCAACAATATAACC","AGATTCCTACACTAGCAGTT","561307.5.peg.891","2345"
"35769",242,74,168,"CAAGAGCTAAAGACACCGCT","GGATTAAGATTGCAGTTCCT","561307.5.peg.891","2345"
"35770",423,74,349,"GCAAAGTAATTCTTAATAGC","GGATTAAGATTGCAGTTCCT","561307.5.peg.891","2345"
"35771",366,74,292,"TCTTCTGTCGCTTTCCAATG","GGATTAAGATTGCAGTTCCT","561307.5.peg.891","2345"
"35772",297,74,223,"TTTGAGCAACAATATAACC","GGATTAAGATTGCAGTTCCT","561307.5.peg.891","2345"
"35773",1,242,241,"AGATTCCTACACTAGCAGTT","CAAGAGCTAAAGACACCGCT","561307.5.peg.891","2345"
"35774",366,242,124,"TCTTCTGTCGCTTTCCAATG","CAAGAGCTAAAGACACCGCT","561307.5.peg.891","2345"
"35775",74,242,168,"GGATTAAGATTGCAGTTCCT","CAAGAGCTAAAGACACCGCT","561307.5.peg.891","2345"
"35776",423,242,181,"GCAAAGTAATTCTTAATAGC","CAAGAGCTAAAGACACCGCT","561307.5.peg.891","2345"
"35777",74,297,223,"GGATTAAGATTGCAGTTCCT","TTTGAGCAACAATATAACC","561307.5.peg.891","2345"
"35778",1,297,296,"AGATTCCTACACTAGCAGTT","TTTGAGCAACAATATAACC","561307.5.peg.891","2345"
"35779",423,297,126,"GCAAAGTAATTCTTAATAGC","TTTGAGCAACAATATAACC","561307.5.peg.891","2345"
"35780",74,366,292,"GGATTAAGATTGCAGTTCCT","TCTTCTGTCGCTTTCCAATG","561307.5.peg.891","2345"
"35781",1,366,365,"AGATTCCTACACTAGCAGTT","TCTTCTGTCGCTTTCCAATG","561307.5.peg.891","2345"
"35782",242,366,124,"CAAGAGCTAAAGACACCGCT","TCTTCTGTCGCTTTCCAATG","561307.5.peg.891","2345"
"35783",1,423,422,"AGATTCCTACACTAGCAGTT","GCAAAGTAATTCTTAATAGC","561307.5.peg.891","2345"
"35784",297,423,126,"TTTGAGCAACAATATAACC","GCAAAGTAATTCTTAATAGC","561307.5.peg.891","2345"
"35785",242,423,181,"CAAGAGCTAAAGACACCGCT","GCAAAGTAATTCTTAATAGC","561307.5.peg.891","2345"
"35786",74,423,349,"GGATTAAGATTGCAGTTCCT","GCAAAGTAATTCTTAATAGC","561307.5.peg.891","2345"
"35787",629,77,552,"CATCGTCCCATTCTAAATCA","CTCTTGAGCTTGTTGTTCCT","561307.5.peg.892","2346"
"35788",332,77,255,"AACAATTGCGTGATAAATT","CTCTTGAGCTTGTTGTTCCT","561307.5.peg.892","2346"
"35789",737,77,660,"GTACTTCTTGACCATAGAAG","CTCTTGAGCTTGTTGTTCCT","561307.5.peg.892","2346"
"35790",759,77,682,"TCACCAGCTACTCCAGCGAT","CTCTTGAGCTTGTTGTTCCT","561307.5.peg.892","2346"
"35791",329,77,252,"CAATTGCGTGATAAATTGGG","CTCTTGAGCTTGTTGTTCCT","561307.5.peg.892","2346"
"35792",290,77,213,"AAACAACCGTTGTTTCACGT","CTCTTGAGCTTGTTGTTCCT","561307.5.peg.892","2346"
"35793",329,165,164,"CAATTGCGTGATAAATTGGG","TGTTCAACCCAACCTGATTG","561307.5.peg.892","2346"
"35794",737,165,572,"GTACTTCTTGACCATAGAAG","TGTTCAACCCAACCTGATTG","561307.5.peg.892","2346"
"35795",332,165,167,"AACAATTGCGTGATAAATT","TGTTCAACCCAACCTGATTG","561307.5.peg.892","2346"
"35796",290,165,125,"AAACAACCGTTGTTTCACGT","TGTTCAACCCAACCTGATTG","561307.5.peg.892","2346"
"35797",629,165,464,"CATCGTCCCATTCTAAATCA","TGTTCAACCCAACCTGATTG","561307.5.peg.892","2346"
"35798",759,165,594,"TCACCAGCTACTCCAGCGAT","TGTTCAACCCAACCTGATTG","561307.5.peg.892","2346"
"35799",165,290,125,"TGTTCAACCCAACCTGATTG","AAACAACCGTTGTTTCACGT","561307.5.peg.892","2346"
"35800",629,290,339,"CATCGTCCCATTCTAAATCA","AAACAACCGTTGTTTCACGT","561307.5.peg.892","2346"
"35801",77,290,213,"CTCTTGAGCTTGTTGTTCCT","AAACAACCGTTGTTTCACGT","561307.5.peg.892","2346"
"35802",737,290,447,"GTACTTCTTGACCATAGAAG","AAACAACCGTTGTTTCACGT","561307.5.peg.892","2346"
"35803",759,290,469,"TCACCAGCTACTCCAGCGAT","AAACAACCGTTGTTTCACGT","561307.5.peg.892","2346"
"35804",737,329,408,"GTACTTCTTGACCATAGAAG","CAATTGCGTGATAAATTGGG","561307.5.peg.892","2346"
"35805",165,329,164,"TGTTCAACCCAACCTGATTG","CAATTGCGTGATAAATTGGG","561307.5.peg.892","2346"
"35806",759,329,430,"TCACCAGCTACTCCAGCGAT","CAATTGCGTGATAAATTGGG","561307.5.peg.892","2346"
"35807",77,329,252,"CTCTTGAGCTTGTTGTTCCT","CAATTGCGTGATAAATTGGG","561307.5.peg.892","2346"
"35808",629,329,300,"CATCGTCCCATTCTAAATCA","CAATTGCGTGATAAATTGGG","561307.5.peg.892","2346"
"35809",77,332,255,"CTCTTGAGCTTGTTGTTCCT","AACAATTGCGTGATAAATT","561307.5.peg.892","2346"
"35810",165,332,167,"TGTTCAACCCAACCTGATTG","AACAATTGCGTGATAAATT","561307.5.peg.892","2346"
"35811",759,332,427,"TCACCAGCTACTCCAGCGAT","AACAATTGCGTGATAAATT","561307.5.peg.892","2346"
"35812",737,332,405,"GTACTTCTTGACCATAGAAG","AACAATTGCGTGATAAATT","561307.5.peg.892","2346"
"35813",629,332,297,"CATCGTCCCATTCTAAATCA","AACAATTGCGTGATAAATT","561307.5.peg.892","2346"
"35814",77,629,552,"CTCTTGAGCTTGTTGTTCCT","CATCGTCCCATTCTAAATCA","561307.5.peg.892","2346"
"35815",290,629,339,"AAACAACCGTTGTTTCACGT","CATCGTCCCATTCTAAATCA","561307.5.peg.892","2346"
"35816",165,629,464,"TGTTCAACCCAACCTGATTG","CATCGTCCCATTCTAAATCA","561307.5.peg.892","2346"
"35817",329,629,300,"CAATTGCGTGATAAATTGGG","CATCGTCCCATTCTAAATCA","561307.5.peg.892","2346"
"35818",759,629,130,"TCACCAGCTACTCCAGCGAT","CATCGTCCCATTCTAAATCA","561307.5.peg.892","2346"
"35819",332,629,297,"AACAATTGCGTGATAAATT","CATCGTCCCATTCTAAATCA","561307.5.peg.892","2346"
"35820",737,629,108,"GTACTTCTTGACCATAGAAG","CATCGTCCCATTCTAAATCA","561307.5.peg.892","2346"
"35821",77,737,660,"CTCTTGAGCTTGTTGTTCCT","GTACTTCTTGACCATAGAAG","561307.5.peg.892","2346"
"35822",332,737,405,"AACAATTGCGTGATAAATT","GTACTTCTTGACCATAGAAG","561307.5.peg.892","2346"
"35823",329,737,408,"CAATTGCGTGATAAATTGGG","GTACTTCTTGACCATAGAAG","561307.5.peg.892","2346"
"35824",290,737,447,"AAACAACCGTTGTTTCACGT","GTACTTCTTGACCATAGAAG","561307.5.peg.892","2346"
"35825",629,737,108,"CATCGTCCCATTCTAAATCA","GTACTTCTTGACCATAGAAG","561307.5.peg.892","2346"
"35826",165,737,572,"TGTTCAACCCAACCTGATTG","GTACTTCTTGACCATAGAAG","561307.5.peg.892","2346"
"35827",332,759,427,"AACAATTGCGTGATAAATT","TCACCAGCTACTCCAGCGAT","561307.5.peg.892","2346"
"35828",290,759,469,"AAACAACCGTTGTTTCACGT","TCACCAGCTACTCCAGCGAT","561307.5.peg.892","2346"
"35829",165,759,594,"TGTTCAACCCAACCTGATTG","TCACCAGCTACTCCAGCGAT","561307.5.peg.892","2346"
"35830",629,759,130,"CATCGTCCCATTCTAAATCA","TCACCAGCTACTCCAGCGAT","561307.5.peg.892","2346"
"35831",77,759,682,"CTCTTGAGCTTGTTGTTCCT","TCACCAGCTACTCCAGCGAT","561307.5.peg.892","2346"
"35832",329,759,430,"CAATTGCGTGATAAATTGGG","TCACCAGCTACTCCAGCGAT","561307.5.peg.892","2346"
"35833",366,245,121,"AATGTTCCACCTTTATGCAT","TTAAGTAACGCAAACCACCA","561307.5.peg.893","2347"
"35834",744,245,499,"CTTCTAACATCATCAACCCA","TTAAGTAACGCAAACCACCA","561307.5.peg.893","2347"
"35835",744,275,469,"CTTCTAACATCATCAACCCA","TTTCGGCAACTACTCCAATT","561307.5.peg.893","2347"
"35836",744,333,411,"CTTCTAACATCATCAACCCA","CACTCTGGAGTCGTAACATG","561307.5.peg.893","2347"
"35837",245,366,121,"TTAAGTAACGCAAACCACCA","AATGTTCCACCTTTATGCAT","561307.5.peg.893","2347"
"35838",744,366,378,"CTTCTAACATCATCAACCCA","AATGTTCCACCTTTATGCAT","561307.5.peg.893","2347"
"35839",275,744,469,"TTTCGGCAACTACTCCAATT","CTTCTAACATCATCAACCCA","561307.5.peg.893","2347"
"35840",333,744,411,"CACTCTGGAGTCGTAACATG","CTTCTAACATCATCAACCCA","561307.5.peg.893","2347"
"35841",245,744,499,"TTAAGTAACGCAAACCACCA","CTTCTAACATCATCAACCCA","561307.5.peg.893","2347"
"35842",366,744,378,"AATGTTCCACCTTTATGCAT","CTTCTAACATCATCAACCCA","561307.5.peg.893","2347"
"35843",480,313,167,"AGTTGTAACACTTTAACGGT","CACTGTTTGCGCTACTTCAA","561307.5.peg.894","2348"
"35844",313,480,167,"CACTGTTTGCGCTACTTCAA","AGTTGTAACACTTTAACGGT","561307.5.peg.894","2348"
"35845",474,185,289,"TTACCATGGCCTTGCAATCT","TTTGACCCAACACTTCAAGT","561307.5.peg.898","2352"
"35846",500,185,315,"TACCGCCACCTAAACGAGAA","TTTGACCCAACACTTCAAGT","561307.5.peg.898","2352"
"35847",185,474,289,"TTTGACCCAACACTTCAAGT","TTACCATGGCCTTGCAATCT","561307.5.peg.898","2352"
"35848",185,500,315,"TTTGACCCAACACTTCAAGT","TACCGCCACCTAAACGAGAA","561307.5.peg.898","2352"
"35849",378,178,200,"CTTCAAGTAAAGTGTCATA","TGATCCTTGTAGATCACTTT","561307.5.peg.899","2353"
"35850",523,178,345,"ACGTTGAATCGCTATTACTT","TGATCCTTGTAGATCACTTT","561307.5.peg.899","2353"
"35851",567,178,389,"ATTTCATCTAGCGGAATTGA","TGATCCTTGTAGATCACTTT","561307.5.peg.899","2353"
"35852",523,378,145,"ACGTTGAATCGCTATTACTT","CTTCAAGTAAAGTGTCATA","561307.5.peg.899","2353"
"35853",178,378,200,"TGATCCTTGTAGATCACTTT","CTTCAAGTAAAGTGTCATA","561307.5.peg.899","2353"
"35854",567,378,189,"ATTTCATCTAGCGGAATTGA","CTTCAAGTAAAGTGTCATA","561307.5.peg.899","2353"
"35855",178,523,345,"TGATCCTTGTAGATCACTTT","ACGTTGAATCGCTATTACTT","561307.5.peg.899","2353"
"35856",378,523,145,"CTTCAAGTAAAGTGTCATA","ACGTTGAATCGCTATTACTT","561307.5.peg.899","2353"
"35857",378,567,189,"CTTCAAGTAAAGTGTCATA","ATTTCATCTAGCGGAATTGA","561307.5.peg.899","2353"
"35858",178,567,389,"TGATCCTTGTAGATCACTTT","ATTTCATCTAGCGGAATTGA","561307.5.peg.899","2353"
"35859",351,6,345,"ACAGGATTTAAAGCAGTCAT","TCGAGGTTTACTTATATGGG","561307.5.peg.9","2354"
"35860",510,6,504,"ATACCACCAGATAATTGATG","TCGAGGTTTACTTATATGGG","561307.5.peg.9","2354"
"35861",351,8,343,"ACAGGATTTAAAGCAGTCAT","TGTCGAGGTTTACTTATATG","561307.5.peg.9","2354"
"35862",510,8,502,"ATACCACCAGATAATTGATG","TGTCGAGGTTTACTTATATG","561307.5.peg.9","2354"
"35863",510,10,500,"ATACCACCAGATAATTGATG","TTGTCGAGGTTTACTTATA","561307.5.peg.9","2354"
"35864",351,10,341,"ACAGGATTTAAAGCAGTCAT","TTGTCGAGGTTTACTTATA","561307.5.peg.9","2354"
"35865",6,351,345,"TCGAGGTTTACTTATATGGG","ACAGGATTTAAAGCAGTCAT","561307.5.peg.9","2354"
"35866",510,351,159,"ATACCACCAGATAATTGATG","ACAGGATTTAAAGCAGTCAT","561307.5.peg.9","2354"
"35867",8,351,343,"TGTCGAGGTTTACTTATATG","ACAGGATTTAAAGCAGTCAT","561307.5.peg.9","2354"
"35868",10,351,341,"TTGTCGAGGTTTACTTATA","ACAGGATTTAAAGCAGTCAT","561307.5.peg.9","2354"
"35869",8,510,502,"TGTCGAGGTTTACTTATATG","ATACCACCAGATAATTGATG","561307.5.peg.9","2354"
"35870",6,510,504,"TCGAGGTTTACTTATATGGG","ATACCACCAGATAATTGATG","561307.5.peg.9","2354"
"35871",351,510,159,"ACAGGATTTAAAGCAGTCAT","ATACCACCAGATAATTGATG","561307.5.peg.9","2354"
"35872",10,510,500,"TTGTCGAGGTTTACTTATA","ATACCACCAGATAATTGATG","561307.5.peg.9","2354"
"35873",364,10,354,"AGGTTCTAAGTGAACATCAC","CTTGATAAACGATAAATTGG","561307.5.peg.90","2355"
"35874",10,364,354,"CTTGATAAACGATAAATTGG","AGGTTCTAAGTGAACATCAC","561307.5.peg.90","2355"
"35875",630,270,360,"AAGTCAATTTCATGTTGACC","TTACCCAAGTATCTAAATC","561307.5.peg.901","2357"
"35876",617,270,347,"GTTGACCAGGGGCAACTTCA","TTACCCAAGTATCTAAATC","561307.5.peg.901","2357"
"35877",628,270,358,"GTCAATTTCATGTTGACCAG","TTACCCAAGTATCTAAATC","561307.5.peg.901","2357"
"35878",440,270,170,"AGAATTCTGGTTCAGGTCCT","TTACCCAAGTATCTAAATC","561307.5.peg.901","2357"
"35879",440,296,144,"AGAATTCTGGTTCAGGTCCT","TACCTTGTCCAGCAGTCCAT","561307.5.peg.901","2357"
"35880",617,296,321,"GTTGACCAGGGGCAACTTCA","TACCTTGTCCAGCAGTCCAT","561307.5.peg.901","2357"
"35881",630,296,334,"AAGTCAATTTCATGTTGACC","TACCTTGTCCAGCAGTCCAT","561307.5.peg.901","2357"
"35882",628,296,332,"GTCAATTTCATGTTGACCAG","TACCTTGTCCAGCAGTCCAT","561307.5.peg.901","2357"
"35883",630,363,267,"AAGTCAATTTCATGTTGACC","GCACGAGGATCCCCTTCAAA","561307.5.peg.901","2357"
"35884",617,363,254,"GTTGACCAGGGGCAACTTCA","GCACGAGGATCCCCTTCAAA","561307.5.peg.901","2357"
"35885",628,363,265,"GTCAATTTCATGTTGACCAG","GCACGAGGATCCCCTTCAAA","561307.5.peg.901","2357"
"35886",270,440,170,"TTACCCAAGTATCTAAATC","AGAATTCTGGTTCAGGTCCT","561307.5.peg.901","2357"
"35887",296,440,144,"TACCTTGTCCAGCAGTCCAT","AGAATTCTGGTTCAGGTCCT","561307.5.peg.901","2357"
"35888",617,440,177,"GTTGACCAGGGGCAACTTCA","AGAATTCTGGTTCAGGTCCT","561307.5.peg.901","2357"
"35889",628,440,188,"GTCAATTTCATGTTGACCAG","AGAATTCTGGTTCAGGTCCT","561307.5.peg.901","2357"
"35890",630,440,190,"AAGTCAATTTCATGTTGACC","AGAATTCTGGTTCAGGTCCT","561307.5.peg.901","2357"
"35891",270,617,347,"TTACCCAAGTATCTAAATC","GTTGACCAGGGGCAACTTCA","561307.5.peg.901","2357"
"35892",296,617,321,"TACCTTGTCCAGCAGTCCAT","GTTGACCAGGGGCAACTTCA","561307.5.peg.901","2357"
"35893",363,617,254,"GCACGAGGATCCCCTTCAAA","GTTGACCAGGGGCAACTTCA","561307.5.peg.901","2357"
"35894",440,617,177,"AGAATTCTGGTTCAGGTCCT","GTTGACCAGGGGCAACTTCA","561307.5.peg.901","2357"
"35895",270,628,358,"TTACCCAAGTATCTAAATC","GTCAATTTCATGTTGACCAG","561307.5.peg.901","2357"
"35896",440,628,188,"AGAATTCTGGTTCAGGTCCT","GTCAATTTCATGTTGACCAG","561307.5.peg.901","2357"
"35897",296,628,332,"TACCTTGTCCAGCAGTCCAT","GTCAATTTCATGTTGACCAG","561307.5.peg.901","2357"
"35898",363,628,265,"GCACGAGGATCCCCTTCAAA","GTCAATTTCATGTTGACCAG","561307.5.peg.901","2357"
"35899",296,630,334,"TACCTTGTCCAGCAGTCCAT","AAGTCAATTTCATGTTGACC","561307.5.peg.901","2357"
"35900",270,630,360,"TTACCCAAGTATCTAAATC","AAGTCAATTTCATGTTGACC","561307.5.peg.901","2357"
"35901",440,630,190,"AGAATTCTGGTTCAGGTCCT","AAGTCAATTTCATGTTGACC","561307.5.peg.901","2357"
"35902",363,630,267,"GCACGAGGATCCCCTTCAAA","AAGTCAATTTCATGTTGACC","561307.5.peg.901","2357"
"35903",357,96,261,"AAGGCTGGTAACGCACCTGT","ACTTCTGGCCACTGAATATT","561307.5.peg.91","2366"
"35904",372,96,276,"GCTGCGCCAATGATCAAGGC","ACTTCTGGCCACTGAATATT","561307.5.peg.91","2366"
"35905",96,357,261,"ACTTCTGGCCACTGAATATT","AAGGCTGGTAACGCACCTGT","561307.5.peg.91","2366"
"35906",96,372,276,"ACTTCTGGCCACTGAATATT","GCTGCGCCAATGATCAAGGC","561307.5.peg.91","2366"
"35907",366,104,262,"GGGACACCTGCAATTTCAAG","AATTAACGTGATCTACAGCA","561307.5.peg.92","2377"
"35908",386,104,282,"TTTGCTTAGCTCTCCTTCTA","AATTAACGTGATCTACAGCA","561307.5.peg.92","2377"
"35909",462,104,358,"TGTCCACCTGATAACTCTGA","AATTAACGTGATCTACAGCA","561307.5.peg.92","2377"
"35910",525,104,421,"TCATCACAAAGCAAGACCGT","AATTAACGTGATCTACAGCA","561307.5.peg.92","2377"
"35911",104,366,262,"AATTAACGTGATCTACAGCA","GGGACACCTGCAATTTCAAG","561307.5.peg.92","2377"
"35912",525,366,159,"TCATCACAAAGCAAGACCGT","GGGACACCTGCAATTTCAAG","561307.5.peg.92","2377"
"35913",104,386,282,"AATTAACGTGATCTACAGCA","TTTGCTTAGCTCTCCTTCTA","561307.5.peg.92","2377"
"35914",525,386,139,"TCATCACAAAGCAAGACCGT","TTTGCTTAGCTCTCCTTCTA","561307.5.peg.92","2377"
"35915",104,462,358,"AATTAACGTGATCTACAGCA","TGTCCACCTGATAACTCTGA","561307.5.peg.92","2377"
"35916",104,525,421,"AATTAACGTGATCTACAGCA","TCATCACAAAGCAAGACCGT","561307.5.peg.92","2377"
"35917",386,525,139,"TTTGCTTAGCTCTCCTTCTA","TCATCACAAAGCAAGACCGT","561307.5.peg.92","2377"
"35918",366,525,159,"GGGACACCTGCAATTTCAAG","TCATCACAAAGCAAGACCGT","561307.5.peg.92","2377"
"35919",222,7,215,"ACTTCAAGTCCAGTCATGCC","ATCATTGAAATCTCAACAGG","561307.5.peg.922","2380"
"35920",7,222,215,"ATCATTGAAATCTCAACAGG","ACTTCAAGTCCAGTCATGCC","561307.5.peg.922","2380"
"35921",177,6,171,"CGCATATTTCAACAATAGA","TGTGAAAGCGCTTGCTTAGG","561307.5.peg.926","2384"
"35922",237,6,231,"TATAGTAACGCATATGATTG","TGTGAAAGCGCTTGCTTAGG","561307.5.peg.926","2384"
"35923",177,9,168,"CGCATATTTCAACAATAGA","ATTTGTGAAAGCGCTTGCTT","561307.5.peg.926","2384"
"35924",237,9,228,"TATAGTAACGCATATGATTG","ATTTGTGAAAGCGCTTGCTT","561307.5.peg.926","2384"
"35925",6,177,171,"TGTGAAAGCGCTTGCTTAGG","CGCATATTTCAACAATAGA","561307.5.peg.926","2384"
"35926",9,177,168,"ATTTGTGAAAGCGCTTGCTT","CGCATATTTCAACAATAGA","561307.5.peg.926","2384"
"35927",6,237,231,"TGTGAAAGCGCTTGCTTAGG","TATAGTAACGCATATGATTG","561307.5.peg.926","2384"
"35928",9,237,228,"ATTTGTGAAAGCGCTTGCTT","TATAGTAACGCATATGATTG","561307.5.peg.926","2384"
"35929",372,79,293,"ATGCATCTAATAGTCTCTT","AATTTGAGTAGCATTGGAGA","561307.5.peg.927","2385"
"35930",633,79,554,"GTTATATCTGATCCGCCACG","AATTTGAGTAGCATTGGAGA","561307.5.peg.927","2385"
"35931",706,79,627,"TTATAAATACCAGACACAT","AATTTGAGTAGCATTGGAGA","561307.5.peg.927","2385"
"35932",661,79,582,"TCTAACACCACTTGATATGA","AATTTGAGTAGCATTGGAGA","561307.5.peg.927","2385"
"35933",661,132,529,"TCTAACACCACTTGATATGA","ACGATAACAATCTTTCGCTC","561307.5.peg.927","2385"
"35934",633,132,501,"GTTATATCTGATCCGCCACG","ACGATAACAATCTTTCGCTC","561307.5.peg.927","2385"
"35935",372,132,240,"ATGCATCTAATAGTCTCTT","ACGATAACAATCTTTCGCTC","561307.5.peg.927","2385"
"35936",706,132,574,"TTATAAATACCAGACACAT","ACGATAACAATCTTTCGCTC","561307.5.peg.927","2385"
"35937",79,372,293,"AATTTGAGTAGCATTGGAGA","ATGCATCTAATAGTCTCTT","561307.5.peg.927","2385"
"35938",633,372,261,"GTTATATCTGATCCGCCACG","ATGCATCTAATAGTCTCTT","561307.5.peg.927","2385"
"35939",706,372,334,"TTATAAATACCAGACACAT","ATGCATCTAATAGTCTCTT","561307.5.peg.927","2385"
"35940",132,372,240,"ACGATAACAATCTTTCGCTC","ATGCATCTAATAGTCTCTT","561307.5.peg.927","2385"
"35941",661,372,289,"TCTAACACCACTTGATATGA","ATGCATCTAATAGTCTCTT","561307.5.peg.927","2385"
"35942",79,633,554,"AATTTGAGTAGCATTGGAGA","GTTATATCTGATCCGCCACG","561307.5.peg.927","2385"
"35943",132,633,501,"ACGATAACAATCTTTCGCTC","GTTATATCTGATCCGCCACG","561307.5.peg.927","2385"
"35944",372,633,261,"ATGCATCTAATAGTCTCTT","GTTATATCTGATCCGCCACG","561307.5.peg.927","2385"
"35945",79,661,582,"AATTTGAGTAGCATTGGAGA","TCTAACACCACTTGATATGA","561307.5.peg.927","2385"
"35946",372,661,289,"ATGCATCTAATAGTCTCTT","TCTAACACCACTTGATATGA","561307.5.peg.927","2385"
"35947",132,661,529,"ACGATAACAATCTTTCGCTC","TCTAACACCACTTGATATGA","561307.5.peg.927","2385"
"35948",372,706,334,"ATGCATCTAATAGTCTCTT","TTATAAATACCAGACACAT","561307.5.peg.927","2385"
"35949",132,706,574,"ACGATAACAATCTTTCGCTC","TTATAAATACCAGACACAT","561307.5.peg.927","2385"
"35950",79,706,627,"AATTTGAGTAGCATTGGAGA","TTATAAATACCAGACACAT","561307.5.peg.927","2385"
"35951",303,125,178,"GTTCTTAACCAATCTACAGT","ATGTATCTTGAATTTGCTGT","561307.5.peg.928","2386"
"35952",459,125,334,"TATTTATGGCATTTACGAT","ATGTATCTTGAATTTGCTGT","561307.5.peg.928","2386"
"35953",459,204,255,"TATTTATGGCATTTACGAT","GATATTGGCTAATATTTAG","561307.5.peg.928","2386"
"35954",125,303,178,"ATGTATCTTGAATTTGCTGT","GTTCTTAACCAATCTACAGT","561307.5.peg.928","2386"
"35955",459,303,156,"TATTTATGGCATTTACGAT","GTTCTTAACCAATCTACAGT","561307.5.peg.928","2386"
"35956",125,459,334,"ATGTATCTTGAATTTGCTGT","TATTTATGGCATTTACGAT","561307.5.peg.928","2386"
"35957",204,459,255,"GATATTGGCTAATATTTAG","TATTTATGGCATTTACGAT","561307.5.peg.928","2386"
"35958",303,459,156,"GTTCTTAACCAATCTACAGT","TATTTATGGCATTTACGAT","561307.5.peg.928","2386"
"35959",216,13,203,"CGATCTTTAAATGAACCTGT","GACAAAGTATACCCAGTAGA","561307.5.peg.929","2387"
"35960",216,27,189,"CGATCTTTAAATGAACCTGT","TAATTAAACTCCTTCTACT","561307.5.peg.929","2387"
"35961",13,216,203,"GACAAAGTATACCCAGTAGA","CGATCTTTAAATGAACCTGT","561307.5.peg.929","2387"
"35962",27,216,189,"TAATTAAACTCCTTCTACT","CGATCTTTAAATGAACCTGT","561307.5.peg.929","2387"
"35963",216,78,138,"TAAAGTTTGTTTCGTCAGT","CCAAGGTTGGCTGTTGATGC","561307.5.peg.930","2389"
"35964",447,78,369,"ATGGTCGGCGCAACATTATC","CCAAGGTTGGCTGTTGATGC","561307.5.peg.930","2389"
"35965",395,78,317,"ATACCTCATGTTTAGACAGT","CCAAGGTTGGCTGTTGATGC","561307.5.peg.930","2389"
"35966",191,78,113,"ATTGCTTAGATGCATCATCA","CCAAGGTTGGCTGTTGATGC","561307.5.peg.930","2389"
"35967",462,78,384,"ATTAAACCACCATAAATGGT","CCAAGGTTGGCTGTTGATGC","561307.5.peg.930","2389"
"35968",216,91,125,"TAAAGTTTGTTTCGTCAGT","ATCAAAGCCAACTCCAAGGT","561307.5.peg.930","2389"
"35969",191,91,100,"ATTGCTTAGATGCATCATCA","ATCAAAGCCAACTCCAAGGT","561307.5.peg.930","2389"
"35970",395,91,304,"ATACCTCATGTTTAGACAGT","ATCAAAGCCAACTCCAAGGT","561307.5.peg.930","2389"
"35971",462,91,371,"ATTAAACCACCATAAATGGT","ATCAAAGCCAACTCCAAGGT","561307.5.peg.930","2389"
"35972",447,91,356,"ATGGTCGGCGCAACATTATC","ATCAAAGCCAACTCCAAGGT","561307.5.peg.930","2389"
"35973",447,95,352,"ATGGTCGGCGCAACATTATC","TAGAATCAAAGCCAACTCCA","561307.5.peg.930","2389"
"35974",216,95,121,"TAAAGTTTGTTTCGTCAGT","TAGAATCAAAGCCAACTCCA","561307.5.peg.930","2389"
"35975",462,95,367,"ATTAAACCACCATAAATGGT","TAGAATCAAAGCCAACTCCA","561307.5.peg.930","2389"
"35976",395,95,300,"ATACCTCATGTTTAGACAGT","TAGAATCAAAGCCAACTCCA","561307.5.peg.930","2389"
"35977",447,191,256,"ATGGTCGGCGCAACATTATC","ATTGCTTAGATGCATCATCA","561307.5.peg.930","2389"
"35978",78,191,113,"CCAAGGTTGGCTGTTGATGC","ATTGCTTAGATGCATCATCA","561307.5.peg.930","2389"
"35979",91,191,100,"ATCAAAGCCAACTCCAAGGT","ATTGCTTAGATGCATCATCA","561307.5.peg.930","2389"
"35980",462,191,271,"ATTAAACCACCATAAATGGT","ATTGCTTAGATGCATCATCA","561307.5.peg.930","2389"
"35981",395,191,204,"ATACCTCATGTTTAGACAGT","ATTGCTTAGATGCATCATCA","561307.5.peg.930","2389"
"35982",78,216,138,"CCAAGGTTGGCTGTTGATGC","TAAAGTTTGTTTCGTCAGT","561307.5.peg.930","2389"
"35983",395,216,179,"ATACCTCATGTTTAGACAGT","TAAAGTTTGTTTCGTCAGT","561307.5.peg.930","2389"
"35984",91,216,125,"ATCAAAGCCAACTCCAAGGT","TAAAGTTTGTTTCGTCAGT","561307.5.peg.930","2389"
"35985",447,216,231,"ATGGTCGGCGCAACATTATC","TAAAGTTTGTTTCGTCAGT","561307.5.peg.930","2389"
"35986",95,216,121,"TAGAATCAAAGCCAACTCCA","TAAAGTTTGTTTCGTCAGT","561307.5.peg.930","2389"
"35987",462,216,246,"ATTAAACCACCATAAATGGT","TAAAGTTTGTTTCGTCAGT","561307.5.peg.930","2389"
"35988",191,395,204,"ATTGCTTAGATGCATCATCA","ATACCTCATGTTTAGACAGT","561307.5.peg.930","2389"
"35989",78,395,317,"CCAAGGTTGGCTGTTGATGC","ATACCTCATGTTTAGACAGT","561307.5.peg.930","2389"
"35990",216,395,179,"TAAAGTTTGTTTCGTCAGT","ATACCTCATGTTTAGACAGT","561307.5.peg.930","2389"
"35991",95,395,300,"TAGAATCAAAGCCAACTCCA","ATACCTCATGTTTAGACAGT","561307.5.peg.930","2389"
"35992",91,395,304,"ATCAAAGCCAACTCCAAGGT","ATACCTCATGTTTAGACAGT","561307.5.peg.930","2389"
"35993",191,447,256,"ATTGCTTAGATGCATCATCA","ATGGTCGGCGCAACATTATC","561307.5.peg.930","2389"
"35994",78,447,369,"CCAAGGTTGGCTGTTGATGC","ATGGTCGGCGCAACATTATC","561307.5.peg.930","2389"
"35995",91,447,356,"ATCAAAGCCAACTCCAAGGT","ATGGTCGGCGCAACATTATC","561307.5.peg.930","2389"
"35996",216,447,231,"TAAAGTTTGTTTCGTCAGT","ATGGTCGGCGCAACATTATC","561307.5.peg.930","2389"
"35997",95,447,352,"TAGAATCAAAGCCAACTCCA","ATGGTCGGCGCAACATTATC","561307.5.peg.930","2389"
"35998",91,462,371,"ATCAAAGCCAACTCCAAGGT","ATTAAACCACCATAAATGGT","561307.5.peg.930","2389"
"35999",95,462,367,"TAGAATCAAAGCCAACTCCA","ATTAAACCACCATAAATGGT","561307.5.peg.930","2389"
"36000",191,462,271,"ATTGCTTAGATGCATCATCA","ATTAAACCACCATAAATGGT","561307.5.peg.930","2389"
"36001",78,462,384,"CCAAGGTTGGCTGTTGATGC","ATTAAACCACCATAAATGGT","561307.5.peg.930","2389"
"36002",216,462,246,"TAAAGTTTGTTTCGTCAGT","ATTAAACCACCATAAATGGT","561307.5.peg.930","2389"
"36003",424,71,353,"AAGATTAAGCTCCAAGTAA","TGTGTCTTGAGTTAAGACTA","561307.5.peg.933","2392"
"36004",422,71,351,"AGATTAAGCTCCAAGTAATG","TGTGTCTTGAGTTAAGACTA","561307.5.peg.933","2392"
"36005",620,71,549,"TACCACCAACAAACGGTGCT","TGTGTCTTGAGTTAAGACTA","561307.5.peg.933","2392"
"36006",319,71,248,"TGCCCAATACAACCATCCCA","TGTGTCTTGAGTTAAGACTA","561307.5.peg.933","2392"
"36007",171,71,100,"TAAGCGAGTATAGCGCCTCC","TGTGTCTTGAGTTAAGACTA","561307.5.peg.933","2392"
"36008",419,71,348,"TTAAGCTCCAAGTAATGGGG","TGTGTCTTGAGTTAAGACTA","561307.5.peg.933","2392"
"36009",627,71,556,"CCAGAGATACCACCAACAAA","TGTGTCTTGAGTTAAGACTA","561307.5.peg.933","2392"
"36010",419,97,322,"TTAAGCTCCAAGTAATGGGG","TGCACCACCTATAGCAATCA","561307.5.peg.933","2392"
"36011",319,97,222,"TGCCCAATACAACCATCCCA","TGCACCACCTATAGCAATCA","561307.5.peg.933","2392"
"36012",620,97,523,"TACCACCAACAAACGGTGCT","TGCACCACCTATAGCAATCA","561307.5.peg.933","2392"
"36013",422,97,325,"AGATTAAGCTCCAAGTAATG","TGCACCACCTATAGCAATCA","561307.5.peg.933","2392"
"36014",424,97,327,"AAGATTAAGCTCCAAGTAA","TGCACCACCTATAGCAATCA","561307.5.peg.933","2392"
"36015",627,97,530,"CCAGAGATACCACCAACAAA","TGCACCACCTATAGCAATCA","561307.5.peg.933","2392"
"36016",620,171,449,"TACCACCAACAAACGGTGCT","TAAGCGAGTATAGCGCCTCC","561307.5.peg.933","2392"
"36017",71,171,100,"TGTGTCTTGAGTTAAGACTA","TAAGCGAGTATAGCGCCTCC","561307.5.peg.933","2392"
"36018",319,171,148,"TGCCCAATACAACCATCCCA","TAAGCGAGTATAGCGCCTCC","561307.5.peg.933","2392"
"36019",424,171,253,"AAGATTAAGCTCCAAGTAA","TAAGCGAGTATAGCGCCTCC","561307.5.peg.933","2392"
"36020",422,171,251,"AGATTAAGCTCCAAGTAATG","TAAGCGAGTATAGCGCCTCC","561307.5.peg.933","2392"
"36021",419,171,248,"TTAAGCTCCAAGTAATGGGG","TAAGCGAGTATAGCGCCTCC","561307.5.peg.933","2392"
"36022",627,171,456,"CCAGAGATACCACCAACAAA","TAAGCGAGTATAGCGCCTCC","561307.5.peg.933","2392"
"36023",71,319,248,"TGTGTCTTGAGTTAAGACTA","TGCCCAATACAACCATCCCA","561307.5.peg.933","2392"
"36024",419,319,100,"TTAAGCTCCAAGTAATGGGG","TGCCCAATACAACCATCCCA","561307.5.peg.933","2392"
"36025",620,319,301,"TACCACCAACAAACGGTGCT","TGCCCAATACAACCATCCCA","561307.5.peg.933","2392"
"36026",171,319,148,"TAAGCGAGTATAGCGCCTCC","TGCCCAATACAACCATCCCA","561307.5.peg.933","2392"
"36027",627,319,308,"CCAGAGATACCACCAACAAA","TGCCCAATACAACCATCCCA","561307.5.peg.933","2392"
"36028",97,319,222,"TGCACCACCTATAGCAATCA","TGCCCAATACAACCATCCCA","561307.5.peg.933","2392"
"36029",424,319,105,"AAGATTAAGCTCCAAGTAA","TGCCCAATACAACCATCCCA","561307.5.peg.933","2392"
"36030",422,319,103,"AGATTAAGCTCCAAGTAATG","TGCCCAATACAACCATCCCA","561307.5.peg.933","2392"
"36031",71,419,348,"TGTGTCTTGAGTTAAGACTA","TTAAGCTCCAAGTAATGGGG","561307.5.peg.933","2392"
"36032",319,419,100,"TGCCCAATACAACCATCCCA","TTAAGCTCCAAGTAATGGGG","561307.5.peg.933","2392"
"36033",627,419,208,"CCAGAGATACCACCAACAAA","TTAAGCTCCAAGTAATGGGG","561307.5.peg.933","2392"
"36034",171,419,248,"TAAGCGAGTATAGCGCCTCC","TTAAGCTCCAAGTAATGGGG","561307.5.peg.933","2392"
"36035",620,419,201,"TACCACCAACAAACGGTGCT","TTAAGCTCCAAGTAATGGGG","561307.5.peg.933","2392"
"36036",97,419,322,"TGCACCACCTATAGCAATCA","TTAAGCTCCAAGTAATGGGG","561307.5.peg.933","2392"
"36037",71,422,351,"TGTGTCTTGAGTTAAGACTA","AGATTAAGCTCCAAGTAATG","561307.5.peg.933","2392"
"36038",627,422,205,"CCAGAGATACCACCAACAAA","AGATTAAGCTCCAAGTAATG","561307.5.peg.933","2392"
"36039",97,422,325,"TGCACCACCTATAGCAATCA","AGATTAAGCTCCAAGTAATG","561307.5.peg.933","2392"
"36040",171,422,251,"TAAGCGAGTATAGCGCCTCC","AGATTAAGCTCCAAGTAATG","561307.5.peg.933","2392"
"36041",319,422,103,"TGCCCAATACAACCATCCCA","AGATTAAGCTCCAAGTAATG","561307.5.peg.933","2392"
"36042",620,422,198,"TACCACCAACAAACGGTGCT","AGATTAAGCTCCAAGTAATG","561307.5.peg.933","2392"
"36043",627,424,203,"CCAGAGATACCACCAACAAA","AAGATTAAGCTCCAAGTAA","561307.5.peg.933","2392"
"36044",71,424,353,"TGTGTCTTGAGTTAAGACTA","AAGATTAAGCTCCAAGTAA","561307.5.peg.933","2392"
"36045",97,424,327,"TGCACCACCTATAGCAATCA","AAGATTAAGCTCCAAGTAA","561307.5.peg.933","2392"
"36046",319,424,105,"TGCCCAATACAACCATCCCA","AAGATTAAGCTCCAAGTAA","561307.5.peg.933","2392"
"36047",620,424,196,"TACCACCAACAAACGGTGCT","AAGATTAAGCTCCAAGTAA","561307.5.peg.933","2392"
"36048",171,424,253,"TAAGCGAGTATAGCGCCTCC","AAGATTAAGCTCCAAGTAA","561307.5.peg.933","2392"
"36049",171,620,449,"TAAGCGAGTATAGCGCCTCC","TACCACCAACAAACGGTGCT","561307.5.peg.933","2392"
"36050",97,620,523,"TGCACCACCTATAGCAATCA","TACCACCAACAAACGGTGCT","561307.5.peg.933","2392"
"36051",319,620,301,"TGCCCAATACAACCATCCCA","TACCACCAACAAACGGTGCT","561307.5.peg.933","2392"
"36052",422,620,198,"AGATTAAGCTCCAAGTAATG","TACCACCAACAAACGGTGCT","561307.5.peg.933","2392"
"36053",419,620,201,"TTAAGCTCCAAGTAATGGGG","TACCACCAACAAACGGTGCT","561307.5.peg.933","2392"
"36054",71,620,549,"TGTGTCTTGAGTTAAGACTA","TACCACCAACAAACGGTGCT","561307.5.peg.933","2392"
"36055",424,620,196,"AAGATTAAGCTCCAAGTAA","TACCACCAACAAACGGTGCT","561307.5.peg.933","2392"
"36056",319,627,308,"TGCCCAATACAACCATCCCA","CCAGAGATACCACCAACAAA","561307.5.peg.933","2392"
"36057",71,627,556,"TGTGTCTTGAGTTAAGACTA","CCAGAGATACCACCAACAAA","561307.5.peg.933","2392"
"36058",97,627,530,"TGCACCACCTATAGCAATCA","CCAGAGATACCACCAACAAA","561307.5.peg.933","2392"
"36059",422,627,205,"AGATTAAGCTCCAAGTAATG","CCAGAGATACCACCAACAAA","561307.5.peg.933","2392"
"36060",419,627,208,"TTAAGCTCCAAGTAATGGGG","CCAGAGATACCACCAACAAA","561307.5.peg.933","2392"
"36061",424,627,203,"AAGATTAAGCTCCAAGTAA","CCAGAGATACCACCAACAAA","561307.5.peg.933","2392"
"36062",171,627,456,"TAAGCGAGTATAGCGCCTCC","CCAGAGATACCACCAACAAA","561307.5.peg.933","2392"
"36063",575,201,374,"CTGACATTAAGATCGTTACT","TTGGCATGCATTCGACGTTC","561307.5.peg.934","2393"
"36064",444,201,243,"GGATCTCTAAAGAAGAATAC","TTGGCATGCATTCGACGTTC","561307.5.peg.934","2393"
"36065",325,201,124,"TCCTGCTACAGTAGAGAAAC","TTGGCATGCATTCGACGTTC","561307.5.peg.934","2393"
"36066",507,201,306,"GCATCTCTCATATTTGTTCT","TTGGCATGCATTCGACGTTC","561307.5.peg.934","2393"
"36067",444,220,224,"GGATCTCTAAAGAAGAATAC","CCCAAATGCACCAGAACCTT","561307.5.peg.934","2393"
"36068",325,220,105,"TCCTGCTACAGTAGAGAAAC","CCCAAATGCACCAGAACCTT","561307.5.peg.934","2393"
"36069",507,220,287,"GCATCTCTCATATTTGTTCT","CCCAAATGCACCAGAACCTT","561307.5.peg.934","2393"
"36070",575,220,355,"CTGACATTAAGATCGTTACT","CCCAAATGCACCAGAACCTT","561307.5.peg.934","2393"
"36071",201,325,124,"TTGGCATGCATTCGACGTTC","TCCTGCTACAGTAGAGAAAC","561307.5.peg.934","2393"
"36072",444,325,119,"GGATCTCTAAAGAAGAATAC","TCCTGCTACAGTAGAGAAAC","561307.5.peg.934","2393"
"36073",220,325,105,"CCCAAATGCACCAGAACCTT","TCCTGCTACAGTAGAGAAAC","561307.5.peg.934","2393"
"36074",507,325,182,"GCATCTCTCATATTTGTTCT","TCCTGCTACAGTAGAGAAAC","561307.5.peg.934","2393"
"36075",575,325,250,"CTGACATTAAGATCGTTACT","TCCTGCTACAGTAGAGAAAC","561307.5.peg.934","2393"
"36076",201,444,243,"TTGGCATGCATTCGACGTTC","GGATCTCTAAAGAAGAATAC","561307.5.peg.934","2393"
"36077",220,444,224,"CCCAAATGCACCAGAACCTT","GGATCTCTAAAGAAGAATAC","561307.5.peg.934","2393"
"36078",325,444,119,"TCCTGCTACAGTAGAGAAAC","GGATCTCTAAAGAAGAATAC","561307.5.peg.934","2393"
"36079",575,444,131,"CTGACATTAAGATCGTTACT","GGATCTCTAAAGAAGAATAC","561307.5.peg.934","2393"
"36080",220,507,287,"CCCAAATGCACCAGAACCTT","GCATCTCTCATATTTGTTCT","561307.5.peg.934","2393"
"36081",325,507,182,"TCCTGCTACAGTAGAGAAAC","GCATCTCTCATATTTGTTCT","561307.5.peg.934","2393"
"36082",201,507,306,"TTGGCATGCATTCGACGTTC","GCATCTCTCATATTTGTTCT","561307.5.peg.934","2393"
"36083",220,575,355,"CCCAAATGCACCAGAACCTT","CTGACATTAAGATCGTTACT","561307.5.peg.934","2393"
"36084",325,575,250,"TCCTGCTACAGTAGAGAAAC","CTGACATTAAGATCGTTACT","561307.5.peg.934","2393"
"36085",201,575,374,"TTGGCATGCATTCGACGTTC","CTGACATTAAGATCGTTACT","561307.5.peg.934","2393"
"36086",444,575,131,"GGATCTCTAAAGAAGAATAC","CTGACATTAAGATCGTTACT","561307.5.peg.934","2393"
"36087",369,33,336,"TCTAATTCTCTAACACCTTC","TGCATATTTGCAGGAACTAC","561307.5.peg.937","2396"
"36088",429,33,396,"TTGTAATACAAACTCTACC","TGCATATTTGCAGGAACTAC","561307.5.peg.937","2396"
"36089",369,42,327,"TCTAATTCTCTAACACCTTC","TAACTGTTTGCATATTTGC","561307.5.peg.937","2396"
"36090",429,42,387,"TTGTAATACAAACTCTACC","TAACTGTTTGCATATTTGC","561307.5.peg.937","2396"
"36091",33,369,336,"TGCATATTTGCAGGAACTAC","TCTAATTCTCTAACACCTTC","561307.5.peg.937","2396"
"36092",42,369,327,"TAACTGTTTGCATATTTGC","TCTAATTCTCTAACACCTTC","561307.5.peg.937","2396"
"36093",33,429,396,"TGCATATTTGCAGGAACTAC","TTGTAATACAAACTCTACC","561307.5.peg.937","2396"
"36094",42,429,387,"TAACTGTTTGCATATTTGC","TTGTAATACAAACTCTACC","561307.5.peg.937","2396"
"36095",228,123,105,"TCTATAGCACGTGGTTTCGT","CCAATTTCGCGAACACTAGG","561307.5.peg.939","2398"
"36096",237,123,114,"CTTACAATTTCTATAGCACG","CCAATTTCGCGAACACTAGG","561307.5.peg.939","2398"
"36097",228,126,102,"TCTATAGCACGTGGTTTCGT","TCACCAATTTCGCGAACACT","561307.5.peg.939","2398"
"36098",237,126,111,"CTTACAATTTCTATAGCACG","TCACCAATTTCGCGAACACT","561307.5.peg.939","2398"
"36099",123,228,105,"CCAATTTCGCGAACACTAGG","TCTATAGCACGTGGTTTCGT","561307.5.peg.939","2398"
"36100",126,228,102,"TCACCAATTTCGCGAACACT","TCTATAGCACGTGGTTTCGT","561307.5.peg.939","2398"
"36101",123,237,114,"CCAATTTCGCGAACACTAGG","CTTACAATTTCTATAGCACG","561307.5.peg.939","2398"
"36102",126,237,111,"TCACCAATTTCGCGAACACT","CTTACAATTTCTATAGCACG","561307.5.peg.939","2398"
"36103",345,135,210,"TGTCTGTATTCAGGATGACC","GCAGCTCCCATAGGTAATCC","561307.5.peg.942","2402"
"36104",840,135,705,"TTCTTTCAACTTCACCTAA","GCAGCTCCCATAGGTAATCC","561307.5.peg.942","2402"
"36105",354,135,219,"CCATCTGTATGTCTGTATTC","GCAGCTCCCATAGGTAATCC","561307.5.peg.942","2402"
"36106",804,135,669,"CCATTAGTTCCTGCTTTATT","GCAGCTCCCATAGGTAATCC","561307.5.peg.942","2402"
"36107",804,144,660,"CCATTAGTTCCTGCTTTATT","GCCATTGGGGCAGCTCCCAT","561307.5.peg.942","2402"
"36108",354,144,210,"CCATCTGTATGTCTGTATTC","GCCATTGGGGCAGCTCCCAT","561307.5.peg.942","2402"
"36109",345,144,201,"TGTCTGTATTCAGGATGACC","GCCATTGGGGCAGCTCCCAT","561307.5.peg.942","2402"
"36110",840,144,696,"TTCTTTCAACTTCACCTAA","GCCATTGGGGCAGCTCCCAT","561307.5.peg.942","2402"
"36111",804,159,645,"CCATTAGTTCCTGCTTTATT","GTCCACAAAGTGTAAGCCAT","561307.5.peg.942","2402"
"36112",840,159,681,"TTCTTTCAACTTCACCTAA","GTCCACAAAGTGTAAGCCAT","561307.5.peg.942","2402"
"36113",354,159,195,"CCATCTGTATGTCTGTATTC","GTCCACAAAGTGTAAGCCAT","561307.5.peg.942","2402"
"36114",345,159,186,"TGTCTGTATTCAGGATGACC","GTCCACAAAGTGTAAGCCAT","561307.5.peg.942","2402"
"36115",804,230,574,"CCATTAGTTCCTGCTTTATT","GCCCTGCAGATAATACGAAA","561307.5.peg.942","2402"
"36116",840,230,610,"TTCTTTCAACTTCACCTAA","GCCCTGCAGATAATACGAAA","561307.5.peg.942","2402"
"36117",345,230,115,"TGTCTGTATTCAGGATGACC","GCCCTGCAGATAATACGAAA","561307.5.peg.942","2402"
"36118",354,230,124,"CCATCTGTATGTCTGTATTC","GCCCTGCAGATAATACGAAA","561307.5.peg.942","2402"
"36119",135,345,210,"GCAGCTCCCATAGGTAATCC","TGTCTGTATTCAGGATGACC","561307.5.peg.942","2402"
"36120",159,345,186,"GTCCACAAAGTGTAAGCCAT","TGTCTGTATTCAGGATGACC","561307.5.peg.942","2402"
"36121",804,345,459,"CCATTAGTTCCTGCTTTATT","TGTCTGTATTCAGGATGACC","561307.5.peg.942","2402"
"36122",144,345,201,"GCCATTGGGGCAGCTCCCAT","TGTCTGTATTCAGGATGACC","561307.5.peg.942","2402"
"36123",840,345,495,"TTCTTTCAACTTCACCTAA","TGTCTGTATTCAGGATGACC","561307.5.peg.942","2402"
"36124",230,345,115,"GCCCTGCAGATAATACGAAA","TGTCTGTATTCAGGATGACC","561307.5.peg.942","2402"
"36125",135,354,219,"GCAGCTCCCATAGGTAATCC","CCATCTGTATGTCTGTATTC","561307.5.peg.942","2402"
"36126",144,354,210,"GCCATTGGGGCAGCTCCCAT","CCATCTGTATGTCTGTATTC","561307.5.peg.942","2402"
"36127",230,354,124,"GCCCTGCAGATAATACGAAA","CCATCTGTATGTCTGTATTC","561307.5.peg.942","2402"
"36128",159,354,195,"GTCCACAAAGTGTAAGCCAT","CCATCTGTATGTCTGTATTC","561307.5.peg.942","2402"
"36129",840,354,486,"TTCTTTCAACTTCACCTAA","CCATCTGTATGTCTGTATTC","561307.5.peg.942","2402"
"36130",804,354,450,"CCATTAGTTCCTGCTTTATT","CCATCTGTATGTCTGTATTC","561307.5.peg.942","2402"
"36131",159,804,645,"GTCCACAAAGTGTAAGCCAT","CCATTAGTTCCTGCTTTATT","561307.5.peg.942","2402"
"36132",230,804,574,"GCCCTGCAGATAATACGAAA","CCATTAGTTCCTGCTTTATT","561307.5.peg.942","2402"
"36133",144,804,660,"GCCATTGGGGCAGCTCCCAT","CCATTAGTTCCTGCTTTATT","561307.5.peg.942","2402"
"36134",135,804,669,"GCAGCTCCCATAGGTAATCC","CCATTAGTTCCTGCTTTATT","561307.5.peg.942","2402"
"36135",345,804,459,"TGTCTGTATTCAGGATGACC","CCATTAGTTCCTGCTTTATT","561307.5.peg.942","2402"
"36136",354,804,450,"CCATCTGTATGTCTGTATTC","CCATTAGTTCCTGCTTTATT","561307.5.peg.942","2402"
"36137",135,840,705,"GCAGCTCCCATAGGTAATCC","TTCTTTCAACTTCACCTAA","561307.5.peg.942","2402"
"36138",354,840,486,"CCATCTGTATGTCTGTATTC","TTCTTTCAACTTCACCTAA","561307.5.peg.942","2402"
"36139",144,840,696,"GCCATTGGGGCAGCTCCCAT","TTCTTTCAACTTCACCTAA","561307.5.peg.942","2402"
"36140",159,840,681,"GTCCACAAAGTGTAAGCCAT","TTCTTTCAACTTCACCTAA","561307.5.peg.942","2402"
"36141",230,840,610,"GCCCTGCAGATAATACGAAA","TTCTTTCAACTTCACCTAA","561307.5.peg.942","2402"
"36142",345,840,495,"TGTCTGTATTCAGGATGACC","TTCTTTCAACTTCACCTAA","561307.5.peg.942","2402"
"36143",181,8,173,"AACGACGTACATCAATGCAC","GAGAGTTTATTTAACGAGA","561307.5.peg.944","2404"
"36144",8,181,173,"GAGAGTTTATTTAACGAGA","AACGACGTACATCAATGCAC","561307.5.peg.944","2404"
"36145",213,6,207,"ACATGATTGCATCTTTACT","CGAACAAATGTTCTATATGG","561307.5.peg.945","2405"
"36146",428,6,422,"TTTCGCTCACAGTAGCATAA","CGAACAAATGTTCTATATGG","561307.5.peg.945","2405"
"36147",168,6,162,"CCAGCTATCACAATGATATC","CGAACAAATGTTCTATATGG","561307.5.peg.945","2405"
"36148",475,6,469,"TCCCTGTTGATGTGTTTCAA","CGAACAAATGTTCTATATGG","561307.5.peg.945","2405"
"36149",6,168,162,"CGAACAAATGTTCTATATGG","CCAGCTATCACAATGATATC","561307.5.peg.945","2405"
"36150",428,168,260,"TTTCGCTCACAGTAGCATAA","CCAGCTATCACAATGATATC","561307.5.peg.945","2405"
"36151",475,168,307,"TCCCTGTTGATGTGTTTCAA","CCAGCTATCACAATGATATC","561307.5.peg.945","2405"
"36152",6,213,207,"CGAACAAATGTTCTATATGG","ACATGATTGCATCTTTACT","561307.5.peg.945","2405"
"36153",428,213,215,"TTTCGCTCACAGTAGCATAA","ACATGATTGCATCTTTACT","561307.5.peg.945","2405"
"36154",475,213,262,"TCCCTGTTGATGTGTTTCAA","ACATGATTGCATCTTTACT","561307.5.peg.945","2405"
"36155",213,428,215,"ACATGATTGCATCTTTACT","TTTCGCTCACAGTAGCATAA","561307.5.peg.945","2405"
"36156",6,428,422,"CGAACAAATGTTCTATATGG","TTTCGCTCACAGTAGCATAA","561307.5.peg.945","2405"
"36157",168,428,260,"CCAGCTATCACAATGATATC","TTTCGCTCACAGTAGCATAA","561307.5.peg.945","2405"
"36158",6,475,469,"CGAACAAATGTTCTATATGG","TCCCTGTTGATGTGTTTCAA","561307.5.peg.945","2405"
"36159",168,475,307,"CCAGCTATCACAATGATATC","TCCCTGTTGATGTGTTTCAA","561307.5.peg.945","2405"
"36160",213,475,262,"ACATGATTGCATCTTTACT","TCCCTGTTGATGTGTTTCAA","561307.5.peg.945","2405"
"36161",730,504,226,"CAATTTGTCTATCTGTTGAG","AAGCGTTTGAATTCACCTTG","561307.5.peg.946","2406"
"36162",942,504,438,"GCTTCAATTCCCTCTATTTC","AAGCGTTTGAATTCACCTTG","561307.5.peg.946","2406"
"36163",504,730,226,"AAGCGTTTGAATTCACCTTG","CAATTTGTCTATCTGTTGAG","561307.5.peg.946","2406"
"36164",942,730,212,"GCTTCAATTCCCTCTATTTC","CAATTTGTCTATCTGTTGAG","561307.5.peg.946","2406"
"36165",504,942,438,"AAGCGTTTGAATTCACCTTG","GCTTCAATTCCCTCTATTTC","561307.5.peg.946","2406"
"36166",730,942,212,"CAATTTGTCTATCTGTTGAG","GCTTCAATTCCCTCTATTTC","561307.5.peg.946","2406"
"36167",482,66,416,"CCCAAGCATGGAATCCCCAA","TTCTTTCCATTTGGATTCTC","561307.5.peg.948","2408"
"36168",303,66,237,"TAAACTCAGGTTTGTCATT","TTCTTTCCATTTGGATTCTC","561307.5.peg.948","2408"
"36169",670,66,604,"AGCACCCATACCTAACGAAA","TTCTTTCCATTTGGATTCTC","561307.5.peg.948","2408"
"36170",494,66,428,"CACCATAAACAGCCCAAGCA","TTCTTTCCATTTGGATTCTC","561307.5.peg.948","2408"
"36171",399,66,333,"GGCGTAGCAAAGTGCGCCAT","TTCTTTCCATTTGGATTCTC","561307.5.peg.948","2408"
"36172",303,96,207,"TAAACTCAGGTTTGTCATT","ATTGCACTATAGATGAAGAC","561307.5.peg.948","2408"
"36173",399,96,303,"GGCGTAGCAAAGTGCGCCAT","ATTGCACTATAGATGAAGAC","561307.5.peg.948","2408"
"36174",494,96,398,"CACCATAAACAGCCCAAGCA","ATTGCACTATAGATGAAGAC","561307.5.peg.948","2408"
"36175",482,96,386,"CCCAAGCATGGAATCCCCAA","ATTGCACTATAGATGAAGAC","561307.5.peg.948","2408"
"36176",670,96,574,"AGCACCCATACCTAACGAAA","ATTGCACTATAGATGAAGAC","561307.5.peg.948","2408"
"36177",66,303,237,"TTCTTTCCATTTGGATTCTC","TAAACTCAGGTTTGTCATT","561307.5.peg.948","2408"
"36178",670,303,367,"AGCACCCATACCTAACGAAA","TAAACTCAGGTTTGTCATT","561307.5.peg.948","2408"
"36179",96,303,207,"ATTGCACTATAGATGAAGAC","TAAACTCAGGTTTGTCATT","561307.5.peg.948","2408"
"36180",482,303,179,"CCCAAGCATGGAATCCCCAA","TAAACTCAGGTTTGTCATT","561307.5.peg.948","2408"
"36181",494,303,191,"CACCATAAACAGCCCAAGCA","TAAACTCAGGTTTGTCATT","561307.5.peg.948","2408"
"36182",66,399,333,"TTCTTTCCATTTGGATTCTC","GGCGTAGCAAAGTGCGCCAT","561307.5.peg.948","2408"
"36183",96,399,303,"ATTGCACTATAGATGAAGAC","GGCGTAGCAAAGTGCGCCAT","561307.5.peg.948","2408"
"36184",670,399,271,"AGCACCCATACCTAACGAAA","GGCGTAGCAAAGTGCGCCAT","561307.5.peg.948","2408"
"36185",66,482,416,"TTCTTTCCATTTGGATTCTC","CCCAAGCATGGAATCCCCAA","561307.5.peg.948","2408"
"36186",96,482,386,"ATTGCACTATAGATGAAGAC","CCCAAGCATGGAATCCCCAA","561307.5.peg.948","2408"
"36187",670,482,188,"AGCACCCATACCTAACGAAA","CCCAAGCATGGAATCCCCAA","561307.5.peg.948","2408"
"36188",303,482,179,"TAAACTCAGGTTTGTCATT","CCCAAGCATGGAATCCCCAA","561307.5.peg.948","2408"
"36189",66,494,428,"TTCTTTCCATTTGGATTCTC","CACCATAAACAGCCCAAGCA","561307.5.peg.948","2408"
"36190",96,494,398,"ATTGCACTATAGATGAAGAC","CACCATAAACAGCCCAAGCA","561307.5.peg.948","2408"
"36191",670,494,176,"AGCACCCATACCTAACGAAA","CACCATAAACAGCCCAAGCA","561307.5.peg.948","2408"
"36192",303,494,191,"TAAACTCAGGTTTGTCATT","CACCATAAACAGCCCAAGCA","561307.5.peg.948","2408"
"36193",494,670,176,"CACCATAAACAGCCCAAGCA","AGCACCCATACCTAACGAAA","561307.5.peg.948","2408"
"36194",96,670,574,"ATTGCACTATAGATGAAGAC","AGCACCCATACCTAACGAAA","561307.5.peg.948","2408"
"36195",303,670,367,"TAAACTCAGGTTTGTCATT","AGCACCCATACCTAACGAAA","561307.5.peg.948","2408"
"36196",66,670,604,"TTCTTTCCATTTGGATTCTC","AGCACCCATACCTAACGAAA","561307.5.peg.948","2408"
"36197",399,670,271,"GGCGTAGCAAAGTGCGCCAT","AGCACCCATACCTAACGAAA","561307.5.peg.948","2408"
"36198",482,670,188,"CCCAAGCATGGAATCCCCAA","AGCACCCATACCTAACGAAA","561307.5.peg.948","2408"
"36199",785,314,471,"CTTTAGACAGTGACATAGTA","TTTGCTTAGCTTGTGGGAAC","561307.5.peg.949","2409"
"36200",915,314,601,"AATACGTCATCTAATTGCCA","TTTGCTTAGCTTGTGGGAAC","561307.5.peg.949","2409"
"36201",666,314,352,"AATTTAGCCCCAGGATGTAG","TTTGCTTAGCTTGTGGGAAC","561307.5.peg.949","2409"
"36202",675,314,361,"CCTTTACGTAATTTAGCCCC","TTTGCTTAGCTTGTGGGAAC","561307.5.peg.949","2409"
"36203",440,314,126,"CTCAAGAATTTCATTTGGA","TTTGCTTAGCTTGTGGGAAC","561307.5.peg.949","2409"
"36204",440,320,120,"CTCAAGAATTTCATTTGGA","ATAATGTTTGCTTAGCTTGT","561307.5.peg.949","2409"
"36205",666,320,346,"AATTTAGCCCCAGGATGTAG","ATAATGTTTGCTTAGCTTGT","561307.5.peg.949","2409"
"36206",675,320,355,"CCTTTACGTAATTTAGCCCC","ATAATGTTTGCTTAGCTTGT","561307.5.peg.949","2409"
"36207",915,320,595,"AATACGTCATCTAATTGCCA","ATAATGTTTGCTTAGCTTGT","561307.5.peg.949","2409"
"36208",785,320,465,"CTTTAGACAGTGACATAGTA","ATAATGTTTGCTTAGCTTGT","561307.5.peg.949","2409"
"36209",666,348,318,"AATTTAGCCCCAGGATGTAG","AAGGCGTGTTCTCCAGTGAT","561307.5.peg.949","2409"
"36210",915,348,567,"AATACGTCATCTAATTGCCA","AAGGCGTGTTCTCCAGTGAT","561307.5.peg.949","2409"
"36211",675,348,327,"CCTTTACGTAATTTAGCCCC","AAGGCGTGTTCTCCAGTGAT","561307.5.peg.949","2409"
"36212",785,348,437,"CTTTAGACAGTGACATAGTA","AAGGCGTGTTCTCCAGTGAT","561307.5.peg.949","2409"
"36213",666,392,274,"AATTTAGCCCCAGGATGTAG","GTCATCTTTAATGTAGAAA","561307.5.peg.949","2409"
"36214",675,392,283,"CCTTTACGTAATTTAGCCCC","GTCATCTTTAATGTAGAAA","561307.5.peg.949","2409"
"36215",785,392,393,"CTTTAGACAGTGACATAGTA","GTCATCTTTAATGTAGAAA","561307.5.peg.949","2409"
"36216",915,392,523,"AATACGTCATCTAATTGCCA","GTCATCTTTAATGTAGAAA","561307.5.peg.949","2409"
"36217",320,440,120,"ATAATGTTTGCTTAGCTTGT","CTCAAGAATTTCATTTGGA","561307.5.peg.949","2409"
"36218",785,440,345,"CTTTAGACAGTGACATAGTA","CTCAAGAATTTCATTTGGA","561307.5.peg.949","2409"
"36219",314,440,126,"TTTGCTTAGCTTGTGGGAAC","CTCAAGAATTTCATTTGGA","561307.5.peg.949","2409"
"36220",675,440,235,"CCTTTACGTAATTTAGCCCC","CTCAAGAATTTCATTTGGA","561307.5.peg.949","2409"
"36221",915,440,475,"AATACGTCATCTAATTGCCA","CTCAAGAATTTCATTTGGA","561307.5.peg.949","2409"
"36222",666,440,226,"AATTTAGCCCCAGGATGTAG","CTCAAGAATTTCATTTGGA","561307.5.peg.949","2409"
"36223",915,666,249,"AATACGTCATCTAATTGCCA","AATTTAGCCCCAGGATGTAG","561307.5.peg.949","2409"
"36224",314,666,352,"TTTGCTTAGCTTGTGGGAAC","AATTTAGCCCCAGGATGTAG","561307.5.peg.949","2409"
"36225",785,666,119,"CTTTAGACAGTGACATAGTA","AATTTAGCCCCAGGATGTAG","561307.5.peg.949","2409"
"36226",392,666,274,"GTCATCTTTAATGTAGAAA","AATTTAGCCCCAGGATGTAG","561307.5.peg.949","2409"
"36227",320,666,346,"ATAATGTTTGCTTAGCTTGT","AATTTAGCCCCAGGATGTAG","561307.5.peg.949","2409"
"36228",440,666,226,"CTCAAGAATTTCATTTGGA","AATTTAGCCCCAGGATGTAG","561307.5.peg.949","2409"
"36229",348,666,318,"AAGGCGTGTTCTCCAGTGAT","AATTTAGCCCCAGGATGTAG","561307.5.peg.949","2409"
"36230",314,675,361,"TTTGCTTAGCTTGTGGGAAC","CCTTTACGTAATTTAGCCCC","561307.5.peg.949","2409"
"36231",440,675,235,"CTCAAGAATTTCATTTGGA","CCTTTACGTAATTTAGCCCC","561307.5.peg.949","2409"
"36232",320,675,355,"ATAATGTTTGCTTAGCTTGT","CCTTTACGTAATTTAGCCCC","561307.5.peg.949","2409"
"36233",392,675,283,"GTCATCTTTAATGTAGAAA","CCTTTACGTAATTTAGCCCC","561307.5.peg.949","2409"
"36234",348,675,327,"AAGGCGTGTTCTCCAGTGAT","CCTTTACGTAATTTAGCCCC","561307.5.peg.949","2409"
"36235",785,675,110,"CTTTAGACAGTGACATAGTA","CCTTTACGTAATTTAGCCCC","561307.5.peg.949","2409"
"36236",915,675,240,"AATACGTCATCTAATTGCCA","CCTTTACGTAATTTAGCCCC","561307.5.peg.949","2409"
"36237",320,785,465,"ATAATGTTTGCTTAGCTTGT","CTTTAGACAGTGACATAGTA","561307.5.peg.949","2409"
"36238",915,785,130,"AATACGTCATCTAATTGCCA","CTTTAGACAGTGACATAGTA","561307.5.peg.949","2409"
"36239",440,785,345,"CTCAAGAATTTCATTTGGA","CTTTAGACAGTGACATAGTA","561307.5.peg.949","2409"
"36240",392,785,393,"GTCATCTTTAATGTAGAAA","CTTTAGACAGTGACATAGTA","561307.5.peg.949","2409"
"36241",314,785,471,"TTTGCTTAGCTTGTGGGAAC","CTTTAGACAGTGACATAGTA","561307.5.peg.949","2409"
"36242",666,785,119,"AATTTAGCCCCAGGATGTAG","CTTTAGACAGTGACATAGTA","561307.5.peg.949","2409"
"36243",675,785,110,"CCTTTACGTAATTTAGCCCC","CTTTAGACAGTGACATAGTA","561307.5.peg.949","2409"
"36244",348,785,437,"AAGGCGTGTTCTCCAGTGAT","CTTTAGACAGTGACATAGTA","561307.5.peg.949","2409"
"36245",392,915,523,"GTCATCTTTAATGTAGAAA","AATACGTCATCTAATTGCCA","561307.5.peg.949","2409"
"36246",348,915,567,"AAGGCGTGTTCTCCAGTGAT","AATACGTCATCTAATTGCCA","561307.5.peg.949","2409"
"36247",320,915,595,"ATAATGTTTGCTTAGCTTGT","AATACGTCATCTAATTGCCA","561307.5.peg.949","2409"
"36248",440,915,475,"CTCAAGAATTTCATTTGGA","AATACGTCATCTAATTGCCA","561307.5.peg.949","2409"
"36249",675,915,240,"CCTTTACGTAATTTAGCCCC","AATACGTCATCTAATTGCCA","561307.5.peg.949","2409"
"36250",785,915,130,"CTTTAGACAGTGACATAGTA","AATACGTCATCTAATTGCCA","561307.5.peg.949","2409"
"36251",314,915,601,"TTTGCTTAGCTTGTGGGAAC","AATACGTCATCTAATTGCCA","561307.5.peg.949","2409"
"36252",666,915,249,"AATTTAGCCCCAGGATGTAG","AATACGTCATCTAATTGCCA","561307.5.peg.949","2409"
"36253",456,333,123,"ATGTATCTTGATGCATCTTC","AATATGACACCAGCAATGGC","561307.5.peg.950","2411"
"36254",333,456,123,"AATATGACACCAGCAATGGC","ATGTATCTTGATGCATCTTC","561307.5.peg.950","2411"
"36255",873,131,742,"GAAAGTATTGTAAACGGCGT","GCGAAATAAATGTTTGCTCG","561307.5.peg.951","2412"
"36256",668,131,537,"CCATAGCTGTGCACACAACA","GCGAAATAAATGTTTGCTCG","561307.5.peg.951","2412"
"36257",585,131,454,"CGTACTTCTTCCATAGTTAA","GCGAAATAAATGTTTGCTCG","561307.5.peg.951","2412"
"36258",335,131,204,"CGCGTAGTCGCTCTGAAATA","GCGAAATAAATGTTTGCTCG","561307.5.peg.951","2412"
"36259",543,131,412,"GGGTGTGTTGGATGCCCCTC","GCGAAATAAATGTTTGCTCG","561307.5.peg.951","2412"
"36260",726,131,595,"CGAATCTGATTGTAGTATTC","GCGAAATAAATGTTTGCTCG","561307.5.peg.951","2412"
"36261",807,131,676,"ATCGTATGATCATATTGCCA","GCGAAATAAATGTTTGCTCG","561307.5.peg.951","2412"
"36262",335,133,202,"CGCGTAGTCGCTCTGAAATA","TTGCGAAATAAATGTTTGCT","561307.5.peg.951","2412"
"36263",807,133,674,"ATCGTATGATCATATTGCCA","TTGCGAAATAAATGTTTGCT","561307.5.peg.951","2412"
"36264",873,133,740,"GAAAGTATTGTAAACGGCGT","TTGCGAAATAAATGTTTGCT","561307.5.peg.951","2412"
"36265",668,133,535,"CCATAGCTGTGCACACAACA","TTGCGAAATAAATGTTTGCT","561307.5.peg.951","2412"
"36266",726,133,593,"CGAATCTGATTGTAGTATTC","TTGCGAAATAAATGTTTGCT","561307.5.peg.951","2412"
"36267",585,133,452,"CGTACTTCTTCCATAGTTAA","TTGCGAAATAAATGTTTGCT","561307.5.peg.951","2412"
"36268",543,133,410,"GGGTGTGTTGGATGCCCCTC","TTGCGAAATAAATGTTTGCT","561307.5.peg.951","2412"
"36269",543,335,208,"GGGTGTGTTGGATGCCCCTC","CGCGTAGTCGCTCTGAAATA","561307.5.peg.951","2412"
"36270",807,335,472,"ATCGTATGATCATATTGCCA","CGCGTAGTCGCTCTGAAATA","561307.5.peg.951","2412"
"36271",668,335,333,"CCATAGCTGTGCACACAACA","CGCGTAGTCGCTCTGAAATA","561307.5.peg.951","2412"
"36272",131,335,204,"GCGAAATAAATGTTTGCTCG","CGCGTAGTCGCTCTGAAATA","561307.5.peg.951","2412"
"36273",726,335,391,"CGAATCTGATTGTAGTATTC","CGCGTAGTCGCTCTGAAATA","561307.5.peg.951","2412"
"36274",585,335,250,"CGTACTTCTTCCATAGTTAA","CGCGTAGTCGCTCTGAAATA","561307.5.peg.951","2412"
"36275",133,335,202,"TTGCGAAATAAATGTTTGCT","CGCGTAGTCGCTCTGAAATA","561307.5.peg.951","2412"
"36276",873,335,538,"GAAAGTATTGTAAACGGCGT","CGCGTAGTCGCTCTGAAATA","561307.5.peg.951","2412"
"36277",131,543,412,"GCGAAATAAATGTTTGCTCG","GGGTGTGTTGGATGCCCCTC","561307.5.peg.951","2412"
"36278",335,543,208,"CGCGTAGTCGCTCTGAAATA","GGGTGTGTTGGATGCCCCTC","561307.5.peg.951","2412"
"36279",668,543,125,"CCATAGCTGTGCACACAACA","GGGTGTGTTGGATGCCCCTC","561307.5.peg.951","2412"
"36280",726,543,183,"CGAATCTGATTGTAGTATTC","GGGTGTGTTGGATGCCCCTC","561307.5.peg.951","2412"
"36281",133,543,410,"TTGCGAAATAAATGTTTGCT","GGGTGTGTTGGATGCCCCTC","561307.5.peg.951","2412"
"36282",807,543,264,"ATCGTATGATCATATTGCCA","GGGTGTGTTGGATGCCCCTC","561307.5.peg.951","2412"
"36283",873,543,330,"GAAAGTATTGTAAACGGCGT","GGGTGTGTTGGATGCCCCTC","561307.5.peg.951","2412"
"36284",873,585,288,"GAAAGTATTGTAAACGGCGT","CGTACTTCTTCCATAGTTAA","561307.5.peg.951","2412"
"36285",807,585,222,"ATCGTATGATCATATTGCCA","CGTACTTCTTCCATAGTTAA","561307.5.peg.951","2412"
"36286",726,585,141,"CGAATCTGATTGTAGTATTC","CGTACTTCTTCCATAGTTAA","561307.5.peg.951","2412"
"36287",133,585,452,"TTGCGAAATAAATGTTTGCT","CGTACTTCTTCCATAGTTAA","561307.5.peg.951","2412"
"36288",335,585,250,"CGCGTAGTCGCTCTGAAATA","CGTACTTCTTCCATAGTTAA","561307.5.peg.951","2412"
"36289",131,585,454,"GCGAAATAAATGTTTGCTCG","CGTACTTCTTCCATAGTTAA","561307.5.peg.951","2412"
"36290",543,668,125,"GGGTGTGTTGGATGCCCCTC","CCATAGCTGTGCACACAACA","561307.5.peg.951","2412"
"36291",873,668,205,"GAAAGTATTGTAAACGGCGT","CCATAGCTGTGCACACAACA","561307.5.peg.951","2412"
"36292",335,668,333,"CGCGTAGTCGCTCTGAAATA","CCATAGCTGTGCACACAACA","561307.5.peg.951","2412"
"36293",131,668,537,"GCGAAATAAATGTTTGCTCG","CCATAGCTGTGCACACAACA","561307.5.peg.951","2412"
"36294",807,668,139,"ATCGTATGATCATATTGCCA","CCATAGCTGTGCACACAACA","561307.5.peg.951","2412"
"36295",133,668,535,"TTGCGAAATAAATGTTTGCT","CCATAGCTGTGCACACAACA","561307.5.peg.951","2412"
"36296",131,726,595,"GCGAAATAAATGTTTGCTCG","CGAATCTGATTGTAGTATTC","561307.5.peg.951","2412"
"36297",335,726,391,"CGCGTAGTCGCTCTGAAATA","CGAATCTGATTGTAGTATTC","561307.5.peg.951","2412"
"36298",543,726,183,"GGGTGTGTTGGATGCCCCTC","CGAATCTGATTGTAGTATTC","561307.5.peg.951","2412"
"36299",873,726,147,"GAAAGTATTGTAAACGGCGT","CGAATCTGATTGTAGTATTC","561307.5.peg.951","2412"
"36300",585,726,141,"CGTACTTCTTCCATAGTTAA","CGAATCTGATTGTAGTATTC","561307.5.peg.951","2412"
"36301",133,726,593,"TTGCGAAATAAATGTTTGCT","CGAATCTGATTGTAGTATTC","561307.5.peg.951","2412"
"36302",131,807,676,"GCGAAATAAATGTTTGCTCG","ATCGTATGATCATATTGCCA","561307.5.peg.951","2412"
"36303",335,807,472,"CGCGTAGTCGCTCTGAAATA","ATCGTATGATCATATTGCCA","561307.5.peg.951","2412"
"36304",543,807,264,"GGGTGTGTTGGATGCCCCTC","ATCGTATGATCATATTGCCA","561307.5.peg.951","2412"
"36305",668,807,139,"CCATAGCTGTGCACACAACA","ATCGTATGATCATATTGCCA","561307.5.peg.951","2412"
"36306",133,807,674,"TTGCGAAATAAATGTTTGCT","ATCGTATGATCATATTGCCA","561307.5.peg.951","2412"
"36307",585,807,222,"CGTACTTCTTCCATAGTTAA","ATCGTATGATCATATTGCCA","561307.5.peg.951","2412"
"36308",131,873,742,"GCGAAATAAATGTTTGCTCG","GAAAGTATTGTAAACGGCGT","561307.5.peg.951","2412"
"36309",585,873,288,"CGTACTTCTTCCATAGTTAA","GAAAGTATTGTAAACGGCGT","561307.5.peg.951","2412"
"36310",543,873,330,"GGGTGTGTTGGATGCCCCTC","GAAAGTATTGTAAACGGCGT","561307.5.peg.951","2412"
"36311",335,873,538,"CGCGTAGTCGCTCTGAAATA","GAAAGTATTGTAAACGGCGT","561307.5.peg.951","2412"
"36312",668,873,205,"CCATAGCTGTGCACACAACA","GAAAGTATTGTAAACGGCGT","561307.5.peg.951","2412"
"36313",133,873,740,"TTGCGAAATAAATGTTTGCT","GAAAGTATTGTAAACGGCGT","561307.5.peg.951","2412"
"36314",726,873,147,"CGAATCTGATTGTAGTATTC","GAAAGTATTGTAAACGGCGT","561307.5.peg.951","2412"
"36315",428,141,287,"CATAAGTCAGAACACCTTCA","CCAGCTATGCACTTAATTAC","561307.5.peg.952","2413"
"36316",428,167,261,"CATAAGTCAGAACACCTTCA","TAAGCTTTCTACAATTGTA","561307.5.peg.952","2413"
"36317",141,428,287,"CCAGCTATGCACTTAATTAC","CATAAGTCAGAACACCTTCA","561307.5.peg.952","2413"
"36318",167,428,261,"TAAGCTTTCTACAATTGTA","CATAAGTCAGAACACCTTCA","561307.5.peg.952","2413"
"36319",399,273,126,"CTATCAGCGATAATTAAATC","CCATCATCAGCAATACCAAC","561307.5.peg.953","2414"
"36320",273,399,126,"CCATCATCAGCAATACCAAC","CTATCAGCGATAATTAAATC","561307.5.peg.953","2414"
"36321",390,290,100,"GCACCTAAGAATGAACCTAT","TAACATCAGGTGAGGCTAAC","561307.5.peg.955","2416"
"36322",478,290,188,"GCCTATTGCTAAACCAATTA","TAACATCAGGTGAGGCTAAC","561307.5.peg.955","2416"
"36323",478,298,180,"GCCTATTGCTAAACCAATTA","AATACCTATAACATCAGGTG","561307.5.peg.955","2416"
"36324",478,331,147,"GCCTATTGCTAAACCAATTA","AATAATCACAGCAGCTAAAC","561307.5.peg.955","2416"
"36325",478,361,117,"GCCTATTGCTAAACCAATTA","AAACAATGGTGCTGTTGGAA","561307.5.peg.955","2416"
"36326",478,366,112,"GCCTATTGCTAAACCAATTA","AATACAAACAATGGTGCTGT","561307.5.peg.955","2416"
"36327",290,390,100,"TAACATCAGGTGAGGCTAAC","GCACCTAAGAATGAACCTAT","561307.5.peg.955","2416"
"36328",290,478,188,"TAACATCAGGTGAGGCTAAC","GCCTATTGCTAAACCAATTA","561307.5.peg.955","2416"
"36329",298,478,180,"AATACCTATAACATCAGGTG","GCCTATTGCTAAACCAATTA","561307.5.peg.955","2416"
"36330",331,478,147,"AATAATCACAGCAGCTAAAC","GCCTATTGCTAAACCAATTA","561307.5.peg.955","2416"
"36331",361,478,117,"AAACAATGGTGCTGTTGGAA","GCCTATTGCTAAACCAATTA","561307.5.peg.955","2416"
"36332",366,478,112,"AATACAAACAATGGTGCTGT","GCCTATTGCTAAACCAATTA","561307.5.peg.955","2416"
"36333",312,138,174,"GCATTGTTCATTAGCCCGTC","CCATCTTGTTCGACTGGAAT","561307.5.peg.956","2417"
"36334",468,138,330,"AAGAATACTGCCACTAATGT","CCATCTTGTTCGACTGGAAT","561307.5.peg.956","2417"
"36335",573,138,435,"CGTCCTGGCAATGTAAATAA","CCATCTTGTTCGACTGGAAT","561307.5.peg.956","2417"
"36336",561,138,423,"GTAAATAAAGGTCTCATAAC","CCATCTTGTTCGACTGGAAT","561307.5.peg.956","2417"
"36337",510,138,372,"AAACCGTATTCCATTAATAG","CCATCTTGTTCGACTGGAAT","561307.5.peg.956","2417"
"36338",588,138,450,"TTATCTACCGTCGAACGTCC","CCATCTTGTTCGACTGGAAT","561307.5.peg.956","2417"
"36339",138,312,174,"CCATCTTGTTCGACTGGAAT","GCATTGTTCATTAGCCCGTC","561307.5.peg.956","2417"
"36340",468,312,156,"AAGAATACTGCCACTAATGT","GCATTGTTCATTAGCCCGTC","561307.5.peg.956","2417"
"36341",561,312,249,"GTAAATAAAGGTCTCATAAC","GCATTGTTCATTAGCCCGTC","561307.5.peg.956","2417"
"36342",573,312,261,"CGTCCTGGCAATGTAAATAA","GCATTGTTCATTAGCCCGTC","561307.5.peg.956","2417"
"36343",510,312,198,"AAACCGTATTCCATTAATAG","GCATTGTTCATTAGCCCGTC","561307.5.peg.956","2417"
"36344",588,312,276,"TTATCTACCGTCGAACGTCC","GCATTGTTCATTAGCCCGTC","561307.5.peg.956","2417"
"36345",138,468,330,"CCATCTTGTTCGACTGGAAT","AAGAATACTGCCACTAATGT","561307.5.peg.956","2417"
"36346",573,468,105,"CGTCCTGGCAATGTAAATAA","AAGAATACTGCCACTAATGT","561307.5.peg.956","2417"
"36347",312,468,156,"GCATTGTTCATTAGCCCGTC","AAGAATACTGCCACTAATGT","561307.5.peg.956","2417"
"36348",588,468,120,"TTATCTACCGTCGAACGTCC","AAGAATACTGCCACTAATGT","561307.5.peg.956","2417"
"36349",138,510,372,"CCATCTTGTTCGACTGGAAT","AAACCGTATTCCATTAATAG","561307.5.peg.956","2417"
"36350",312,510,198,"GCATTGTTCATTAGCCCGTC","AAACCGTATTCCATTAATAG","561307.5.peg.956","2417"
"36351",312,561,249,"GCATTGTTCATTAGCCCGTC","GTAAATAAAGGTCTCATAAC","561307.5.peg.956","2417"
"36352",138,561,423,"CCATCTTGTTCGACTGGAAT","GTAAATAAAGGTCTCATAAC","561307.5.peg.956","2417"
"36353",138,573,435,"CCATCTTGTTCGACTGGAAT","CGTCCTGGCAATGTAAATAA","561307.5.peg.956","2417"
"36354",468,573,105,"AAGAATACTGCCACTAATGT","CGTCCTGGCAATGTAAATAA","561307.5.peg.956","2417"
"36355",312,573,261,"GCATTGTTCATTAGCCCGTC","CGTCCTGGCAATGTAAATAA","561307.5.peg.956","2417"
"36356",312,588,276,"GCATTGTTCATTAGCCCGTC","TTATCTACCGTCGAACGTCC","561307.5.peg.956","2417"
"36357",138,588,450,"CCATCTTGTTCGACTGGAAT","TTATCTACCGTCGAACGTCC","561307.5.peg.956","2417"
"36358",468,588,120,"AAGAATACTGCCACTAATGT","TTATCTACCGTCGAACGTCC","561307.5.peg.956","2417"
"36359",383,7,376,"CAATTTCAAACGAACCTTTA","AAGGTTACAAACTCAGCAGG","561307.5.peg.959","2420"
"36360",383,10,373,"CAATTTCAAACGAACCTTTA","TTAAAGGTTACAAACTCAGC","561307.5.peg.959","2420"
"36361",7,383,376,"AAGGTTACAAACTCAGCAGG","CAATTTCAAACGAACCTTTA","561307.5.peg.959","2420"
"36362",10,383,373,"TTAAAGGTTACAAACTCAGC","CAATTTCAAACGAACCTTTA","561307.5.peg.959","2420"
"36363",423,1,422,"CAAATGATTCAACTGAACA","TAATTAGTAGAGGTGAGTA","561307.5.peg.96","2421"
"36364",516,1,515,"AAATCATATGGTGATGTACG","TAATTAGTAGAGGTGAGTA","561307.5.peg.96","2421"
"36365",528,1,527,"CCTAGGCCTTGGAAATCATA","TAATTAGTAGAGGTGAGTA","561307.5.peg.96","2421"
"36366",539,1,538,"GTCCTTCAACACCTAGGCCT","TAATTAGTAGAGGTGAGTA","561307.5.peg.96","2421"
"36367",1,423,422,"TAATTAGTAGAGGTGAGTA","CAAATGATTCAACTGAACA","561307.5.peg.96","2421"
"36368",528,423,105,"CCTAGGCCTTGGAAATCATA","CAAATGATTCAACTGAACA","561307.5.peg.96","2421"
"36369",539,423,116,"GTCCTTCAACACCTAGGCCT","CAAATGATTCAACTGAACA","561307.5.peg.96","2421"
"36370",1,516,515,"TAATTAGTAGAGGTGAGTA","AAATCATATGGTGATGTACG","561307.5.peg.96","2421"
"36371",1,528,527,"TAATTAGTAGAGGTGAGTA","CCTAGGCCTTGGAAATCATA","561307.5.peg.96","2421"
"36372",423,528,105,"CAAATGATTCAACTGAACA","CCTAGGCCTTGGAAATCATA","561307.5.peg.96","2421"
"36373",1,539,538,"TAATTAGTAGAGGTGAGTA","GTCCTTCAACACCTAGGCCT","561307.5.peg.96","2421"
"36374",423,539,116,"CAAATGATTCAACTGAACA","GTCCTTCAACACCTAGGCCT","561307.5.peg.96","2421"
"36375",189,6,183,"TAACTGTGCACAGCCGCATA","GGGTTTAATTTAATGATAGG","561307.5.peg.960","2422"
"36376",6,189,183,"GGGTTTAATTTAATGATAGG","TAACTGTGCACAGCCGCATA","561307.5.peg.960","2422"
"36377",489,220,269,"AATATACCACCACCTAGAAG","TAATTCGCCCACTATAGGAT","561307.5.peg.961","2423"
"36378",552,220,332,"ATAATGGCAATGATCGCAAT","TAATTCGCCCACTATAGGAT","561307.5.peg.961","2423"
"36379",600,220,380,"TTAGCAACTGTTTCTTCCTC","TAATTCGCCCACTATAGGAT","561307.5.peg.961","2423"
"36380",552,225,327,"ATAATGGCAATGATCGCAAT","GAAAGTAATTCGCCCACTAT","561307.5.peg.961","2423"
"36381",489,225,264,"AATATACCACCACCTAGAAG","GAAAGTAATTCGCCCACTAT","561307.5.peg.961","2423"
"36382",600,225,375,"TTAGCAACTGTTTCTTCCTC","GAAAGTAATTCGCCCACTAT","561307.5.peg.961","2423"
"36383",220,489,269,"TAATTCGCCCACTATAGGAT","AATATACCACCACCTAGAAG","561307.5.peg.961","2423"
"36384",225,489,264,"GAAAGTAATTCGCCCACTAT","AATATACCACCACCTAGAAG","561307.5.peg.961","2423"
"36385",600,489,111,"TTAGCAACTGTTTCTTCCTC","AATATACCACCACCTAGAAG","561307.5.peg.961","2423"
"36386",220,552,332,"TAATTCGCCCACTATAGGAT","ATAATGGCAATGATCGCAAT","561307.5.peg.961","2423"
"36387",225,552,327,"GAAAGTAATTCGCCCACTAT","ATAATGGCAATGATCGCAAT","561307.5.peg.961","2423"
"36388",220,600,380,"TAATTCGCCCACTATAGGAT","TTAGCAACTGTTTCTTCCTC","561307.5.peg.961","2423"
"36389",489,600,111,"AATATACCACCACCTAGAAG","TTAGCAACTGTTTCTTCCTC","561307.5.peg.961","2423"
"36390",225,600,375,"GAAAGTAATTCGCCCACTAT","TTAGCAACTGTTTCTTCCTC","561307.5.peg.961","2423"
"36391",258,133,125,"TTACTGCCAGCGCTTAATTG","CACATTCATTGAAGTTGTGT","561307.5.peg.964","2426"
"36392",260,133,127,"TATTACTGCCAGCGCTTAAT","CACATTCATTGAAGTTGTGT","561307.5.peg.964","2426"
"36393",133,258,125,"CACATTCATTGAAGTTGTGT","TTACTGCCAGCGCTTAATTG","561307.5.peg.964","2426"
"36394",133,260,127,"CACATTCATTGAAGTTGTGT","TATTACTGCCAGCGCTTAAT","561307.5.peg.964","2426"
"36395",240,75,165,"ACTGACATCCTCATCGCTTC","TCCAATGCATCATATGCATA","561307.5.peg.965","2427"
"36396",75,240,165,"TCCAATGCATCATATGCATA","ACTGACATCCTCATCGCTTC","561307.5.peg.965","2427"
"36397",699,98,601,"TATAAGTTGAGCTGTCCATT","GTGTCATCGTTCTAATCAAT","561307.5.peg.966","2428"
"36398",482,98,384,"CAGACGCAACAATATTACTG","GTGTCATCGTTCTAATCAAT","561307.5.peg.966","2428"
"36399",265,98,167,"CAATTGCCGTTTGTCGTTAA","GTGTCATCGTTCTAATCAAT","561307.5.peg.966","2428"
"36400",265,135,130,"CAATTGCCGTTTGTCGTTAA","CCAAATGCACGTGAAATAAT","561307.5.peg.966","2428"
"36401",482,135,347,"CAGACGCAACAATATTACTG","CCAAATGCACGTGAAATAAT","561307.5.peg.966","2428"
"36402",699,135,564,"TATAAGTTGAGCTGTCCATT","CCAAATGCACGTGAAATAAT","561307.5.peg.966","2428"
"36403",482,159,323,"CAGACGCAACAATATTACTG","GAAACAATACCCACACCACT","561307.5.peg.966","2428"
"36404",265,159,106,"CAATTGCCGTTTGTCGTTAA","GAAACAATACCCACACCACT","561307.5.peg.966","2428"
"36405",699,159,540,"TATAAGTTGAGCTGTCCATT","GAAACAATACCCACACCACT","561307.5.peg.966","2428"
"36406",159,265,106,"GAAACAATACCCACACCACT","CAATTGCCGTTTGTCGTTAA","561307.5.peg.966","2428"
"36407",98,265,167,"GTGTCATCGTTCTAATCAAT","CAATTGCCGTTTGTCGTTAA","561307.5.peg.966","2428"
"36408",699,265,434,"TATAAGTTGAGCTGTCCATT","CAATTGCCGTTTGTCGTTAA","561307.5.peg.966","2428"
"36409",135,265,130,"CCAAATGCACGTGAAATAAT","CAATTGCCGTTTGTCGTTAA","561307.5.peg.966","2428"
"36410",482,265,217,"CAGACGCAACAATATTACTG","CAATTGCCGTTTGTCGTTAA","561307.5.peg.966","2428"
"36411",135,482,347,"CCAAATGCACGTGAAATAAT","CAGACGCAACAATATTACTG","561307.5.peg.966","2428"
"36412",98,482,384,"GTGTCATCGTTCTAATCAAT","CAGACGCAACAATATTACTG","561307.5.peg.966","2428"
"36413",699,482,217,"TATAAGTTGAGCTGTCCATT","CAGACGCAACAATATTACTG","561307.5.peg.966","2428"
"36414",159,482,323,"GAAACAATACCCACACCACT","CAGACGCAACAATATTACTG","561307.5.peg.966","2428"
"36415",265,482,217,"CAATTGCCGTTTGTCGTTAA","CAGACGCAACAATATTACTG","561307.5.peg.966","2428"
"36416",98,699,601,"GTGTCATCGTTCTAATCAAT","TATAAGTTGAGCTGTCCATT","561307.5.peg.966","2428"
"36417",265,699,434,"CAATTGCCGTTTGTCGTTAA","TATAAGTTGAGCTGTCCATT","561307.5.peg.966","2428"
"36418",482,699,217,"CAGACGCAACAATATTACTG","TATAAGTTGAGCTGTCCATT","561307.5.peg.966","2428"
"36419",135,699,564,"CCAAATGCACGTGAAATAAT","TATAAGTTGAGCTGTCCATT","561307.5.peg.966","2428"
"36420",159,699,540,"GAAACAATACCCACACCACT","TATAAGTTGAGCTGTCCATT","561307.5.peg.966","2428"
"36421",308,11,297,"CAGCTTTGGAAGAATGTAAA","TGAAAGTATAGCATTAAAG","561307.5.peg.968","2430"
"36422",582,11,571,"TTTAGCGTTTGCTTAACAGC","TGAAAGTATAGCATTAAAG","561307.5.peg.968","2430"
"36423",322,11,311,"TCGTCCGACCGTTCCAGCTT","TGAAAGTATAGCATTAAAG","561307.5.peg.968","2430"
"36424",11,308,297,"TGAAAGTATAGCATTAAAG","CAGCTTTGGAAGAATGTAAA","561307.5.peg.968","2430"
"36425",582,308,274,"TTTAGCGTTTGCTTAACAGC","CAGCTTTGGAAGAATGTAAA","561307.5.peg.968","2430"
"36426",11,322,311,"TGAAAGTATAGCATTAAAG","TCGTCCGACCGTTCCAGCTT","561307.5.peg.968","2430"
"36427",582,322,260,"TTTAGCGTTTGCTTAACAGC","TCGTCCGACCGTTCCAGCTT","561307.5.peg.968","2430"
"36428",322,582,260,"TCGTCCGACCGTTCCAGCTT","TTTAGCGTTTGCTTAACAGC","561307.5.peg.968","2430"
"36429",308,582,274,"CAGCTTTGGAAGAATGTAAA","TTTAGCGTTTGCTTAACAGC","561307.5.peg.968","2430"
"36430",11,582,571,"TGAAAGTATAGCATTAAAG","TTTAGCGTTTGCTTAACAGC","561307.5.peg.968","2430"
"36431",168,68,100,"TGACTATAAATAGGGTTTCC","AGTCAATCGCACGTTTAATT","561307.5.peg.969","2431"
"36432",68,168,100,"AGTCAATCGCACGTTTAATT","TGACTATAAATAGGGTTTCC","561307.5.peg.969","2431"
"36433",416,100,316,"CTTCAGTAATTGTACCACCA","ATTAACAACACGCGACACTG","561307.5.peg.97","2432"
"36434",471,100,371,"TTTGTTCCTGATACTACTAC","ATTAACAACACGCGACACTG","561307.5.peg.97","2432"
"36435",416,192,224,"CTTCAGTAATTGTACCACCA","AAACCTCTAGCAACAGCATT","561307.5.peg.97","2432"
"36436",471,192,279,"TTTGTTCCTGATACTACTAC","AAACCTCTAGCAACAGCATT","561307.5.peg.97","2432"
"36437",100,416,316,"ATTAACAACACGCGACACTG","CTTCAGTAATTGTACCACCA","561307.5.peg.97","2432"
"36438",192,416,224,"AAACCTCTAGCAACAGCATT","CTTCAGTAATTGTACCACCA","561307.5.peg.97","2432"
"36439",100,471,371,"ATTAACAACACGCGACACTG","TTTGTTCCTGATACTACTAC","561307.5.peg.97","2432"
"36440",192,471,279,"AAACCTCTAGCAACAGCATT","TTTGTTCCTGATACTACTAC","561307.5.peg.97","2432"
"36441",375,273,102,"TGTCTTGTCTCAGTAGTCCA","GTTTCATGGATTTCTTGCAC","561307.5.peg.975","2438"
"36442",273,375,102,"GTTTCATGGATTTCTTGCAC","TGTCTTGTCTCAGTAGTCCA","561307.5.peg.975","2438"
"36443",168,4,164,"AGTACATTTGACAATTACT","TCTAAACAGAAAGGGGATGA","561307.5.peg.976","2439"
"36444",486,4,482,"GCCATATGCAACGTTGCATT","TCTAAACAGAAAGGGGATGA","561307.5.peg.976","2439"
"36445",480,4,476,"TGCAACGTTGCATTGGGAAA","TCTAAACAGAAAGGGGATGA","561307.5.peg.976","2439"
"36446",515,4,511,"CAGAAATACCAAATTGTGTT","TCTAAACAGAAAGGGGATGA","561307.5.peg.976","2439"
"36447",480,11,469,"TGCAACGTTGCATTGGGAAA","AGCGACGTCTAAACAGAAAG","561307.5.peg.976","2439"
"36448",486,11,475,"GCCATATGCAACGTTGCATT","AGCGACGTCTAAACAGAAAG","561307.5.peg.976","2439"
"36449",168,11,157,"AGTACATTTGACAATTACT","AGCGACGTCTAAACAGAAAG","561307.5.peg.976","2439"
"36450",515,11,504,"CAGAAATACCAAATTGTGTT","AGCGACGTCTAAACAGAAAG","561307.5.peg.976","2439"
"36451",168,13,155,"AGTACATTTGACAATTACT","CTAGCGACGTCTAAACAGAA","561307.5.peg.976","2439"
"36452",486,13,473,"GCCATATGCAACGTTGCATT","CTAGCGACGTCTAAACAGAA","561307.5.peg.976","2439"
"36453",515,13,502,"CAGAAATACCAAATTGTGTT","CTAGCGACGTCTAAACAGAA","561307.5.peg.976","2439"
"36454",480,13,467,"TGCAACGTTGCATTGGGAAA","CTAGCGACGTCTAAACAGAA","561307.5.peg.976","2439"
"36455",13,168,155,"CTAGCGACGTCTAAACAGAA","AGTACATTTGACAATTACT","561307.5.peg.976","2439"
"36456",11,168,157,"AGCGACGTCTAAACAGAAAG","AGTACATTTGACAATTACT","561307.5.peg.976","2439"
"36457",4,168,164,"TCTAAACAGAAAGGGGATGA","AGTACATTTGACAATTACT","561307.5.peg.976","2439"
"36458",480,168,312,"TGCAACGTTGCATTGGGAAA","AGTACATTTGACAATTACT","561307.5.peg.976","2439"
"36459",486,168,318,"GCCATATGCAACGTTGCATT","AGTACATTTGACAATTACT","561307.5.peg.976","2439"
"36460",515,168,347,"CAGAAATACCAAATTGTGTT","AGTACATTTGACAATTACT","561307.5.peg.976","2439"
"36461",4,480,476,"TCTAAACAGAAAGGGGATGA","TGCAACGTTGCATTGGGAAA","561307.5.peg.976","2439"
"36462",168,480,312,"AGTACATTTGACAATTACT","TGCAACGTTGCATTGGGAAA","561307.5.peg.976","2439"
"36463",11,480,469,"AGCGACGTCTAAACAGAAAG","TGCAACGTTGCATTGGGAAA","561307.5.peg.976","2439"
"36464",13,480,467,"CTAGCGACGTCTAAACAGAA","TGCAACGTTGCATTGGGAAA","561307.5.peg.976","2439"
"36465",168,486,318,"AGTACATTTGACAATTACT","GCCATATGCAACGTTGCATT","561307.5.peg.976","2439"
"36466",4,486,482,"TCTAAACAGAAAGGGGATGA","GCCATATGCAACGTTGCATT","561307.5.peg.976","2439"
"36467",11,486,475,"AGCGACGTCTAAACAGAAAG","GCCATATGCAACGTTGCATT","561307.5.peg.976","2439"
"36468",13,486,473,"CTAGCGACGTCTAAACAGAA","GCCATATGCAACGTTGCATT","561307.5.peg.976","2439"
"36469",4,515,511,"TCTAAACAGAAAGGGGATGA","CAGAAATACCAAATTGTGTT","561307.5.peg.976","2439"
"36470",11,515,504,"AGCGACGTCTAAACAGAAAG","CAGAAATACCAAATTGTGTT","561307.5.peg.976","2439"
"36471",13,515,502,"CTAGCGACGTCTAAACAGAA","CAGAAATACCAAATTGTGTT","561307.5.peg.976","2439"
"36472",168,515,347,"AGTACATTTGACAATTACT","CAGAAATACCAAATTGTGTT","561307.5.peg.976","2439"
"36473",120,9,111,"ACCTCGATCATCAATGGGTC","ACAAATCCATTAGGTGTAGG","561307.5.peg.977","2440"
"36474",125,9,116,"CGATAACCTCGATCATCAAT","ACAAATCCATTAGGTGTAGG","561307.5.peg.977","2440"
"36475",386,9,377,"TCAAACTTCTTAATCCTTGC","ACAAATCCATTAGGTGTAGG","561307.5.peg.977","2440"
"36476",252,9,243,"ACTGCAGTGACACGTACAAT","ACAAATCCATTAGGTGTAGG","561307.5.peg.977","2440"
"36477",330,9,321,"GTCTCACGATCTTTAACGTG","ACAAATCCATTAGGTGTAGG","561307.5.peg.977","2440"
"36478",120,12,108,"ACCTCGATCATCAATGGGTC","GTTACAAATCCATTAGGTGT","561307.5.peg.977","2440"
"36479",330,12,318,"GTCTCACGATCTTTAACGTG","GTTACAAATCCATTAGGTGT","561307.5.peg.977","2440"
"36480",386,12,374,"TCAAACTTCTTAATCCTTGC","GTTACAAATCCATTAGGTGT","561307.5.peg.977","2440"
"36481",125,12,113,"CGATAACCTCGATCATCAAT","GTTACAAATCCATTAGGTGT","561307.5.peg.977","2440"
"36482",252,12,240,"ACTGCAGTGACACGTACAAT","GTTACAAATCCATTAGGTGT","561307.5.peg.977","2440"
"36483",330,26,304,"GTCTCACGATCTTTAACGTG","TTGATACCTCCTACACCTAA","561307.5.peg.977","2440"
"36484",252,26,226,"ACTGCAGTGACACGTACAAT","TTGATACCTCCTACACCTAA","561307.5.peg.977","2440"
"36485",386,26,360,"TCAAACTTCTTAATCCTTGC","TTGATACCTCCTACACCTAA","561307.5.peg.977","2440"
"36486",9,120,111,"ACAAATCCATTAGGTGTAGG","ACCTCGATCATCAATGGGTC","561307.5.peg.977","2440"
"36487",386,120,266,"TCAAACTTCTTAATCCTTGC","ACCTCGATCATCAATGGGTC","561307.5.peg.977","2440"
"36488",252,120,132,"ACTGCAGTGACACGTACAAT","ACCTCGATCATCAATGGGTC","561307.5.peg.977","2440"
"36489",330,120,210,"GTCTCACGATCTTTAACGTG","ACCTCGATCATCAATGGGTC","561307.5.peg.977","2440"
"36490",12,120,108,"GTTACAAATCCATTAGGTGT","ACCTCGATCATCAATGGGTC","561307.5.peg.977","2440"
"36491",9,125,116,"ACAAATCCATTAGGTGTAGG","CGATAACCTCGATCATCAAT","561307.5.peg.977","2440"
"36492",386,125,261,"TCAAACTTCTTAATCCTTGC","CGATAACCTCGATCATCAAT","561307.5.peg.977","2440"
"36493",12,125,113,"GTTACAAATCCATTAGGTGT","CGATAACCTCGATCATCAAT","561307.5.peg.977","2440"
"36494",330,125,205,"GTCTCACGATCTTTAACGTG","CGATAACCTCGATCATCAAT","561307.5.peg.977","2440"
"36495",252,125,127,"ACTGCAGTGACACGTACAAT","CGATAACCTCGATCATCAAT","561307.5.peg.977","2440"
"36496",9,252,243,"ACAAATCCATTAGGTGTAGG","ACTGCAGTGACACGTACAAT","561307.5.peg.977","2440"
"36497",12,252,240,"GTTACAAATCCATTAGGTGT","ACTGCAGTGACACGTACAAT","561307.5.peg.977","2440"
"36498",125,252,127,"CGATAACCTCGATCATCAAT","ACTGCAGTGACACGTACAAT","561307.5.peg.977","2440"
"36499",26,252,226,"TTGATACCTCCTACACCTAA","ACTGCAGTGACACGTACAAT","561307.5.peg.977","2440"
"36500",120,252,132,"ACCTCGATCATCAATGGGTC","ACTGCAGTGACACGTACAAT","561307.5.peg.977","2440"
"36501",386,252,134,"TCAAACTTCTTAATCCTTGC","ACTGCAGTGACACGTACAAT","561307.5.peg.977","2440"
"36502",12,330,318,"GTTACAAATCCATTAGGTGT","GTCTCACGATCTTTAACGTG","561307.5.peg.977","2440"
"36503",125,330,205,"CGATAACCTCGATCATCAAT","GTCTCACGATCTTTAACGTG","561307.5.peg.977","2440"
"36504",9,330,321,"ACAAATCCATTAGGTGTAGG","GTCTCACGATCTTTAACGTG","561307.5.peg.977","2440"
"36505",120,330,210,"ACCTCGATCATCAATGGGTC","GTCTCACGATCTTTAACGTG","561307.5.peg.977","2440"
"36506",26,330,304,"TTGATACCTCCTACACCTAA","GTCTCACGATCTTTAACGTG","561307.5.peg.977","2440"
"36507",9,386,377,"ACAAATCCATTAGGTGTAGG","TCAAACTTCTTAATCCTTGC","561307.5.peg.977","2440"
"36508",252,386,134,"ACTGCAGTGACACGTACAAT","TCAAACTTCTTAATCCTTGC","561307.5.peg.977","2440"
"36509",12,386,374,"GTTACAAATCCATTAGGTGT","TCAAACTTCTTAATCCTTGC","561307.5.peg.977","2440"
"36510",125,386,261,"CGATAACCTCGATCATCAAT","TCAAACTTCTTAATCCTTGC","561307.5.peg.977","2440"
"36511",120,386,266,"ACCTCGATCATCAATGGGTC","TCAAACTTCTTAATCCTTGC","561307.5.peg.977","2440"
"36512",26,386,360,"TTGATACCTCCTACACCTAA","TCAAACTTCTTAATCCTTGC","561307.5.peg.977","2440"
"36513",354,30,324,"TCATAGTCGTTAAATGTCTC","CTAGAGTGATGCACCAAC","561307.5.peg.978","2441"
"36514",656,30,626,"TGACATGTTCAAACTGCCAT","CTAGAGTGATGCACCAAC","561307.5.peg.978","2441"
"36515",168,30,138,"TCTCCTACGACACGCTCAAT","CTAGAGTGATGCACCAAC","561307.5.peg.978","2441"
"36516",408,30,378,"CCTAAACGTGATTTGTAACT","CTAGAGTGATGCACCAAC","561307.5.peg.978","2441"
"36517",648,30,618,"TCAAACTGCCATGGGTGTAC","CTAGAGTGATGCACCAAC","561307.5.peg.978","2441"
"36518",752,30,722,"TCGTACGAATCGATTGTTGA","CTAGAGTGATGCACCAAC","561307.5.peg.978","2441"
"36519",752,168,584,"TCGTACGAATCGATTGTTGA","TCTCCTACGACACGCTCAAT","561307.5.peg.978","2441"
"36520",408,168,240,"CCTAAACGTGATTTGTAACT","TCTCCTACGACACGCTCAAT","561307.5.peg.978","2441"
"36521",30,168,138,"CTAGAGTGATGCACCAAC","TCTCCTACGACACGCTCAAT","561307.5.peg.978","2441"
"36522",656,168,488,"TGACATGTTCAAACTGCCAT","TCTCCTACGACACGCTCAAT","561307.5.peg.978","2441"
"36523",354,168,186,"TCATAGTCGTTAAATGTCTC","TCTCCTACGACACGCTCAAT","561307.5.peg.978","2441"
"36524",648,168,480,"TCAAACTGCCATGGGTGTAC","TCTCCTACGACACGCTCAAT","561307.5.peg.978","2441"
"36525",168,354,186,"TCTCCTACGACACGCTCAAT","TCATAGTCGTTAAATGTCTC","561307.5.peg.978","2441"
"36526",656,354,302,"TGACATGTTCAAACTGCCAT","TCATAGTCGTTAAATGTCTC","561307.5.peg.978","2441"
"36527",752,354,398,"TCGTACGAATCGATTGTTGA","TCATAGTCGTTAAATGTCTC","561307.5.peg.978","2441"
"36528",648,354,294,"TCAAACTGCCATGGGTGTAC","TCATAGTCGTTAAATGTCTC","561307.5.peg.978","2441"
"36529",30,354,324,"CTAGAGTGATGCACCAAC","TCATAGTCGTTAAATGTCTC","561307.5.peg.978","2441"
"36530",168,408,240,"TCTCCTACGACACGCTCAAT","CCTAAACGTGATTTGTAACT","561307.5.peg.978","2441"
"36531",30,408,378,"CTAGAGTGATGCACCAAC","CCTAAACGTGATTTGTAACT","561307.5.peg.978","2441"
"36532",656,408,248,"TGACATGTTCAAACTGCCAT","CCTAAACGTGATTTGTAACT","561307.5.peg.978","2441"
"36533",752,408,344,"TCGTACGAATCGATTGTTGA","CCTAAACGTGATTTGTAACT","561307.5.peg.978","2441"
"36534",648,408,240,"TCAAACTGCCATGGGTGTAC","CCTAAACGTGATTTGTAACT","561307.5.peg.978","2441"
"36535",168,648,480,"TCTCCTACGACACGCTCAAT","TCAAACTGCCATGGGTGTAC","561307.5.peg.978","2441"
"36536",30,648,618,"CTAGAGTGATGCACCAAC","TCAAACTGCCATGGGTGTAC","561307.5.peg.978","2441"
"36537",752,648,104,"TCGTACGAATCGATTGTTGA","TCAAACTGCCATGGGTGTAC","561307.5.peg.978","2441"
"36538",354,648,294,"TCATAGTCGTTAAATGTCTC","TCAAACTGCCATGGGTGTAC","561307.5.peg.978","2441"
"36539",408,648,240,"CCTAAACGTGATTTGTAACT","TCAAACTGCCATGGGTGTAC","561307.5.peg.978","2441"
"36540",30,656,626,"CTAGAGTGATGCACCAAC","TGACATGTTCAAACTGCCAT","561307.5.peg.978","2441"
"36541",408,656,248,"CCTAAACGTGATTTGTAACT","TGACATGTTCAAACTGCCAT","561307.5.peg.978","2441"
"36542",168,656,488,"TCTCCTACGACACGCTCAAT","TGACATGTTCAAACTGCCAT","561307.5.peg.978","2441"
"36543",354,656,302,"TCATAGTCGTTAAATGTCTC","TGACATGTTCAAACTGCCAT","561307.5.peg.978","2441"
"36544",30,752,722,"CTAGAGTGATGCACCAAC","TCGTACGAATCGATTGTTGA","561307.5.peg.978","2441"
"36545",408,752,344,"CCTAAACGTGATTTGTAACT","TCGTACGAATCGATTGTTGA","561307.5.peg.978","2441"
"36546",648,752,104,"TCAAACTGCCATGGGTGTAC","TCGTACGAATCGATTGTTGA","561307.5.peg.978","2441"
"36547",354,752,398,"TCATAGTCGTTAAATGTCTC","TCGTACGAATCGATTGTTGA","561307.5.peg.978","2441"
"36548",168,752,584,"TCTCCTACGACACGCTCAAT","TCGTACGAATCGATTGTTGA","561307.5.peg.978","2441"
"36549",711,243,468,"TGATTTGATAAGGATGTGT","CCATCGATAAGCCATACCTC","561307.5.peg.979","2442"
"36550",791,243,548,"CTGAATCACCGGAAACGCCA","CCATCGATAAGCCATACCTC","561307.5.peg.979","2442"
"36551",552,243,309,"TGGAATGATGTATGACATTC","CCATCGATAAGCCATACCTC","561307.5.peg.979","2442"
"36552",802,243,559,"CGTCGGGTACACTGAATCAC","CCATCGATAAGCCATACCTC","561307.5.peg.979","2442"
"36553",489,243,246,"CTCTTAGGAGTCGGATGAAA","CCATCGATAAGCCATACCTC","561307.5.peg.979","2442"
"36554",498,243,255,"CCACTTGCACTCTTAGGAGT","CCATCGATAAGCCATACCTC","561307.5.peg.979","2442"
"36555",818,243,575,"CAGTTCTAACCGAAGACGTC","CCATCGATAAGCCATACCTC","561307.5.peg.979","2442"
"36556",243,489,246,"CCATCGATAAGCCATACCTC","CTCTTAGGAGTCGGATGAAA","561307.5.peg.979","2442"
"36557",711,489,222,"TGATTTGATAAGGATGTGT","CTCTTAGGAGTCGGATGAAA","561307.5.peg.979","2442"
"36558",802,489,313,"CGTCGGGTACACTGAATCAC","CTCTTAGGAGTCGGATGAAA","561307.5.peg.979","2442"
"36559",791,489,302,"CTGAATCACCGGAAACGCCA","CTCTTAGGAGTCGGATGAAA","561307.5.peg.979","2442"
"36560",818,489,329,"CAGTTCTAACCGAAGACGTC","CTCTTAGGAGTCGGATGAAA","561307.5.peg.979","2442"
"36561",243,498,255,"CCATCGATAAGCCATACCTC","CCACTTGCACTCTTAGGAGT","561307.5.peg.979","2442"
"36562",802,498,304,"CGTCGGGTACACTGAATCAC","CCACTTGCACTCTTAGGAGT","561307.5.peg.979","2442"
"36563",791,498,293,"CTGAATCACCGGAAACGCCA","CCACTTGCACTCTTAGGAGT","561307.5.peg.979","2442"
"36564",818,498,320,"CAGTTCTAACCGAAGACGTC","CCACTTGCACTCTTAGGAGT","561307.5.peg.979","2442"
"36565",711,498,213,"TGATTTGATAAGGATGTGT","CCACTTGCACTCTTAGGAGT","561307.5.peg.979","2442"
"36566",791,552,239,"CTGAATCACCGGAAACGCCA","TGGAATGATGTATGACATTC","561307.5.peg.979","2442"
"36567",711,552,159,"TGATTTGATAAGGATGTGT","TGGAATGATGTATGACATTC","561307.5.peg.979","2442"
"36568",243,552,309,"CCATCGATAAGCCATACCTC","TGGAATGATGTATGACATTC","561307.5.peg.979","2442"
"36569",802,552,250,"CGTCGGGTACACTGAATCAC","TGGAATGATGTATGACATTC","561307.5.peg.979","2442"
"36570",818,552,266,"CAGTTCTAACCGAAGACGTC","TGGAATGATGTATGACATTC","561307.5.peg.979","2442"
"36571",243,711,468,"CCATCGATAAGCCATACCTC","TGATTTGATAAGGATGTGT","561307.5.peg.979","2442"
"36572",818,711,107,"CAGTTCTAACCGAAGACGTC","TGATTTGATAAGGATGTGT","561307.5.peg.979","2442"
"36573",498,711,213,"CCACTTGCACTCTTAGGAGT","TGATTTGATAAGGATGTGT","561307.5.peg.979","2442"
"36574",552,711,159,"TGGAATGATGTATGACATTC","TGATTTGATAAGGATGTGT","561307.5.peg.979","2442"
"36575",489,711,222,"CTCTTAGGAGTCGGATGAAA","TGATTTGATAAGGATGTGT","561307.5.peg.979","2442"
"36576",243,791,548,"CCATCGATAAGCCATACCTC","CTGAATCACCGGAAACGCCA","561307.5.peg.979","2442"
"36577",489,791,302,"CTCTTAGGAGTCGGATGAAA","CTGAATCACCGGAAACGCCA","561307.5.peg.979","2442"
"36578",552,791,239,"TGGAATGATGTATGACATTC","CTGAATCACCGGAAACGCCA","561307.5.peg.979","2442"
"36579",498,791,293,"CCACTTGCACTCTTAGGAGT","CTGAATCACCGGAAACGCCA","561307.5.peg.979","2442"
"36580",243,802,559,"CCATCGATAAGCCATACCTC","CGTCGGGTACACTGAATCAC","561307.5.peg.979","2442"
"36581",498,802,304,"CCACTTGCACTCTTAGGAGT","CGTCGGGTACACTGAATCAC","561307.5.peg.979","2442"
"36582",552,802,250,"TGGAATGATGTATGACATTC","CGTCGGGTACACTGAATCAC","561307.5.peg.979","2442"
"36583",489,802,313,"CTCTTAGGAGTCGGATGAAA","CGTCGGGTACACTGAATCAC","561307.5.peg.979","2442"
"36584",498,818,320,"CCACTTGCACTCTTAGGAGT","CAGTTCTAACCGAAGACGTC","561307.5.peg.979","2442"
"36585",552,818,266,"TGGAATGATGTATGACATTC","CAGTTCTAACCGAAGACGTC","561307.5.peg.979","2442"
"36586",489,818,329,"CTCTTAGGAGTCGGATGAAA","CAGTTCTAACCGAAGACGTC","561307.5.peg.979","2442"
"36587",711,818,107,"TGATTTGATAAGGATGTGT","CAGTTCTAACCGAAGACGTC","561307.5.peg.979","2442"
"36588",243,818,575,"CCATCGATAAGCCATACCTC","CAGTTCTAACCGAAGACGTC","561307.5.peg.979","2442"
"36589",362,126,236,"CTCCAACAATTGTGGCACTA","TTAAACGCATTTGATTGAA","561307.5.peg.98","2443"
"36590",359,126,233,"CAACAATTGTGGCACTATGG","TTAAACGCATTTGATTGAA","561307.5.peg.98","2443"
"36591",514,126,388,"TTCTTTAGCTAAGTATTGTG","TTAAACGCATTTGATTGAA","561307.5.peg.98","2443"
"36592",607,126,481,"TAAGTAGTAACATGGTTAT","TTAAACGCATTTGATTGAA","561307.5.peg.98","2443"
"36593",565,126,439,"ACCATCTCCATGATGTGCAT","TTAAACGCATTTGATTGAA","561307.5.peg.98","2443"
"36594",359,207,152,"CAACAATTGTGGCACTATGG","TCGTCATCTGTTGCAATTCT","561307.5.peg.98","2443"
"36595",565,207,358,"ACCATCTCCATGATGTGCAT","TCGTCATCTGTTGCAATTCT","561307.5.peg.98","2443"
"36596",607,207,400,"TAAGTAGTAACATGGTTAT","TCGTCATCTGTTGCAATTCT","561307.5.peg.98","2443"
"36597",514,207,307,"TTCTTTAGCTAAGTATTGTG","TCGTCATCTGTTGCAATTCT","561307.5.peg.98","2443"
"36598",362,207,155,"CTCCAACAATTGTGGCACTA","TCGTCATCTGTTGCAATTCT","561307.5.peg.98","2443"
"36599",126,359,233,"TTAAACGCATTTGATTGAA","CAACAATTGTGGCACTATGG","561307.5.peg.98","2443"
"36600",514,359,155,"TTCTTTAGCTAAGTATTGTG","CAACAATTGTGGCACTATGG","561307.5.peg.98","2443"
"36601",607,359,248,"TAAGTAGTAACATGGTTAT","CAACAATTGTGGCACTATGG","561307.5.peg.98","2443"
"36602",207,359,152,"TCGTCATCTGTTGCAATTCT","CAACAATTGTGGCACTATGG","561307.5.peg.98","2443"
"36603",565,359,206,"ACCATCTCCATGATGTGCAT","CAACAATTGTGGCACTATGG","561307.5.peg.98","2443"
"36604",126,362,236,"TTAAACGCATTTGATTGAA","CTCCAACAATTGTGGCACTA","561307.5.peg.98","2443"
"36605",207,362,155,"TCGTCATCTGTTGCAATTCT","CTCCAACAATTGTGGCACTA","561307.5.peg.98","2443"
"36606",565,362,203,"ACCATCTCCATGATGTGCAT","CTCCAACAATTGTGGCACTA","561307.5.peg.98","2443"
"36607",514,362,152,"TTCTTTAGCTAAGTATTGTG","CTCCAACAATTGTGGCACTA","561307.5.peg.98","2443"
"36608",607,362,245,"TAAGTAGTAACATGGTTAT","CTCCAACAATTGTGGCACTA","561307.5.peg.98","2443"
"36609",126,514,388,"TTAAACGCATTTGATTGAA","TTCTTTAGCTAAGTATTGTG","561307.5.peg.98","2443"
"36610",207,514,307,"TCGTCATCTGTTGCAATTCT","TTCTTTAGCTAAGTATTGTG","561307.5.peg.98","2443"
"36611",362,514,152,"CTCCAACAATTGTGGCACTA","TTCTTTAGCTAAGTATTGTG","561307.5.peg.98","2443"
"36612",359,514,155,"CAACAATTGTGGCACTATGG","TTCTTTAGCTAAGTATTGTG","561307.5.peg.98","2443"
"36613",207,565,358,"TCGTCATCTGTTGCAATTCT","ACCATCTCCATGATGTGCAT","561307.5.peg.98","2443"
"36614",126,565,439,"TTAAACGCATTTGATTGAA","ACCATCTCCATGATGTGCAT","561307.5.peg.98","2443"
"36615",359,565,206,"CAACAATTGTGGCACTATGG","ACCATCTCCATGATGTGCAT","561307.5.peg.98","2443"
"36616",362,565,203,"CTCCAACAATTGTGGCACTA","ACCATCTCCATGATGTGCAT","561307.5.peg.98","2443"
"36617",126,607,481,"TTAAACGCATTTGATTGAA","TAAGTAGTAACATGGTTAT","561307.5.peg.98","2443"
"36618",207,607,400,"TCGTCATCTGTTGCAATTCT","TAAGTAGTAACATGGTTAT","561307.5.peg.98","2443"
"36619",359,607,248,"CAACAATTGTGGCACTATGG","TAAGTAGTAACATGGTTAT","561307.5.peg.98","2443"
"36620",362,607,245,"CTCCAACAATTGTGGCACTA","TAAGTAGTAACATGGTTAT","561307.5.peg.98","2443"
"36621",147,11,136,"GTAGTGATGCCATATAAAT","GGTACGGTAGTTAAACCTGA","561307.5.peg.980","2444"
"36622",441,11,430,"ACCTTTCCACGATCTTCAGC","GGTACGGTAGTTAAACCTGA","561307.5.peg.980","2444"
"36623",249,11,238,"TCACCTAGCTTCCCCCATAT","GGTACGGTAGTTAAACCTGA","561307.5.peg.980","2444"
"36624",510,11,499,"GCTGTAACACCGCCAATTAA","GGTACGGTAGTTAAACCTGA","561307.5.peg.980","2444"
"36625",222,11,211,"GCTATCATCGTCGTTACAGC","GGTACGGTAGTTAAACCTGA","561307.5.peg.980","2444"
"36626",354,11,343,"CTCACAAGTACAAACTGTAA","GGTACGGTAGTTAAACCTGA","561307.5.peg.980","2444"
"36627",222,32,190,"GCTATCATCGTCGTTACAGC","TCATATGTCACCATTGGATT","561307.5.peg.980","2444"
"36628",249,32,217,"TCACCTAGCTTCCCCCATAT","TCATATGTCACCATTGGATT","561307.5.peg.980","2444"
"36629",510,32,478,"GCTGTAACACCGCCAATTAA","TCATATGTCACCATTGGATT","561307.5.peg.980","2444"
"36630",441,32,409,"ACCTTTCCACGATCTTCAGC","TCATATGTCACCATTGGATT","561307.5.peg.980","2444"
"36631",147,32,115,"GTAGTGATGCCATATAAAT","TCATATGTCACCATTGGATT","561307.5.peg.980","2444"
"36632",354,32,322,"CTCACAAGTACAAACTGTAA","TCATATGTCACCATTGGATT","561307.5.peg.980","2444"
"36633",11,147,136,"GGTACGGTAGTTAAACCTGA","GTAGTGATGCCATATAAAT","561307.5.peg.980","2444"
"36634",32,147,115,"TCATATGTCACCATTGGATT","GTAGTGATGCCATATAAAT","561307.5.peg.980","2444"
"36635",354,147,207,"CTCACAAGTACAAACTGTAA","GTAGTGATGCCATATAAAT","561307.5.peg.980","2444"
"36636",441,147,294,"ACCTTTCCACGATCTTCAGC","GTAGTGATGCCATATAAAT","561307.5.peg.980","2444"
"36637",249,147,102,"TCACCTAGCTTCCCCCATAT","GTAGTGATGCCATATAAAT","561307.5.peg.980","2444"
"36638",510,147,363,"GCTGTAACACCGCCAATTAA","GTAGTGATGCCATATAAAT","561307.5.peg.980","2444"
"36639",441,222,219,"ACCTTTCCACGATCTTCAGC","GCTATCATCGTCGTTACAGC","561307.5.peg.980","2444"
"36640",354,222,132,"CTCACAAGTACAAACTGTAA","GCTATCATCGTCGTTACAGC","561307.5.peg.980","2444"
"36641",32,222,190,"TCATATGTCACCATTGGATT","GCTATCATCGTCGTTACAGC","561307.5.peg.980","2444"
"36642",510,222,288,"GCTGTAACACCGCCAATTAA","GCTATCATCGTCGTTACAGC","561307.5.peg.980","2444"
"36643",11,222,211,"GGTACGGTAGTTAAACCTGA","GCTATCATCGTCGTTACAGC","561307.5.peg.980","2444"
"36644",11,249,238,"GGTACGGTAGTTAAACCTGA","TCACCTAGCTTCCCCCATAT","561307.5.peg.980","2444"
"36645",510,249,261,"GCTGTAACACCGCCAATTAA","TCACCTAGCTTCCCCCATAT","561307.5.peg.980","2444"
"36646",32,249,217,"TCATATGTCACCATTGGATT","TCACCTAGCTTCCCCCATAT","561307.5.peg.980","2444"
"36647",147,249,102,"GTAGTGATGCCATATAAAT","TCACCTAGCTTCCCCCATAT","561307.5.peg.980","2444"
"36648",354,249,105,"CTCACAAGTACAAACTGTAA","TCACCTAGCTTCCCCCATAT","561307.5.peg.980","2444"
"36649",441,249,192,"ACCTTTCCACGATCTTCAGC","TCACCTAGCTTCCCCCATAT","561307.5.peg.980","2444"
"36650",32,354,322,"TCATATGTCACCATTGGATT","CTCACAAGTACAAACTGTAA","561307.5.peg.980","2444"
"36651",249,354,105,"TCACCTAGCTTCCCCCATAT","CTCACAAGTACAAACTGTAA","561307.5.peg.980","2444"
"36652",222,354,132,"GCTATCATCGTCGTTACAGC","CTCACAAGTACAAACTGTAA","561307.5.peg.980","2444"
"36653",510,354,156,"GCTGTAACACCGCCAATTAA","CTCACAAGTACAAACTGTAA","561307.5.peg.980","2444"
"36654",11,354,343,"GGTACGGTAGTTAAACCTGA","CTCACAAGTACAAACTGTAA","561307.5.peg.980","2444"
"36655",147,354,207,"GTAGTGATGCCATATAAAT","CTCACAAGTACAAACTGTAA","561307.5.peg.980","2444"
"36656",11,441,430,"GGTACGGTAGTTAAACCTGA","ACCTTTCCACGATCTTCAGC","561307.5.peg.980","2444"
"36657",222,441,219,"GCTATCATCGTCGTTACAGC","ACCTTTCCACGATCTTCAGC","561307.5.peg.980","2444"
"36658",249,441,192,"TCACCTAGCTTCCCCCATAT","ACCTTTCCACGATCTTCAGC","561307.5.peg.980","2444"
"36659",32,441,409,"TCATATGTCACCATTGGATT","ACCTTTCCACGATCTTCAGC","561307.5.peg.980","2444"
"36660",147,441,294,"GTAGTGATGCCATATAAAT","ACCTTTCCACGATCTTCAGC","561307.5.peg.980","2444"
"36661",32,510,478,"TCATATGTCACCATTGGATT","GCTGTAACACCGCCAATTAA","561307.5.peg.980","2444"
"36662",11,510,499,"GGTACGGTAGTTAAACCTGA","GCTGTAACACCGCCAATTAA","561307.5.peg.980","2444"
"36663",249,510,261,"TCACCTAGCTTCCCCCATAT","GCTGTAACACCGCCAATTAA","561307.5.peg.980","2444"
"36664",147,510,363,"GTAGTGATGCCATATAAAT","GCTGTAACACCGCCAATTAA","561307.5.peg.980","2444"
"36665",354,510,156,"CTCACAAGTACAAACTGTAA","GCTGTAACACCGCCAATTAA","561307.5.peg.980","2444"
"36666",222,510,288,"GCTATCATCGTCGTTACAGC","GCTGTAACACCGCCAATTAA","561307.5.peg.980","2444"
"36667",881,21,860,"TTGCAAATGGTACTTTGACA","ACACCTCGCATTCTTAATAT","561307.5.peg.981","2445"
"36668",133,21,112,"CTCACTATTCGATACAATTC","ACACCTCGCATTCTTAATAT","561307.5.peg.981","2445"
"36669",403,21,382,"TAATTGTTTAGCAAGCTGTG","ACACCTCGCATTCTTAATAT","561307.5.peg.981","2445"
"36670",873,21,852,"GGTACTTTGACATGGTTATA","ACACCTCGCATTCTTAATAT","561307.5.peg.981","2445"
"36671",267,21,246,"ACCCTTCCCTCTATCGTAAT","ACACCTCGCATTCTTAATAT","561307.5.peg.981","2445"
"36672",729,21,708,"TGATATTGCCAAGGATGTAC","ACACCTCGCATTCTTAATAT","561307.5.peg.981","2445"
"36673",762,21,741,"ATCTCTTTCGCAAAGACGTT","ACACCTCGCATTCTTAATAT","561307.5.peg.981","2445"
"36674",894,21,873,"CCTAATGACTGCATTGCAAA","ACACCTCGCATTCTTAATAT","561307.5.peg.981","2445"
"36675",729,133,596,"TGATATTGCCAAGGATGTAC","CTCACTATTCGATACAATTC","561307.5.peg.981","2445"
"36676",873,133,740,"GGTACTTTGACATGGTTATA","CTCACTATTCGATACAATTC","561307.5.peg.981","2445"
"36677",267,133,134,"ACCCTTCCCTCTATCGTAAT","CTCACTATTCGATACAATTC","561307.5.peg.981","2445"
"36678",21,133,112,"ACACCTCGCATTCTTAATAT","CTCACTATTCGATACAATTC","561307.5.peg.981","2445"
"36679",403,133,270,"TAATTGTTTAGCAAGCTGTG","CTCACTATTCGATACAATTC","561307.5.peg.981","2445"
"36680",762,133,629,"ATCTCTTTCGCAAAGACGTT","CTCACTATTCGATACAATTC","561307.5.peg.981","2445"
"36681",881,133,748,"TTGCAAATGGTACTTTGACA","CTCACTATTCGATACAATTC","561307.5.peg.981","2445"
"36682",894,133,761,"CCTAATGACTGCATTGCAAA","CTCACTATTCGATACAATTC","561307.5.peg.981","2445"
"36683",873,267,606,"GGTACTTTGACATGGTTATA","ACCCTTCCCTCTATCGTAAT","561307.5.peg.981","2445"
"36684",21,267,246,"ACACCTCGCATTCTTAATAT","ACCCTTCCCTCTATCGTAAT","561307.5.peg.981","2445"
"36685",762,267,495,"ATCTCTTTCGCAAAGACGTT","ACCCTTCCCTCTATCGTAAT","561307.5.peg.981","2445"
"36686",729,267,462,"TGATATTGCCAAGGATGTAC","ACCCTTCCCTCTATCGTAAT","561307.5.peg.981","2445"
"36687",133,267,134,"CTCACTATTCGATACAATTC","ACCCTTCCCTCTATCGTAAT","561307.5.peg.981","2445"
"36688",881,267,614,"TTGCAAATGGTACTTTGACA","ACCCTTCCCTCTATCGTAAT","561307.5.peg.981","2445"
"36689",894,267,627,"CCTAATGACTGCATTGCAAA","ACCCTTCCCTCTATCGTAAT","561307.5.peg.981","2445"
"36690",403,267,136,"TAATTGTTTAGCAAGCTGTG","ACCCTTCCCTCTATCGTAAT","561307.5.peg.981","2445"
"36691",762,403,359,"ATCTCTTTCGCAAAGACGTT","TAATTGTTTAGCAAGCTGTG","561307.5.peg.981","2445"
"36692",729,403,326,"TGATATTGCCAAGGATGTAC","TAATTGTTTAGCAAGCTGTG","561307.5.peg.981","2445"
"36693",894,403,491,"CCTAATGACTGCATTGCAAA","TAATTGTTTAGCAAGCTGTG","561307.5.peg.981","2445"
"36694",881,403,478,"TTGCAAATGGTACTTTGACA","TAATTGTTTAGCAAGCTGTG","561307.5.peg.981","2445"
"36695",21,403,382,"ACACCTCGCATTCTTAATAT","TAATTGTTTAGCAAGCTGTG","561307.5.peg.981","2445"
"36696",873,403,470,"GGTACTTTGACATGGTTATA","TAATTGTTTAGCAAGCTGTG","561307.5.peg.981","2445"
"36697",267,403,136,"ACCCTTCCCTCTATCGTAAT","TAATTGTTTAGCAAGCTGTG","561307.5.peg.981","2445"
"36698",133,403,270,"CTCACTATTCGATACAATTC","TAATTGTTTAGCAAGCTGTG","561307.5.peg.981","2445"
"36699",133,729,596,"CTCACTATTCGATACAATTC","TGATATTGCCAAGGATGTAC","561307.5.peg.981","2445"
"36700",873,729,144,"GGTACTTTGACATGGTTATA","TGATATTGCCAAGGATGTAC","561307.5.peg.981","2445"
"36701",267,729,462,"ACCCTTCCCTCTATCGTAAT","TGATATTGCCAAGGATGTAC","561307.5.peg.981","2445"
"36702",403,729,326,"TAATTGTTTAGCAAGCTGTG","TGATATTGCCAAGGATGTAC","561307.5.peg.981","2445"
"36703",894,729,165,"CCTAATGACTGCATTGCAAA","TGATATTGCCAAGGATGTAC","561307.5.peg.981","2445"
"36704",881,729,152,"TTGCAAATGGTACTTTGACA","TGATATTGCCAAGGATGTAC","561307.5.peg.981","2445"
"36705",21,729,708,"ACACCTCGCATTCTTAATAT","TGATATTGCCAAGGATGTAC","561307.5.peg.981","2445"
"36706",21,762,741,"ACACCTCGCATTCTTAATAT","ATCTCTTTCGCAAAGACGTT","561307.5.peg.981","2445"
"36707",881,762,119,"TTGCAAATGGTACTTTGACA","ATCTCTTTCGCAAAGACGTT","561307.5.peg.981","2445"
"36708",403,762,359,"TAATTGTTTAGCAAGCTGTG","ATCTCTTTCGCAAAGACGTT","561307.5.peg.981","2445"
"36709",267,762,495,"ACCCTTCCCTCTATCGTAAT","ATCTCTTTCGCAAAGACGTT","561307.5.peg.981","2445"
"36710",133,762,629,"CTCACTATTCGATACAATTC","ATCTCTTTCGCAAAGACGTT","561307.5.peg.981","2445"
"36711",873,762,111,"GGTACTTTGACATGGTTATA","ATCTCTTTCGCAAAGACGTT","561307.5.peg.981","2445"
"36712",894,762,132,"CCTAATGACTGCATTGCAAA","ATCTCTTTCGCAAAGACGTT","561307.5.peg.981","2445"
"36713",21,873,852,"ACACCTCGCATTCTTAATAT","GGTACTTTGACATGGTTATA","561307.5.peg.981","2445"
"36714",133,873,740,"CTCACTATTCGATACAATTC","GGTACTTTGACATGGTTATA","561307.5.peg.981","2445"
"36715",403,873,470,"TAATTGTTTAGCAAGCTGTG","GGTACTTTGACATGGTTATA","561307.5.peg.981","2445"
"36716",267,873,606,"ACCCTTCCCTCTATCGTAAT","GGTACTTTGACATGGTTATA","561307.5.peg.981","2445"
"36717",762,873,111,"ATCTCTTTCGCAAAGACGTT","GGTACTTTGACATGGTTATA","561307.5.peg.981","2445"
"36718",729,873,144,"TGATATTGCCAAGGATGTAC","GGTACTTTGACATGGTTATA","561307.5.peg.981","2445"
"36719",21,881,860,"ACACCTCGCATTCTTAATAT","TTGCAAATGGTACTTTGACA","561307.5.peg.981","2445"
"36720",729,881,152,"TGATATTGCCAAGGATGTAC","TTGCAAATGGTACTTTGACA","561307.5.peg.981","2445"
"36721",403,881,478,"TAATTGTTTAGCAAGCTGTG","TTGCAAATGGTACTTTGACA","561307.5.peg.981","2445"
"36722",267,881,614,"ACCCTTCCCTCTATCGTAAT","TTGCAAATGGTACTTTGACA","561307.5.peg.981","2445"
"36723",133,881,748,"CTCACTATTCGATACAATTC","TTGCAAATGGTACTTTGACA","561307.5.peg.981","2445"
"36724",762,881,119,"ATCTCTTTCGCAAAGACGTT","TTGCAAATGGTACTTTGACA","561307.5.peg.981","2445"
"36725",133,894,761,"CTCACTATTCGATACAATTC","CCTAATGACTGCATTGCAAA","561307.5.peg.981","2445"
"36726",729,894,165,"TGATATTGCCAAGGATGTAC","CCTAATGACTGCATTGCAAA","561307.5.peg.981","2445"
"36727",21,894,873,"ACACCTCGCATTCTTAATAT","CCTAATGACTGCATTGCAAA","561307.5.peg.981","2445"
"36728",267,894,627,"ACCCTTCCCTCTATCGTAAT","CCTAATGACTGCATTGCAAA","561307.5.peg.981","2445"
"36729",403,894,491,"TAATTGTTTAGCAAGCTGTG","CCTAATGACTGCATTGCAAA","561307.5.peg.981","2445"
"36730",762,894,132,"ATCTCTTTCGCAAAGACGTT","CCTAATGACTGCATTGCAAA","561307.5.peg.981","2445"
"36731",309,177,132,"CGCTCCATATTACGTTTCGA","TGTCTTAAATACGGCTTAAG","561307.5.peg.982","2446"
"36732",375,177,198,"CTTGCTTCCATAACTGCAAT","TGTCTTAAATACGGCTTAAG","561307.5.peg.982","2446"
"36733",309,186,123,"CGCTCCATATTACGTTTCGA","TCAGGATCCTGTCTTAAATA","561307.5.peg.982","2446"
"36734",375,186,189,"CTTGCTTCCATAACTGCAAT","TCAGGATCCTGTCTTAAATA","561307.5.peg.982","2446"
"36735",177,309,132,"TGTCTTAAATACGGCTTAAG","CGCTCCATATTACGTTTCGA","561307.5.peg.982","2446"
"36736",186,309,123,"TCAGGATCCTGTCTTAAATA","CGCTCCATATTACGTTTCGA","561307.5.peg.982","2446"
"36737",177,375,198,"TGTCTTAAATACGGCTTAAG","CTTGCTTCCATAACTGCAAT","561307.5.peg.982","2446"
"36738",186,375,189,"TCAGGATCCTGTCTTAAATA","CTTGCTTCCATAACTGCAAT","561307.5.peg.982","2446"
"36739",391,108,283,"TCTTCAACCATTTCTACAT","AGTTGATGAAGTTGAACCAT","561307.5.peg.983","2447"
"36740",414,108,306,"AAATAACCCCCATGTGCATC","AGTTGATGAAGTTGAACCAT","561307.5.peg.983","2447"
"36741",472,108,364,"CCAATATGCATCGTCAATAG","AGTTGATGAAGTTGAACCAT","561307.5.peg.983","2447"
"36742",414,135,279,"AAATAACCCCCATGTGCATC","TTTGCAAACACTTCATGTTT","561307.5.peg.983","2447"
"36743",472,135,337,"CCAATATGCATCGTCAATAG","TTTGCAAACACTTCATGTTT","561307.5.peg.983","2447"
"36744",391,135,256,"TCTTCAACCATTTCTACAT","TTTGCAAACACTTCATGTTT","561307.5.peg.983","2447"
"36745",472,174,298,"CCAATATGCATCGTCAATAG","CGATCTTTCATGCTGCCTCC","561307.5.peg.983","2447"
"36746",414,174,240,"AAATAACCCCCATGTGCATC","CGATCTTTCATGCTGCCTCC","561307.5.peg.983","2447"
"36747",391,174,217,"TCTTCAACCATTTCTACAT","CGATCTTTCATGCTGCCTCC","561307.5.peg.983","2447"
"36748",472,198,274,"CCAATATGCATCGTCAATAG","TGTTCAATGATGTACTTGGC","561307.5.peg.983","2447"
"36749",391,198,193,"TCTTCAACCATTTCTACAT","TGTTCAATGATGTACTTGGC","561307.5.peg.983","2447"
"36750",414,198,216,"AAATAACCCCCATGTGCATC","TGTTCAATGATGTACTTGGC","561307.5.peg.983","2447"
"36751",108,391,283,"AGTTGATGAAGTTGAACCAT","TCTTCAACCATTTCTACAT","561307.5.peg.983","2447"
"36752",198,391,193,"TGTTCAATGATGTACTTGGC","TCTTCAACCATTTCTACAT","561307.5.peg.983","2447"
"36753",174,391,217,"CGATCTTTCATGCTGCCTCC","TCTTCAACCATTTCTACAT","561307.5.peg.983","2447"
"36754",135,391,256,"TTTGCAAACACTTCATGTTT","TCTTCAACCATTTCTACAT","561307.5.peg.983","2447"
"36755",135,414,279,"TTTGCAAACACTTCATGTTT","AAATAACCCCCATGTGCATC","561307.5.peg.983","2447"
"36756",108,414,306,"AGTTGATGAAGTTGAACCAT","AAATAACCCCCATGTGCATC","561307.5.peg.983","2447"
"36757",198,414,216,"TGTTCAATGATGTACTTGGC","AAATAACCCCCATGTGCATC","561307.5.peg.983","2447"
"36758",174,414,240,"CGATCTTTCATGCTGCCTCC","AAATAACCCCCATGTGCATC","561307.5.peg.983","2447"
"36759",174,472,298,"CGATCTTTCATGCTGCCTCC","CCAATATGCATCGTCAATAG","561307.5.peg.983","2447"
"36760",135,472,337,"TTTGCAAACACTTCATGTTT","CCAATATGCATCGTCAATAG","561307.5.peg.983","2447"
"36761",108,472,364,"AGTTGATGAAGTTGAACCAT","CCAATATGCATCGTCAATAG","561307.5.peg.983","2447"
"36762",198,472,274,"TGTTCAATGATGTACTTGGC","CCAATATGCATCGTCAATAG","561307.5.peg.983","2447"
"36763",238,12,226,"TAAAGATACAGCGACGTCAG","ATTGTCATACATCACGAAGG","561307.5.peg.984","2448"
"36764",366,12,354,"TAGAGATTTCCTCTAAGTT","ATTGTCATACATCACGAAGG","561307.5.peg.984","2448"
"36765",270,12,258,"CATGATTCTACAGCACCTAC","ATTGTCATACATCACGAAGG","561307.5.peg.984","2448"
"36766",360,12,348,"ATTTCCTCTAAGTTAGGTGC","ATTGTCATACATCACGAAGG","561307.5.peg.984","2448"
"36767",462,12,450,"ACTGTATCAGTAGAAACTGT","ATTGTCATACATCACGAAGG","561307.5.peg.984","2448"
"36768",396,12,384,"TTTGACGCGACAATTAAGTC","ATTGTCATACATCACGAAGG","561307.5.peg.984","2448"
"36769",270,15,255,"CATGATTCTACAGCACCTAC","CTCATTGTCATACATCACGA","561307.5.peg.984","2448"
"36770",366,15,351,"TAGAGATTTCCTCTAAGTT","CTCATTGTCATACATCACGA","561307.5.peg.984","2448"
"36771",360,15,345,"ATTTCCTCTAAGTTAGGTGC","CTCATTGTCATACATCACGA","561307.5.peg.984","2448"
"36772",396,15,381,"TTTGACGCGACAATTAAGTC","CTCATTGTCATACATCACGA","561307.5.peg.984","2448"
"36773",238,15,223,"TAAAGATACAGCGACGTCAG","CTCATTGTCATACATCACGA","561307.5.peg.984","2448"
"36774",462,15,447,"ACTGTATCAGTAGAAACTGT","CTCATTGTCATACATCACGA","561307.5.peg.984","2448"
"36775",462,238,224,"ACTGTATCAGTAGAAACTGT","TAAAGATACAGCGACGTCAG","561307.5.peg.984","2448"
"36776",360,238,122,"ATTTCCTCTAAGTTAGGTGC","TAAAGATACAGCGACGTCAG","561307.5.peg.984","2448"
"36777",396,238,158,"TTTGACGCGACAATTAAGTC","TAAAGATACAGCGACGTCAG","561307.5.peg.984","2448"
"36778",366,238,128,"TAGAGATTTCCTCTAAGTT","TAAAGATACAGCGACGTCAG","561307.5.peg.984","2448"
"36779",15,238,223,"CTCATTGTCATACATCACGA","TAAAGATACAGCGACGTCAG","561307.5.peg.984","2448"
"36780",12,238,226,"ATTGTCATACATCACGAAGG","TAAAGATACAGCGACGTCAG","561307.5.peg.984","2448"
"36781",15,270,255,"CTCATTGTCATACATCACGA","CATGATTCTACAGCACCTAC","561307.5.peg.984","2448"
"36782",462,270,192,"ACTGTATCAGTAGAAACTGT","CATGATTCTACAGCACCTAC","561307.5.peg.984","2448"
"36783",396,270,126,"TTTGACGCGACAATTAAGTC","CATGATTCTACAGCACCTAC","561307.5.peg.984","2448"
"36784",12,270,258,"ATTGTCATACATCACGAAGG","CATGATTCTACAGCACCTAC","561307.5.peg.984","2448"
"36785",15,360,345,"CTCATTGTCATACATCACGA","ATTTCCTCTAAGTTAGGTGC","561307.5.peg.984","2448"
"36786",462,360,102,"ACTGTATCAGTAGAAACTGT","ATTTCCTCTAAGTTAGGTGC","561307.5.peg.984","2448"
"36787",12,360,348,"ATTGTCATACATCACGAAGG","ATTTCCTCTAAGTTAGGTGC","561307.5.peg.984","2448"
"36788",238,360,122,"TAAAGATACAGCGACGTCAG","ATTTCCTCTAAGTTAGGTGC","561307.5.peg.984","2448"
"36789",12,366,354,"ATTGTCATACATCACGAAGG","TAGAGATTTCCTCTAAGTT","561307.5.peg.984","2448"
"36790",238,366,128,"TAAAGATACAGCGACGTCAG","TAGAGATTTCCTCTAAGTT","561307.5.peg.984","2448"
"36791",15,366,351,"CTCATTGTCATACATCACGA","TAGAGATTTCCTCTAAGTT","561307.5.peg.984","2448"
"36792",15,396,381,"CTCATTGTCATACATCACGA","TTTGACGCGACAATTAAGTC","561307.5.peg.984","2448"
"36793",12,396,384,"ATTGTCATACATCACGAAGG","TTTGACGCGACAATTAAGTC","561307.5.peg.984","2448"
"36794",238,396,158,"TAAAGATACAGCGACGTCAG","TTTGACGCGACAATTAAGTC","561307.5.peg.984","2448"
"36795",270,396,126,"CATGATTCTACAGCACCTAC","TTTGACGCGACAATTAAGTC","561307.5.peg.984","2448"
"36796",238,462,224,"TAAAGATACAGCGACGTCAG","ACTGTATCAGTAGAAACTGT","561307.5.peg.984","2448"
"36797",12,462,450,"ATTGTCATACATCACGAAGG","ACTGTATCAGTAGAAACTGT","561307.5.peg.984","2448"
"36798",360,462,102,"ATTTCCTCTAAGTTAGGTGC","ACTGTATCAGTAGAAACTGT","561307.5.peg.984","2448"
"36799",15,462,447,"CTCATTGTCATACATCACGA","ACTGTATCAGTAGAAACTGT","561307.5.peg.984","2448"
"36800",270,462,192,"CATGATTCTACAGCACCTAC","ACTGTATCAGTAGAAACTGT","561307.5.peg.984","2448"
"36801",259,71,188,"CAACAAACCTGAGACAGCAA","TAAACCAGCAATAACGATT","561307.5.peg.985","2449"
"36802",302,71,231,"AAAGCCCTGGTGAGGCTATT","TAAACCAGCAATAACGATT","561307.5.peg.985","2449"
"36803",259,147,112,"CAACAAACCTGAGACAGCAA","AACGCCTGTATCACCGTACC","561307.5.peg.985","2449"
"36804",302,147,155,"AAAGCCCTGGTGAGGCTATT","AACGCCTGTATCACCGTACC","561307.5.peg.985","2449"
"36805",71,259,188,"TAAACCAGCAATAACGATT","CAACAAACCTGAGACAGCAA","561307.5.peg.985","2449"
"36806",147,259,112,"AACGCCTGTATCACCGTACC","CAACAAACCTGAGACAGCAA","561307.5.peg.985","2449"
"36807",71,302,231,"TAAACCAGCAATAACGATT","AAAGCCCTGGTGAGGCTATT","561307.5.peg.985","2449"
"36808",147,302,155,"AACGCCTGTATCACCGTACC","AAAGCCCTGGTGAGGCTATT","561307.5.peg.985","2449"
"36809",189,83,106,"ATTGATCCATACTGTCATT","AGATTAACGCGAAGATGAGA","561307.5.peg.986","2450"
"36810",312,83,229,"ATAATATCAGGTGAGGCAAT","AGATTAACGCGAAGATGAGA","561307.5.peg.986","2450"
"36811",319,83,236,"GATACCGATAATATCAGGTG","AGATTAACGCGAAGATGAGA","561307.5.peg.986","2450"
"36812",485,83,402,"CGATGATTATGAGTGTTGTC","AGATTAACGCGAAGATGAGA","561307.5.peg.986","2450"
"36813",265,83,182,"TAAACCACTCATTCCTAGTG","AGATTAACGCGAAGATGAGA","561307.5.peg.986","2450"
"36814",319,112,207,"GATACCGATAATATCAGGTG","CATACTTACCACTGAAACGA","561307.5.peg.986","2450"
"36815",312,112,200,"ATAATATCAGGTGAGGCAAT","CATACTTACCACTGAAACGA","561307.5.peg.986","2450"
"36816",265,112,153,"TAAACCACTCATTCCTAGTG","CATACTTACCACTGAAACGA","561307.5.peg.986","2450"
"36817",485,112,373,"CGATGATTATGAGTGTTGTC","CATACTTACCACTGAAACGA","561307.5.peg.986","2450"
"36818",485,156,329,"CGATGATTATGAGTGTTGTC","TACATCAGTACGCGTTGTAA","561307.5.peg.986","2450"
"36819",319,156,163,"GATACCGATAATATCAGGTG","TACATCAGTACGCGTTGTAA","561307.5.peg.986","2450"
"36820",265,156,109,"TAAACCACTCATTCCTAGTG","TACATCAGTACGCGTTGTAA","561307.5.peg.986","2450"
"36821",312,156,156,"ATAATATCAGGTGAGGCAAT","TACATCAGTACGCGTTGTAA","561307.5.peg.986","2450"
"36822",319,189,130,"GATACCGATAATATCAGGTG","ATTGATCCATACTGTCATT","561307.5.peg.986","2450"
"36823",312,189,123,"ATAATATCAGGTGAGGCAAT","ATTGATCCATACTGTCATT","561307.5.peg.986","2450"
"36824",83,189,106,"AGATTAACGCGAAGATGAGA","ATTGATCCATACTGTCATT","561307.5.peg.986","2450"
"36825",485,189,296,"CGATGATTATGAGTGTTGTC","ATTGATCCATACTGTCATT","561307.5.peg.986","2450"
"36826",83,265,182,"AGATTAACGCGAAGATGAGA","TAAACCACTCATTCCTAGTG","561307.5.peg.986","2450"
"36827",112,265,153,"CATACTTACCACTGAAACGA","TAAACCACTCATTCCTAGTG","561307.5.peg.986","2450"
"36828",156,265,109,"TACATCAGTACGCGTTGTAA","TAAACCACTCATTCCTAGTG","561307.5.peg.986","2450"
"36829",485,265,220,"CGATGATTATGAGTGTTGTC","TAAACCACTCATTCCTAGTG","561307.5.peg.986","2450"
"36830",112,312,200,"CATACTTACCACTGAAACGA","ATAATATCAGGTGAGGCAAT","561307.5.peg.986","2450"
"36831",83,312,229,"AGATTAACGCGAAGATGAGA","ATAATATCAGGTGAGGCAAT","561307.5.peg.986","2450"
"36832",189,312,123,"ATTGATCCATACTGTCATT","ATAATATCAGGTGAGGCAAT","561307.5.peg.986","2450"
"36833",156,312,156,"TACATCAGTACGCGTTGTAA","ATAATATCAGGTGAGGCAAT","561307.5.peg.986","2450"
"36834",485,312,173,"CGATGATTATGAGTGTTGTC","ATAATATCAGGTGAGGCAAT","561307.5.peg.986","2450"
"36835",83,319,236,"AGATTAACGCGAAGATGAGA","GATACCGATAATATCAGGTG","561307.5.peg.986","2450"
"36836",485,319,166,"CGATGATTATGAGTGTTGTC","GATACCGATAATATCAGGTG","561307.5.peg.986","2450"
"36837",156,319,163,"TACATCAGTACGCGTTGTAA","GATACCGATAATATCAGGTG","561307.5.peg.986","2450"
"36838",112,319,207,"CATACTTACCACTGAAACGA","GATACCGATAATATCAGGTG","561307.5.peg.986","2450"
"36839",189,319,130,"ATTGATCCATACTGTCATT","GATACCGATAATATCAGGTG","561307.5.peg.986","2450"
"36840",83,485,402,"AGATTAACGCGAAGATGAGA","CGATGATTATGAGTGTTGTC","561307.5.peg.986","2450"
"36841",112,485,373,"CATACTTACCACTGAAACGA","CGATGATTATGAGTGTTGTC","561307.5.peg.986","2450"
"36842",189,485,296,"ATTGATCCATACTGTCATT","CGATGATTATGAGTGTTGTC","561307.5.peg.986","2450"
"36843",319,485,166,"GATACCGATAATATCAGGTG","CGATGATTATGAGTGTTGTC","561307.5.peg.986","2450"
"36844",156,485,329,"TACATCAGTACGCGTTGTAA","CGATGATTATGAGTGTTGTC","561307.5.peg.986","2450"
"36845",312,485,173,"ATAATATCAGGTGAGGCAAT","CGATGATTATGAGTGTTGTC","561307.5.peg.986","2450"
"36846",265,485,220,"TAAACCACTCATTCCTAGTG","CGATGATTATGAGTGTTGTC","561307.5.peg.986","2450"
"36847",456,123,333,"TACGATCGATTAACTTAGA","CTATCCAATCCGAGATTAGG","561307.5.peg.988","2452"
"36848",456,126,330,"TACGATCGATTAACTTAGA","CCACTATCCAATCCGAGATT","561307.5.peg.988","2452"
"36849",456,201,255,"TACGATCGATTAACTTAGA","CCTACAATCACACCTAATAA","561307.5.peg.988","2452"
"36850",123,456,333,"CTATCCAATCCGAGATTAGG","TACGATCGATTAACTTAGA","561307.5.peg.988","2452"
"36851",126,456,330,"CCACTATCCAATCCGAGATT","TACGATCGATTAACTTAGA","561307.5.peg.988","2452"
"36852",201,456,255,"CCTACAATCACACCTAATAA","TACGATCGATTAACTTAGA","561307.5.peg.988","2452"
"36853",225,11,214,"GCAACATAAATTCTACCTTC","TACAATCACGACGTCGATTG","561307.5.peg.99","2454"
"36854",251,11,240,"AACCCACAATGAGTTGATCT","TACAATCACGACGTCGATTG","561307.5.peg.99","2454"
"36855",284,11,273,"GCTCAATTTCATCAGGATAG","TACAATCACGACGTCGATTG","561307.5.peg.99","2454"
"36856",120,11,109,"TCAAATCTTCGTGTGTTAA","TACAATCACGACGTCGATTG","561307.5.peg.99","2454"
"36857",327,11,316,"GCCCCCAATTCGATTAAATA","TACAATCACGACGTCGATTG","561307.5.peg.99","2454"
"36858",11,120,109,"TACAATCACGACGTCGATTG","TCAAATCTTCGTGTGTTAA","561307.5.peg.99","2454"
"36859",251,120,131,"AACCCACAATGAGTTGATCT","TCAAATCTTCGTGTGTTAA","561307.5.peg.99","2454"
"36860",284,120,164,"GCTCAATTTCATCAGGATAG","TCAAATCTTCGTGTGTTAA","561307.5.peg.99","2454"
"36861",225,120,105,"GCAACATAAATTCTACCTTC","TCAAATCTTCGTGTGTTAA","561307.5.peg.99","2454"
"36862",327,120,207,"GCCCCCAATTCGATTAAATA","TCAAATCTTCGTGTGTTAA","561307.5.peg.99","2454"
"36863",11,225,214,"TACAATCACGACGTCGATTG","GCAACATAAATTCTACCTTC","561307.5.peg.99","2454"
"36864",120,225,105,"TCAAATCTTCGTGTGTTAA","GCAACATAAATTCTACCTTC","561307.5.peg.99","2454"
"36865",327,225,102,"GCCCCCAATTCGATTAAATA","GCAACATAAATTCTACCTTC","561307.5.peg.99","2454"
"36866",120,251,131,"TCAAATCTTCGTGTGTTAA","AACCCACAATGAGTTGATCT","561307.5.peg.99","2454"
"36867",11,251,240,"TACAATCACGACGTCGATTG","AACCCACAATGAGTTGATCT","561307.5.peg.99","2454"
"36868",11,284,273,"TACAATCACGACGTCGATTG","GCTCAATTTCATCAGGATAG","561307.5.peg.99","2454"
"36869",120,284,164,"TCAAATCTTCGTGTGTTAA","GCTCAATTTCATCAGGATAG","561307.5.peg.99","2454"
"36870",11,327,316,"TACAATCACGACGTCGATTG","GCCCCCAATTCGATTAAATA","561307.5.peg.99","2454"
"36871",225,327,102,"GCAACATAAATTCTACCTTC","GCCCCCAATTCGATTAAATA","561307.5.peg.99","2454"
"36872",120,327,207,"TCAAATCTTCGTGTGTTAA","GCCCCCAATTCGATTAAATA","561307.5.peg.99","2454"
"36873",387,201,186,"TCTAAGACCCCATTTAATAC","GAACAATTGACTTGATGCAT","561307.5.peg.990","2455"
"36874",201,387,186,"GAACAATTGACTTGATGCAT","TCTAAGACCCCATTTAATAC","561307.5.peg.990","2455"
"36875",185,6,179,"TAAATTGAAGTCTTGTTCCT","GTAAAGATAAAGATAGAGG","561307.5.peg.992","2457"
"36876",216,6,210,"GATTCTTCTAATTGCTCACT","GTAAAGATAAAGATAGAGG","561307.5.peg.992","2457"
"36877",267,6,261,"TCCTCTAAACCTGAGTCAGT","GTAAAGATAAAGATAGAGG","561307.5.peg.992","2457"
"36878",6,185,179,"GTAAAGATAAAGATAGAGG","TAAATTGAAGTCTTGTTCCT","561307.5.peg.992","2457"
"36879",6,216,210,"GTAAAGATAAAGATAGAGG","GATTCTTCTAATTGCTCACT","561307.5.peg.992","2457"
"36880",6,267,261,"GTAAAGATAAAGATAGAGG","TCCTCTAAACCTGAGTCAGT","561307.5.peg.992","2457"
"36881",546,438,108,"TGTGTTGTTTGTGTTGATGC","CGAGCATATCGACGCGCAGA","561307.5.peg.993","2458"
"36882",438,546,108,"CGAGCATATCGACGCGCAGA","TGTGTTGTTTGTGTTGATGC","561307.5.peg.993","2458"
"36883",816,147,669,"TCTGAAATCATCATTTCGTA","AAATCTTCTGGTACAGATGA","561307.5.peg.994","2459"
"36884",310,147,163,"GGATTTACAGGATAAATAT","AAATCTTCTGGTACAGATGA","561307.5.peg.994","2459"
"36885",705,147,558,"GTAATAGTACGTTGTAACAT","AAATCTTCTGGTACAGATGA","561307.5.peg.994","2459"
"36886",492,147,345,"GTGTATACTCAAATGCAAT","AAATCTTCTGGTACAGATGA","561307.5.peg.994","2459"
"36887",1071,147,924,"GCTTTATGATGATCAGTCGT","AAATCTTCTGGTACAGATGA","561307.5.peg.994","2459"
"36888",1128,147,981,"TCGAAGTTAATTCCTTGACC","AAATCTTCTGGTACAGATGA","561307.5.peg.994","2459"
"36889",290,147,143,"CGGCTTTAAGATGCCCGTAT","AAATCTTCTGGTACAGATGA","561307.5.peg.994","2459"
"36890",990,147,843,"GCAACAATTTCCAAGTGACT","AAATCTTCTGGTACAGATGA","561307.5.peg.994","2459"
"36891",1098,147,951,"GCATCGCCATGTATAATAAT","AAATCTTCTGGTACAGATGA","561307.5.peg.994","2459"
"36892",870,147,723,"AACTGCAAGCTACCATCTTC","AAATCTTCTGGTACAGATGA","561307.5.peg.994","2459"
"36893",1014,147,867,"CTCGTACGCCCCTCAACAAC","AAATCTTCTGGTACAGATGA","561307.5.peg.994","2459"
"36894",1296,147,1149,"TCTGCATTGACATGGAATAT","AAATCTTCTGGTACAGATGA","561307.5.peg.994","2459"
"36895",1098,290,808,"GCATCGCCATGTATAATAAT","CGGCTTTAAGATGCCCGTAT","561307.5.peg.994","2459"
"36896",492,290,202,"GTGTATACTCAAATGCAAT","CGGCTTTAAGATGCCCGTAT","561307.5.peg.994","2459"
"36897",990,290,700,"GCAACAATTTCCAAGTGACT","CGGCTTTAAGATGCCCGTAT","561307.5.peg.994","2459"
"36898",1014,290,724,"CTCGTACGCCCCTCAACAAC","CGGCTTTAAGATGCCCGTAT","561307.5.peg.994","2459"
"36899",816,290,526,"TCTGAAATCATCATTTCGTA","CGGCTTTAAGATGCCCGTAT","561307.5.peg.994","2459"
"36900",705,290,415,"GTAATAGTACGTTGTAACAT","CGGCTTTAAGATGCCCGTAT","561307.5.peg.994","2459"
"36901",870,290,580,"AACTGCAAGCTACCATCTTC","CGGCTTTAAGATGCCCGTAT","561307.5.peg.994","2459"
"36902",1296,290,1006,"TCTGCATTGACATGGAATAT","CGGCTTTAAGATGCCCGTAT","561307.5.peg.994","2459"
"36903",1128,290,838,"TCGAAGTTAATTCCTTGACC","CGGCTTTAAGATGCCCGTAT","561307.5.peg.994","2459"
"36904",1071,290,781,"GCTTTATGATGATCAGTCGT","CGGCTTTAAGATGCCCGTAT","561307.5.peg.994","2459"
"36905",147,290,143,"AAATCTTCTGGTACAGATGA","CGGCTTTAAGATGCCCGTAT","561307.5.peg.994","2459"
"36906",147,310,163,"AAATCTTCTGGTACAGATGA","GGATTTACAGGATAAATAT","561307.5.peg.994","2459"
"36907",1128,310,818,"TCGAAGTTAATTCCTTGACC","GGATTTACAGGATAAATAT","561307.5.peg.994","2459"
"36908",816,310,506,"TCTGAAATCATCATTTCGTA","GGATTTACAGGATAAATAT","561307.5.peg.994","2459"
"36909",1071,310,761,"GCTTTATGATGATCAGTCGT","GGATTTACAGGATAAATAT","561307.5.peg.994","2459"
"36910",492,310,182,"GTGTATACTCAAATGCAAT","GGATTTACAGGATAAATAT","561307.5.peg.994","2459"
"36911",870,310,560,"AACTGCAAGCTACCATCTTC","GGATTTACAGGATAAATAT","561307.5.peg.994","2459"
"36912",705,310,395,"GTAATAGTACGTTGTAACAT","GGATTTACAGGATAAATAT","561307.5.peg.994","2459"
"36913",1014,310,704,"CTCGTACGCCCCTCAACAAC","GGATTTACAGGATAAATAT","561307.5.peg.994","2459"
"36914",1098,310,788,"GCATCGCCATGTATAATAAT","GGATTTACAGGATAAATAT","561307.5.peg.994","2459"
"36915",990,310,680,"GCAACAATTTCCAAGTGACT","GGATTTACAGGATAAATAT","561307.5.peg.994","2459"
"36916",1296,310,986,"TCTGCATTGACATGGAATAT","GGATTTACAGGATAAATAT","561307.5.peg.994","2459"
"36917",1128,492,636,"TCGAAGTTAATTCCTTGACC","GTGTATACTCAAATGCAAT","561307.5.peg.994","2459"
"36918",705,492,213,"GTAATAGTACGTTGTAACAT","GTGTATACTCAAATGCAAT","561307.5.peg.994","2459"
"36919",870,492,378,"AACTGCAAGCTACCATCTTC","GTGTATACTCAAATGCAAT","561307.5.peg.994","2459"
"36920",147,492,345,"AAATCTTCTGGTACAGATGA","GTGTATACTCAAATGCAAT","561307.5.peg.994","2459"
"36921",310,492,182,"GGATTTACAGGATAAATAT","GTGTATACTCAAATGCAAT","561307.5.peg.994","2459"
"36922",1014,492,522,"CTCGTACGCCCCTCAACAAC","GTGTATACTCAAATGCAAT","561307.5.peg.994","2459"
"36923",816,492,324,"TCTGAAATCATCATTTCGTA","GTGTATACTCAAATGCAAT","561307.5.peg.994","2459"
"36924",290,492,202,"CGGCTTTAAGATGCCCGTAT","GTGTATACTCAAATGCAAT","561307.5.peg.994","2459"
"36925",1296,492,804,"TCTGCATTGACATGGAATAT","GTGTATACTCAAATGCAAT","561307.5.peg.994","2459"
"36926",1071,492,579,"GCTTTATGATGATCAGTCGT","GTGTATACTCAAATGCAAT","561307.5.peg.994","2459"
"36927",990,492,498,"GCAACAATTTCCAAGTGACT","GTGTATACTCAAATGCAAT","561307.5.peg.994","2459"
"36928",1098,492,606,"GCATCGCCATGTATAATAAT","GTGTATACTCAAATGCAAT","561307.5.peg.994","2459"
"36929",147,705,558,"AAATCTTCTGGTACAGATGA","GTAATAGTACGTTGTAACAT","561307.5.peg.994","2459"
"36930",1128,705,423,"TCGAAGTTAATTCCTTGACC","GTAATAGTACGTTGTAACAT","561307.5.peg.994","2459"
"36931",290,705,415,"CGGCTTTAAGATGCCCGTAT","GTAATAGTACGTTGTAACAT","561307.5.peg.994","2459"
"36932",492,705,213,"GTGTATACTCAAATGCAAT","GTAATAGTACGTTGTAACAT","561307.5.peg.994","2459"
"36933",1296,705,591,"TCTGCATTGACATGGAATAT","GTAATAGTACGTTGTAACAT","561307.5.peg.994","2459"
"36934",1014,705,309,"CTCGTACGCCCCTCAACAAC","GTAATAGTACGTTGTAACAT","561307.5.peg.994","2459"
"36935",816,705,111,"TCTGAAATCATCATTTCGTA","GTAATAGTACGTTGTAACAT","561307.5.peg.994","2459"
"36936",990,705,285,"GCAACAATTTCCAAGTGACT","GTAATAGTACGTTGTAACAT","561307.5.peg.994","2459"
"36937",310,705,395,"GGATTTACAGGATAAATAT","GTAATAGTACGTTGTAACAT","561307.5.peg.994","2459"
"36938",870,705,165,"AACTGCAAGCTACCATCTTC","GTAATAGTACGTTGTAACAT","561307.5.peg.994","2459"
"36939",1071,705,366,"GCTTTATGATGATCAGTCGT","GTAATAGTACGTTGTAACAT","561307.5.peg.994","2459"
"36940",1098,705,393,"GCATCGCCATGTATAATAAT","GTAATAGTACGTTGTAACAT","561307.5.peg.994","2459"
"36941",1071,816,255,"GCTTTATGATGATCAGTCGT","TCTGAAATCATCATTTCGTA","561307.5.peg.994","2459"
"36942",1014,816,198,"CTCGTACGCCCCTCAACAAC","TCTGAAATCATCATTTCGTA","561307.5.peg.994","2459"
"36943",990,816,174,"GCAACAATTTCCAAGTGACT","TCTGAAATCATCATTTCGTA","561307.5.peg.994","2459"
"36944",705,816,111,"GTAATAGTACGTTGTAACAT","TCTGAAATCATCATTTCGTA","561307.5.peg.994","2459"
"36945",290,816,526,"CGGCTTTAAGATGCCCGTAT","TCTGAAATCATCATTTCGTA","561307.5.peg.994","2459"
"36946",1098,816,282,"GCATCGCCATGTATAATAAT","TCTGAAATCATCATTTCGTA","561307.5.peg.994","2459"
"36947",492,816,324,"GTGTATACTCAAATGCAAT","TCTGAAATCATCATTTCGTA","561307.5.peg.994","2459"
"36948",310,816,506,"GGATTTACAGGATAAATAT","TCTGAAATCATCATTTCGTA","561307.5.peg.994","2459"
"36949",1128,816,312,"TCGAAGTTAATTCCTTGACC","TCTGAAATCATCATTTCGTA","561307.5.peg.994","2459"
"36950",147,816,669,"AAATCTTCTGGTACAGATGA","TCTGAAATCATCATTTCGTA","561307.5.peg.994","2459"
"36951",1296,816,480,"TCTGCATTGACATGGAATAT","TCTGAAATCATCATTTCGTA","561307.5.peg.994","2459"
"36952",1071,870,201,"GCTTTATGATGATCAGTCGT","AACTGCAAGCTACCATCTTC","561307.5.peg.994","2459"
"36953",1014,870,144,"CTCGTACGCCCCTCAACAAC","AACTGCAAGCTACCATCTTC","561307.5.peg.994","2459"
"36954",290,870,580,"CGGCTTTAAGATGCCCGTAT","AACTGCAAGCTACCATCTTC","561307.5.peg.994","2459"
"36955",492,870,378,"GTGTATACTCAAATGCAAT","AACTGCAAGCTACCATCTTC","561307.5.peg.994","2459"
"36956",147,870,723,"AAATCTTCTGGTACAGATGA","AACTGCAAGCTACCATCTTC","561307.5.peg.994","2459"
"36957",310,870,560,"GGATTTACAGGATAAATAT","AACTGCAAGCTACCATCTTC","561307.5.peg.994","2459"
"36958",705,870,165,"GTAATAGTACGTTGTAACAT","AACTGCAAGCTACCATCTTC","561307.5.peg.994","2459"
"36959",990,870,120,"GCAACAATTTCCAAGTGACT","AACTGCAAGCTACCATCTTC","561307.5.peg.994","2459"
"36960",1296,870,426,"TCTGCATTGACATGGAATAT","AACTGCAAGCTACCATCTTC","561307.5.peg.994","2459"
"36961",1098,870,228,"GCATCGCCATGTATAATAAT","AACTGCAAGCTACCATCTTC","561307.5.peg.994","2459"
"36962",1128,870,258,"TCGAAGTTAATTCCTTGACC","AACTGCAAGCTACCATCTTC","561307.5.peg.994","2459"
"36963",816,990,174,"TCTGAAATCATCATTTCGTA","GCAACAATTTCCAAGTGACT","561307.5.peg.994","2459"
"36964",147,990,843,"AAATCTTCTGGTACAGATGA","GCAACAATTTCCAAGTGACT","561307.5.peg.994","2459"
"36965",870,990,120,"AACTGCAAGCTACCATCTTC","GCAACAATTTCCAAGTGACT","561307.5.peg.994","2459"
"36966",310,990,680,"GGATTTACAGGATAAATAT","GCAACAATTTCCAAGTGACT","561307.5.peg.994","2459"
"36967",705,990,285,"GTAATAGTACGTTGTAACAT","GCAACAATTTCCAAGTGACT","561307.5.peg.994","2459"
"36968",1128,990,138,"TCGAAGTTAATTCCTTGACC","GCAACAATTTCCAAGTGACT","561307.5.peg.994","2459"
"36969",1098,990,108,"GCATCGCCATGTATAATAAT","GCAACAATTTCCAAGTGACT","561307.5.peg.994","2459"
"36970",492,990,498,"GTGTATACTCAAATGCAAT","GCAACAATTTCCAAGTGACT","561307.5.peg.994","2459"
"36971",1296,990,306,"TCTGCATTGACATGGAATAT","GCAACAATTTCCAAGTGACT","561307.5.peg.994","2459"
"36972",290,990,700,"CGGCTTTAAGATGCCCGTAT","GCAACAATTTCCAAGTGACT","561307.5.peg.994","2459"
"36973",816,1014,198,"TCTGAAATCATCATTTCGTA","CTCGTACGCCCCTCAACAAC","561307.5.peg.994","2459"
"36974",310,1014,704,"GGATTTACAGGATAAATAT","CTCGTACGCCCCTCAACAAC","561307.5.peg.994","2459"
"36975",705,1014,309,"GTAATAGTACGTTGTAACAT","CTCGTACGCCCCTCAACAAC","561307.5.peg.994","2459"
"36976",492,1014,522,"GTGTATACTCAAATGCAAT","CTCGTACGCCCCTCAACAAC","561307.5.peg.994","2459"
"36977",147,1014,867,"AAATCTTCTGGTACAGATGA","CTCGTACGCCCCTCAACAAC","561307.5.peg.994","2459"
"36978",290,1014,724,"CGGCTTTAAGATGCCCGTAT","CTCGTACGCCCCTCAACAAC","561307.5.peg.994","2459"
"36979",1128,1014,114,"TCGAAGTTAATTCCTTGACC","CTCGTACGCCCCTCAACAAC","561307.5.peg.994","2459"
"36980",870,1014,144,"AACTGCAAGCTACCATCTTC","CTCGTACGCCCCTCAACAAC","561307.5.peg.994","2459"
"36981",1296,1014,282,"TCTGCATTGACATGGAATAT","CTCGTACGCCCCTCAACAAC","561307.5.peg.994","2459"
"36982",492,1071,579,"GTGTATACTCAAATGCAAT","GCTTTATGATGATCAGTCGT","561307.5.peg.994","2459"
"36983",147,1071,924,"AAATCTTCTGGTACAGATGA","GCTTTATGATGATCAGTCGT","561307.5.peg.994","2459"
"36984",816,1071,255,"TCTGAAATCATCATTTCGTA","GCTTTATGATGATCAGTCGT","561307.5.peg.994","2459"
"36985",1296,1071,225,"TCTGCATTGACATGGAATAT","GCTTTATGATGATCAGTCGT","561307.5.peg.994","2459"
"36986",290,1071,781,"CGGCTTTAAGATGCCCGTAT","GCTTTATGATGATCAGTCGT","561307.5.peg.994","2459"
"36987",870,1071,201,"AACTGCAAGCTACCATCTTC","GCTTTATGATGATCAGTCGT","561307.5.peg.994","2459"
"36988",705,1071,366,"GTAATAGTACGTTGTAACAT","GCTTTATGATGATCAGTCGT","561307.5.peg.994","2459"
"36989",310,1071,761,"GGATTTACAGGATAAATAT","GCTTTATGATGATCAGTCGT","561307.5.peg.994","2459"
"36990",870,1098,228,"AACTGCAAGCTACCATCTTC","GCATCGCCATGTATAATAAT","561307.5.peg.994","2459"
"36991",1296,1098,198,"TCTGCATTGACATGGAATAT","GCATCGCCATGTATAATAAT","561307.5.peg.994","2459"
"36992",990,1098,108,"GCAACAATTTCCAAGTGACT","GCATCGCCATGTATAATAAT","561307.5.peg.994","2459"
"36993",290,1098,808,"CGGCTTTAAGATGCCCGTAT","GCATCGCCATGTATAATAAT","561307.5.peg.994","2459"
"36994",816,1098,282,"TCTGAAATCATCATTTCGTA","GCATCGCCATGTATAATAAT","561307.5.peg.994","2459"
"36995",705,1098,393,"GTAATAGTACGTTGTAACAT","GCATCGCCATGTATAATAAT","561307.5.peg.994","2459"
"36996",310,1098,788,"GGATTTACAGGATAAATAT","GCATCGCCATGTATAATAAT","561307.5.peg.994","2459"
"36997",147,1098,951,"AAATCTTCTGGTACAGATGA","GCATCGCCATGTATAATAAT","561307.5.peg.994","2459"
"36998",492,1098,606,"GTGTATACTCAAATGCAAT","GCATCGCCATGTATAATAAT","561307.5.peg.994","2459"
"36999",310,1128,818,"GGATTTACAGGATAAATAT","TCGAAGTTAATTCCTTGACC","561307.5.peg.994","2459"
"37000",870,1128,258,"AACTGCAAGCTACCATCTTC","TCGAAGTTAATTCCTTGACC","561307.5.peg.994","2459"
"37001",816,1128,312,"TCTGAAATCATCATTTCGTA","TCGAAGTTAATTCCTTGACC","561307.5.peg.994","2459"
"37002",1014,1128,114,"CTCGTACGCCCCTCAACAAC","TCGAAGTTAATTCCTTGACC","561307.5.peg.994","2459"
"37003",147,1128,981,"AAATCTTCTGGTACAGATGA","TCGAAGTTAATTCCTTGACC","561307.5.peg.994","2459"
"37004",990,1128,138,"GCAACAATTTCCAAGTGACT","TCGAAGTTAATTCCTTGACC","561307.5.peg.994","2459"
"37005",492,1128,636,"GTGTATACTCAAATGCAAT","TCGAAGTTAATTCCTTGACC","561307.5.peg.994","2459"
"37006",1296,1128,168,"TCTGCATTGACATGGAATAT","TCGAAGTTAATTCCTTGACC","561307.5.peg.994","2459"
"37007",290,1128,838,"CGGCTTTAAGATGCCCGTAT","TCGAAGTTAATTCCTTGACC","561307.5.peg.994","2459"
"37008",705,1128,423,"GTAATAGTACGTTGTAACAT","TCGAAGTTAATTCCTTGACC","561307.5.peg.994","2459"
"37009",870,1296,426,"AACTGCAAGCTACCATCTTC","TCTGCATTGACATGGAATAT","561307.5.peg.994","2459"
"37010",1098,1296,198,"GCATCGCCATGTATAATAAT","TCTGCATTGACATGGAATAT","561307.5.peg.994","2459"
"37011",147,1296,1149,"AAATCTTCTGGTACAGATGA","TCTGCATTGACATGGAATAT","561307.5.peg.994","2459"
"37012",705,1296,591,"GTAATAGTACGTTGTAACAT","TCTGCATTGACATGGAATAT","561307.5.peg.994","2459"
"37013",310,1296,986,"GGATTTACAGGATAAATAT","TCTGCATTGACATGGAATAT","561307.5.peg.994","2459"
"37014",1071,1296,225,"GCTTTATGATGATCAGTCGT","TCTGCATTGACATGGAATAT","561307.5.peg.994","2459"
"37015",290,1296,1006,"CGGCTTTAAGATGCCCGTAT","TCTGCATTGACATGGAATAT","561307.5.peg.994","2459"
"37016",816,1296,480,"TCTGAAATCATCATTTCGTA","TCTGCATTGACATGGAATAT","561307.5.peg.994","2459"
"37017",990,1296,306,"GCAACAATTTCCAAGTGACT","TCTGCATTGACATGGAATAT","561307.5.peg.994","2459"
"37018",1128,1296,168,"TCGAAGTTAATTCCTTGACC","TCTGCATTGACATGGAATAT","561307.5.peg.994","2459"
"37019",1014,1296,282,"CTCGTACGCCCCTCAACAAC","TCTGCATTGACATGGAATAT","561307.5.peg.994","2459"
"37020",492,1296,804,"GTGTATACTCAAATGCAAT","TCTGCATTGACATGGAATAT","561307.5.peg.994","2459"
"37021",432,12,420,"TGAAATCTTGCGTTGTAAT","TTGAAACAGTTCGTGGCGTT","561307.5.peg.995","2460"
"37022",354,12,342,"AAATAACGGTGTTCATAACC","TTGAAACAGTTCGTGGCGTT","561307.5.peg.995","2460"
"37023",597,12,585,"TATTTGATAAACTGACAAG","TTGAAACAGTTCGTGGCGTT","561307.5.peg.995","2460"
"37024",354,91,263,"AAATAACGGTGTTCATAACC","CGTGACAAACGTAATCATCG","561307.5.peg.995","2460"
"37025",597,91,506,"TATTTGATAAACTGACAAG","CGTGACAAACGTAATCATCG","561307.5.peg.995","2460"
"37026",432,91,341,"TGAAATCTTGCGTTGTAAT","CGTGACAAACGTAATCATCG","561307.5.peg.995","2460"
"37027",12,354,342,"TTGAAACAGTTCGTGGCGTT","AAATAACGGTGTTCATAACC","561307.5.peg.995","2460"
"37028",597,354,243,"TATTTGATAAACTGACAAG","AAATAACGGTGTTCATAACC","561307.5.peg.995","2460"
"37029",91,354,263,"CGTGACAAACGTAATCATCG","AAATAACGGTGTTCATAACC","561307.5.peg.995","2460"
"37030",12,432,420,"TTGAAACAGTTCGTGGCGTT","TGAAATCTTGCGTTGTAAT","561307.5.peg.995","2460"
"37031",597,432,165,"TATTTGATAAACTGACAAG","TGAAATCTTGCGTTGTAAT","561307.5.peg.995","2460"
"37032",91,432,341,"CGTGACAAACGTAATCATCG","TGAAATCTTGCGTTGTAAT","561307.5.peg.995","2460"
"37033",12,597,585,"TTGAAACAGTTCGTGGCGTT","TATTTGATAAACTGACAAG","561307.5.peg.995","2460"
"37034",91,597,506,"CGTGACAAACGTAATCATCG","TATTTGATAAACTGACAAG","561307.5.peg.995","2460"
"37035",354,597,243,"AAATAACGGTGTTCATAACC","TATTTGATAAACTGACAAG","561307.5.peg.995","2460"
"37036",432,597,165,"TGAAATCTTGCGTTGTAAT","TATTTGATAAACTGACAAG","561307.5.peg.995","2460"
"37037",119,10,109,"ATTTCCCAAGTCTTGATTCG","AGACGCATTGAATTAATGGG","561307.5.peg.997","2462"
"37038",119,12,107,"ATTTCCCAAGTCTTGATTCG","AAAGACGCATTGAATTAATG","561307.5.peg.997","2462"
"37039",10,119,109,"AGACGCATTGAATTAATGGG","ATTTCCCAAGTCTTGATTCG","561307.5.peg.997","2462"
"37040",12,119,107,"AAAGACGCATTGAATTAATG","ATTTCCCAAGTCTTGATTCG","561307.5.peg.997","2462"
"37041",432,70,362,"GCTATCTTATTCGCTAATCC","GTGTCCAACTGTTCCCCCTC","561307.5.peg.998","2463"
"37042",70,432,362,"GTGTCCAACTGTTCCCCCTC","GCTATCTTATTCGCTAATCC","561307.5.peg.998","2463"
